CaseID,ActivityString,Duration,TimeSinceLastEvent,Timestamp,PlannedDuration,PlannedTimestamp,InstanceID,StartTime,FinishedActivity
0,AE,218,218,218,199,199,0,0,A
0,BE,215,215,433,210,409,0,218,B
0,CE,736,736,1169,935,1344,0,433,C
0,DE,1539,1539,2708,840,2184,0,1169,D
0,E,2880,172,2880,3315,3315,0,0,E
0,F,696,696,3576,300,3615,0,2880,F
0,G,515,515,4091,1965,5580,0,3576,G
0,H,1280,1280,5371,2760,8340,0,4091,H
0,M,7559,7559,12930,9919,18259,0,5371,M
0,N,2865,2865,15795,240,18499,0,12930,N
0,O,1265,1265,17060,1330,19829,0,15795,O
0,P,434,434,17494,780,20609,0,17060,P
1,AE,584,584,584,844,844,1,0,A
1,BE,297,297,881,90,934,1,584,B
1,CE,1415,1415,2296,1935,2869,1,881,C
1,DE,2888,592,2888,2964,2964,1,0,E
1,DF,239,239,3127,180,3144,1,2888,F
1,DG,756,756,3883,970,4114,1,3127,G
1,DF,331,331,4214,160,4274,1,3883,F
1,DG,1142,1142,5356,1080,5354,1,4214,G
1,DH,5790,2730,8086,3780,6649,1,2296,D
1,H,6628,3898,11984,7020,12374,1,5356,H
1,M,3016,3016,15000,3030,15404,1,11984,M
1,N,286,286,15286,300,15704,1,15000,N
1,O,526,526,15812,835,16539,1,15286,O
1,P,445,445,16257,3870,20409,1,15812,P
2,A,4119,4119,4119,4380,4380,2,0,A
2,B,280,280,4399,90,4470,2,4119,B
2,C,547,547,4946,905,5375,2,4399,C
2,D,321,321,5267,3780,9155,2,4946,D
2,M,642,642,5909,1433,10588,2,5267,M
2,N,969,969,6878,240,10828,2,5909,N
2,O,1280,1280,8158,1200,12028,2,6878,O
2,P,1520,1520,9678,550,12578,2,8158,P
3,A,169,169,169,759,759,3,0,A
3,B,777,777,946,240,999,3,169,B
3,C,577,577,1523,340,1339,3,946,C
3,B,1109,1109,2632,1340,2679,3,1523,B
3,C,820,820,3452,1240,3919,3,2632,C
3,D,535,535,3987,335,4254,3,3452,D
3,M,3176,3176,7163,3963,8217,3,3987,M
3,N,883,883,8046,90,8307,3,7163,N
3,O,956,956,9002,815,9122,3,8046,O
3,P,159,159,9161,3780,12902,3,9002,P
4,A,1485,1485,1485,1597,1597,4,0,A
4,B,241,241,1726,150,1747,4,1485,B
4,C,612,612,2338,585,2332,4,1726,C
4,B,289,289,2627,340,2672,4,2338,B
4,C,135,135,2762,130,2802,4,2627,C
4,D,1255,1255,4017,4230,7032,4,2762,D
4,M,179,179,4196,152,7184,4,4017,M
4,N,131,131,4327,180,7364,4,4196,N
4,O,167,167,4494,230,7594,4,4327,O
4,N,872,872,5366,810,8404,4,4494,N
4,O,346,346,5712,740,9144,4,5366,O
4,P,4797,4797,10509,4140,13284,4,5712,P
5,AE,59,59,59,59,59,5,0,E
5,AF,98,39,98,181,181,5,0,A
5,BF,259,259,357,240,421,5,98,B
5,CF,223,223,580,215,636,5,357,C
5,DF,115,115,695,4890,5526,5,580,D
5,F,1934,1298,1993,525,584,5,59,F
5,G,2270,2270,4263,3615,4199,5,1993,G
5,H,21025,21025,25288,3960,8159,5,4263,H
5,M,29,29,25317,136,8295,5,25288,M
5,N,308,308,25625,240,8535,5,25317,N
5,O,682,682,26307,960,9495,5,25625,O
5,P,467,467,26774,3960,13455,5,26307,P
6,AEI,33,33,33,252,252,6,0,E
6,AFI,153,120,153,250,250,6,0,I
6,AFJ,212,59,212,1300,1300,6,0,A
6,BFJ,181,122,334,150,400,6,153,J
6,BFK,399,98,432,240,492,6,33,F
6,BGK,181,83,515,525,925,6,334,K
6,BGJ,164,81,596,275,767,6,432,G
6,BHJ,764,683,1279,415,1340,6,515,J
6,BHK,727,44,1323,5070,5837,6,596,H
6,BK,108,64,1387,80,1420,6,1279,K
6,BL,1267,92,1479,240,1540,6,212,B
6,CL,135,135,1614,270,1810,6,1479,C
6,DL,1258,1031,2645,2880,4300,6,1387,L
6,D,2161,1130,3775,5070,6880,6,1614,D
6,M,81,81,3856,329,7209,6,3775,M
6,N,763,763,4619,570,7779,6,3856,N
6,O,79,79,4698,80,7859,6,4619,O
6,P,151,151,4849,2880,10739,6,4698,P
7,AE,87,87,87,139,139,7,0,A
7,BE,110,23,110,303,303,7,0,E
7,BF,232,209,319,240,379,7,87,B
7,CF,154,154,473,255,634,7,319,C
7,BF,371,8,481,240,543,7,110,F
7,BG,143,143,624,215,758,7,481,G
7,BH,563,412,1036,460,1094,7,473,B
7,CH,182,182,1218,215,1309,7,1036,C
7,DH,919,325,1543,4890,5648,7,624,H
7,D,374,49,1592,4890,6199,7,1218,D
7,M,19,19,1611,119,6318,7,1592,M
7,N,298,298,1909,240,6558,7,1611,N
7,O,678,678,2587,960,7518,7,1909,O
7,P,161,161,2748,3960,11478,7,2587,P
8,A,68,68,68,387,387,8,0,A
8,B,514,514,582,240,627,8,68,B
8,C,219,219,801,285,912,8,582,C
8,D,1170,1170,1971,5160,6072,8,801,D
8,M,1074,1074,3045,933,7005,8,1971,M
8,N,677,677,3722,180,7185,8,3045,N
8,O,695,695,4417,885,8070,8,3722,O
8,P,2830,2830,7247,6680,14750,8,4417,P
9,A,6013,6013,6013,6145,6145,9,0,A
9,B,385,385,6398,300,6445,9,6013,B
9,C,635,635,7033,810,7255,9,6398,C
9,D,672,672,7705,1560,8815,9,7033,D
9,M,336,336,8041,495,9310,9,7705,M
9,N,481,481,8522,300,9610,9,8041,N
9,O,625,625,9147,820,10430,9,8522,O
9,P,218,218,9365,3960,14390,9,9147,P
10,AE,96,96,96,748,748,10,0,A
10,BE,154,58,154,231,231,10,0,E
10,BF,187,187,341,150,381,10,154,F
10,BG,758,513,854,150,898,10,96,B
10,CG,643,130,984,620,1001,10,341,G
10,CH,152,22,1006,395,1293,10,854,C
10,DH,193,193,1199,3960,5253,10,1006,D
10,H,282,67,1266,4200,5201,10,984,H
10,M,1088,1088,2354,1580,6833,10,1266,M
10,N,685,685,3039,240,7073,10,2354,N
10,O,581,581,3620,905,7978,10,3039,O
10,P,223,223,3843,3960,11938,10,3620,P
11,A,1157,1157,1157,1415,1415,11,0,A
11,B,346,346,1503,150,1565,11,1157,B
11,C,179,179,1682,280,1845,11,1503,C
11,D,977,977,2659,5160,7005,11,1682,D
11,M,591,591,3250,730,7735,11,2659,M
11,N,257,257,3507,180,7915,11,3250,N
11,O,127,127,3634,145,8060,11,3507,O
11,P,20,20,3654,2880,10940,11,3634,P
12,AEI,112,112,112,898,898,12,0,A
12,BEI,216,104,216,227,227,12,0,I
12,BEJ,310,94,310,974,974,12,0,E
12,BFJ,102,8,318,150,377,12,216,J
12,BFK,187,187,505,455,832,12,318,K
12,BFL,965,572,1077,240,1138,12,112,B
12,CFL,845,78,1155,240,1214,12,310,F
12,CGL,186,108,1263,415,1553,12,1077,C
12,DGL,11,11,1274,6715,8268,12,1263,D
12,GL,157,38,1312,415,1629,12,1155,G
12,HL,47,47,1359,5160,6789,12,1312,H
12,L,869,15,1374,5005,5837,12,505,L
12,M,59,59,1433,238,8506,12,1374,M
12,N,254,254,1687,135,8641,12,1433,N
12,O,319,319,2006,280,8921,12,1687,O
12,P,140,140,2146,5160,14081,12,2006,P
13,AE,733,733,733,1499,1499,13,0,E
13,AF,1059,1059,1792,300,1799,13,733,F
13,AG,759,759,2551,970,2769,13,1792,G
13,AH,3004,453,3004,3140,3140,13,0,A
13,BH,324,324,3328,240,3380,13,3004,B
13,CH,1320,543,3871,3960,6729,13,2551,H
13,C,808,265,4136,995,4375,13,3328,C
13,D,200,200,4336,3960,8335,13,4136,D
13,M,40,40,4376,395,8730,13,4336,M
13,N,475,475,4851,165,8895,13,4376,N
13,O,1058,1058,5909,1275,10170,13,4851,O
13,P,934,934,6843,3960,14130,13,5909,P
14,AEI,136,136,136,142,142,14,0,A
14,BEI,182,182,318,240,382,14,136,B
14,CEI,538,220,538,447,447,14,0,I
14,CEJ,36,36,574,180,627,14,538,J
14,CEK,1093,837,1411,1085,1467,14,318,C
14,DEK,987,150,1561,935,1562,14,574,K
14,DEL,289,139,1700,550,2017,14,1411,D
14,EL,1814,114,1814,2331,2331,14,0,E
14,FL,693,440,2254,385,1947,14,1561,L
14,F,653,213,2467,180,2511,14,1814,F
14,G,917,917,3384,890,3401,14,2467,G
14,H,1528,1528,4912,550,3951,14,3384,H
14,M,133,133,5045,405,4356,14,4912,M
14,N,406,406,5451,180,4536,14,5045,N
14,O,749,749,6200,840,5376,14,5451,O
14,P,164,164,6364,6680,12056,14,6200,P
15,A,413,413,413,1081,1081,15,0,A
15,B,859,859,1272,180,1261,15,413,B
15,C,928,928,2200,1575,2836,15,1272,C
15,B,1531,1531,3731,1014,3850,15,2200,B
15,C,1282,1282,5013,961,4811,15,3731,C
15,D,687,687,5700,9720,14531,15,5013,D
15,M,36949,36949,42649,37994,52525,15,5700,M
15,N,1075,1075,43724,90,52615,15,42649,N
15,O,983,983,44707,1210,53825,15,43724,O
15,P,11,11,44718,3780,57605,15,44707,P
16,AE,254,254,254,778,778,16,0,A
16,BE,792,538,792,1191,1191,16,0,E
16,BF,894,356,1148,420,1198,16,254,B
16,CF,792,436,1584,420,1611,16,792,F
16,CG,1353,1353,2937,1411,3022,16,1584,G
16,CH,2375,586,3523,1410,2608,16,1148,C
16,DH,580,580,4103,320,2928,16,3523,D
16,H,2110,944,5047,604,3626,16,2937,H
16,M,2589,2589,7636,2931,6557,16,5047,M
16,N,532,532,8168,240,6797,16,7636,N
16,O,720,720,8888,920,7717,16,8168,O
16,P,108,108,8996,3960,11677,16,8888,P
17,AE,1315,1315,1315,3366,3366,17,0,E
17,AF,2099,2099,3414,90,3456,17,1315,F
17,AG,840,840,4254,1250,4706,17,3414,G
17,AH,427,427,4681,3780,8486,17,4254,H
17,A,26485,21804,26485,27415,27415,17,0,A
17,B,963,963,27448,90,27505,17,26485,B
17,C,1027,1027,28475,1220,28725,17,27448,C
17,D,5,5,28480,3780,32505,17,28475,D
17,M,390,390,28870,927,33432,17,28480,M
17,N,565,565,29435,90,33522,17,28870,N
17,O,1527,1527,30962,2320,35842,17,29435,O
17,P,1681,1681,32643,3420,39262,17,30962,P
18,A,140,140,140,671,671,18,0,A
18,B,713,713,853,240,911,18,140,B
18,C,381,381,1234,280,1191,18,853,C
18,D,2959,2959,4193,5160,6351,18,1234,D
18,M,1730,1730,5923,3180,9531,18,4193,M
18,N,1590,1590,7513,90,9621,18,5923,N
18,O,733,733,8246,1240,10861,18,7513,O
18,N,409,409,8655,5,10866,18,8246,N
18,O,635,635,9290,935,11801,18,8655,O
18,P,1115,1115,10405,3780,15581,18,9290,P
19,AE,488,488,488,518,518,19,0,E
19,AF,140,140,628,170,688,19,488,F
19,AG,543,543,1171,465,1153,19,628,G
19,AF,1150,1150,2321,1210,2363,19,1171,F
19,AG,808,808,3129,920,3283,19,2321,G
19,AH,1037,1037,4166,1175,4458,19,3129,H
19,A,4568,402,4568,5442,5442,19,0,A
19,B,934,934,5502,120,5562,19,4568,B
19,C,260,260,5762,420,5982,19,5502,C
19,B,655,655,6417,495,6477,19,5762,B
19,C,688,688,7105,810,7287,19,6417,C
19,D,3013,3013,10118,5040,12327,19,7105,D
19,M,1283,1283,11401,1317,13644,19,10118,M
19,N,629,629,12030,360,14004,19,11401,N
19,O,784,784,12814,700,14704,19,12030,O
19,P,492,492,13306,550,15254,19,12814,P
20,AE,53,53,53,302,302,20,0,E
20,AF,167,114,167,327,327,20,0,A
20,BF,268,154,321,90,392,20,53,F
20,BG,278,124,445,90,417,20,167,B
20,CG,562,438,883,1010,1402,20,321,G
20,CH,584,146,1029,1010,1427,20,445,C
20,DH,260,114,1143,3780,5182,20,883,H
20,D,358,244,1387,3780,5207,20,1029,D
20,M,52,52,1439,606,5813,20,1387,M
20,N,763,763,2202,240,6053,20,1439,N
20,O,542,542,2744,810,6863,20,2202,O
20,P,7005,7005,9749,3960,10823,20,2744,P
21,A,116,116,116,249,249,21,0,A
21,B,223,223,339,150,399,21,116,B
21,C,155,155,494,385,784,21,339,C
21,D,3518,3518,4012,3160,3944,21,494,D
21,M,16,16,4028,82,4026,21,4012,M
21,N,138,138,4166,135,4161,21,4028,N
21,O,157,157,4323,285,4446,21,4166,O
21,P,432,432,4755,5160,9606,21,4323,P
22,AEI,34,34,34,47,47,22,0,E
22,AFI,100,100,134,150,197,22,34,F
22,AGI,234,100,234,2127,2127,22,0,A
22,BGI,189,89,323,455,652,22,134,G
22,BHI,410,87,410,1252,1252,22,0,I
22,BHJ,873,786,1196,5005,5657,22,323,H
22,BJ,932,146,1342,150,1402,22,410,J
22,BK,72,72,1414,350,1752,22,1342,K
22,BL,236,236,1650,2880,4632,22,1414,L
22,B,2158,742,2392,300,2427,22,234,B
22,C,783,783,3175,705,3132,22,2392,C
22,D,1459,1459,4634,5400,8532,22,3175,D
22,M,34,34,4668,139,8671,22,4634,M
22,N,292,292,4960,240,8911,22,4668,N
22,O,867,867,5827,945,9856,22,4960,O
22,P,2060,2060,7887,5160,15016,22,5827,P
23,AE,172,172,172,287,287,23,0,A
23,BE,179,179,351,150,437,23,172,B
23,CE,426,75,426,813,813,23,0,E
23,CF,659,659,1085,330,1143,23,426,F
23,CG,828,94,1179,870,1307,23,351,C
23,BG,787,693,1872,5001,6144,23,1085,G
23,BH,983,290,2162,905,2212,23,1179,B
23,CH,834,834,2996,4941,7153,23,2162,C
23,DH,2207,1083,4079,2854,8998,23,1872,H
23,D,3341,2258,6337,2735,9888,23,2996,D
23,M,4312,4312,10649,4583,14471,23,6337,M
23,N,1057,1057,11706,780,15251,23,10649,N
23,O,832,832,12538,1205,16456,23,11706,O
23,N,1623,1623,14161,1360,17816,23,12538,N
23,O,808,808,14969,1075,18891,23,14161,O
23,P,4090,4090,19059,1075,19966,23,14969,P
24,AEI,98,98,98,295,295,24,0,A
24,BEI,389,291,389,921,921,24,0,E
24,BFI,382,91,480,240,535,24,98,B
24,CFI,143,143,623,270,805,24,480,C
24,DFI,657,34,657,3954,3954,24,0,I
24,DFJ,814,546,1203,300,1221,24,389,F
24,DGJ,2015,1435,2638,5070,5875,24,623,D
24,GJ,1544,109,2747,910,2131,24,1203,G
24,FJ,2422,332,3079,210,4164,24,657,J
24,FK,947,947,4026,330,4494,24,3079,K
24,FJ,2210,931,4957,2855,4986,24,2747,F
24,GJ,805,805,5762,960,5946,24,4957,G
24,HJ,1868,132,5894,1460,5954,24,4026,J
24,HK,949,949,6843,810,6764,24,5894,K
24,HL,1629,548,7391,3960,9906,24,5762,H
24,L,1569,1021,8412,3810,10574,24,6843,L
24,M,343,343,8755,989,11563,24,8412,M
24,N,830,830,9585,240,11803,24,8755,N
24,O,134,134,9719,270,12073,24,9585,O
24,N,515,515,10234,380,12453,24,9719,N
24,O,156,156,10390,260,12713,24,10234,O
24,P,1966,1966,12356,5100,17813,24,10390,P
25,AEI,72,72,72,692,692,25,0,A
25,BEI,87,15,87,59,59,25,0,E
25,BFI,171,171,258,240,299,25,87,F
25,BGI,820,562,820,3204,3204,25,0,I
25,BGJ,851,103,923,270,962,25,72,B
25,CGJ,864,199,1122,970,1269,25,258,G
25,CHJ,122,122,1244,3960,5229,25,1122,H
25,CJ,1062,741,1985,930,1892,25,923,C
25,DJ,2586,1421,3406,240,3444,25,820,J
25,DK,705,705,4111,815,4259,25,3406,K
25,DL,213,213,4324,9700,13959,25,4111,L
25,D,3613,1274,5598,435,2327,25,1985,D
25,M,380,380,5978,1233,15192,25,5598,M
25,N,944,944,6922,150,15342,25,5978,N
25,O,821,821,7743,1030,16372,25,6922,O
25,N,1167,1167,8910,925,17297,25,7743,N
25,O,631,631,9541,705,18002,25,8910,O
25,P,5859,5859,15400,4230,22232,25,9541,P
26,A,494,494,494,1211,1211,26,0,A
26,B,772,772,1266,90,1301,26,494,B
26,C,897,897,2163,1250,2551,26,1266,C
26,D,4,4,2167,3780,6331,26,2163,D
26,M,525,525,2692,860,7191,26,2167,M
26,N,368,368,3060,90,7281,26,2692,N
26,O,1424,1424,4484,1935,9216,26,3060,O
26,P,1287,1287,5771,3780,12996,26,4484,P
27,A,51,51,51,115,115,27,0,A
27,B,227,227,278,240,355,27,51,B
27,C,731,731,1009,975,1330,27,278,C
27,D,7,7,1016,6465,7795,27,1009,D
27,M,78,78,1094,814,8609,27,1016,M
27,N,812,812,1906,135,8744,27,1094,N
27,O,290,290,2196,300,9044,27,1906,O
27,P,24,24,2220,5100,14144,27,2196,P
28,AE,48,48,48,123,123,28,0,A
28,BE,534,486,534,1064,1064,28,0,E
28,BF,596,110,644,420,543,28,48,B
28,CF,563,453,1097,90,1154,28,534,F
28,CG,495,495,1592,860,2014,28,1097,G
28,CH,1048,100,1692,1240,1783,28,644,C
28,DH,365,365,2057,360,2143,28,1692,D
28,H,1284,819,2876,3780,5794,28,1592,H
28,M,2591,2591,5467,2741,8535,28,2876,M
28,N,265,265,5732,150,8685,28,5467,N
28,O,761,761,6493,1000,9685,28,5732,O
28,N,862,862,7355,640,10325,28,6493,N
28,O,183,183,7538,95,10420,28,7355,O
28,P,2649,2649,10187,4230,14650,28,7538,P
29,A,9,9,9,342,342,29,0,A
29,B,583,583,592,300,642,29,9,B
29,C,322,322,914,510,1152,29,592,C
29,B,784,784,1698,660,1812,29,914,B
29,C,1805,1805,3503,1155,2967,29,1698,C
29,B,193,193,3696,845,3812,29,3503,B
29,C,939,939,4635,1500,5312,29,3696,C
29,D,444,444,5079,3960,9272,29,4635,D
29,M,36,36,5115,1045,10317,29,5079,M
29,N,1195,1195,6310,240,10557,29,5115,N
29,O,884,884,7194,995,11552,29,6310,O
29,P,2,2,7196,4680,16232,29,7194,P
30,AEI,24,24,24,56,56,30,0,E
30,AFI,241,241,265,240,296,30,24,F
30,AGI,516,516,781,785,1081,30,265,G
30,AHI,892,111,892,1024,1024,30,0,A
30,BHI,159,48,940,3960,5041,30,781,H
30,BI,559,511,1451,420,1444,30,892,B
30,CI,726,726,2177,845,2289,30,1451,C
30,DI,2341,2341,4518,3960,6249,30,2177,D
30,I,15981,11463,15981,16266,16266,30,0,I
30,J,512,512,16493,240,16506,30,15981,J
30,K,521,521,17014,780,17286,30,16493,K
30,L,3513,3513,20527,3960,21246,30,17014,L
30,M,1244,1244,21771,1545,22791,30,20527,M
30,N,411,411,22182,150,22941,30,21771,N
30,O,606,606,22788,725,23666,30,22182,O
30,N,192,192,22980,95,23761,30,22788,N
30,O,242,242,23222,210,23971,30,22980,O
30,P,2184,2184,25406,4170,28141,30,23222,P
31,AE,10,10,10,139,139,31,0,A
31,BE,87,77,87,216,216,31,0,E
31,BF,305,228,315,240,379,31,10,B
31,CF,310,82,397,240,456,31,87,F
31,CG,818,736,1133,975,1354,31,315,C
31,DG,741,5,1138,985,1441,31,397,G
31,DH,7,7,1145,6465,7906,31,1138,H
31,D,786,774,1919,5040,6394,31,1133,D
31,M,31,31,1950,114,8020,31,1919,M
31,N,260,260,2210,240,8260,31,1950,N
31,O,342,342,2552,465,8725,31,2210,O
31,P,33561,33561,36113,5760,14485,31,2552,P
32,AE,283,283,283,509,509,32,0,A
32,BE,429,429,712,240,749,32,283,B
32,CE,369,369,1081,1305,2054,32,712,C
32,DE,588,588,1669,9040,11094,32,1081,D
32,E,1674,5,1674,1768,1768,32,0,E
32,F,209,209,1883,150,1918,32,1674,F
32,G,634,634,2517,585,2503,32,1883,G
32,F,1538,1538,4055,1530,4033,32,2517,F
32,G,1248,1248,5303,570,4603,32,4055,G
32,H,73,73,5376,4230,8833,32,5303,H
32,M,16424,16424,21800,16955,28049,32,5376,M
32,N,556,556,22356,90,28139,32,21800,N
32,O,605,605,22961,820,28959,32,22356,O
32,N,958,958,23919,725,29684,32,22961,N
32,O,229,229,24148,695,30379,32,23919,O
32,P,4388,4388,28536,3780,34159,32,24148,P
33,AEI,83,83,83,141,141,33,0,I
33,AEJ,93,10,93,136,136,33,0,A
33,BEJ,166,166,259,135,271,33,93,B
33,BEJ,176,0,259,150,291,33,83,J
33,CEK,122,122,381,110,401,33,259,K
33,CEL,201,79,460,295,566,33,259,C
33,DEL,151,72,532,4230,4631,33,381,L
33,DE,111,39,571,5160,5726,33,460,D
33,E,950,379,950,1082,1082,33,0,E
33,F,321,321,1271,240,1322,33,950,F
33,G,758,758,2029,915,2237,33,1271,G
33,F,399,399,2428,165,2402,33,2029,F
33,G,1276,1276,3704,1260,3662,33,2428,G
33,H,341,341,4045,3960,7622,33,3704,H
33,M,256,256,4301,1438,9060,33,4045,M
33,N,1209,1209,5510,90,9150,33,4301,N
33,O,911,911,6421,1240,10390,33,5510,O
33,N,461,461,6882,125,10515,33,6421,N
33,O,399,399,7281,800,11315,33,6882,O
33,P,3070,3070,10351,3780,15095,33,7281,P
34,A,3529,3529,3529,3858,3858,34,0,A
34,B,702,702,4231,90,3948,34,3529,B
34,C,524,524,4755,815,4763,34,4231,C
34,B,3647,3647,8402,3695,8458,34,4755,B
34,C,1346,1346,9748,1840,10298,34,8402,C
34,D,1121,1121,10869,3780,14078,34,9748,D
34,M,355,355,11224,1290,15368,34,10869,M
34,N,1310,1310,12534,300,15668,34,11224,N
34,O,672,672,13206,805,16473,34,12534,O
34,P,1257,1257,14463,2940,19413,34,13206,P
35,AE,190,190,190,241,241,35,0,A
35,BE,135,135,325,135,376,35,190,B
35,CE,405,80,405,1220,1220,35,0,E
35,CF,166,86,491,285,661,35,325,C
35,DF,337,337,828,5160,5821,35,491,D
35,F,941,518,1346,155,1375,35,405,F
35,G,276,276,1622,250,1625,35,1346,G
35,H,591,591,2213,2880,4505,35,1622,H
35,M,6225,6225,8438,7282,13103,35,2213,M
35,N,1083,1083,9521,90,13193,35,8438,N
35,O,850,850,10371,1250,14443,35,9521,O
35,P,1310,1310,11681,3780,18223,35,10371,P
36,A,5505,5505,5505,5877,5877,36,0,A
36,B,584,584,6089,240,6117,36,5505,B
36,C,157,157,6246,920,7037,36,6089,C
36,D,859,859,7105,3960,10997,36,6246,D
36,M,929,929,8034,1315,12312,36,7105,M
36,N,590,590,8624,240,12552,36,8034,N
36,O,502,502,9126,845,13397,36,8624,O
36,P,636,636,9762,3960,17357,36,9126,P
37,AEI,569,569,569,1329,1329,37,0,I
37,AEJ,1150,1150,1719,420,1749,37,569,J
37,AEK,2080,361,2080,2713,2713,37,0,A
37,BEK,950,589,2669,1160,2909,37,1719,K
37,BEL,697,108,2777,90,2803,37,2080,B
37,CEL,625,625,3402,1100,3903,37,2777,C
37,DEL,3975,573,3975,4843,4843,37,0,E
37,DFL,1314,8,3983,635,3544,37,2669,L
37,DF,928,920,4903,90,4933,37,3975,F
37,DG,493,493,5396,905,5838,37,4903,G
37,DH,3734,1740,7136,3780,7683,37,3402,D
37,H,19652,17912,25048,3780,9618,37,5396,H
37,M,163,163,25211,1048,10666,37,25048,M
37,N,1005,1005,26216,180,10846,37,25211,N
37,O,981,981,27197,1050,11896,37,26216,O
37,N,668,668,27865,600,12496,37,27197,N
37,O,192,192,28057,260,12756,37,27865,O
37,P,1421,1421,29478,5160,17916,37,28057,P
38,AEI,29,29,29,898,898,38,0,A
38,BEI,515,486,515,490,490,38,0,I
38,BEJ,219,219,734,300,790,38,515,J
38,BEK,1049,344,1078,240,1138,38,29,B
38,CEK,1161,83,1161,1213,1213,38,0,E
38,CFK,352,352,1513,360,1573,38,1161,F
38,CGK,946,167,1680,1115,1905,38,734,K
38,CGJ,773,171,1851,950,2088,38,1078,C
38,BGJ,716,378,2229,875,2448,38,1513,G
38,BFJ,1042,1042,3271,999,3447,38,2229,F
38,BGJ,1485,65,3336,1365,3453,38,1851,B
38,CGJ,2438,782,4118,2389,4294,38,1680,J
38,CGK,937,90,4208,928,4375,38,3271,G
38,CHK,894,22,4230,927,4380,38,3336,C
38,DHK,529,529,4759,393,4773,38,4230,D
38,HK,937,296,5055,928,5222,38,4118,K
38,HL,1137,290,5345,1143,5518,38,4208,H
38,L,1125,835,6180,1143,6365,38,5055,L
38,M,4545,4545,10725,4654,11019,38,6180,M
38,N,199,199,10924,180,11199,38,10725,N
38,O,551,551,11475,555,11754,38,10924,O
38,N,240,240,11715,205,11959,38,11475,N
38,O,779,779,12494,775,12734,38,11715,O
38,P,1125,1125,13619,2820,15554,38,12494,P
39,AEI,77,77,77,385,385,39,0,I
39,AEJ,639,639,716,300,685,39,77,J
39,AEK,710,710,1426,805,1490,39,716,K
39,AEL,44,44,1470,1560,3050,39,1426,L
39,AE,2084,614,2084,3190,3190,39,0,E
39,AF,1377,1377,3461,300,3490,39,2084,F
39,AG,659,659,4120,840,4330,39,3461,G
39,AH,315,315,4435,1560,5890,39,4120,H
39,A,14484,10049,14484,14854,14854,39,0,A
39,B,688,688,15172,300,15154,39,14484,B
39,C,719,719,15891,735,15889,39,15172,C
39,D,53,53,15944,1560,17449,39,15891,D
39,M,2875,2875,18819,2920,20369,39,15944,M
39,N,303,303,19122,300,20669,39,18819,N
39,O,727,727,19849,855,21524,39,19122,O
39,N,316,316,20165,185,21709,39,19849,N
39,O,93,93,20258,300,22009,39,20165,O
39,P,1591,1591,21849,2100,24109,39,20258,P
40,A,1147,1147,1147,1476,1476,40,0,A
40,B,525,525,1672,240,1716,40,1147,B
40,C,596,596,2268,740,2456,40,1672,C
40,D,1425,1425,3693,5590,8046,40,2268,D
40,M,104,104,3797,390,8436,40,3693,M
40,N,444,444,4241,180,8616,40,3797,N
40,O,162,162,4403,225,8841,40,4241,O
40,N,441,441,4844,675,9516,40,4403,N
40,O,345,345,5189,390,9906,40,4844,O
40,P,6015,6015,11204,3960,13866,40,5189,P
41,A,73,73,73,112,112,41,0,A
41,B,99,99,172,120,232,41,73,B
41,C,1610,1610,1782,980,1212,41,172,C
41,D,714,714,2496,5440,6652,41,1782,D
41,M,103,103,2599,132,6784,41,2496,M
41,N,107,107,2706,135,6919,41,2599,N
41,O,193,193,2899,295,7214,41,2706,O
41,P,68,68,2967,5100,12314,41,2899,P
42,AEI,41,41,41,781,781,42,0,A
42,BEI,197,156,197,139,139,42,0,E
42,BFI,62,62,259,180,319,42,197,F
42,BGI,865,647,906,150,931,42,41,B
42,CGI,172,172,1078,125,1056,42,906,C
42,BGI,1230,152,1230,1320,1320,42,0,I
42,BGJ,347,347,1577,300,1620,42,1230,J
42,BGK,1497,179,1756,980,1299,42,259,G
42,BFK,655,476,2232,750,2370,42,1577,K
42,BFL,979,503,2735,1485,2784,42,1756,F
42,BGL,1786,129,2864,1845,2901,42,1078,B
42,CGL,670,541,3405,685,3469,42,2735,G
42,CHL,592,51,3456,675,3576,42,2864,C
42,DHL,1633,409,3865,1560,3930,42,2232,L
42,DH,1202,742,4607,5760,9229,42,3405,H
42,D,3985,2834,7441,4200,7776,42,3456,D
42,M,14618,14618,22059,14735,23964,42,7441,M
42,N,396,396,22455,300,24264,42,22059,N
42,O,536,536,22991,740,25004,42,22455,O
42,P,115,115,23106,1560,26564,42,22991,P
43,AEI,90,90,90,826,826,43,0,E
43,AFI,922,922,1012,240,1066,43,90,F
43,AGI,795,795,1807,1015,2081,43,1012,G
43,AHI,1025,1025,2832,3960,6041,43,1807,H
43,AI,3064,232,3064,3355,3355,43,0,I
43,AJ,495,495,3559,240,3595,43,3064,J
43,AK,693,693,4252,920,4515,43,3559,K
43,AL,311,311,4563,3960,8475,43,4252,L
43,A,21475,16912,21475,22224,22224,43,0,A
43,B,1785,1785,23260,90,22314,43,21475,B
43,C,871,871,24131,1120,23434,43,23260,C
43,D,354,354,24485,3780,27214,43,24131,D
43,M,1028,1028,25513,2974,30188,43,24485,M
43,N,1968,1968,27481,90,30278,43,25513,N
43,O,1157,1157,28638,1430,31708,43,27481,O
43,P,159,159,28797,3780,35488,43,28638,P
44,A,1181,1181,1181,1863,1863,44,0,A
44,B,712,712,1893,90,1953,44,1181,B
44,C,946,946,2839,1255,3208,44,1893,C
44,D,797,797,3636,3780,6988,44,2839,D
44,M,1525,1525,5161,1540,8528,44,3636,M
44,N,116,116,5277,150,8678,44,5161,N
44,O,155,155,5432,90,8768,44,5277,O
44,N,856,856,6288,915,9683,44,5432,N
44,O,127,127,6415,282,9965,44,6288,O
44,P,1055,1055,7470,1178,11143,44,6415,P
45,A,248,248,248,990,990,45,0,A
45,B,925,925,1173,240,1230,45,248,B
45,C,204,204,1377,415,1645,45,1173,C
45,D,14,14,1391,5280,6925,45,1377,D
45,M,111,111,1502,180,7105,45,1391,M
45,N,260,260,1762,240,7345,45,1502,N
45,O,527,527,2289,500,7845,45,1762,O
45,P,7497,7497,9786,6000,13845,45,2289,P
46,A,3,3,3,315,315,46,0,A
46,B,432,432,435,165,480,46,3,B
46,C,1031,1031,1466,1275,1755,46,435,C
46,D,985,985,2451,3960,5715,46,1466,D
46,M,685,685,3136,1374,7089,46,2451,M
46,N,728,728,3864,90,7179,46,3136,N
46,O,458,458,4322,855,8034,46,3864,O
46,P,1475,1475,5797,3780,11814,46,4322,P
47,AE,32,32,32,7,7,47,0,E
47,AF,90,58,90,180,180,47,0,A
47,BF,95,37,127,180,187,47,32,F
47,BG,146,146,273,220,407,47,127,G
47,BH,194,11,284,150,330,47,90,B
47,CH,105,105,389,140,470,47,284,C
47,DH,588,588,977,4200,4670,47,389,D
47,H,3803,3099,4076,4140,4547,47,273,H
47,M,175,175,4251,364,5034,47,4076,M
47,N,300,300,4551,150,5184,47,4251,N
47,O,612,612,5163,635,5819,47,4551,O
47,P,297,297,5460,4230,10049,47,5163,P
48,AE,2238,2238,2238,2388,2388,48,0,E
48,AF,193,193,2431,90,2478,48,2238,F
48,AG,498,498,2929,815,3293,48,2431,G
48,AF,3296,367,3296,3637,3637,48,0,A
48,BF,370,370,3666,90,3727,48,3296,B
48,CF,654,654,4320,795,4522,48,3666,C
48,BF,1418,27,4347,1105,4398,48,2929,F
48,BG,649,622,4969,460,4982,48,4320,B
48,CG,1312,690,5659,1850,6248,48,4347,G
48,CH,1625,935,6594,1885,6867,48,4969,C
48,DH,1220,285,6879,3780,10028,48,5659,H
48,D,904,619,7498,3780,10647,48,6594,D
48,M,11,11,7509,670,11317,48,7498,M
48,N,911,911,8420,300,11617,48,7509,N
48,O,951,951,9371,930,12547,48,8420,O
48,P,3792,3792,13163,2760,15307,48,9371,P
49,AEI,80,80,80,1064,1064,49,0,E
49,AFI,95,15,95,986,986,49,0,I
49,AFJ,1073,1073,1168,240,1226,49,95,J
49,AFK,1164,76,1244,240,1304,49,80,F
49,AGK,202,126,1370,265,1491,49,1168,K
49,AGL,244,118,1488,265,1569,49,1244,G
49,AHL,1202,1084,2572,5460,6951,49,1370,L
49,AH,2849,277,2849,3325,3325,49,0,A
49,BH,716,716,3565,300,3625,49,2849,B
49,CH,827,827,4392,1100,4725,49,3565,C
49,BH,4262,1358,5750,5460,7029,49,1488,H
49,B,2014,656,6406,1785,6510,49,4392,B
49,C,2927,2927,9333,2826,9336,49,6406,C
49,D,2,2,9335,384,9720,49,9333,D
49,M,21,21,9356,43,9763,49,9335,M
49,N,157,157,9513,150,9913,49,9356,N
49,O,143,143,9656,455,10368,49,9513,O
49,P,3720,3720,13376,3565,13933,49,9656,P
50,AEI,280,280,280,555,555,50,0,A
50,BEI,302,302,582,90,645,50,280,B
50,CEI,785,203,785,1371,1371,50,0,E
50,CFI,810,25,810,2558,2558,50,0,I
50,CFJ,621,596,1406,90,1461,50,785,F
50,CGJ,1482,658,2064,1780,2425,50,582,C
50,DGJ,71,71,2135,3780,6205,50,2064,D
50,GJ,1006,277,2412,1225,2686,50,1406,G
50,HJ,55,55,2467,3780,6466,50,2412,H
50,J,1777,120,2587,90,2648,50,810,J
50,K,1016,1016,3603,1240,3888,50,2587,K
50,L,38,38,3641,3780,7668,50,3603,L
50,M,459,459,4100,1156,8824,50,3641,M
50,N,727,727,4827,90,8914,50,4100,N
50,O,514,514,5341,905,9819,50,4827,O
50,P,2293,2293,7634,3780,13599,50,5341,P
51,A,2917,2917,2917,3144,3144,51,0,A
51,B,567,567,3484,300,3444,51,2917,B
51,C,528,528,4012,811,4255,51,3484,C
51,D,1369,1369,5381,3885,8140,51,4012,D
51,M,13324,13324,18705,14221,22361,51,5381,M
51,N,927,927,19632,90,22451,51,18705,N
51,O,960,960,20592,1240,23691,51,19632,O
51,N,829,829,21421,550,24241,51,20592,N
51,O,607,607,22028,890,25131,51,21421,O
51,P,179,179,22207,3780,28911,51,22028,P
52,A,537,537,537,1281,1281,52,0,A
52,B,927,927,1464,240,1521,52,537,B
52,C,971,971,2435,1015,2536,52,1464,C
52,B,534,534,2969,485,3021,52,2435,B
52,C,401,401,3370,510,3531,52,2969,C
52,D,111,111,3481,3960,7491,52,3370,D
52,M,62,62,3543,379,7870,52,3481,M
52,N,497,497,4040,240,8110,52,3543,N
52,O,147,147,4187,385,8495,52,4040,O
52,P,5098,5098,9285,9700,18195,52,4187,P
53,A,267,267,267,1085,1085,53,0,A
53,B,938,938,1205,180,1265,53,267,B
53,C,1009,1009,2214,1050,2315,53,1205,C
53,D,2203,2203,4417,5040,7355,53,2214,D
53,M,65,65,4482,146,7501,53,4417,M
53,N,165,165,4647,135,7636,53,4482,N
53,O,151,151,4798,215,7851,53,4647,O
53,P,20,20,4818,4890,12741,53,4798,P
54,AEI,89,89,89,1045,1045,54,0,E
54,AFI,99,10,99,1162,1162,54,0,A
54,BFI,1168,1158,1257,240,1285,54,89,F
54,BGI,1213,55,1312,210,1372,54,99,B
54,CGI,157,157,1469,265,1637,54,1312,C
54,BGI,780,568,2037,940,2225,54,1257,G
54,BHI,2148,111,2148,2291,2291,54,0,I
54,BHJ,161,161,2309,90,2381,54,2148,J
54,BHK,436,436,2745,820,3201,54,2309,K
54,BHJ,1485,209,2954,1355,2992,54,1469,B
54,CHJ,585,376,3330,160,3361,54,2745,J
54,CHK,1329,36,3366,6990,9215,54,2037,H
54,CK,778,366,3732,930,3922,54,2954,C
54,DK,952,550,4282,1425,4786,54,3330,K
54,DL,1014,1014,5296,3780,8566,54,4282,L
54,D,3164,1600,6896,6990,10912,54,3732,D
54,M,663,663,7559,1548,12460,54,6896,M
54,N,986,986,8545,150,12610,54,7559,N
54,O,625,625,9170,645,13255,54,8545,O
54,N,326,326,9496,310,13565,54,9170,N
54,O,115,115,9611,125,13690,54,9496,O
54,P,3885,3885,13496,4230,17920,54,9611,P
55,AEI,65,65,65,140,140,55,0,I
55,AEJ,74,9,74,987,987,55,0,E
55,AFJ,126,52,126,264,264,55,0,A
55,BFJ,180,119,245,150,290,55,65,J
55,BFK,291,172,417,155,419,55,126,B
55,CFK,229,57,474,185,475,55,245,K
55,CFL,263,206,680,100,519,55,417,C
55,BFL,461,461,1141,680,1199,55,680,B
55,CFL,1106,39,1180,240,1227,55,74,F
55,CGL,229,229,1409,380,1607,55,1180,G
55,CHL,53,53,1462,5460,7067,55,1409,H
55,CL,1000,12,1474,4230,4705,55,474,L
55,C,459,126,1600,255,1454,55,1141,C
55,D,1000,1000,2600,2880,4334,55,1600,D
55,M,870,870,3470,930,7997,55,2600,M
55,N,318,318,3788,300,8297,55,3470,N
55,O,695,695,4483,805,9102,55,3788,O
55,N,989,989,5472,845,9947,55,4483,N
55,O,409,409,5881,590,10537,55,5472,O
55,P,1598,1598,7479,1140,11677,55,5881,P
56,AEI,54,54,54,1688,1688,56,0,I
56,AEJ,170,116,170,845,845,56,0,A
56,BEJ,203,33,203,202,202,56,0,E
56,BFJ,179,179,382,240,442,56,203,F
56,BGJ,136,136,518,295,737,56,382,G
56,BHJ,102,102,620,5100,5837,56,518,H
56,BJ,801,351,971,180,1025,56,170,B
56,CJ,217,217,1188,345,1370,56,971,C
56,BJ,429,429,1617,290,1660,56,1188,B
56,CJ,1833,270,1887,240,1928,56,54,J
56,CK,229,229,2116,295,2223,56,1887,K
56,CL,85,85,2201,5100,7323,56,2116,L
56,C,767,183,2384,695,2355,56,1617,C
56,D,363,363,2747,1440,3795,56,2384,D
56,M,113,113,2860,185,7508,56,2747,M
56,N,174,174,3034,150,7658,56,2860,N
56,O,145,145,3179,220,7878,56,3034,O
56,P,763,763,3942,375,8253,56,3179,P
57,AEI,2,2,2,291,291,57,0,A
57,BEI,27,25,27,161,161,57,0,E
57,BFI,115,88,115,212,212,57,0,I
57,BFJ,318,230,345,240,401,57,27,F
57,BGJ,323,93,438,240,452,57,115,J
57,BGK,486,50,488,240,531,57,2,B
57,CGK,507,507,995,725,1256,57,488,C
57,BGK,569,12,1007,695,1147,57,438,K
57,BGJ,745,83,1090,695,1096,57,345,G
57,BFJ,211,211,1301,370,1466,57,1090,F
57,BGJ,360,66,1367,370,1517,57,1007,J
57,BGK,1392,1326,2693,1620,3086,57,1301,G
57,BHK,226,226,2919,3960,7046,57,2693,H
57,BK,1672,120,3039,1620,3137,57,1367,K
57,BL,908,908,3947,3960,7097,57,3039,L
57,B,3143,191,4138,2990,4246,57,995,B
57,C,1016,1016,5154,1620,5866,57,4138,C
57,D,212,212,5366,3960,9826,57,5154,D
57,M,451,451,5817,1028,10854,57,5366,M
57,N,672,672,6489,150,11004,57,5817,N
57,O,160,160,6649,385,11389,57,6489,O
57,N,386,386,7035,145,11534,57,6649,N
57,O,108,108,7143,125,11659,57,7035,O
57,P,28,28,7171,4230,15889,57,7143,P
58,AE,58,58,58,135,135,58,0,A
58,BE,168,168,226,135,270,58,58,B
58,CE,374,148,374,1367,1367,58,0,E
58,CF,204,56,430,285,555,58,226,C
58,DF,709,709,1139,5160,5715,58,430,D
58,F,1024,259,1398,90,1457,58,374,F
58,G,943,943,2341,1285,2742,58,1398,G
58,H,1242,1242,3583,3780,6522,58,2341,H
58,M,854,854,4437,1190,7712,58,3583,M
58,N,519,519,4956,90,7802,58,4437,N
58,O,897,897,5853,1240,9042,58,4956,O
58,P,93,93,5946,3780,12822,58,5853,P
59,AEI,95,95,95,682,682,59,0,A
59,BEI,284,189,284,508,508,59,0,E
59,BFI,416,416,700,240,748,59,284,F
59,BGI,776,171,871,240,922,59,95,B
59,CGI,168,168,1039,200,1122,59,871,C
59,DGI,407,407,1446,5220,6342,59,1039,D
59,GI,824,78,1524,985,1733,59,700,G
59,FI,1659,135,1659,5234,5234,59,0,I
59,FJ,714,579,2238,750,2483,59,1524,F
59,GJ,484,484,2722,510,2993,59,2238,G
59,HJ,126,126,2848,3960,6953,59,2722,H
59,J,3593,2404,5252,90,5324,59,1659,J
59,K,686,686,5938,1040,6364,59,5252,K
59,L,791,791,6729,3780,10144,59,5938,L
59,M,1096,1096,7825,2863,13007,59,6729,M
59,N,1793,1793,9618,90,13097,59,7825,N
59,O,547,547,10165,1035,14132,59,9618,O
59,P,6564,6564,16729,3780,17912,59,10165,P
60,AEI,83,83,83,122,122,60,0,A
60,BEI,184,101,184,362,362,60,0,I
60,BEJ,275,174,358,300,422,60,83,B
60,CEJ,268,94,452,150,512,60,184,J
60,CEK,560,108,560,3690,3690,60,0,E
60,CFK,117,9,569,385,897,60,452,K
60,CFL,631,420,989,820,1242,60,358,C
60,DFL,15,15,1004,5315,6557,60,989,D
60,FL,566,131,1135,3190,4087,60,569,L
60,F,3370,2795,3930,300,3990,60,560,F
60,G,811,811,4741,1100,5090,60,3930,G
60,F,1443,1443,6184,1155,6245,60,4741,F
60,G,525,525,6709,770,7015,60,6184,G
60,H,148,148,6857,340,7355,60,6709,H
60,M,84,84,6941,1145,8500,60,6857,M
60,N,1241,1241,8182,240,8740,60,6941,N
60,O,680,680,8862,760,9500,60,8182,O
60,P,828,828,9690,7680,17180,60,8862,P
61,AEI,23,23,23,239,239,61,0,E
61,AFI,315,315,338,150,389,61,23,F
61,AGI,667,667,1005,915,1304,61,338,G
61,AFI,1263,258,1263,1378,1378,61,0,I
61,AFJ,284,284,1547,240,1618,61,1263,J
61,AFK,642,100,1647,400,1704,61,1005,F
61,AGK,574,574,2221,1050,2754,61,1647,G
61,AHK,717,43,2264,855,2473,61,1547,K
61,AHJ,95,52,2316,3300,6054,61,2221,H
61,AJ,436,384,2700,340,2813,61,2264,J
61,AK,2737,37,2737,2984,2984,61,0,A
61,BK,346,346,3083,150,3134,61,2737,B
61,CK,559,559,3642,585,3719,61,3083,C
61,BK,451,451,4093,400,4119,61,3642,B
61,CK,127,127,4220,1050,5169,61,4093,C
61,DK,2434,914,5134,2820,5633,61,2700,K
61,DL,34,34,5168,3960,9593,61,5134,L
61,D,1433,485,5653,3300,8469,61,4220,D
61,M,86,86,5739,94,9687,61,5653,M
61,N,57,57,5796,120,9807,61,5739,N
61,O,224,224,6020,125,9932,61,5796,O
61,P,2371,2371,8391,2880,12812,61,6020,P
62,AE,154,154,154,495,495,62,0,E
62,AF,372,218,372,1439,1439,62,0,A
62,BF,361,143,515,90,585,62,154,F
62,BG,576,576,1091,935,1520,62,515,G
62,BH,135,135,1226,3780,5300,62,1091,H
62,B,1167,313,1539,150,1589,62,372,B
62,C,136,136,1675,115,1704,62,1539,C
62,B,266,266,1941,280,1984,62,1675,B
62,C,791,791,2732,775,2759,62,1941,C
62,D,1572,1572,4304,4230,6989,62,2732,D
62,M,1567,1567,5871,2444,9433,62,4304,M
62,N,907,907,6778,90,9523,62,5871,N
62,O,483,483,7261,845,10368,62,6778,O
62,P,1361,1361,8622,3780,14148,62,7261,P
63,AE,713,713,713,1087,1087,63,0,E
63,AF,494,494,1207,180,1267,63,713,F
63,AG,2047,840,2047,2183,2183,63,0,A
63,BG,304,304,2351,180,2363,63,2047,B
63,CG,1735,591,2942,1170,2437,63,1207,G
63,CF,897,306,3248,1200,3563,63,2351,C
63,BF,1285,1285,4533,1030,4593,63,3248,B
63,CF,256,256,4789,340,4933,63,4533,C
63,DF,2406,559,5348,3000,5437,63,2942,F
63,DG,995,436,5784,920,5853,63,4789,D
63,G,501,65,5849,570,6007,63,5348,G
63,H,120,120,5969,350,6357,63,5849,H
63,M,1639,1639,7608,1539,7896,63,5969,M
63,N,426,426,8034,600,8496,63,7608,N
63,O,1690,1690,9724,1740,10236,63,8034,O
63,P,1703,1703,11427,420,10656,63,9724,P
64,AEI,71,71,71,171,171,64,0,A
64,BEI,144,73,144,152,152,64,0,E
64,BFI,88,88,232,150,302,64,144,F
64,BGI,245,13,245,661,661,64,0,I
64,BGJ,202,28,273,150,321,64,71,B
64,CGJ,191,191,464,455,776,64,273,C
64,DGJ,501,269,733,795,1097,64,232,G
64,DHJ,571,83,816,210,871,64,245,J
64,DHK,162,79,895,2880,3977,64,733,H
64,DK,174,95,990,375,1246,64,816,K
64,DL,56,56,1046,5475,6721,64,990,L
64,D,3724,3142,4188,3565,4341,64,464,D
64,M,304,304,4492,1344,8065,64,4188,M
64,N,1225,1225,5717,240,8305,64,4492,N
64,O,762,762,6479,780,9085,64,5717,O
64,P,2775,2775,9254,7680,16765,64,6479,P
65,A,136,136,136,151,151,65,0,A
65,B,107,107,243,150,301,65,136,B
65,C,182,182,425,455,756,65,243,C
65,D,855,855,1280,3565,4321,65,425,D
65,M,148,148,1428,1064,5385,65,1280,M
65,N,1039,1039,2467,180,5565,65,1428,N
65,O,163,163,2630,225,5790,65,2467,O
65,N,859,859,3489,835,6625,65,2630,N
65,O,238,238,3727,390,7015,65,3489,O
65,P,1759,1759,5486,3960,10975,65,3727,P
66,A,4404,4404,4404,4845,4845,66,0,A
66,B,678,678,5082,270,5115,66,4404,B
66,C,816,816,5898,810,5925,66,5082,C
66,D,5758,5758,11656,550,6475,66,5898,D
66,M,338,338,11994,950,7425,66,11656,M
66,N,702,702,12696,150,7575,66,11994,N
66,O,80,80,12776,50,7625,66,12696,O
66,N,2295,2295,15071,2330,9955,66,12776,N
66,O,774,774,15845,945,10900,66,15071,O
66,P,1116,1116,16961,5160,16060,66,15845,P
67,AEI,19,19,19,131,131,67,0,A
67,BEI,63,44,63,273,273,67,0,I
67,BEJ,204,160,223,150,281,67,19,B
67,CEJ,336,113,336,496,496,67,0,E
67,CFJ,127,14,350,155,436,67,223,C
67,DFJ,104,104,454,4200,4636,67,350,D
67,FJ,404,13,467,240,513,67,63,J
67,FK,278,147,614,90,586,67,336,F
67,GK,161,14,628,215,728,67,467,K
67,GL,612,598,1226,1010,1596,67,614,G
67,HL,2889,2889,4115,3780,5376,67,1226,H
67,L,9767,6280,10395,4890,5618,67,628,L
67,M,10,10,10405,817,6435,67,10395,M
67,N,1046,1046,11451,240,6675,67,10405,N
67,O,468,468,11919,785,7460,67,11451,O
67,P,220,220,12139,3960,11420,67,11919,P
68,A,36,36,36,2292,2292,68,0,A
68,B,2452,2452,2488,240,2532,68,36,B
68,C,723,723,3211,970,3502,68,2488,C
68,D,306,306,3517,3960,7462,68,3211,D
68,M,600,600,4117,1481,8943,68,3517,M
68,N,905,905,5022,90,9033,68,4117,N
68,O,561,561,5583,880,9913,68,5022,O
68,N,440,440,6023,110,10023,68,5583,N
68,O,1514,1514,7537,2315,12338,68,6023,O
68,P,4422,4422,11959,3420,15758,68,7537,P
69,A,635,635,635,1095,1095,69,0,A
69,B,511,511,1146,90,1185,69,635,B
69,C,995,995,2141,1240,2425,69,1146,C
69,D,166,166,2307,3780,6205,69,2141,D
69,M,476,476,2783,700,6905,69,2307,M
69,N,297,297,3080,90,6995,69,2783,N
69,O,1388,1388,4468,1935,8930,69,3080,O
69,P,1976,1976,6444,3780,12710,69,4468,P
70,AE,296,296,296,379,379,70,0,E
70,AF,327,31,327,982,982,70,0,A
70,BF,189,158,485,150,529,70,296,F
70,BG,179,179,664,385,914,70,485,G
70,BH,3,3,667,3960,4874,70,664,H
70,B,758,418,1085,150,1132,70,327,B
70,C,168,168,1253,155,1287,70,1085,C
70,D,218,218,1471,4200,5487,70,1253,D
70,M,25,25,1496,93,5580,70,1471,M
70,N,184,184,1680,150,5730,70,1496,N
70,O,157,157,1837,840,6570,70,1680,O
70,P,591,591,2428,3540,10110,70,1837,P
71,AE,52,52,52,1927,1927,71,0,E
71,AF,434,382,434,1076,1076,71,0,A
71,BF,694,694,1128,90,1166,71,434,B
71,CF,547,547,1675,850,2016,71,1128,C
71,DF,1995,372,2047,165,2092,71,52,F
71,DG,900,900,2947,1075,3167,71,2047,G
71,DH,1109,1109,4056,3960,7127,71,2947,H
71,D,4051,1670,5726,3780,5796,71,1675,D
71,M,1279,1279,7005,1592,8719,71,5726,M
71,N,362,362,7367,90,8809,71,7005,N
71,O,586,586,7953,860,9669,71,7367,O
71,N,294,294,8247,35,9704,71,7953,N
71,O,515,515,8762,790,10494,71,8247,O
71,P,793,793,9555,3780,14274,71,8762,P
72,AE,45,45,45,32,32,72,0,A
72,BE,195,195,240,240,272,72,45,B
72,CE,517,517,757,785,1057,72,240,C
72,DE,232,232,989,3960,5017,72,757,D
72,E,1217,228,1217,1210,1210,72,0,E
72,F,257,257,1474,300,1510,72,1217,F
72,G,800,800,2274,815,2325,72,1474,G
72,H,1965,1965,4239,3960,6285,72,2274,H
72,M,445,445,4684,515,6800,72,4239,M
72,N,481,481,5165,420,7220,72,4684,N
72,O,704,704,5869,910,8130,72,5165,O
72,P,185,185,6054,3960,12090,72,5869,P
73,AE,187,187,187,2435,2435,73,0,E
73,AF,362,175,362,1820,1820,73,0,A
73,BF,1866,1866,2228,300,2120,73,362,B
73,CF,2531,490,2718,300,2735,73,187,F
73,CG,542,52,2770,735,2855,73,2228,C
73,BG,335,335,3105,385,3240,73,2770,B
73,CG,713,326,3431,920,3655,73,2718,G
73,CF,453,127,3558,435,3675,73,3105,C
73,DF,331,331,3889,4050,7725,73,3558,D
73,F,1507,1049,4938,1405,5060,73,3431,F
73,G,775,775,5713,1220,6280,73,4938,G
73,H,372,372,6085,3960,10240,73,5713,H
73,M,105,105,6190,295,10535,73,6085,M
73,N,340,340,6530,180,10715,73,6190,N
73,O,238,238,6768,540,11255,73,6530,O
73,N,611,611,7379,340,11595,73,6768,N
73,O,738,738,8117,810,12405,73,7379,O
73,P,135,135,8252,4110,16515,73,8117,P
74,A,76,76,76,92,92,74,0,A
74,B,211,211,287,240,332,74,76,B
74,C,790,790,1077,970,1302,74,287,C
74,D,180,180,1257,3960,5262,74,1077,D
74,M,311,311,1568,1176,6438,74,1257,M
74,N,1043,1043,2611,150,6588,74,1568,N
74,O,794,794,3405,790,7378,74,2611,O
74,P,965,965,4370,4200,11578,74,3405,P
75,A,1938,1938,1938,1450,1450,75,0,A
75,B,1192,1192,3130,300,1750,75,1938,B
75,C,1058,1058,4188,720,2470,75,3130,C
75,B,206,206,4394,405,2875,75,4188,B
75,C,1026,1026,5420,1050,3925,75,4394,C
75,D,2961,2961,8381,4050,7975,75,5420,D
75,M,71,71,8452,100,8075,75,8381,M
75,N,84,84,8536,155,8230,75,8452,N
75,O,85,85,8621,90,8320,75,8536,O
75,P,166,166,8787,2880,11200,75,8621,P
76,AEI,114,114,114,1100,1100,76,0,E
76,AFI,171,57,171,1359,1359,76,0,A
76,BFI,335,164,335,862,862,76,0,I
76,BFJ,625,625,960,150,1012,76,335,J
76,BFK,130,130,1090,130,1142,76,960,K
76,BFJ,1190,214,1304,240,1340,76,114,F
76,BGJ,264,50,1354,250,1392,76,1090,J
76,BGK,1383,200,1554,240,1599,76,171,B
76,CGK,616,416,1970,555,1947,76,1354,K
76,CGL,700,34,2004,760,2100,76,1304,G
76,CHL,713,263,2267,760,2359,76,1554,C
76,DHL,1104,1104,3371,7680,10039,76,2267,D
76,HL,1703,302,3673,4230,6177,76,1970,L
76,H,2423,754,4427,7680,9780,76,2004,H
76,M,156,156,4583,257,10296,76,4427,M
76,N,291,291,4874,240,10536,76,4583,N
76,O,816,816,5690,765,11301,76,4874,O
76,N,374,374,6064,420,11721,76,5690,N
76,O,126,126,6190,380,12101,76,6064,O
76,P,3091,3091,9281,3960,16061,76,6190,P
77,A,256,256,256,808,808,77,0,A
77,B,705,705,961,210,1018,77,256,B
77,C,346,346,1307,375,1393,77,961,C
77,D,15,15,1322,5300,6693,77,1307,D
77,M,33,33,1355,46,6739,77,1322,M
77,N,90,90,1445,135,6874,77,1355,N
77,O,194,194,1639,285,7159,77,1445,O
77,P,295,295,1934,5160,12319,77,1639,P
78,A,1791,1791,1791,3026,3026,78,0,A
78,B,1266,1266,3057,90,3116,78,1791,B
78,C,712,712,3769,1105,4221,78,3057,C
78,D,338,338,4107,3780,8001,78,3769,D
78,M,4266,4266,8373,5041,13042,78,4107,M
78,N,846,846,9219,90,13132,78,8373,N
78,O,694,694,9913,1155,14287,78,9219,O
78,P,60,60,9973,3780,18067,78,9913,P
79,AEI,321,321,321,259,259,79,0,I
79,AEJ,237,237,558,300,559,79,321,J
79,AEK,703,145,703,1345,1345,79,0,E
79,AFK,1343,640,1343,1420,1420,79,0,A
79,BFK,891,251,1594,300,1645,79,703,F
79,BGK,329,78,1672,300,1720,79,1343,B
79,CGK,1128,14,1686,1320,1879,79,558,K
79,CGJ,895,803,2489,1050,2695,79,1594,G
79,CFJ,1074,271,2760,1055,2934,79,1686,J
79,CFK,1157,69,2829,1320,3040,79,1672,C
79,BFK,392,52,2881,350,3045,79,2489,F
79,BGK,333,212,3093,510,3444,79,2760,K
79,BGL,111,111,3204,3960,7404,79,3093,L
79,BG,553,230,3434,510,3555,79,2881,G
79,BH,1087,482,3916,1055,4095,79,2829,B
79,CH,441,441,4357,510,4605,79,3916,C
79,DH,78,78,4435,3960,8565,79,4357,D
79,H,1363,362,4797,3960,7515,79,3434,H
79,M,12116,12116,16913,13176,21741,79,4797,M
79,N,1095,1095,18008,90,21831,79,16913,N
79,O,1159,1159,19167,1375,23206,79,18008,O
79,N,568,568,19735,340,23546,79,19167,N
79,O,143,143,19878,585,24131,79,19735,O
79,P,2985,2985,22863,3780,27911,79,19878,P
80,A,5888,5888,5888,6286,6286,80,0,A
80,B,508,508,6396,180,6466,80,5888,B
80,C,1281,1281,7677,1240,7706,80,6396,C
80,B,1841,1841,9518,1855,9561,80,7677,B
80,C,598,598,10116,720,10281,80,9518,C
80,D,318,318,10434,6900,17181,80,10116,D
80,M,1677,1677,12111,1962,19143,80,10434,M
80,N,553,553,12664,300,19443,80,12111,N
80,O,1136,1136,13800,1110,20553,80,12664,O
80,P,1575,1575,15375,3960,24513,80,13800,P
81,AE,1261,1261,1261,1690,1690,81,0,E
81,AF,1436,175,1436,1601,1601,81,0,A
81,BF,261,261,1697,150,1751,81,1436,B
81,CF,116,116,1813,115,1866,81,1697,C
81,BF,719,167,1980,300,1990,81,1261,F
81,BG,779,612,2592,710,2576,81,1813,B
81,CG,660,48,2640,755,2745,81,1980,G
81,CH,120,120,2760,1560,4305,81,2640,H
81,C,670,502,3262,805,3381,81,2592,C
81,D,1382,1382,4644,4230,7611,81,3262,D
81,M,265,265,4909,280,7891,81,4644,M
81,N,264,264,5173,300,8191,81,4909,N
81,O,769,769,5942,840,9031,81,5173,O
81,N,767,767,6709,705,9736,81,5942,N
81,O,782,782,7491,990,10726,81,6709,O
81,P,24703,24703,32194,4020,14746,81,7491,P
82,AE,477,477,477,455,455,82,0,E
82,AF,523,46,523,325,325,82,0,A
82,BF,259,213,736,300,755,82,477,F
82,BG,732,519,1255,120,445,82,523,B
82,CG,668,149,1404,840,1595,82,736,G
82,CH,644,495,1899,960,1405,82,1255,C
82,BH,707,707,2606,1230,2635,82,1899,B
82,CH,739,739,3345,900,3535,82,2606,C
82,DH,2634,2634,5979,720,4255,82,3345,D
82,H,4826,251,6230,1140,2735,82,1404,H
82,M,7,7,6237,47,4302,82,6230,M
82,N,280,280,6517,300,4602,82,6237,N
82,O,645,645,7162,770,5372,82,6517,O
82,P,17,17,7179,5325,10697,82,7162,P
83,AEI,64,64,64,124,124,83,0,I
83,AEJ,164,100,164,322,322,83,0,A
83,BEJ,247,147,311,240,364,83,64,J
83,BEK,218,71,382,90,412,83,164,B
83,CEK,548,166,548,624,624,83,0,E
83,CFK,202,202,750,180,804,83,548,F
83,CGK,827,388,1138,975,1339,83,311,K
83,CGL,855,99,1237,1275,1687,83,382,C
83,DGL,639,152,1389,835,1639,83,750,G
83,DHL,300,148,1537,3780,5467,83,1237,D
83,HL,777,378,1915,5040,6379,83,1138,L
83,H,4426,3900,5815,5400,7039,83,1389,H
83,M,45,45,5860,278,7317,83,5815,M
83,N,307,307,6167,135,7452,83,5860,N
83,O,596,596,6763,385,7837,83,6167,O
83,P,34,34,6797,7555,15392,83,6763,P
84,A,394,394,394,1437,1437,84,0,A
84,B,1505,1505,1899,420,1857,84,394,B
84,C,904,904,2803,1190,3047,84,1899,C
84,D,8477,8477,11280,665,3712,84,2803,D
84,M,3045,3045,14325,4162,7874,84,11280,M
84,N,1192,1192,15517,90,7964,84,14325,N
84,O,527,527,16044,915,8879,84,15517,O
84,N,816,816,16860,465,9344,84,16044,N
84,O,485,485,17345,790,10134,84,16860,O
84,P,1658,1658,19003,3780,13914,84,17345,P
85,AEI,8,8,8,406,406,85,0,I
85,AEJ,592,592,600,270,676,85,8,J
85,AEK,1478,878,1478,3045,3045,85,0,E
85,AFK,1148,270,1748,1170,1846,85,600,K
85,AFL,1853,105,1853,1877,1877,85,0,A
85,BFL,204,204,2057,240,2117,85,1853,B
85,CFL,274,274,2331,330,2447,85,2057,C
85,BFL,2047,1194,3525,600,3645,85,1478,F
85,BGL,1478,284,3809,1410,3857,85,2331,B
85,CGL,1130,1130,4939,1074,4931,85,3809,C
85,DGL,1639,225,5164,1275,4920,85,3525,G
85,DFL,595,370,5534,356,5287,85,4939,D
85,FL,606,236,5770,890,5810,85,5164,F
85,GL,893,893,6663,945,6755,85,5770,G
85,HL,956,956,7619,370,7125,85,6663,H
85,L,7820,1949,9568,435,2281,85,1748,L
85,M,585,585,10153,1491,8616,85,9568,M
85,N,930,930,11083,90,8706,85,10153,N
85,O,578,578,11661,880,9586,85,11083,O
85,N,417,417,12078,110,9696,85,11661,N
85,O,1483,1483,13561,2315,12011,85,12078,O
85,P,1209,1209,14770,3420,15431,85,13561,P
86,A,63,63,63,39,39,86,0,A
86,B,185,185,248,240,279,86,63,B
86,C,257,257,505,285,564,86,248,C
86,D,1048,1048,1553,5160,5724,86,505,D
86,M,1051,1051,2604,1995,7719,86,1553,M
86,N,696,696,3300,180,7899,86,2604,N
86,O,795,795,4095,885,8784,86,3300,O
86,N,853,853,4948,395,9179,86,4095,N
86,O,591,591,5539,680,9859,86,4948,O
86,P,2063,2063,7602,5460,15319,86,5539,P
87,AE,117,117,117,292,292,87,0,A
87,BE,342,342,459,180,472,87,117,B
87,CE,595,595,1054,683,1155,87,459,C
87,DE,1773,719,1773,1966,1966,87,0,E
87,DF,235,235,2008,90,2056,87,1773,F
87,DG,864,864,2872,1275,3331,87,2008,G
87,DH,219,219,3091,3780,7111,87,2872,H
87,D,7534,5497,8588,4080,5235,87,1054,D
87,M,14028,14028,22616,15137,22248,87,8588,M
87,N,1170,1170,23786,150,22398,87,22616,N
87,O,1049,1049,24835,395,22793,87,23786,O
87,P,814,814,25649,660,23453,87,24835,P
88,A,1654,1654,1654,2655,2655,88,0,A
88,B,1205,1205,2859,240,2895,88,1654,B
88,C,507,507,3366,775,3670,88,2859,C
88,D,39275,39275,42641,3960,7630,88,3366,D
88,M,156,156,42797,404,8034,88,42641,M
88,N,452,452,43249,270,8304,88,42797,N
88,O,601,601,43850,735,9039,88,43249,O
88,N,1222,1222,45072,1070,10109,88,43850,N
88,O,513,513,45585,535,10644,88,45072,O
88,P,4158,4158,49743,2880,13524,88,45585,P
89,AEI,9,9,9,124,124,89,0,A
89,BEI,38,29,38,61,61,89,0,E
89,BFI,111,111,149,150,211,89,38,F
89,BGI,287,147,296,240,364,89,9,B
89,CGI,179,32,328,455,666,89,149,G
89,CHI,384,56,384,1031,1031,89,0,I
89,CHJ,708,620,1004,975,1339,89,296,C
89,DHJ,737,117,1121,150,1181,89,384,J
89,DHK,72,72,1193,350,1531,89,1121,K
89,DHL,889,24,1217,5125,5791,89,328,H
89,DL,253,229,1446,3940,5471,89,1193,L
89,D,850,408,1854,5040,6379,89,1004,D
89,M,23,23,1877,28,6407,89,1854,M
89,N,211,211,2088,240,6647,89,1877,N
89,O,260,260,2348,215,6862,89,2088,O
89,P,1084,1084,3432,5370,12232,89,2348,P
90,AEI,400,400,400,488,488,90,0,A
90,BEI,255,255,655,150,638,90,400,B
90,CEI,778,778,1433,620,1258,90,655,C
90,DEI,1838,405,1838,2576,2576,90,0,E
90,DFI,840,840,2678,150,2726,90,1838,F
90,DGI,1359,114,2792,4200,5458,90,1433,D
90,GI,675,561,3353,920,3646,90,2678,G
90,HI,1341,1341,4694,3960,7606,90,3353,H
90,I,7160,2466,7160,7391,7391,90,0,I
90,J,437,437,7597,240,7631,90,7160,J
90,K,884,884,8481,920,8551,90,7597,K
90,L,88,88,8569,3960,12511,90,8481,L
90,M,1135,1135,9704,1364,13875,90,8569,M
90,N,443,443,10147,240,14115,90,9704,N
90,O,557,557,10704,740,14855,90,10147,O
90,P,136,136,10840,3960,18815,90,10704,P
91,AEI,74,74,74,1297,1297,91,0,E
91,AFI,694,620,694,2057,2057,91,0,A
91,BFI,1303,683,1377,120,1417,91,74,F
91,BGI,281,281,1658,420,1837,91,1377,G
91,BFI,1543,579,2237,90,2147,91,694,B
91,BFI,579,0,2237,465,2302,91,1658,F
91,CGI,682,682,2919,810,3112,91,2237,G
91,CHI,724,42,2961,1130,3277,91,2237,C
91,DHI,4032,1071,4032,4407,4407,91,0,I
91,DHJ,1408,295,4327,5040,8152,91,2919,H
91,DJ,370,75,4402,120,4527,91,4032,J
91,DK,199,199,4601,390,4917,91,4402,K
91,DJ,1484,1484,6085,1225,6142,91,4601,J
91,DK,700,700,6785,810,6952,91,6085,K
91,DL,363,363,7148,5040,11992,91,6785,L
91,D,12784,8597,15745,3780,7057,91,2961,D
91,M,8386,8386,24131,8852,20844,91,15745,M
91,N,1666,1666,25797,1260,22104,91,24131,N
91,O,280,280,26077,400,22504,91,25797,O
91,P,6805,6805,32882,425,22929,91,26077,P
92,A,551,551,551,1447,1447,92,0,A
92,B,1016,1016,1567,180,1627,92,551,B
92,C,977,977,2544,1050,2677,92,1567,C
92,D,2166,2166,4710,5040,7717,92,2544,D
92,M,55,55,4765,1121,8838,92,4710,M
92,N,1249,1249,6014,240,9078,92,4765,N
92,O,745,745,6759,760,9838,92,6014,O
92,P,53,53,6812,7680,17518,92,6759,P
93,AEI,526,526,526,1065,1065,93,0,A
93,BEI,700,700,1226,210,1275,93,526,B
93,CEI,149,149,1375,255,1530,93,1226,C
93,BEI,1746,371,1746,1882,1882,93,0,I
93,BEJ,151,151,1897,150,2032,93,1746,J
93,BEK,2398,501,2398,2740,2740,93,0,E
93,BFK,669,168,2566,935,2967,93,1897,K
93,BFJ,1273,82,2648,1175,2705,93,1375,B
93,CFJ,462,212,2860,150,2890,93,2398,F
93,CGJ,557,345,3205,540,3245,93,2648,C
93,DGJ,1022,677,3882,380,3270,93,2860,G
93,DFJ,1569,253,4135,1225,4192,93,2566,J
93,DFK,557,557,4692,540,4732,93,4135,K
93,DFL,8873,8063,12755,9635,12905,93,3882,F
93,DGL,474,474,13229,290,13195,93,12755,G
93,DHL,24449,14425,27654,2880,6125,93,3205,D
93,HL,24066,1104,28758,2880,7612,93,4692,L
93,H,39976,24447,53205,240,13435,93,13229,H
93,M,7168,7168,60373,7088,20523,93,53205,M
93,N,107,107,60480,240,20763,93,60373,N
93,O,705,705,61185,185,20948,93,60480,O
93,N,1214,1214,62399,1805,22753,93,61185,N
93,O,657,657,63056,755,23508,93,62399,O
93,P,1234,1234,64290,240,23748,93,63056,P
94,AEI,106,106,106,2277,2277,94,0,I
94,AEJ,299,193,299,817,817,94,0,A
94,BEJ,913,913,1212,90,907,94,299,B
94,CEJ,1942,730,1942,2245,2245,94,0,E
94,CFJ,839,109,2051,1275,2182,94,1212,C
94,DFJ,2351,406,2457,240,2517,94,106,J
94,DFK,708,193,2650,420,2665,94,1942,F
94,DGK,461,461,3111,510,3175,94,2650,G
94,DHK,758,104,3215,770,3287,94,2457,K
94,DHL,619,619,3834,550,3837,94,3215,L
94,DH,4442,2659,6493,3780,5962,94,2051,D
94,H,4742,1360,7853,550,3725,94,3111,H
94,M,2184,2184,10037,5486,11448,94,7853,M
94,N,3676,3676,13713,420,11868,94,10037,N
94,O,622,622,14335,691,12559,94,13713,O
94,P,2242,2242,16577,609,13168,94,14335,P
95,AEI,1,1,1,107,107,95,0,I
95,AEJ,343,343,344,300,407,95,1,J
95,AEK,781,437,781,1466,1466,95,0,A
95,BEK,805,368,1149,820,1227,95,344,K
95,BEJ,805,437,1586,180,1646,95,781,B
95,CEJ,1863,277,1863,2637,2637,95,0,E
95,CFJ,947,233,2096,930,2157,95,1149,J
95,CFK,249,249,2345,385,2542,95,2096,K
95,CFL,785,26,2371,975,2621,95,1586,C
95,BFL,262,236,2607,5400,7942,95,2345,L
95,BF,963,219,2826,240,2877,95,1863,F
95,BG,745,745,3571,1015,3892,95,2826,G
95,BF,1471,271,3842,1315,3936,95,2371,B
95,CF,619,619,4461,648,4584,95,3842,C
95,DF,1100,210,4671,820,4712,95,3571,F
95,DG,246,36,4707,372,4956,95,4461,D
95,G,213,177,4884,375,5087,95,4671,G
95,H,4269,4269,9153,3960,9047,95,4884,H
95,M,216,216,9369,721,9768,95,9153,M
95,N,694,694,10063,240,10008,95,9369,N
95,O,151,151,10214,385,10393,95,10063,O
95,N,312,312,10526,65,10458,95,10214,N
95,O,563,563,11089,785,11243,95,10526,O
95,P,921,921,12010,3960,15203,95,11089,P
96,AE,3292,3292,3292,4112,4112,96,0,A
96,BE,901,901,4193,90,4202,96,3292,B
96,CE,1104,1104,5297,1400,5602,96,4193,C
96,DE,2930,2930,8227,3840,9442,96,5297,D
96,E,37159,28932,37159,38054,38054,96,0,E
96,F,925,925,38084,90,38144,96,37159,F
96,G,975,975,39059,1220,39364,96,38084,G
96,H,34,34,39093,3780,43144,96,39059,H
96,M,207,207,39300,1041,44185,96,39093,M
96,N,865,865,40165,90,44275,96,39300,N
96,O,643,643,40808,935,45210,96,40165,O
96,P,347,347,41155,3780,48990,96,40808,P
97,AEI,81,81,81,144,144,97,0,I
97,AEJ,241,241,322,240,384,97,81,J
97,AEK,473,151,473,740,740,97,0,E
97,AFK,250,99,572,285,669,97,322,K
97,AFL,297,198,770,90,830,97,473,F
97,AGL,538,538,1308,825,1655,97,770,G
97,AFL,771,771,2079,480,2135,97,1308,F
97,AGL,1925,418,2497,5160,5829,97,572,L
97,AG,1097,679,3176,1340,3475,97,2079,G
97,AH,4319,1143,4319,4909,4909,97,0,A
97,BH,1221,78,4397,3780,7255,97,3176,H
97,B,620,542,4939,90,4999,97,4319,B
97,C,541,541,5480,820,5819,97,4939,C
97,B,776,776,6256,475,6294,97,5480,B
97,C,1151,1151,7407,1405,7699,97,6256,C
97,D,2526,2526,9933,3780,11479,97,7407,D
97,M,633,633,10566,3195,14674,97,9933,M
97,N,2636,2636,13202,90,14764,97,10566,N
97,O,923,923,14125,1240,16004,97,13202,O
97,N,312,312,14437,5,16009,97,14125,N
97,O,744,744,15181,1080,17089,97,14437,O
97,P,814,814,15995,3780,20869,97,15181,P
98,AE,302,302,302,1446,1446,98,0,A
98,BE,1061,759,1061,1381,1381,98,0,E
98,BF,1328,569,1630,240,1686,98,302,B
98,CF,583,14,1644,300,1681,98,1061,F
98,CG,201,187,1831,405,2091,98,1630,C
98,DG,1260,1073,2904,1275,2956,98,1644,G
98,DF,497,497,3401,455,3411,98,2904,F
98,DG,1945,375,3776,5160,7251,98,1831,D
98,G,1007,632,4408,1500,4911,98,3401,G
98,H,286,286,4694,3960,8871,98,4408,H
98,M,127,127,4821,190,9061,98,4694,M
98,N,149,149,4970,135,9196,98,4821,N
98,O,183,183,5153,285,9481,98,4970,O
98,P,107,107,5260,5160,14641,98,5153,P
99,AEI,282,282,282,1259,1259,99,0,I
99,AEJ,335,53,335,1109,1109,99,0,A
99,BEJ,1140,805,1140,1499,1499,99,0,E
99,BFJ,954,149,1289,240,1349,99,335,B
99,CFJ,142,142,1431,395,1744,99,1289,C
99,DFJ,1157,8,1439,240,1499,99,282,J
99,DFK,152,152,1591,395,1894,99,1439,K
99,DFL,600,149,1740,300,1799,99,1140,F
99,DGL,893,893,2633,1105,2904,99,1740,G
99,DFL,1119,77,2710,9700,11594,99,1591,L
99,DF,1191,1114,3824,1010,3914,99,2633,F
99,DG,2848,455,4279,9700,11444,99,1431,D
99,G,3300,2845,7124,3470,7384,99,3824,G
99,H,1838,1838,8962,385,7769,99,7124,H
99,M,357,357,9319,1591,13185,99,8962,M
99,N,1541,1541,10860,360,13545,99,9319,N
99,O,242,242,11102,330,13875,99,10860,O
99,N,1221,1221,12323,1175,15050,99,11102,N
99,O,861,861,13184,1056,16106,99,12323,O
99,P,335,335,13519,1494,17600,99,13184,P
100,AE,168,168,168,1357,1357,100,0,E
100,AF,1225,1057,1225,1595,1595,100,0,A
100,BF,1384,327,1552,240,1597,100,168,F
100,BG,622,295,1847,300,1895,100,1225,B
100,CG,855,560,2407,760,2357,100,1552,G
100,CH,864,304,2711,1045,2940,100,1847,C
100,DH,249,249,2960,1140,4080,100,2711,D
100,H,3576,3023,5983,7680,10037,100,2407,H
100,M,22,22,6005,235,10272,100,5983,M
100,N,490,490,6495,300,10572,100,6005,N
100,O,554,554,7049,720,11292,100,6495,O
100,P,308,308,7357,2940,14232,100,7049,P
101,A,56,56,56,151,151,101,0,A
101,B,180,180,236,135,286,101,56,B
101,C,167,167,403,285,571,101,236,C
101,D,146,146,549,5160,5731,101,403,D
101,M,901,901,1450,1285,7016,101,549,M
101,N,526,526,1976,180,7196,101,1450,N
101,O,192,192,2168,150,7346,101,1976,O
101,P,4155,4155,6323,385,7731,101,2168,P
102,AE,176,176,176,171,171,102,0,E
102,AF,474,298,474,1576,1576,102,0,A
102,BF,928,630,1104,150,321,102,176,F
102,BG,230,230,1334,490,811,102,1104,G
102,BH,1248,388,1722,180,1756,102,474,B
102,CH,562,562,2284,674,2430,102,1722,C
102,DH,1411,461,2745,720,1531,102,1334,H
102,D,1433,972,3717,4080,6510,102,2284,D
102,M,10209,10209,13926,11189,17699,102,3717,M
102,N,1202,1202,15128,240,17939,102,13926,N
102,O,1458,1458,16586,2880,20819,102,15128,O
102,P,408,408,16994,2400,23219,102,16586,P
103,AEI,19,19,19,157,157,103,0,A
103,BEI,243,243,262,150,307,103,19,B
103,CEI,254,254,516,100,407,103,262,C
103,DEI,521,5,521,492,492,103,0,E
103,DFI,711,190,711,1214,1214,103,0,I
103,DFJ,215,25,736,300,792,103,521,F
103,DGJ,246,26,762,4230,4637,103,516,D
103,GJ,640,589,1351,180,1394,103,711,J
103,GK,943,328,1679,935,1727,103,736,G
103,HK,852,524,2203,910,2304,103,1351,K
103,HL,608,84,2287,550,2277,103,1679,H
103,L,923,839,3126,550,2854,103,2203,L
103,M,1122,1122,4248,1654,6291,103,3126,M
103,N,781,781,5029,270,6561,103,4248,N
103,O,968,968,5997,1025,7586,103,5029,O
103,P,18317,18317,24314,355,7941,103,5997,P
104,A,160,160,160,1194,1194,104,0,A
104,B,1221,1221,1381,240,1434,104,160,B
104,C,828,828,2209,1020,2454,104,1381,C
104,D,6286,6286,8495,4680,7134,104,2209,D
104,M,1804,1804,10299,2039,9173,104,8495,M
104,N,261,261,10560,90,9263,104,10299,N
104,O,449,449,11009,820,10083,104,10560,O
104,N,403,403,11412,30,10113,104,11009,N
104,O,229,229,11641,695,10808,104,11412,O
104,P,2675,2675,14316,3780,14588,104,11641,P
105,AEI,152,152,152,733,733,105,0,I
105,AEJ,191,39,191,232,232,105,0,A
105,BEJ,271,80,271,897,897,105,0,E
105,BFJ,146,66,337,150,382,105,191,B
105,CFJ,174,174,511,170,552,105,337,C
105,DFJ,677,318,829,150,883,105,152,J
105,DFK,197,197,1026,145,1028,105,829,K
105,DFL,763,8,1034,180,1077,105,271,F
105,DGL,190,190,1224,220,1297,105,1034,G
105,DHL,738,25,1249,4200,4752,105,511,D
105,HL,1683,1460,2709,4200,5228,105,1026,L
105,H,2163,678,3387,4200,5497,105,1224,H
105,M,138,138,3525,308,5805,105,3387,M
105,N,380,380,3905,240,6045,105,3525,N
105,O,491,491,4396,815,6860,105,3905,O
105,P,57,57,4453,3840,10700,105,4396,P
106,AEI,377,377,377,2358,2358,106,0,E
106,AFI,427,50,427,889,889,106,0,I
106,AFJ,603,603,1030,150,1039,106,427,J
106,AFK,104,104,1134,180,1219,106,1030,K
106,AFL,310,310,1444,4170,5389,106,1134,L
106,AF,2080,1013,2457,150,2508,106,377,F
106,AG,123,123,2580,155,2663,106,2457,G
106,AH,504,504,3084,4200,6863,106,2580,H
106,A,4928,1844,4928,5083,5083,106,0,A
106,B,271,271,5199,90,5173,106,4928,B
106,C,921,921,6120,1225,6398,106,5199,C
106,D,1011,1011,7131,3780,10178,106,6120,D
106,M,47,47,7178,932,11110,106,7131,M
106,N,1091,1091,8269,240,11350,106,7178,N
106,O,654,654,8923,880,12230,106,8269,O
106,P,150,150,9073,3960,16190,106,8923,P
107,AEI,61,61,61,169,169,107,0,E
107,AFI,160,160,221,90,259,107,61,F
107,AGI,428,207,428,1538,1538,107,0,A
107,BGI,619,191,619,864,864,107,0,I
107,BGJ,741,343,962,1130,1389,107,221,G
107,BFJ,423,80,1042,150,1014,107,619,J
107,BFK,1201,587,1629,150,1688,107,428,B
107,CFK,1039,452,2081,1110,2124,107,1042,K
107,CFL,575,123,2204,610,2298,107,1629,C
107,DFL,280,280,2484,4200,6498,107,2204,D
107,FL,1647,125,2609,1255,2644,107,962,F
107,GL,852,852,3461,1275,3919,107,2609,G
107,HL,1530,150,3611,3960,6084,107,2081,L
107,H,312,162,3773,3780,7699,107,3461,H
107,M,167,167,3940,242,7941,107,3773,M
107,N,179,179,4119,150,8091,107,3940,N
107,O,601,601,4720,765,8856,107,4119,O
107,P,520,520,5240,3600,12456,107,4720,P
108,A,85,85,85,797,797,108,0,A
108,B,808,808,893,135,932,108,85,B
108,C,139,139,1032,215,1147,108,893,C
108,D,327,327,1359,4890,6037,108,1032,D
108,M,261,261,1620,1088,7125,108,1359,M
108,N,861,861,2481,90,7215,108,1620,N
108,O,1151,1151,3632,1400,8615,108,2481,O
108,P,122,122,3754,3780,12395,108,3632,P
109,A,536,536,536,1308,1308,109,0,A
109,B,959,959,1495,240,1548,109,536,B
109,C,802,802,2297,1030,2578,109,1495,C
109,D,97,97,2394,3960,6538,109,2297,D
109,M,637,637,3031,1300,7838,109,2394,M
109,N,694,694,3725,90,7928,109,3031,N
109,O,944,944,4669,1225,9153,109,3725,O
109,N,500,500,5169,205,9358,109,4669,N
109,O,167,167,5336,585,9943,109,5169,O
109,P,2406,2406,7742,3780,13723,109,5336,P
110,AE,629,629,629,783,783,110,0,A
110,BE,207,207,836,90,873,110,629,B
110,CE,1580,744,1580,2513,2513,110,0,E
110,CF,843,99,1679,820,1693,110,836,C
110,BF,718,718,2397,765,2458,110,1679,B
110,CF,960,143,2540,90,2603,110,1580,F
110,CG,522,522,3062,880,3483,110,2540,G
110,CF,471,471,3533,110,3593,110,3062,F
110,CG,1450,1450,4983,2315,5908,110,3533,G
110,CH,114,114,5097,3420,9328,110,4983,H
110,C,2904,204,5301,2320,4778,110,2397,C
110,D,1210,1210,6511,3420,8198,110,5301,D
110,M,1416,1416,7927,2593,11921,110,6511,M
110,N,1375,1375,9302,240,12161,110,7927,N
110,O,1064,1064,10366,855,13016,110,9302,O
110,P,1235,1235,11601,3960,16976,110,10366,P
111,A,104,104,104,365,365,111,0,A
111,B,336,336,440,180,545,111,104,B
111,C,1691,1691,2131,2010,2555,111,440,C
111,B,1126,1126,3257,810,3365,111,2131,B
111,C,670,670,3927,815,4180,111,3257,C
111,D,164,164,4091,610,4790,111,3927,D
111,M,344,344,4435,1149,5939,111,4091,M
111,N,895,895,5330,150,6089,111,4435,N
111,O,153,153,5483,100,6189,111,5330,O
111,N,547,547,6030,570,6759,111,5483,N
111,O,715,715,6745,660,7419,111,6030,O
111,P,1516,1516,8261,4230,11649,111,6745,P
112,AE,12,12,12,238,238,112,0,E
112,AF,44,32,44,101,101,112,0,A
112,BF,146,146,190,135,236,112,44,B
112,CF,314,136,326,135,373,112,12,F
112,CG,193,57,383,285,521,112,190,C
112,DG,83,83,466,5160,5681,112,383,D
112,G,160,20,486,280,653,112,326,G
112,H,286,286,772,5160,5813,112,486,H
112,M,444,444,1216,904,6717,112,772,M
112,N,601,601,1817,150,6867,112,1216,N
112,O,104,104,1921,180,7047,112,1817,O
112,P,310,310,2231,4170,11217,112,1921,P
113,A,72,72,72,106,106,113,0,A
113,B,123,123,195,150,256,113,72,B
113,C,180,180,375,455,711,113,195,C
113,D,915,915,1290,3565,4276,113,375,D
113,M,155,155,1445,1123,5399,113,1290,M
113,N,995,995,2440,90,5489,113,1445,N
113,O,1034,1034,3474,1220,6709,113,2440,O
113,N,387,387,3861,195,6904,113,3474,N
113,O,162,162,4023,585,7489,113,3861,O
113,P,2360,2360,6383,3780,11269,113,4023,P
114,AEI,215,215,215,809,809,114,0,A
114,BEI,694,694,909,150,959,114,215,B
114,CEI,168,168,1077,120,1079,114,909,C
114,BEI,265,265,1342,300,1379,114,1077,B
114,CEI,1888,546,1888,2379,2379,114,0,E
114,CFI,648,102,1990,610,1989,114,1342,C
114,DFI,591,489,2479,150,2529,114,1888,F
114,DGI,163,163,2642,120,2649,114,2479,G
114,DFI,276,276,2918,300,2949,114,2642,F
114,DGI,3018,100,3018,3491,3491,114,0,I
114,DGJ,634,534,3552,610,3559,114,2918,G
114,DHJ,661,127,3679,240,3731,114,3018,J
114,DHK,882,882,4561,970,4701,114,3679,K
114,DHJ,1185,176,4737,4230,7789,114,3552,H
114,DJ,1418,1242,5979,1310,6011,114,4561,J
114,DK,4096,107,6086,4230,6219,114,1990,D
114,K,705,598,6684,880,6891,114,5979,K
114,L,1005,1005,7689,3960,10851,114,6684,L
114,M,1164,1164,8853,1240,12091,114,7689,M
114,N,305,305,9158,240,12331,114,8853,N
114,O,2275,2275,11433,860,13191,114,9158,O
114,N,377,377,11810,1795,14986,114,11433,N
114,O,1016,1016,12826,1260,16246,114,11810,O
114,P,1497,1497,14323,3960,20206,114,12826,P
115,AEI,32,32,32,358,358,115,0,A
115,BEI,64,32,64,123,123,115,0,I
115,BEJ,169,105,169,455,455,115,0,E
115,BFJ,196,91,260,180,303,115,64,J
115,BFK,155,155,415,210,513,115,260,K
115,BFL,344,98,513,90,545,115,169,F
115,BGL,565,84,597,300,658,115,32,B
115,CGL,202,20,617,365,878,115,415,L
115,CG,224,120,737,600,1145,115,513,G
115,CF,681,541,1278,825,1483,115,597,C
115,BF,1393,852,2130,1000,2145,115,737,F
115,BG,1089,237,2367,1110,2593,115,1278,B
115,CG,463,463,2830,630,3223,115,2367,C
115,DG,1127,427,3257,1275,3420,115,2130,G
115,DH,4639,4639,7896,3780,7200,115,3257,H
115,D,15795,10729,18625,6060,9283,115,2830,D
115,M,688,688,19313,2883,12166,115,18625,M
115,N,2388,2388,21701,240,12406,115,19313,N
115,O,150,150,21851,415,12821,115,21701,O
115,N,1489,1489,23340,1205,14026,115,21851,N
115,O,963,963,24303,1225,15251,115,23340,O
115,P,8204,8204,32507,3960,19211,115,24303,P
116,AEI,233,233,233,1274,1274,116,0,I
116,AEJ,480,247,480,575,575,116,0,A
116,BEJ,236,236,716,180,755,116,480,B
116,CEJ,252,252,968,460,1215,116,716,C
116,BEJ,329,329,1297,135,1350,116,968,B
116,CEJ,1158,94,1391,150,1424,116,233,J
116,CEK,230,136,1527,2970,4320,116,1297,C
116,DEK,1555,28,1555,4459,4459,116,0,E
116,DFK,654,490,2045,735,2159,116,1391,K
116,DFL,1620,1620,3665,4230,6389,116,2045,L
116,DF,3281,1171,4836,420,4879,116,1555,F
116,DG,1282,1282,6118,1376,6255,116,4836,G
116,DH,505,505,6623,504,6759,116,6118,H
116,D,7018,1922,8545,1440,5760,116,1527,D
116,M,3223,3223,11768,3495,10254,116,8545,M
116,N,653,653,12421,420,10674,116,11768,N
116,O,851,851,13272,1160,11834,116,12421,O
116,N,958,958,14230,680,12514,116,13272,N
116,O,383,383,14613,525,13039,116,14230,O
116,P,4985,4985,19598,1155,14194,116,14613,P
117,A,261,261,261,654,654,117,0,A
117,B,585,585,846,240,894,117,261,B
117,C,996,996,1842,976,1870,117,846,C
117,B,481,481,2323,365,2235,117,1842,B
117,C,2359,2359,4682,1260,3495,117,2323,C
117,D,2739,2739,7421,3960,7455,117,4682,D
117,M,192,192,7613,877,8332,117,7421,M
117,N,932,932,8545,300,8632,117,7613,N
117,O,684,684,9229,820,9452,117,8545,O
117,N,1139,1139,10368,990,10442,117,9229,N
117,O,223,223,10591,396,10838,117,10368,O
117,P,3,3,10594,8400,19238,117,10591,P
118,AEI,23,23,23,393,393,118,0,I
118,AEJ,174,151,174,676,676,118,0,A
118,BEJ,454,303,477,135,528,118,23,J
118,BEK,229,229,706,295,823,118,477,K
118,BEL,99,99,805,5100,5923,118,706,L
118,BE,689,58,863,240,916,118,174,B
118,CE,196,196,1059,300,1216,118,863,C
118,DE,1746,687,1746,2656,2656,118,0,E
118,DF,951,951,2697,90,2746,118,1746,F
118,DG,554,554,3251,880,3626,118,2697,G
118,DF,3595,1403,4654,5100,6316,118,1059,D
118,F,1681,278,4932,1345,4971,118,3251,F
118,G,1128,1128,6060,1425,6396,118,4932,G
118,H,17,17,6077,3780,10176,118,6060,H
118,M,687,687,6764,1068,11244,118,6077,M
118,N,906,906,7670,180,11424,118,6764,N
118,O,571,571,8241,895,12319,118,7670,O
118,N,1037,1037,9278,1100,13419,118,8241,N
118,O,442,442,9720,565,13984,118,9278,O
118,P,490,490,10210,6960,20944,118,9720,P
119,A,1427,1427,1427,1591,1591,119,0,A
119,B,314,314,1741,210,1801,119,1427,B
119,C,153,153,1894,255,2056,119,1741,C
119,B,917,917,2811,795,2851,119,1894,B
119,C,460,460,3271,760,3611,119,2811,C
119,D,985,985,4256,3600,7211,119,3271,D
119,M,780,780,5036,1239,8450,119,4256,M
119,N,484,484,5520,90,8540,119,5036,N
119,O,335,335,5855,820,9360,119,5520,O
119,N,1761,1761,7616,1260,10620,119,5855,N
119,O,719,719,8335,1060,11680,119,7616,O
119,P,2355,2355,10690,3780,15460,119,8335,P
120,A,3277,3277,3277,3458,3458,120,0,A
120,B,225,225,3502,90,3548,120,3277,B
120,C,635,635,4137,820,4368,120,3502,C
120,B,547,547,4684,375,4743,120,4137,B
120,C,407,407,5091,740,5483,120,4684,C
120,D,2596,2596,7687,3780,9263,120,5091,D
120,M,237,237,7924,401,9664,120,7687,M
120,N,188,188,8112,90,9754,120,7924,N
120,O,347,347,8459,750,10504,120,8112,O
120,P,1239,1239,9698,4625,15129,120,8459,P
121,AE,62,62,62,236,236,121,0,A
121,BE,251,251,313,135,371,121,62,B
121,CE,719,719,1032,845,1216,121,313,C
121,DE,1630,1630,2662,5220,6436,121,1032,D
121,E,12740,10078,12740,13135,13135,121,0,E
121,F,812,812,13552,300,13435,121,12740,F
121,G,646,646,14198,760,14195,121,13552,G
121,H,273,273,14471,1560,15755,121,14198,H
121,M,4425,4425,18896,4470,20225,121,14471,M
121,N,303,303,19199,300,20525,121,18896,N
121,O,724,724,19923,855,21380,121,19199,O
121,N,469,469,20392,340,21720,121,19923,N
121,O,124,124,20516,775,22495,121,20392,O
121,P,15,15,20531,1620,24115,121,20516,P
122,A,291,291,291,354,354,122,0,A
122,B,253,253,544,240,594,122,291,B
122,C,806,806,1350,970,1564,122,544,C
122,D,94,94,1444,4020,5584,122,1350,D
122,M,7978,7978,9422,8562,14146,122,1444,M
122,N,624,624,10046,90,14236,122,9422,N
122,O,975,975,11021,1225,15461,122,10046,O
122,N,1452,1452,12473,1195,16656,122,11021,N
122,O,203,203,12676,675,17331,122,12473,O
122,P,362,362,13038,3780,21111,122,12676,P
123,A,41,41,41,246,246,123,0,A
123,B,491,491,532,90,336,123,41,B
123,C,920,920,1452,1005,1341,123,532,C
123,D,65,65,1517,3780,5121,123,1452,D
123,M,53,53,1570,395,5516,123,1517,M
123,N,478,478,2048,165,5681,123,1570,N
123,O,1004,1004,3052,1275,6956,123,2048,O
123,P,170,170,3222,3960,10916,123,3052,P
124,AEI,71,71,71,551,551,124,0,I
124,AEJ,823,823,894,420,971,124,71,J
124,AEK,1374,480,1374,1549,1549,124,0,E
124,AFK,279,279,1653,150,1699,124,1374,F
124,AGK,916,157,1810,880,1851,124,894,K
124,AGL,221,64,1874,176,1875,124,1653,G
124,AHL,2198,324,2198,2416,2416,124,0,A
124,BHL,365,365,2563,180,2596,124,2198,B
124,CHL,915,226,2789,379,2254,124,1874,H
124,CL,900,674,3463,930,3526,124,2563,C
124,DL,3426,1773,5236,550,2401,124,1810,L
124,D,3571,1798,7034,550,4076,124,3463,D
124,M,264,264,7298,1720,5796,124,7034,M
124,N,1551,1551,8849,150,5946,124,7298,N
124,O,81,81,8930,55,6001,124,8849,O
124,N,921,921,9851,930,6931,124,8930,N
124,O,810,810,10661,930,7861,124,9851,O
124,P,4419,4419,15080,6990,14851,124,10661,P
125,AEI,7,7,7,148,148,125,0,A
125,BEI,68,61,68,144,144,125,0,I
125,BEJ,257,257,325,240,384,125,68,J
125,BEK,334,16,341,240,388,125,7,B
125,CEK,726,726,1067,975,1363,125,341,C
125,DEK,803,61,1128,945,1329,125,325,K
125,DEL,735,735,1863,5160,6489,125,1128,L
125,DE,1095,299,2162,3960,5323,125,1067,D
125,E,4072,1910,4072,4707,4707,125,0,E
125,F,667,667,4739,90,4797,125,4072,F
125,G,311,311,5050,705,5502,125,4739,G
125,H,1063,1063,6113,3780,9282,125,5050,H
125,M,66,66,6179,65,9347,125,6113,M
125,N,196,196,6375,240,9587,125,6179,N
125,O,764,764,7139,1005,10592,125,6375,O
125,P,2383,2383,9522,3960,14552,125,7139,P
126,A,1143,1143,1143,1595,1595,126,0,A
126,B,695,695,1838,300,1895,126,1143,B
126,C,765,765,2603,830,2725,126,1838,C
126,D,25,25,2628,5310,8035,126,2603,D
126,M,101,101,2729,108,8143,126,2628,M
126,N,183,183,2912,240,8383,126,2729,N
126,O,249,249,3161,240,8623,126,2912,O
126,P,506,506,3667,5250,13873,126,3161,P
127,A,43,43,43,1182,1182,127,0,A
127,B,1166,1166,1209,90,1272,127,43,B
127,C,1030,1030,2239,1220,2492,127,1209,C
127,D,39,39,2278,3780,6272,127,2239,D
127,M,1989,1989,4267,2701,8973,127,2278,M
127,N,749,749,5016,90,9063,127,4267,N
127,O,203,203,5219,605,9668,127,5016,O
127,P,8598,8598,13817,3780,13448,127,5219,P
128,AE,43,43,43,2843,2843,128,0,A
128,BE,86,43,86,205,205,128,0,E
128,BF,210,210,296,135,340,128,86,F
128,BG,194,194,490,285,625,128,296,G
128,BH,108,108,598,5160,5785,128,490,H
128,B,2985,2430,3028,240,3083,128,43,B
128,C,223,223,3251,285,3368,128,3028,C
128,D,1323,1323,4574,5160,8528,128,3251,D
128,M,772,772,5346,1544,10072,128,4574,M
128,N,797,797,6143,90,10162,128,5346,N
128,O,881,881,7024,1250,11412,128,6143,O
128,P,1653,1653,8677,3780,15192,128,7024,P
129,AE,24,24,24,88,88,129,0,A
129,BE,271,271,295,240,328,129,24,B
129,CE,832,832,1127,1045,1373,129,295,C
129,DE,464,464,1591,3960,5333,129,1127,D
129,E,6122,4531,6122,6842,6842,129,0,E
129,F,749,749,6871,90,6932,129,6122,F
129,G,260,260,7131,630,7562,129,6871,G
129,H,472,472,7603,3780,11342,129,7131,H
129,M,367,367,7970,671,12013,129,7603,M
129,N,330,330,8300,90,12103,129,7970,N
129,O,526,526,8826,845,12948,129,8300,O
129,P,445,445,9271,3780,16728,129,8826,P
130,AE,101,101,101,684,684,130,0,A
130,BE,766,766,867,240,924,130,101,B
130,CE,175,175,1042,285,1209,130,867,C
130,DE,1194,152,1194,2056,2056,130,0,E
130,DF,915,915,2109,90,2146,130,1194,F
130,DG,1214,147,2256,5100,6309,130,1042,D
130,G,329,182,2438,1825,3971,130,2109,G
130,H,1660,1660,4098,3780,7751,130,2438,H
130,M,391,391,4489,1318,9069,130,4098,M
130,N,958,958,5447,90,9159,130,4489,N
130,O,772,772,6219,1200,10359,130,5447,O
130,N,911,911,7130,465,10824,130,6219,N
130,O,678,678,7808,1060,11884,130,7130,O
130,P,1055,1055,8863,3780,15664,130,7808,P
131,AEI,1,1,1,1348,1348,131,0,E
131,AFI,55,54,55,545,545,131,0,A
131,BFI,145,90,145,165,165,131,0,I
131,BFJ,345,345,490,300,465,131,145,J
131,BFK,764,329,819,300,845,131,55,B
131,CFK,668,339,1158,750,1215,131,490,K
131,CFJ,568,229,1387,760,1605,131,819,C
131,DFJ,249,20,1407,245,1460,131,1158,J
131,DFK,1467,61,1468,180,1528,131,1,F
131,DGK,228,167,1635,440,1900,131,1407,K
131,DGL,332,165,1800,545,2073,131,1468,G
131,DFL,1395,982,2782,3960,5565,131,1387,D
131,FL,987,5,2787,760,2833,131,1800,F
131,GL,1155,3,2790,2160,4060,131,1635,L
131,G,622,619,3409,610,3443,131,2787,G
131,H,10984,10984,14393,5100,8543,131,3409,H
131,M,2839,2839,17232,2865,11408,131,14393,M
131,N,221,221,17453,240,11648,131,17232,N
131,O,701,701,18154,740,12388,131,17453,O
131,N,364,364,18518,420,12808,131,18154,N
131,O,883,883,19401,800,13608,131,18518,O
131,P,74,74,19475,5220,18828,131,19401,P
132,AE,152,152,152,415,415,132,0,A
132,BE,299,299,451,90,505,132,152,B
132,CE,971,971,1422,1470,1975,132,451,C
132,DE,2107,685,2107,2600,2600,132,0,E
132,DF,1007,322,2429,3780,5755,132,1422,D
132,F,524,202,2631,90,2690,132,2107,F
132,G,556,556,3187,820,3510,132,2631,G
132,F,1221,1221,4408,785,4295,132,3187,F
132,G,1206,1206,5614,1790,6085,132,4408,G
132,H,998,998,6612,3780,9865,132,5614,H
132,M,5738,5738,12350,8788,18653,132,6612,M
132,N,4124,4124,16474,90,18743,132,12350,N
132,O,632,632,17106,1130,19873,132,16474,O
132,P,2775,2775,19881,3780,23653,132,17106,P
133,AEI,45,45,45,758,758,133,0,I
133,AEJ,876,831,876,1309,1309,133,0,A
133,BEJ,892,61,937,240,998,133,45,J
133,BEK,641,580,1517,270,1579,133,876,B
133,CEK,1640,123,1640,1680,1680,133,0,E
133,CFK,248,125,1765,205,1784,133,1517,C
133,BFK,233,108,1873,250,1930,133,1640,F
133,BGK,229,121,1994,260,2044,133,1765,B
133,CGK,1061,4,1998,1390,2388,133,937,K
133,CGJ,682,678,2676,2880,4924,133,1994,C
133,DGJ,919,116,2792,1170,3100,133,1873,G
133,DFJ,1610,816,3608,2585,4973,133,1998,J
133,DFK,921,105,3713,655,3755,133,2792,F
133,DGK,661,661,4374,191,3946,133,3713,G
133,DHK,768,2,4376,1560,6533,133,3608,K
133,DHL,2907,1207,5583,3445,8369,133,2676,D
133,HL,4618,3411,8994,3600,10133,133,4376,L
133,H,6370,1750,10744,824,4770,133,4374,H
133,M,193,193,10937,203,10336,133,10744,M
133,N,136,136,11073,240,10576,133,10937,N
133,O,1099,1099,12172,1074,11650,133,11073,O
133,P,448,448,12620,356,12006,133,12172,P
134,A,662,662,662,839,839,134,0,A
134,B,216,216,878,90,929,134,662,B
134,C,1415,1415,2293,1935,2864,134,878,C
134,D,2806,2806,5099,3780,6644,134,2293,D
134,M,85,85,5184,399,7043,134,5099,M
134,N,379,379,5563,90,7133,134,5184,N
134,O,1399,1399,6962,1745,8878,134,5563,O
134,P,39,39,7001,3780,12658,134,6962,P
135,A,420,420,420,434,434,135,0,A
135,B,149,149,569,195,629,135,420,B
135,C,713,713,1282,700,1329,135,569,C
135,D,1457,1457,2739,385,1714,135,1282,D
135,M,117,117,2856,560,2274,135,2739,M
135,N,837,837,3693,420,2694,135,2856,N
135,O,873,873,4566,1114,3808,135,3693,O
135,P,776,776,5342,341,4149,135,4566,P
136,AE,22,22,22,185,185,136,0,E
136,AF,71,49,71,872,872,136,0,A
136,BF,388,339,410,240,425,136,22,F
136,BG,237,237,647,755,1180,136,410,G
136,BH,994,418,1065,240,1112,136,71,B
136,CH,198,198,1263,265,1377,136,1065,C
136,DH,1167,551,1814,3670,4850,136,647,H
136,D,4238,3687,5501,5460,6837,136,1263,D
136,M,188,188,5689,194,7031,136,5501,M
136,N,126,126,5815,150,7181,136,5689,N
136,O,216,216,6031,455,7636,136,5815,O
136,P,837,837,6868,3565,11201,136,6031,P
137,AEI,93,93,93,392,392,137,0,A
137,BEI,239,146,239,349,349,137,0,E
137,BFI,444,205,444,1078,1078,137,0,I
137,BFJ,415,64,508,180,572,137,93,B
137,CFJ,480,211,719,385,734,137,239,F
137,CGJ,498,287,1006,735,1307,137,508,C
137,DGJ,101,101,1107,2880,4187,137,1006,D
137,GJ,784,121,1228,210,1288,137,444,J
137,GK,1155,646,1874,1435,2169,137,719,G
137,FK,903,257,2131,1000,2288,137,1228,K
137,FL,2065,2065,4196,5165,7453,137,2131,L
137,F,3357,1035,5231,3185,5354,137,1874,F
137,G,732,732,5963,770,6124,137,5231,G
137,H,50,50,6013,340,6464,137,5963,H
137,M,486,486,6499,1465,8918,137,6013,M
137,N,1009,1009,7508,90,9008,137,6499,N
137,O,1045,1045,8553,1220,10228,137,7508,O
137,N,353,353,8906,175,10403,137,8553,N
137,O,254,254,9160,695,11098,137,8906,O
137,P,19940,19940,29100,3780,14878,137,9160,P
138,AEI,105,105,105,118,118,138,0,E
138,AFI,194,89,194,623,623,138,0,A
138,BFI,122,33,227,150,268,138,105,F
138,BGI,166,166,393,130,398,138,227,G
138,BFI,454,255,648,90,713,138,194,B
138,CFI,909,654,1302,930,1328,138,393,F
138,CGI,330,330,1632,645,1973,138,1302,G
138,CHI,1517,533,2165,2315,3028,138,648,C
138,DHI,1872,1339,3504,4230,6203,138,1632,H
138,DI,1699,360,3864,3420,6448,138,2165,D
138,I,7433,3569,7433,8224,8224,138,0,I
138,J,821,821,8254,90,8314,138,7433,J
138,K,660,660,8914,905,9219,138,8254,K
138,J,339,339,9253,90,9309,138,8914,J
138,K,1609,1609,10862,2320,11629,138,9253,K
138,L,32933,32933,43795,3420,15049,138,10862,L
138,M,2711,2711,46506,3118,18167,138,43795,M
138,N,437,437,46943,90,18257,138,46506,N
138,O,1709,1709,48652,1940,20197,138,46943,O
138,P,135,135,48787,3780,23977,138,48652,P
139,AEI,45,45,45,126,126,139,0,E
139,AFI,165,165,210,135,261,139,45,F
139,AGI,119,119,329,215,476,139,210,G
139,AHI,619,619,948,4890,5366,139,329,H
139,AI,1647,699,1647,1608,1608,139,0,I
139,AJ,1700,53,1700,2432,2432,139,0,A
139,BJ,152,99,1799,240,1848,139,1647,J
139,BK,831,732,2531,150,2582,139,1700,B
139,CK,1022,290,2821,855,2703,139,1799,K
139,CL,767,477,3298,1030,3612,139,2531,C
139,DL,2499,2022,5320,3960,6663,139,2821,L
139,D,2588,566,5886,3960,7572,139,3298,D
139,M,497,497,6383,1597,9169,139,5886,M
139,N,1296,1296,7679,240,9409,139,6383,N
139,O,754,754,8433,970,10379,139,7679,O
139,P,1001,1001,9434,3960,14339,139,8433,P
140,AEI,89,89,89,670,670,140,0,I
140,AEJ,853,853,942,300,970,140,89,J
140,AEK,1113,171,1113,1123,1123,140,0,E
140,AFK,216,216,1329,240,1363,140,1113,F
140,AGK,904,517,1846,925,1895,140,942,K
140,AGL,707,190,2036,960,2323,140,1329,G
140,AHL,175,175,2211,3960,6283,140,2036,H
140,AL,1517,1152,3363,2760,4655,140,1846,L
140,A,13315,9952,13315,14220,14220,140,0,A
140,B,1158,1158,14473,300,14520,140,13315,B
140,C,943,943,15416,905,15425,140,14473,C
140,D,1478,1478,16894,2760,18185,140,15416,D
140,M,1549,1549,18443,1575,19760,140,16894,M
140,N,283,283,18726,280,20040,140,18443,N
140,O,911,911,19637,910,20950,140,18726,O
140,P,1556,1556,21193,550,21500,140,19637,P
141,AEI,66,66,66,86,86,141,0,I
141,AEJ,288,222,288,478,478,141,0,A
141,BEJ,223,1,289,240,326,141,66,J
141,BEK,470,469,758,240,718,141,288,B
141,CEK,827,358,1116,995,1321,141,289,K
141,CEL,364,364,1480,3960,5281,141,1116,L
141,CE,785,63,1543,735,1453,141,758,C
141,DE,1122,1122,2665,3960,5413,141,1543,D
141,E,8700,6035,8700,9128,9128,141,0,E
141,F,461,461,9161,90,9218,141,8700,F
141,G,807,807,9968,1130,10348,141,9161,G
141,H,132,132,10100,3780,14128,141,9968,H
141,M,2055,2055,12155,3090,17218,141,10100,M
141,N,1067,1067,13222,90,17308,141,12155,N
141,O,731,731,13953,1135,18443,141,13222,O
141,P,14635,14635,28588,3780,22223,141,13953,P
142,AE,296,296,296,331,331,142,0,A
142,BE,238,238,534,240,571,142,296,B
142,CE,961,961,1495,900,1471,142,534,C
142,BE,355,355,1850,400,1871,142,1495,B
142,CE,655,655,2505,800,2671,142,1850,C
142,DE,3057,3057,5562,4140,6811,142,2505,D
142,E,10934,5372,10934,14161,14161,142,0,E
142,F,3444,3444,14378,240,14401,142,10934,F
142,G,659,659,15037,980,15381,142,14378,G
142,H,1615,1615,16652,3960,19341,142,15037,H
142,M,2572,2572,19224,2938,22279,142,16652,M
142,N,572,572,19796,240,22519,142,19224,N
142,O,836,836,20632,920,23439,142,19796,O
142,P,59,59,20691,3960,27399,142,20632,P
143,A,612,612,612,1073,1073,143,0,A
143,B,626,626,1238,150,1223,143,612,B
143,C,175,175,1413,220,1443,143,1238,C
143,B,1518,1518,2931,1535,2978,143,1413,B
143,C,337,337,3268,645,3623,143,2931,C
143,D,3405,3405,6673,4230,7853,143,3268,D
143,M,350,350,7023,401,8254,143,6673,M
143,N,171,171,7194,180,8434,143,7023,N
143,O,1241,1241,8435,935,9369,143,7194,O
143,P,3322,3322,11757,660,10029,143,8435,P
144,AE,255,255,255,1398,1398,144,0,E
144,AF,323,68,323,1250,1250,144,0,A
144,BF,957,957,1280,90,1340,144,323,B
144,CF,1240,215,1495,150,1548,144,255,F
144,CG,162,162,1657,125,1673,144,1495,G
144,CF,405,405,2062,425,2098,144,1657,F
144,CG,990,208,2270,1240,2580,144,1280,C
144,DG,824,616,2886,825,2923,144,2062,G
144,DH,260,260,3146,4170,7093,144,2886,H
144,D,2924,2048,5194,3840,6420,144,2270,D
144,M,4234,4234,9428,4857,11950,144,5194,M
144,N,654,654,10082,90,12040,144,9428,N
144,O,719,719,10801,920,12960,144,10082,O
144,P,388,388,11189,3780,16740,144,10801,P
145,AE,181,181,181,244,244,145,0,E
145,AF,254,254,435,240,484,145,181,F
145,AG,650,215,650,685,685,145,0,A
145,BG,335,335,985,360,1045,145,650,B
145,CG,976,426,1411,910,1394,145,435,G
145,CH,691,265,1676,655,1700,145,985,C
145,DH,3194,3194,4870,550,2250,145,1676,D
145,H,6476,3017,7887,550,1944,145,1411,H
145,M,582,582,8469,1017,3267,145,7887,M
145,N,857,857,9326,420,3687,145,8469,N
145,O,880,880,10206,1240,4927,145,9326,O
145,P,624,624,10830,335,5262,145,10206,P
146,AE,44,44,44,119,119,146,0,A
146,BE,141,141,185,135,254,146,44,B
146,CE,198,198,383,215,469,146,185,C
146,DE,595,595,978,4890,5359,146,383,D
146,E,1134,156,1134,1862,1862,146,0,E
146,F,896,896,2030,240,2102,146,1134,F
146,G,675,675,2705,700,2802,146,2030,G
146,H,265,265,2970,3960,6762,146,2705,H
146,M,177,177,3147,249,7011,146,2970,M
146,N,170,170,3317,150,7161,146,3147,N
146,O,636,636,3953,765,7926,146,3317,O
146,P,482,482,4435,3600,11526,146,3953,P
147,AE,291,291,291,140,140,147,0,A
147,BE,59,59,350,300,440,147,291,B
147,CE,400,50,400,722,722,147,0,E
147,CF,606,606,1006,360,1082,147,400,F
147,CG,970,314,1320,690,1130,147,350,C
147,BG,166,166,1486,390,1520,147,1320,B
147,CG,1097,617,2103,1000,2082,147,1006,G
147,CH,703,86,2189,750,2270,147,1486,C
147,DH,2272,2272,4461,3960,6230,147,2189,D
147,H,2872,514,4975,550,2632,147,2103,H
147,M,1001,1001,5976,1520,7750,147,4975,M
147,N,660,660,6636,150,7900,147,5976,N
147,O,854,854,7490,2165,10065,147,6636,O
147,P,1843,1843,9333,2880,12945,147,7490,P
148,A,3634,3634,3634,3734,3734,148,0,A
148,B,141,141,3775,90,3824,148,3634,B
148,C,616,616,4391,815,4639,148,3775,C
148,B,1422,1422,5813,1105,5744,148,4391,B
148,C,1312,1312,7125,1850,7594,148,5813,C
148,D,2088,2088,9213,3780,11374,148,7125,D
148,M,246,246,9459,740,12114,148,9213,M
148,N,749,749,10208,300,12414,148,9459,N
148,O,960,960,11168,925,13339,148,10208,O
148,P,3915,3915,15083,2760,16099,148,11168,P
149,A,88,88,88,104,104,149,0,A
149,B,99,99,187,135,239,149,88,B
149,C,240,240,427,285,524,149,187,C
149,D,128,128,555,5160,5684,149,427,D
149,M,1024,1024,1579,1388,7072,149,555,M
149,N,429,429,2008,90,7162,149,1579,N
149,O,902,902,2910,1250,8412,149,2008,O
149,P,674,674,3584,3780,12192,149,2910,P
150,A,224,224,224,265,265,150,0,A
150,B,161,161,385,210,475,150,224,B
150,C,383,383,768,600,1075,150,385,C
150,B,558,558,1326,305,1380,150,768,B
150,C,871,871,2197,1162,2542,150,1326,C
150,D,2064,2064,4261,1953,4495,150,2197,D
150,M,157,157,4418,1312,5807,150,4261,M
150,N,1421,1421,5839,300,6107,150,4418,N
150,O,553,553,6392,1595,7702,150,5839,O
150,P,3,3,6395,7050,14752,150,6392,P
151,AEI,77,77,77,228,228,151,0,E
151,AFI,137,60,137,216,216,151,0,A
151,BFI,241,104,241,1110,1110,151,0,I
151,BFJ,168,64,305,150,366,151,137,B
151,CFJ,244,16,321,150,378,151,77,F
151,CGJ,178,178,499,455,833,151,321,G
151,CHJ,577,383,882,795,1161,151,305,C
151,DHJ,989,348,1230,180,1290,151,241,J
151,DHK,888,157,1387,3565,4398,151,499,H
151,DK,1218,713,2100,2880,4041,151,882,D
151,K,926,56,2156,1050,2340,151,1230,K
151,L,762,762,2918,6460,8800,151,2156,L
151,M,212,212,3130,231,9031,151,2918,M
151,N,95,95,3225,135,9166,151,3130,N
151,O,147,147,3372,280,9446,151,3225,O
151,P,309,309,3681,5160,14606,151,3372,P
152,A,122,122,122,1385,1385,152,0,A
152,B,1342,1342,1464,150,1535,152,122,B
152,C,96,96,1560,60,1595,152,1464,C
152,B,636,636,2196,665,2260,152,1560,B
152,C,52,52,2248,35,2295,152,2196,C
152,D,330,330,2578,2880,5175,152,2248,D
152,M,294,294,2872,322,5497,152,2578,M
152,N,124,124,2996,150,5647,152,2872,N
152,O,163,163,3159,130,5777,152,2996,O
152,N,866,866,4025,875,6652,152,3159,N
152,O,665,665,4690,690,7342,152,4025,O
152,P,2900,2900,7590,4230,11572,152,4690,P
153,A,150,150,150,789,789,153,0,A
153,B,759,759,909,180,969,153,150,B
153,C,126,126,1035,365,1334,153,909,C
153,D,30,30,1065,5605,6939,153,1035,D
153,M,331,331,1396,1406,8345,153,1065,M
153,N,1267,1267,2663,240,8585,153,1396,N
153,O,760,760,3423,760,9345,153,2663,O
153,P,1176,1176,4599,7680,17025,153,3423,P
154,A,108,108,108,205,205,154,0,A
154,B,189,189,297,150,355,154,108,B
154,C,158,158,455,455,810,154,297,C
154,D,918,918,1373,3565,4375,154,455,D
154,M,124,124,1497,248,4623,154,1373,M
154,N,219,219,1716,135,4758,154,1497,N
154,O,180,180,1896,290,5048,154,1716,O
154,P,3024,3024,4920,5160,10208,154,1896,P
155,A,27,27,27,123,123,155,0,A
155,B,268,268,295,240,363,155,27,B
155,C,896,896,1191,975,1338,155,295,C
155,D,733,733,1924,5040,6378,155,1191,D
155,M,64,64,1988,92,6470,155,1924,M
155,N,125,125,2113,135,6605,155,1988,N
155,O,149,149,2262,285,6890,155,2113,O
155,P,718,718,2980,5160,12050,155,2262,P
156,A,1,1,1,169,169,156,0,A
156,B,336,336,337,240,409,156,1,B
156,C,721,721,1058,975,1384,156,337,C
156,D,22,22,1080,6465,7849,156,1058,D
156,M,180,180,1260,198,8047,156,1080,M
156,N,113,113,1373,135,8182,156,1260,N
156,O,168,168,1541,280,8462,156,1373,O
156,P,164,164,1705,5160,13622,156,1541,P
157,AE,1307,1307,1307,1612,1612,157,0,A
157,BE,365,365,1672,90,1702,157,1307,B
157,CE,504,504,2176,860,2562,157,1672,C
157,DE,1899,1899,4075,3780,6342,157,2176,D
157,E,36496,32421,36496,37477,37477,157,0,E
157,F,1011,1011,37507,90,37567,157,36496,F
157,G,1012,1012,38519,1220,38787,157,37507,G
157,H,5,5,38524,3780,42567,157,38519,H
157,M,3052,3052,41576,3241,45808,157,38524,M
157,N,222,222,41798,90,45898,157,41576,N
157,O,557,557,42355,805,46703,157,41798,O
157,P,960,960,43315,3780,50483,157,42355,P
158,AEI,121,121,121,913,913,158,0,I
158,AEJ,216,95,216,176,176,158,0,E
158,AFJ,150,150,366,240,416,158,216,F
158,AGJ,112,112,478,395,811,158,366,G
158,AFJ,890,533,1011,150,1063,158,121,J
158,AFK,1169,158,1169,4669,4669,158,0,A
158,BFK,159,1,1170,120,1183,158,1011,K
158,BFJ,772,80,1250,480,1291,158,478,F
158,BGJ,742,742,1992,920,2211,158,1250,G
158,BHJ,1532,710,2702,1560,2743,158,1170,J
158,BHK,655,655,3357,650,3393,158,2702,K
158,BHL,3516,1328,4685,90,4759,158,1169,B
158,CHL,1001,1001,5686,1345,6104,158,4685,C
158,DHL,2204,2204,7890,3780,9884,158,5686,D
158,HL,8801,4268,12158,4230,7623,158,3357,L
158,H,19064,8898,21056,3960,6171,158,1992,H
158,M,147,147,21203,165,10049,158,21056,M
158,N,282,282,21485,300,10349,158,21203,N
158,O,666,666,22151,800,11149,158,21485,O
158,P,110,110,22261,1140,12289,158,22151,P
159,A,3,3,3,208,208,159,0,A
159,B,322,322,325,180,388,159,3,B
159,C,757,757,1082,985,1373,159,325,C
159,D,2352,2352,3434,3495,4868,159,1082,D
159,M,44,44,3478,1195,6063,159,3434,M
159,N,1341,1341,4819,240,6303,159,3478,N
159,O,831,831,5650,760,7063,159,4819,O
159,P,665,665,6315,7680,14743,159,5650,P
160,AE,25,25,25,228,228,160,0,E
160,AF,95,70,95,786,786,160,0,A
160,BF,355,285,380,135,363,160,25,F
160,BG,203,203,583,290,653,160,380,G
160,BH,139,139,722,5160,5813,160,583,H
160,B,781,154,876,150,936,160,95,B
160,C,163,163,1039,540,1476,160,876,C
160,D,349,349,1388,720,2196,160,1039,D
160,M,732,732,2120,1184,6997,160,1388,M
160,N,515,515,2635,90,7087,160,2120,N
160,O,997,997,3632,1250,8337,160,2635,O
160,P,2061,2061,5693,3780,12117,160,3632,P
161,AEI,620,620,620,1009,1009,161,0,E
161,AFI,817,197,817,1152,1152,161,0,A
161,BFI,559,362,1179,180,1189,161,620,F
161,BGI,489,127,1306,180,1332,161,817,B
161,CGI,1632,326,1632,1988,1988,161,0,I
161,CGJ,906,580,2212,930,2262,161,1306,C
161,DGJ,596,16,2228,300,2288,161,1632,J
161,DGK,1805,756,2984,910,2099,161,1179,G
161,DHK,876,120,3104,890,3178,161,2228,K
161,DHL,3813,3813,6917,385,3563,161,3104,L
161,DH,5720,1015,7932,550,2812,161,2212,D
161,H,5267,319,8251,550,2649,161,2984,H
161,M,2102,2102,10353,2358,5921,161,8251,M
161,N,632,632,10985,420,6341,161,10353,N
161,O,724,724,11709,816,7157,161,10985,O
161,P,354,354,12063,414,7571,161,11709,P
162,AE,259,259,259,474,474,162,0,E
162,AF,441,182,441,515,515,162,0,A
162,BF,326,144,585,150,624,162,259,F
162,BG,191,47,632,180,695,162,441,B
162,CG,164,164,796,140,835,162,632,C
162,DG,43,43,839,2880,3715,162,796,D
162,G,443,189,1028,455,1079,162,585,G
162,F,416,416,1444,405,1484,162,1028,F
162,G,320,320,1764,110,1594,162,1444,G
162,H,866,866,2630,4230,5824,162,1764,H
162,M,43,43,2673,145,5969,162,2630,M
162,N,196,196,2869,150,6119,162,2673,N
162,O,167,167,3036,130,6249,162,2869,O
162,P,110,110,3146,2850,9099,162,3036,P
163,AEI,179,179,179,1041,1041,163,0,A
163,BEI,260,81,260,1557,1557,163,0,I
163,BEJ,964,883,1143,150,1191,163,179,B
163,CEJ,183,183,1326,130,1321,163,1143,C
163,DEJ,50,50,1376,4230,5551,163,1326,D
163,EJ,1613,237,1613,2212,2212,163,0,E
163,FJ,1551,198,1811,300,1857,163,260,J
163,FK,629,431,2242,90,2302,163,1613,F
163,GK,509,509,2751,820,3122,163,2242,G
163,FK,1120,180,2931,1320,3177,163,1811,K
163,FL,368,368,3299,3960,7137,163,2931,L
163,F,1756,1208,4507,1430,4552,163,2751,F
163,G,913,913,5420,1275,5827,163,4507,G
163,H,226,226,5646,3780,9607,163,5420,H
163,M,3,3,5649,321,9928,163,5646,M
163,N,438,438,6087,165,10093,163,5649,N
163,O,1031,1031,7118,1275,11368,163,6087,O
163,P,860,860,7978,3960,15328,163,7118,P
164,AEI,610,610,610,1541,1541,164,0,I
164,AEJ,797,187,797,1655,1655,164,0,E
164,AFJ,966,779,1576,90,1631,164,610,J
164,AFK,1625,49,1625,1837,1837,164,0,A
164,BFK,903,75,1700,90,1745,164,797,F
164,BGK,269,194,1894,90,1927,164,1625,B
164,CGK,483,483,2377,820,2747,164,1894,C
164,DGK,858,57,2434,1200,2831,164,1576,K
164,DGL,128,71,2505,3780,6527,164,2377,D
164,GL,830,25,2530,1250,2995,164,1700,G
164,HL,4,4,2534,3780,6775,164,2530,H
164,L,324,224,2758,3780,6611,164,2434,L
164,M,230,230,2988,2052,8827,164,2758,M
164,N,2118,2118,5106,360,9187,164,2988,N
164,O,1012,1012,6118,1125,10312,164,5106,O
164,N,193,193,6311,80,10392,164,6118,N
164,O,157,157,6468,120,10512,164,6311,O
164,P,6222,6222,12690,550,11062,164,6468,P
165,AE,142,142,142,143,143,165,0,E
165,AF,208,208,350,240,383,165,142,F
165,AG,806,806,1156,1040,1423,165,350,G
165,AH,303,303,1459,3960,5383,165,1156,H
165,A,7818,6359,7818,7731,7731,165,0,A
165,B,1373,1373,9191,90,7821,165,7818,B
165,C,1034,1034,10225,1400,9221,165,9191,C
165,D,839,839,11064,3780,13001,165,10225,D
165,M,618,618,11682,1183,14184,165,11064,M
165,N,605,605,12287,90,14274,165,11682,N
165,O,377,377,12664,795,15069,165,12287,O
165,P,1922,1922,14586,3780,18849,165,12664,P
166,AEI,35,35,35,104,104,166,0,I
166,AEJ,65,30,65,214,214,166,0,E
166,AFJ,180,115,180,849,849,166,0,A
166,BFJ,163,18,198,135,239,166,35,J
166,BFK,232,99,297,135,349,166,65,F
166,BGK,214,115,412,295,534,166,198,K
166,BGL,213,98,510,285,634,166,297,G
166,BHL,157,59,569,5160,5694,166,412,L
166,BH,86,27,596,5160,5794,166,510,H
166,B,851,435,1031,240,1089,166,180,B
166,C,835,835,1866,1015,2104,166,1031,C
166,B,855,855,2721,650,2754,166,1866,B
166,C,242,242,2963,385,3139,166,2721,C
166,D,622,622,3585,3960,7099,166,2963,D
166,M,628,628,4213,699,7798,166,3585,M
166,N,164,164,4377,150,7948,166,4213,N
166,O,31,31,4408,95,8043,166,4377,O
166,N,299,299,4707,235,8278,166,4408,N
166,O,149,149,4856,210,8488,166,4707,O
166,P,81,81,4937,5700,14188,166,4856,P
167,A,3513,3513,3513,5833,5833,167,0,A
167,B,2357,2357,5870,90,5923,167,3513,B
167,C,731,731,6601,1130,7053,167,5870,C
167,B,1835,1835,8436,1420,8473,167,6601,B
167,C,893,893,9329,1240,9713,167,8436,C
167,D,31,31,9360,3780,13493,167,9329,D
167,M,102,102,9462,1121,14614,167,9360,M
167,N,1198,1198,10660,240,14854,167,9462,N
167,O,696,696,11356,760,15614,167,10660,O
167,P,976,976,12332,7680,23294,167,11356,P
168,A,1834,1834,1834,1195,1195,168,0,A
168,B,889,889,2723,155,1350,168,1834,B
168,C,609,609,3332,640,1990,168,2723,C
168,D,6108,6108,9440,2880,4870,168,3332,D
168,M,214,214,9654,410,5280,168,9440,M
168,N,322,322,9976,185,5465,168,9654,N
168,O,722,722,10698,525,5990,168,9976,O
168,N,214,214,10912,415,6405,168,10698,N
168,O,579,579,11491,585,6990,168,10912,O
168,N,260,260,11751,250,7240,168,11491,N
168,O,1319,1319,13070,1280,8520,168,11751,O
168,P,34,34,13104,2880,11400,168,13070,P
169,AE,58,58,58,97,97,169,0,E
169,AF,78,20,78,822,822,169,0,A
169,BF,92,72,150,110,207,169,58,F
169,BG,173,173,323,280,487,169,150,G
169,BH,161,161,484,5160,5647,169,323,H
169,B,797,391,875,110,932,169,78,B
169,C,172,172,1047,285,1217,169,875,C
169,D,167,167,1214,5160,6377,169,1047,D
169,M,292,292,1506,718,7095,169,1214,M
169,N,683,683,2189,300,7395,169,1506,N
169,O,174,174,2363,280,7675,169,2189,O
169,N,1732,1732,4095,1650,9325,169,2363,N
169,O,129,129,4224,225,9550,169,4095,O
169,P,1155,1155,5379,4740,14290,169,4224,P
170,AE,1,1,1,764,764,170,0,E
170,AF,249,248,249,189,189,170,0,A
170,BF,180,180,429,300,489,170,249,B
170,CF,971,543,972,240,1004,170,1,F
170,CG,852,309,1281,840,1329,170,429,C
170,BG,360,360,1641,325,1654,170,1281,B
170,CG,693,24,1665,880,1884,170,972,G
170,CH,95,95,1760,3960,5844,170,1665,H
170,C,748,629,2389,780,2434,170,1641,C
170,D,1044,1044,3433,4080,6514,170,2389,D
170,M,1236,1236,4669,1459,7973,170,3433,M
170,N,317,317,4986,150,8123,170,4669,N
170,O,622,622,5608,590,8713,170,4986,O
170,N,597,597,6205,600,9313,170,5608,N
170,O,1028,1028,7233,765,10078,170,6205,O
170,P,1516,1516,8749,3600,13678,170,7233,P
171,AE,340,340,340,1414,1414,171,0,A
171,BE,545,205,545,2633,2633,171,0,E
171,BF,1189,984,1529,150,1564,171,340,B
171,CF,744,744,2273,730,2294,171,1529,C
171,BF,2198,470,2743,180,2813,171,545,F
171,BG,62,62,2805,125,2938,171,2743,G
171,BF,258,258,3063,185,3123,171,2805,F
171,BG,880,90,3153,910,3204,171,2273,B
171,CG,162,72,3225,275,3398,171,3063,G
171,CH,176,104,3329,95,3299,171,3153,C
171,DH,3928,3928,7257,4230,7529,171,3329,D
171,H,6681,2649,9906,5070,8468,171,3225,H
171,M,124,124,10030,951,9419,171,9906,M
171,N,922,922,10952,150,9569,171,10030,N
171,O,120,120,11072,100,9669,171,10952,O
171,N,2221,2221,13293,2225,11894,171,11072,N
171,O,572,572,13865,605,12499,171,13293,O
171,P,12741,12741,26606,4230,16729,171,13865,P
172,A,340,340,340,434,434,172,0,A
172,B,394,394,734,360,794,172,340,B
172,C,1115,1115,1849,1495,2289,172,734,C
172,B,1834,1834,3683,1445,3734,172,1849,B
172,C,890,890,4573,1046,4780,172,3683,C
172,D,1219,1219,5792,1049,5829,172,4573,D
172,M,1697,1697,7489,1712,7541,172,5792,M
172,N,205,205,7694,240,7781,172,7489,N
172,O,1381,1381,9075,970,8751,172,7694,O
172,N,1493,1493,10568,1770,10521,172,9075,N
172,O,653,653,11221,900,11421,172,10568,O
172,P,273,273,11494,3960,15381,172,11221,P
173,AEI,69,69,69,789,789,173,0,A
173,BEI,200,131,200,266,266,173,0,E
173,BFI,287,87,287,1059,1059,173,0,I
173,BFJ,298,211,498,300,566,173,200,F
173,BGJ,839,410,908,180,969,173,69,B
173,CGJ,717,307,1215,820,1386,173,498,G
173,CFJ,955,27,1242,240,1299,173,287,J
173,CFK,929,595,1837,1170,2139,173,908,C
173,BFK,1050,428,2265,930,2316,173,1215,F
173,BGK,1183,160,2425,1030,2329,173,1242,K
173,BGJ,165,5,2430,385,2701,173,2265,G
173,BHJ,93,93,2523,5400,8101,173,2430,H
173,BJ,813,127,2650,560,2699,173,1837,B
173,CJ,147,147,2797,157,2856,173,2650,C
173,DJ,1226,854,3651,1355,3684,173,2425,J
173,DK,1227,1227,4878,1620,5304,173,3651,K
173,DL,2933,852,5730,2963,5819,173,2797,D
173,L,1222,370,6100,3960,9264,173,4878,L
173,M,296,296,6396,807,10071,173,6100,M
173,N,608,608,7004,150,10221,173,6396,N
173,O,113,113,7117,115,10336,173,7004,O
173,N,588,588,7705,580,10916,173,7117,N
173,O,663,663,8368,590,11506,173,7705,O
173,P,2140,2140,10508,4230,15736,173,8368,P
174,AE,679,679,679,1002,1002,174,0,E
174,AF,446,446,1125,180,1182,174,679,F
174,AG,893,893,2018,1160,2342,174,1125,G
174,AF,2979,961,2979,3806,3806,174,0,A
174,BF,1623,662,3641,1380,3722,174,2018,F
174,BG,1019,357,3998,240,4046,174,2979,B
174,CG,588,231,4229,648,4370,174,3641,G
174,CH,270,270,4499,372,4742,174,4229,H
174,C,792,291,4790,1030,5076,174,3998,C
174,B,1114,1114,5904,810,5886,174,4790,B
174,C,93,93,5997,380,6266,174,5904,C
174,D,4220,4220,10217,3960,10226,174,5997,D
174,M,1392,1392,11609,1466,11692,174,10217,M
174,N,264,264,11873,240,11932,174,11609,N
174,O,119,119,11992,380,12312,174,11873,O
174,N,774,774,12766,505,12817,174,11992,N
174,O,280,280,13046,500,13317,174,12766,O
174,P,7313,7313,20359,4020,17337,174,13046,P
175,AEI,1,1,1,497,497,175,0,I
175,AEJ,143,142,143,691,691,175,0,A
175,BEJ,616,474,617,180,677,175,1,J
175,BEK,165,165,782,230,907,175,617,K
175,BEL,731,92,874,240,931,175,143,B
175,CEL,144,52,926,4140,5047,175,782,L
175,CE,166,114,1040,225,1156,175,874,C
175,DE,399,399,1439,4890,6046,175,1040,D
175,E,1660,221,1660,1809,1809,175,0,E
175,F,278,278,1938,180,1989,175,1660,F
175,G,492,492,2430,590,2579,175,1938,G
175,H,499,499,2929,4140,6719,175,2430,H
175,M,667,667,3596,1518,8237,175,2929,M
175,N,1047,1047,4643,240,8477,175,3596,N
175,O,899,899,5542,975,9452,175,4643,O
175,P,148,148,5690,3960,13412,175,5542,P
176,AE,309,309,309,1577,1577,176,0,A
176,BE,598,289,598,790,790,176,0,E
176,BF,312,312,910,180,970,176,598,F
176,BG,147,147,1057,155,1125,176,910,G
176,BH,101,101,1158,2880,4005,176,1057,H
176,B,1445,596,1754,240,1817,176,309,B
176,C,755,755,2509,975,2792,176,1754,C
176,B,862,862,3371,615,3407,176,2509,B
176,C,171,171,3542,255,3662,176,3371,C
176,D,48,48,3590,5160,8822,176,3542,D
176,M,60,60,3650,512,9334,176,3590,M
176,N,542,542,4192,150,9484,176,3650,N
176,O,1617,1617,5809,500,9984,176,4192,O
176,P,884,884,6693,385,10369,176,5809,P
177,AEI,98,98,98,164,164,177,0,I
177,AEJ,172,74,172,221,221,177,0,A
177,BEJ,161,87,259,150,314,177,98,J
177,BEK,222,135,394,240,461,177,172,B
177,CEK,190,55,449,455,769,177,259,K
177,CEL,851,796,1245,975,1436,177,394,C
177,DEL,850,54,1299,3565,4334,177,449,L
177,DE,1442,143,1442,1524,1524,177,0,E
177,DF,172,172,1614,150,1674,177,1442,F
177,DG,120,120,1734,375,2049,177,1614,G
177,DH,752,263,1997,5040,6476,177,1245,D
177,H,988,725,2722,4700,6749,177,1734,H
177,M,34137,34137,36859,35112,41861,177,2722,M
177,N,1004,1004,37863,90,41951,177,36859,N
177,O,1043,1043,38906,1220,43171,177,37863,O
177,N,412,412,39318,215,43386,177,38906,N
177,O,227,227,39545,605,43991,177,39318,O
177,P,3588,3588,43133,3780,47771,177,39545,P
178,A,180,180,180,529,529,178,0,A
178,B,469,469,649,180,709,178,180,B
178,C,492,492,1141,735,1444,178,649,C
178,D,133,133,1274,2880,4324,178,1141,D
178,M,69,69,1343,1110,5434,178,1274,M
178,N,1223,1223,2566,240,5674,178,1343,N
178,O,732,732,3298,780,6454,178,2566,O
178,P,818,818,4116,7680,14134,178,3298,P
179,AEI,58,58,58,127,127,179,0,E
179,AFI,106,48,106,855,855,179,0,A
179,BFI,180,74,180,1097,1097,179,0,I
179,BFJ,160,38,218,135,262,179,58,F
179,BGJ,220,220,438,380,642,179,218,G
179,BHJ,179,179,617,5460,6102,179,438,H
179,BJ,841,330,947,150,1005,179,106,B
179,CJ,1037,270,1217,180,1277,179,180,J
179,CK,456,186,1403,255,1260,179,947,C
179,DK,957,771,2174,1050,2327,179,1217,K
179,DJ,1112,341,2515,2880,4140,179,1403,D
179,J,1031,690,3205,935,3262,179,2174,J
179,K,270,270,3475,380,3642,179,3205,K
179,L,1025,1025,4500,5460,9102,179,3475,L
179,M,513,513,5013,1119,10221,179,4500,M
179,N,710,710,5723,150,10371,179,5013,N
179,O,228,228,5951,185,10556,179,5723,O
179,N,308,308,6259,355,10911,179,5951,N
179,O,150,150,6409,120,11031,179,6259,O
179,P,990,990,7399,4230,15261,179,6409,P
180,A,290,290,290,528,528,180,0,A
180,B,267,267,557,90,618,180,290,B
180,C,546,546,1103,845,1463,180,557,C
180,D,386,386,1489,3780,5243,180,1103,D
180,M,3230,3230,4719,5272,10515,180,1489,M
180,N,2294,2294,7013,300,10815,180,4719,N
180,O,755,755,7768,920,11735,180,7013,O
180,P,1059,1059,8827,3960,15695,180,7768,P
181,AEI,123,123,123,78,78,181,0,I
181,AEJ,141,141,264,240,318,181,123,J
181,AEK,113,113,377,380,698,181,264,K
181,AEJ,697,320,697,1969,1969,181,0,A
181,BEJ,715,18,715,310,310,181,0,E
181,BFJ,745,407,1122,460,1158,181,377,J
181,BFK,509,102,1224,960,1270,181,715,F
181,BGK,497,395,1619,790,1948,181,1122,K
181,BGL,428,33,1652,595,1865,181,1224,G
181,BFL,1467,512,2164,240,2209,181,697,B
181,CFL,1290,745,2909,3960,5908,181,1619,L
181,CF,951,206,3115,1180,3389,181,2164,C
181,DF,1490,27,3142,1320,3185,181,1652,F
181,DG,238,238,3380,1145,4330,181,3142,G
181,DH,661,661,4041,1590,5920,181,3380,H
181,D,1834,908,4949,4020,7409,181,3115,D
181,M,546,546,5495,742,8151,181,4949,M
181,N,458,458,5953,300,8451,181,5495,N
181,O,577,577,6530,675,9126,181,5953,O
181,N,530,530,7060,440,9566,181,6530,N
181,O,557,557,7617,810,10376,181,7060,O
181,P,2159,2159,9776,3960,14336,181,7617,P
182,A,340,340,340,611,611,182,0,A
182,B,452,452,792,240,851,182,340,B
182,C,881,881,1673,985,1836,182,792,C
182,B,1468,1468,3141,1350,3186,182,1673,B
182,C,690,690,3831,980,4166,182,3141,C
182,D,3046,3046,6877,3960,8126,182,3831,D
182,M,140,140,7017,105,8231,182,6877,M
182,N,226,226,7243,300,8531,182,7017,N
182,O,581,581,7824,845,9376,182,7243,O
182,P,452,452,8276,1590,10966,182,7824,P
183,AEI,357,357,357,1405,1405,183,0,A
183,BEI,781,424,781,1577,1577,183,0,I
183,BEJ,796,15,796,1655,1655,183,0,E
183,BFJ,1095,656,1452,90,1495,183,357,B
183,CFJ,868,197,1649,90,1667,183,781,J
183,CFK,904,51,1700,90,1745,183,796,F
183,CGK,830,830,2530,1250,2995,183,1700,G
183,CHK,3,3,2533,3780,6775,183,2530,H
183,CK,1278,197,2730,1700,3195,183,1452,C
183,DK,1273,192,2922,1565,3232,183,1649,K
183,DL,225,33,2955,3780,6975,183,2730,D
183,L,26109,26076,29031,4505,7737,183,2922,L
183,M,736,736,29767,1328,9065,183,29031,M
183,N,634,634,30401,90,9155,183,29767,N
183,O,229,229,30630,695,9850,183,30401,O
183,P,1956,1956,32586,3780,13630,183,30630,P
184,A,609,609,609,1228,1228,184,0,A
184,B,1389,1389,1998,780,2008,184,609,B
184,C,840,840,2838,1162,3170,184,1998,C
184,D,171,171,3009,473,3643,184,2838,D
184,M,1,1,3010,1512,5155,184,3009,M
184,N,1767,1767,4777,300,5455,184,3010,N
184,O,733,733,5510,730,6185,184,4777,O
184,P,4433,4433,9943,5760,11945,184,5510,P
185,AEI,76,76,76,1060,1060,185,0,E
185,AFI,1184,1184,1260,240,1300,185,76,F
185,AGI,1535,275,1535,1535,1535,185,0,I
185,AGJ,269,269,1804,300,1835,185,1535,J
185,AGK,680,136,1940,705,2005,185,1260,G
185,AHK,625,489,2429,750,2585,185,1804,K
185,AHL,5785,3356,5785,5845,5845,185,0,A
185,BHL,3861,16,5801,5760,7765,185,1940,H
185,BL,323,307,6108,300,6145,185,5785,B
185,CL,650,650,6758,750,6895,185,6108,C
185,DL,4821,492,7250,1560,4145,185,2429,L
185,D,1810,1318,8568,1560,8455,185,6758,D
185,M,1284,1284,9852,1475,9930,185,8568,M
185,N,463,463,10315,300,10230,185,9852,N
185,O,840,840,11155,2140,12370,185,10315,O
185,P,1328,1328,12483,2645,15015,185,11155,P
186,AE,1635,1635,1635,2947,2947,186,0,A
186,BE,1977,342,1977,2922,2922,186,0,E
186,BF,976,976,2953,90,3012,186,1977,F
186,BG,1501,183,3136,240,3187,186,1635,B
186,CG,711,711,3847,850,4037,186,3136,C
186,DG,1292,398,4245,1630,4642,186,2953,G
186,DH,492,94,4339,3960,7997,186,3847,D
186,H,836,742,5081,3780,8422,186,4245,H
186,M,1883,1883,6964,8573,16995,186,5081,M
186,N,6725,6725,13689,90,17085,186,6964,N
186,O,675,675,14364,1140,18225,186,13689,O
186,P,322,322,14686,3780,22005,186,14364,P
187,AEI,62,62,62,45,45,187,0,I
187,AEJ,246,184,246,432,432,187,0,E
187,AEJ,184,0,246,150,195,187,62,J
187,AFK,307,61,307,490,490,187,0,A
187,BFK,95,34,341,100,295,187,246,K
187,BFL,15,15,356,2880,3175,187,341,L
187,BF,358,248,604,240,672,187,246,F
187,BG,303,6,610,180,670,187,307,B
187,CG,127,127,737,155,825,187,610,C
187,DG,9,9,746,2880,3705,187,737,D
187,G,971,829,1575,975,1647,187,604,G
187,F,640,640,2215,615,2262,187,1575,F
187,G,228,228,2443,255,2517,187,2215,G
187,H,1331,1331,3774,5160,7677,187,2443,H
187,M,263,263,4037,175,7852,187,3774,M
187,N,705,705,4742,150,8002,187,4037,N
187,O,282,282,5024,230,8232,187,4742,O
187,P,99,99,5123,2881,11113,187,5024,P
188,AEI,93,93,93,1092,1092,188,0,A
188,BEI,104,11,104,797,797,188,0,I
188,BEJ,789,789,893,150,947,188,104,J
188,BEK,248,248,1141,495,1442,188,893,K
188,BEL,1253,205,1346,300,1392,188,93,B
188,CEL,617,412,1758,3900,5342,188,1141,L
188,CE,951,539,2297,1000,2392,188,1346,C
188,DE,2798,501,2798,2915,2915,188,0,E
188,DF,782,281,3079,3960,6352,188,2297,D
188,F,300,19,3098,240,3155,188,2798,F
188,G,675,675,3773,850,4005,188,3098,G
188,H,234,234,4007,3960,7965,188,3773,H
188,M,6989,6989,10996,7478,15443,188,4007,M
188,N,691,691,11687,240,15683,188,10996,N
188,O,572,572,12259,875,16558,188,11687,O
188,P,51,51,12310,3960,20518,188,12259,P
189,AEI,72,72,72,1103,1103,189,0,E
189,AFI,149,77,149,319,319,189,0,I
189,AFJ,197,197,346,90,409,189,149,J
189,AFK,1061,787,1133,90,1193,189,72,F
189,AGK,1544,757,1890,1780,2189,189,346,K
189,AGL,12,12,1902,3780,5969,189,1890,L
189,AG,1021,252,2154,1210,2403,189,1133,G
189,AH,636,636,2790,3780,6183,189,2154,H
189,A,37030,34240,37030,37991,37991,189,0,A
189,B,989,989,38019,90,38081,189,37030,B
189,C,1041,1041,39060,1220,39301,189,38019,C
189,D,107,107,39167,3780,43081,189,39060,D
189,M,1769,1769,40936,2038,45119,189,39167,M
189,N,571,571,41507,360,45479,189,40936,N
189,O,354,354,41861,947,46426,189,41507,O
189,P,1370,1370,43231,948,47374,189,41861,P
190,AE,58,58,58,127,127,190,0,E
190,AF,370,312,370,442,442,190,0,A
190,BF,360,48,418,330,457,190,58,F
190,BG,163,115,533,150,592,190,370,B
190,CG,147,147,680,145,737,190,533,C
190,BG,1004,742,1422,942,1399,190,418,G
190,BH,298,298,1720,348,1747,190,1422,H
190,B,1163,123,1843,1140,1877,190,680,B
190,C,782,782,2625,660,2537,190,1843,C
190,D,1065,1065,3690,4230,6767,190,2625,D
190,M,4583,4583,8273,4739,11506,190,3690,M
190,N,202,202,8475,90,11596,190,8273,N
190,O,472,472,8947,800,12396,190,8475,O
190,N,395,395,9342,70,12466,190,8947,N
190,O,204,204,9546,625,13091,190,9342,O
190,P,6523,6523,16069,3780,16871,190,9546,P
191,AE,395,395,395,460,460,191,0,E
191,AF,330,330,725,300,760,191,395,F
191,AG,1069,344,1069,1661,1661,191,0,A
191,BG,632,288,1357,740,1500,191,725,G
191,BH,78,78,1435,1560,3060,191,1357,H
191,B,769,403,1838,240,1901,191,1069,B
191,C,735,735,2573,845,2746,191,1838,C
191,D,1958,1958,4531,5220,7966,191,2573,D
191,M,1600,1600,6131,1635,9601,191,4531,M
191,N,298,298,6429,300,9901,191,6131,N
191,O,788,788,7217,855,10756,191,6429,O
191,N,764,764,7981,720,11476,191,7217,N
191,O,616,616,8597,780,12256,191,7981,O
191,P,134,134,8731,4020,16276,191,8597,P
192,A,1319,1319,1319,1394,1394,192,0,A
192,B,247,247,1566,240,1634,192,1319,B
192,C,529,529,2095,745,2379,192,1566,C
192,B,477,477,2572,335,2714,192,2095,B
192,C,162,162,2734,300,3014,192,2572,C
192,D,31,31,2765,5100,8114,192,2734,D
192,M,363,363,3128,608,8722,192,2765,M
192,N,240,240,3368,120,8842,192,3128,N
192,O,159,159,3527,90,8932,192,3368,O
192,N,593,593,4120,590,9522,192,3527,N
192,O,167,167,4287,295,9817,192,4120,O
192,P,246,246,4533,5160,14977,192,4287,P
193,AEI,233,233,233,1585,1585,193,0,A
193,BEI,1532,1299,1532,1610,1610,193,0,E
193,BFI,233,233,1765,210,1820,193,1532,F
193,BGI,1616,84,1849,300,1885,193,233,B
193,CGI,183,99,1948,255,2075,193,1765,G
193,CFI,667,568,2516,805,2690,193,1849,C
193,DFI,244,244,2760,1560,4250,193,2516,D
193,FI,1467,655,3415,1390,3465,193,1948,F
193,GI,706,706,4121,845,4310,193,3415,G
193,HI,495,495,4616,5220,9530,193,4121,H
193,I,14620,10004,14620,14669,14669,193,0,I
193,J,350,350,14970,300,14969,193,14620,J
193,K,542,542,15512,805,15774,193,14970,K
193,L,177,177,15689,1560,17334,193,15512,L
193,M,4535,4535,20224,4700,22034,193,15689,M
193,N,382,382,20606,240,22274,193,20224,N
193,O,923,923,21529,995,23269,193,20606,O
193,N,162,162,21691,290,23559,193,21529,N
193,O,915,915,22606,1080,24639,193,21691,O
193,P,1558,1558,24164,3960,28599,193,22606,P
194,AEI,67,67,67,705,705,194,0,I
194,AEJ,282,215,282,888,888,194,0,A
194,BEJ,728,513,795,150,855,194,67,J
194,BEK,696,183,978,150,1038,194,282,B
194,CEK,213,30,1008,130,985,194,795,K
194,CEJ,251,221,1229,175,1213,194,978,C
194,DEJ,1390,161,1390,1490,1490,194,0,E
194,DFJ,455,73,1463,530,1515,194,1008,J
194,DFK,6,6,1469,105,1620,194,1463,K
194,DFL,373,294,1763,300,1790,194,1390,F
194,DGL,554,554,2317,835,2625,194,1763,G
194,DHL,1811,723,3040,1520,2733,194,1229,D
194,HL,2106,535,3575,4230,5850,194,1469,L
194,H,1539,281,3856,2940,5565,194,2317,H
194,M,1857,1857,5713,2129,7979,194,3856,M
194,N,513,513,6226,240,8219,194,5713,N
194,O,339,339,6565,885,9104,194,6226,O
194,P,9064,9064,15629,3720,12824,194,6565,P
195,AEI,52,52,52,30,30,195,0,A
195,BEI,351,351,403,300,330,195,52,B
195,CEI,847,444,847,1414,1414,195,0,I
195,CEJ,886,442,1289,1005,1335,195,403,C
195,DEJ,621,179,1468,90,1504,195,847,J
195,DEK,327,327,1795,800,2304,195,1468,K
195,DEL,893,893,2688,3780,6084,195,1795,L
195,DE,4401,1713,4401,4300,4300,195,0,E
195,DF,155,155,4556,300,4600,195,4401,F
195,DG,888,888,5444,1005,5605,195,4556,G
195,DH,537,537,5981,1200,6805,195,5444,H
195,D,8136,3444,9425,1200,2535,195,1289,D
195,M,5290,5290,14715,5447,12252,195,9425,M
195,N,253,253,14968,90,12342,195,14715,N
195,O,737,737,15705,815,13157,195,14968,O
195,N,2488,2488,18193,2475,15632,195,15705,N
195,O,764,764,18957,1195,16827,195,18193,O
195,P,70,70,19027,3780,20607,195,18957,P
196,A,777,777,777,624,624,196,0,A
196,B,598,598,1375,780,1404,196,777,B
196,C,648,648,2023,780,2184,196,1375,C
196,D,2114,2114,4137,460,2644,196,2023,D
196,M,3376,3376,7513,3661,6305,196,4137,M
196,N,382,382,7895,155,6460,196,7513,N
196,O,966,966,8861,1135,7595,196,7895,O
196,N,1970,1970,10831,1790,9385,196,8861,N
196,O,1124,1124,11955,2205,11590,196,10831,O
196,P,522,522,12477,1740,13330,196,11955,P
197,A,175,175,175,163,163,197,0,A
197,B,115,115,290,150,313,197,175,B
197,C,180,180,470,455,768,197,290,C
197,D,838,838,1308,3565,4333,197,470,D
197,M,163,163,1471,831,5164,197,1308,M
197,N,865,865,2336,240,5404,197,1471,N
197,O,240,240,2576,255,5659,197,2336,O
197,P,75,75,2651,5160,10819,197,2576,P
198,A,3155,3155,3155,3485,3485,198,0,A
198,B,530,530,3685,240,3725,198,3155,B
198,C,871,871,4556,970,4695,198,3685,C
198,B,2017,2017,6573,1910,6605,198,4556,B
198,C,1072,1072,7645,1260,7865,198,6573,C
198,D,3071,3071,10716,3960,11825,198,7645,D
198,M,181,181,10897,779,12604,198,10716,M
198,N,704,704,11601,150,12754,198,10897,N
198,O,226,226,11827,125,12879,198,11601,O
198,N,245,245,12072,345,13224,198,11827,N
198,O,191,191,12263,120,13344,198,12072,O
198,P,961,961,13224,4230,17574,198,12263,P
199,AE,507,507,507,691,691,199,0,A
199,BE,264,264,771,90,781,199,507,B
199,CE,1649,878,1649,1630,1630,199,0,E
199,CF,232,232,1881,300,1930,199,1649,F
199,CG,1424,314,2195,1935,2716,199,771,C
199,DG,637,323,2518,750,2680,199,1881,G
199,DF,267,267,2785,155,2835,199,2518,F
199,DG,341,341,3126,415,3250,199,2785,G
199,DH,2738,1807,4933,3780,6496,199,2195,D
199,H,10199,8392,13325,1140,4390,199,3126,H
199,M,122,122,13447,347,6843,199,13325,M
199,N,305,305,13752,90,6933,199,13447,N
199,O,1416,1416,15168,1780,8713,199,13752,O
199,N,696,696,15864,385,9098,199,15168,N
199,O,721,721,16585,1080,10178,199,15864,O
199,P,894,894,17479,3780,13958,199,16585,P
200,AE,464,464,464,1037,1037,200,0,E
200,AF,689,689,1153,150,1187,200,464,F
200,AG,203,203,1356,140,1327,200,1153,G
200,AF,2988,1632,2988,3699,3699,200,0,A
200,BF,1747,115,3103,1820,3147,200,1356,F
200,BG,809,694,3797,150,3849,200,2988,B
200,CG,935,241,4038,725,3872,200,3103,G
200,CH,299,58,4096,435,4284,200,3797,C
200,BH,59,1,4097,4230,8102,200,4038,H
200,B,1707,1706,5803,1565,5849,200,4096,B
200,C,817,817,6620,725,6574,200,5803,C
200,D,2939,2939,9559,4230,10804,200,6620,D
200,M,79,79,9638,913,11717,200,9559,M
200,N,1053,1053,10691,240,11957,200,9638,N
200,O,1540,1540,12231,1040,12997,200,10691,O
200,P,179,179,12410,3960,16957,200,12231,P
201,AEI,317,317,317,848,848,201,0,E
201,AFI,354,37,354,411,411,201,0,A
201,BFI,284,284,638,300,711,201,354,B
201,CFI,758,758,1396,975,1686,201,638,C
201,BFI,1187,108,1504,780,1628,201,317,F
201,BGI,884,776,2280,635,2321,201,1396,B
201,CGI,18,18,2298,415,2736,201,2280,C
201,DGI,870,76,2374,1080,2708,201,1504,G
201,DFI,967,967,3341,765,3473,201,2374,F
201,DGI,1362,1362,4703,1755,5228,201,3341,G
201,DHI,6332,1629,6332,7199,7199,201,0,I
201,DHJ,904,904,7236,90,7289,201,6332,J
201,DHK,491,491,7727,880,8169,201,7236,K
201,DHJ,3070,46,7773,350,5578,201,4703,H
201,DJ,432,386,8159,55,8224,201,7727,J
201,DK,6144,283,8442,6060,8796,201,2298,D
201,K,2696,2413,10855,1245,9469,201,8159,K
201,L,59,59,10914,3780,13249,201,10855,L
201,M,1318,1318,12232,1196,14445,201,10914,M
201,N,128,128,12360,300,14745,201,12232,N
201,O,648,648,13008,840,15585,201,12360,O
201,P,2364,2364,15372,4080,19665,201,13008,P
202,A,481,481,481,767,767,202,0,A
202,B,342,342,823,90,857,202,481,B
202,C,1380,1380,2203,1865,2722,202,823,C
202,D,1326,1326,3529,3780,6502,202,2203,D
202,M,316,316,3845,496,6998,202,3529,M
202,N,295,295,4140,180,7178,202,3845,N
202,O,871,871,5011,1250,8428,202,4140,O
202,P,94,94,5105,6680,15108,202,5011,P
203,AEI,211,211,211,831,831,203,0,A
203,BEI,668,668,879,90,921,203,211,B
203,CEI,904,25,904,1828,1828,203,0,I
203,CEJ,906,881,1785,1250,2171,203,879,C
203,DEJ,951,70,1855,90,1918,203,904,J
203,DEK,74,4,1859,3780,5951,203,1785,D
203,EK,906,902,2761,1250,3168,203,1855,K
203,EL,130,130,2891,3780,6948,203,2761,L
203,E,17000,14109,17000,17550,17550,203,0,E
203,F,571,571,17571,90,17640,203,17000,F
203,G,873,873,18444,1215,18855,203,17571,G
203,H,204,204,18648,3780,22635,203,18444,H
203,M,183,183,18831,1902,24537,203,18648,M
203,N,1778,1778,20609,90,24627,203,18831,N
203,O,549,549,21158,915,25542,203,20609,O
203,P,1768,1768,22926,3780,29322,203,21158,P
204,A,167,167,167,59,59,204,0,A
204,B,73,73,240,240,299,204,167,B
204,C,158,158,398,390,689,204,240,C
204,B,943,943,1341,700,1389,204,398,B
204,C,504,504,1845,785,2174,204,1341,C
204,D,1032,1032,2877,3960,6134,204,1845,D
204,M,1552,1552,4429,1732,7866,204,2877,M
204,N,392,392,4821,240,8106,204,4429,N
204,O,637,637,5458,740,8846,204,4821,O
204,N,1083,1083,6541,970,9816,204,5458,N
204,O,344,344,6885,660,10476,204,6541,O
204,P,293,293,7178,3960,14436,204,6885,P
205,A,141,141,141,139,139,205,0,A
205,B,94,94,235,150,289,205,141,B
205,C,666,666,901,765,1054,205,235,C
205,D,462,462,1363,3600,4654,205,901,D
205,M,40,40,1403,94,4748,205,1363,M
205,N,144,144,1547,150,4898,205,1403,N
205,O,116,116,1663,120,5018,205,1547,O
205,P,970,970,2633,2850,7868,205,1663,P
206,AE,231,231,231,396,396,206,0,E
206,AF,266,266,497,135,531,206,231,F
206,AG,528,31,528,575,575,206,0,A
206,BG,310,310,838,300,875,206,528,B
206,CG,728,387,1225,845,1376,206,497,G
206,CH,690,303,1528,740,1615,206,838,C
206,DH,62,62,1590,1560,3175,206,1528,D
206,H,1910,1545,3135,5220,6596,206,1225,H
206,M,4300,4300,7435,4345,10941,206,3135,M
206,N,313,313,7748,300,11241,206,7435,N
206,O,701,701,8449,855,12096,206,7748,O
206,N,362,362,8811,220,12316,206,8449,N
206,O,292,292,9103,410,12726,206,8811,O
206,P,3789,3789,12892,2070,14796,206,9103,P
207,A,2955,2955,2955,3088,3088,207,0,A
207,B,339,339,3294,240,3328,207,2955,B
207,C,658,658,3952,725,4053,207,3294,C
207,B,421,421,4373,330,4383,207,3952,B
207,C,1133,1133,5506,2420,6803,207,4373,C
207,B,3187,3187,8693,2490,9293,207,5506,B
207,C,808,808,9501,480,9773,207,8693,C
207,D,2789,2789,12290,3960,13733,207,9501,D
207,M,1940,1940,14230,2644,16377,207,12290,M
207,N,851,851,15081,210,16587,207,14230,N
207,O,593,593,15674,730,17317,207,15081,O
207,P,1140,1140,16814,4080,21397,207,15674,P
208,AEI,46,46,46,141,141,208,0,I
208,AEJ,179,179,225,150,291,208,46,J
208,AEK,268,43,268,743,743,208,0,A
208,BEK,151,108,376,145,436,208,225,K
208,BEL,453,77,453,818,818,208,0,E
208,BFL,711,526,979,300,1043,208,268,B
208,CFL,707,104,1083,2900,3336,208,376,L
208,CF,117,13,1096,135,1178,208,979,C
208,DF,722,79,1175,420,1238,208,453,F
208,DG,138,138,1313,140,1378,208,1175,G
208,DH,195,195,1508,5060,6438,208,1313,H
208,D,2788,2376,3884,5060,6238,208,1096,D
208,M,160,160,4044,214,6652,208,3884,M
208,N,105,105,4149,110,6762,208,4044,N
208,O,141,141,4290,285,7047,208,4149,O
208,P,187,187,4477,5160,12207,208,4290,P
209,A,1239,1239,1239,1321,1321,209,0,A
209,B,191,191,1430,150,1471,209,1239,B
209,C,690,690,2120,700,2171,209,1430,C
209,B,793,793,2913,780,2951,209,2120,B
209,C,205,205,3118,110,3061,209,2913,C
209,D,10302,10302,13420,4230,7291,209,3118,D
209,M,3267,3267,16687,5047,12338,209,13420,M
209,N,1770,1770,18457,90,12428,209,16687,N
209,O,1161,1161,19618,1360,13788,209,18457,O
209,N,2397,2397,22015,2150,15938,209,19618,N
209,O,432,432,22447,815,16753,209,22015,O
209,P,8190,8190,30637,3780,20533,209,22447,P
210,AE,163,163,163,1049,1049,210,0,E
210,AF,334,171,334,543,543,210,0,A
210,BF,449,449,783,300,843,210,334,B
210,CF,1006,386,1169,180,1229,210,163,F
210,CG,962,576,1745,1155,1998,210,783,C
210,DG,1008,432,2177,1050,2279,210,1169,G
210,DH,1312,880,3057,5600,7598,210,1745,D
210,H,2163,1283,4340,5040,7319,210,2177,H
210,M,33572,33572,37912,34522,42120,210,4340,M
210,N,980,980,38892,90,42210,210,37912,N
210,O,1107,1107,39999,1210,43420,210,38892,O
210,N,346,346,40345,220,43640,210,39999,N
210,O,189,189,40534,605,44245,210,40345,O
210,P,5573,5573,46107,3780,48025,210,40534,P
211,AEI,1,1,1,320,320,211,0,A
211,BEI,69,68,69,722,722,211,0,E
211,BFI,514,446,515,240,560,211,1,B
211,CFI,829,383,898,240,962,211,69,F
211,CGI,143,143,1041,265,1227,211,898,G
211,CHI,939,413,1454,1035,1595,211,515,C
211,BHI,177,177,1631,55,1650,211,1454,B
211,CHI,1731,100,1731,1607,1607,211,0,I
211,CHJ,241,241,1972,390,1997,211,1731,J
211,CHK,499,158,2130,365,2015,211,1631,C
211,DHK,1548,459,2589,5470,6697,211,1041,H
211,DK,485,26,2615,3960,5975,211,2130,D
211,K,1087,444,3059,1140,3137,211,1972,K
211,J,1123,1123,4182,1135,4272,211,3059,J
211,K,946,946,5128,1115,5387,211,4182,K
211,L,2205,2205,7333,1330,6717,211,5128,L
211,M,368,368,7701,1075,7792,211,7333,M
211,N,802,802,8503,150,7942,211,7701,N
211,O,116,116,8619,100,8042,211,8503,O
211,N,778,778,9397,785,8827,211,8619,N
211,O,659,659,10056,605,9432,211,9397,O
211,P,12852,12852,22908,4230,13662,211,10056,P
212,AEI,12,12,12,380,380,212,0,E
212,AFI,133,121,133,1116,1116,212,0,I
212,AFJ,191,58,191,2679,2679,212,0,A
212,BFJ,756,577,768,420,800,212,12,F
212,BGJ,1170,535,1303,240,1356,212,133,J
212,BGK,643,108,1411,691,1491,212,768,G
212,BHK,923,815,2226,760,2116,212,1303,K
212,BHL,2682,647,2873,240,2919,212,191,B
212,CHL,751,751,3624,760,3679,212,2873,C
212,DHL,2642,429,4053,744,2235,212,1411,H
212,DL,3063,2634,6687,7680,11359,212,3624,D
212,L,4926,465,7152,7680,9796,212,2226,L
212,M,163,163,7315,371,11730,212,7152,M
212,N,308,308,7623,150,11880,212,7315,N
212,O,500,500,8123,500,12380,212,7623,O
212,N,352,352,8475,355,12735,212,8123,N
212,O,188,188,8663,175,12910,212,8475,O
212,P,1117,1117,9780,4230,17140,212,8663,P
213,AE,142,142,142,1609,1609,213,0,E
213,AF,645,503,645,723,723,213,0,A
213,BF,272,272,917,240,963,213,645,B
213,CF,1662,887,1804,240,1849,213,142,F
213,CG,1032,145,1949,890,1853,213,917,C
213,BG,232,232,2181,380,2233,213,1949,B
213,CG,108,108,2289,210,2443,213,2181,C
213,DG,41,41,2330,4140,6583,213,2289,D
213,G,615,89,2419,850,2699,213,1804,G
213,F,602,602,3021,345,3044,213,2419,F
213,G,2273,2273,5294,2820,5864,213,3021,G
213,H,45,45,5339,3960,9824,213,5294,H
213,M,177,177,5516,214,10038,213,5339,M
213,N,95,95,5611,120,10158,213,5516,N
213,O,173,173,5784,125,10283,213,5611,O
213,P,2339,2339,8123,2880,13163,213,5784,P
214,AEI,20,20,20,80,80,214,0,A
214,BEI,136,116,136,366,366,214,0,I
214,BEJ,251,135,271,240,320,214,20,B
214,CEJ,326,55,326,357,357,214,0,E
214,CFJ,181,181,507,240,597,214,326,F
214,CGJ,618,247,754,420,786,214,136,J
214,CGK,754,271,1025,970,1290,214,271,C
214,DGK,278,278,1303,3960,5250,214,1025,D
214,GK,1003,454,1757,1079,1865,214,754,K
214,GL,2175,925,2682,1680,2277,214,507,G
214,FL,1009,84,2766,356,2221,214,1757,L
214,F,1003,919,3685,1440,3717,214,2682,F
214,G,1043,1043,4728,1079,4796,214,3685,G
214,H,792,792,5520,356,5152,214,4728,H
214,M,4580,4580,10100,5547,10797,214,5520,M
214,N,993,993,11093,90,10887,214,10100,N
214,O,527,527,11620,905,11792,214,11093,O
214,N,1157,1157,12777,770,12562,214,11620,N
214,O,870,870,13647,1300,13862,214,12777,O
214,P,571,571,14218,3780,17642,214,13647,P
215,AE,68,68,68,138,138,215,0,A
215,BE,183,115,183,1087,1087,215,0,E
215,BF,246,131,314,240,378,215,68,B
215,CF,154,154,468,255,633,215,314,C
215,BF,571,571,1039,460,1093,215,468,B
215,CF,145,145,1184,215,1308,215,1039,C
215,DF,1164,163,1347,300,1387,215,183,F
215,DG,781,781,2128,970,2357,215,1347,G
215,DH,1678,734,2862,4890,6198,215,1184,D
215,H,1482,748,3610,3960,6317,215,2128,H
215,M,9632,9632,13242,10287,16604,215,3610,M
215,N,849,849,14091,240,16844,215,13242,N
215,O,867,867,14958,860,17704,215,14091,O
215,P,3415,3415,18373,3960,21664,215,14958,P
216,A,424,424,424,618,618,216,0,A
216,B,232,232,656,90,708,216,424,B
216,C,822,822,1478,1275,1983,216,656,C
216,D,87,87,1565,3780,5763,216,1478,D
216,M,75,75,1640,670,6433,216,1565,M
216,N,778,778,2418,240,6673,216,1640,N
216,O,228,228,2646,380,7053,216,2418,O
216,P,410,410,3056,5460,12513,216,2646,P
217,AE,110,110,110,902,902,217,0,A
217,BE,973,973,1083,240,1142,217,110,B
217,CE,1634,551,1634,2243,2243,217,0,E
217,CF,961,410,2044,1030,2172,217,1083,C
217,BF,739,329,2373,180,2423,217,1634,F
217,BG,657,328,2701,485,2657,217,2044,B
217,CG,578,250,2951,625,3048,217,2373,G
217,CH,412,162,3113,510,3167,217,2701,C
217,DH,60,60,3173,3960,7127,217,3113,D
217,H,438,216,3389,6960,10008,217,2951,H
217,M,6062,6062,9451,7390,17398,217,3389,M
217,N,1357,1357,10808,90,17488,217,9451,N
217,O,1083,1083,11891,1370,18858,217,10808,O
217,N,719,719,12610,420,19278,217,11891,N
217,O,199,199,12809,605,19883,217,12610,O
217,P,20089,20089,32898,3780,23663,217,12809,P
218,AE,56,56,56,131,131,218,0,A
218,BE,131,75,131,233,233,218,0,E
218,BF,163,88,219,150,281,218,56,B
218,CF,193,105,324,150,383,218,131,F
218,CG,220,115,439,455,736,218,219,C
218,DG,467,352,791,795,1178,218,324,G
218,DH,843,491,1282,3565,4301,218,439,D
218,H,525,34,1316,2880,4058,218,791,H
218,M,325,325,1641,1366,5667,218,1316,M
218,N,1227,1227,2868,240,5907,218,1641,N
218,O,838,838,3706,995,6902,218,2868,O
218,P,7442,7442,11148,4680,11582,218,3706,P
219,A,226,226,226,1501,1501,219,0,A
219,B,1314,1314,1540,90,1591,219,226,B
219,C,694,694,2234,950,2541,219,1540,C
219,B,353,353,2587,65,2606,219,2234,B
219,C,990,990,3577,1390,3996,219,2587,C
219,D,934,934,4511,3780,7776,219,3577,D
219,M,21204,21204,25715,23277,31053,219,4511,M
219,N,2111,2111,27826,90,31143,219,25715,N
219,O,780,780,28606,1345,32488,219,27826,O
219,P,6979,6979,35585,3780,36268,219,28606,P
220,A,47,47,47,112,112,220,0,A
220,B,189,189,236,150,262,220,47,B
220,C,575,575,811,685,947,220,236,C
220,D,108,108,919,3690,4637,220,811,D
220,M,269,269,1188,1948,6585,220,919,M
220,N,238,238,1426,240,6825,220,1188,N
220,O,1879,1879,3305,1801,8626,220,1426,O
220,P,475,475,3780,3360,11986,220,3305,P
221,AE,401,401,401,863,863,221,0,E
221,AF,498,498,899,90,953,221,401,F
221,AG,1555,656,1555,1694,1694,221,0,A
221,BG,395,395,1950,300,1994,221,1555,B
221,CG,1134,83,2033,1315,2268,221,899,G
221,CH,537,454,2487,811,2805,221,1950,C
221,DH,229,229,2716,2940,5745,221,2487,D
221,H,1683,1000,3716,3780,6048,221,2033,H
221,M,155,155,3871,1020,7068,221,3716,M
221,N,1120,1120,4991,300,7368,221,3871,N
221,O,593,593,5584,795,8163,221,4991,O
221,P,117,117,5701,1140,9303,221,5584,P
222,AEI,80,80,80,185,185,222,0,E
222,AFI,185,105,185,427,427,222,0,A
222,BFI,220,115,300,150,335,222,80,F
222,BGI,69,69,369,110,445,222,300,G
222,BHI,377,8,377,793,793,222,0,I
222,BHJ,352,160,537,165,592,222,185,B
222,CHJ,431,271,808,90,883,222,377,J
222,CHK,550,279,1087,850,1442,222,537,C
222,DHK,127,127,1214,2880,4322,222,1087,D
222,HK,659,253,1467,950,1833,222,808,K
222,HJ,1043,1043,2510,685,2518,222,1467,J
222,HK,858,858,3368,1240,3758,222,2510,K
222,HL,61,61,3429,3780,7538,222,3368,L
222,H,3517,457,3886,4230,4675,222,369,H
222,M,62,62,3948,148,7686,222,3886,M
222,N,269,269,4217,240,7926,222,3948,N
222,O,250,250,4467,215,8141,222,4217,O
222,P,164,164,4631,4890,13031,222,4467,P
223,A,35,35,35,55,55,223,0,A
223,B,530,530,565,570,625,223,35,B
223,C,287,287,852,80,705,223,565,C
223,B,349,349,1201,240,945,223,852,B
223,C,125,125,1326,130,1075,223,1201,C
223,D,36,36,1362,2850,3925,223,1326,D
223,M,432,432,1794,622,4547,223,1362,M
223,N,305,305,2099,180,4727,223,1794,N
223,O,1555,1555,3654,1715,6442,223,2099,O
223,N,1333,1333,4987,1260,7702,223,3654,N
223,O,2083,2083,7070,2022,9724,223,4987,O
223,P,1497,1497,8567,1608,11332,223,7070,P
224,AEI,83,83,83,1086,1086,224,0,I
224,AEJ,547,464,547,822,822,224,0,E
224,AFJ,504,504,1051,210,1032,224,547,F
224,AGJ,1191,223,1274,240,1326,224,83,J
224,AGK,276,53,1327,290,1322,224,1051,G
224,AHK,850,797,2124,1020,2346,224,1274,K
224,AHL,1268,471,2595,1230,2552,224,1327,H
224,AL,4450,3979,6574,4680,7026,224,2124,L
224,A,13918,7344,13918,14387,14387,224,0,A
224,B,562,562,14480,90,14477,224,13918,B
224,C,1092,1092,15572,1380,15857,224,14480,C
224,B,313,313,15885,85,15942,224,15572,B
224,C,430,430,16315,795,16737,224,15885,C
224,D,1831,1831,18146,3780,20517,224,16315,D
224,M,1876,1876,20022,2019,22536,224,18146,M
224,N,196,196,20218,90,22626,224,20022,N
224,O,843,843,21061,820,23446,224,20218,O
224,N,1770,1770,22831,1815,25261,224,21061,N
224,O,416,416,23247,740,26001,224,22831,O
224,P,2638,2638,25885,3780,29781,224,23247,P
225,AE,55,55,55,126,126,225,0,A
225,BE,70,15,70,908,908,225,0,E
225,BF,1030,1030,1100,240,1148,225,70,F
225,BG,1511,466,1566,1500,1626,225,55,B
225,CG,851,385,1951,1030,2178,225,1100,G
225,CF,862,477,2428,1000,2626,225,1566,C
225,BF,612,135,2563,485,2663,225,1951,F
225,BG,392,392,2955,510,3173,225,2563,G
225,BH,205,205,3160,3960,7133,225,2955,H
225,B,1077,345,3505,910,3536,225,2428,B
225,C,159,159,3664,195,3731,225,3505,C
225,D,534,534,4198,5220,8951,225,3664,D
225,M,37206,37206,41404,36978,45929,225,4198,M
225,N,640,640,42044,90,46019,225,41404,N
225,O,1239,1239,43283,1470,47489,225,42044,O
225,P,98,98,43381,3780,51269,225,43283,P
226,AEI,12,12,12,101,101,226,0,I
226,AEJ,310,298,310,1055,1055,226,0,E
226,AFJ,304,6,316,240,341,226,12,J
226,AFK,244,244,560,515,856,226,316,K
226,AFL,625,65,625,413,413,226,0,A
226,BFL,151,151,776,420,833,226,625,B
226,CFL,31,31,807,95,928,226,776,C
226,BFL,331,331,1138,260,1188,226,807,B
226,CFL,981,153,1291,300,1355,226,310,F
226,CGL,198,45,1336,520,1708,226,1138,C
226,DGL,284,239,1575,345,1700,226,1291,G
226,DFL,952,952,2527,885,2585,226,1575,F
226,DGL,222,222,2749,515,3100,226,2527,G
226,DHL,5092,2903,5652,6150,7006,226,560,L
226,DH,4207,1304,6956,6150,9250,226,2749,H
226,D,14254,8634,15590,6150,7858,226,1336,D
226,M,3020,3020,18610,3020,12270,226,15590,M
226,N,29,29,18639,90,12360,226,18610,N
226,O,727,727,19366,1135,13495,226,18639,O
226,P,290,290,19656,3780,17275,226,19366,P
227,AEI,50,50,50,830,830,227,0,I
227,AEJ,749,699,749,755,755,227,0,E
227,AFJ,120,120,869,180,935,227,749,F
227,AGJ,961,142,1011,240,1070,227,50,J
227,AGK,161,19,1030,140,1075,227,869,G
227,AHK,44,44,1074,2880,3955,227,1030,H
227,AK,163,100,1174,290,1360,227,1011,K
227,AL,139,139,1313,5100,6460,227,1174,L
227,A,4135,2822,4135,4334,4334,227,0,A
227,B,238,238,4373,90,4424,227,4135,B
227,C,1375,1375,5748,1855,6279,227,4373,C
227,D,1169,1169,6917,3780,10059,227,5748,D
227,M,84,84,7001,252,10311,227,6917,M
227,N,268,268,7269,150,10461,227,7001,N
227,O,124,124,7393,115,10576,227,7269,O
227,N,1169,1169,8562,965,11541,227,7393,N
227,O,441,441,9003,690,12231,227,8562,O
227,P,1062,1062,10065,4230,16461,227,9003,P
228,A,147,147,147,1189,1189,228,0,A
228,B,1162,1162,1309,180,1369,228,147,B
228,C,729,729,2038,970,2339,228,1309,C
228,B,1137,1137,3175,915,3254,228,2038,B
228,C,2759,2759,5934,2810,6064,228,3175,C
228,D,2834,2834,8768,385,6449,228,5934,D
228,M,100,100,8868,411,6860,228,8768,M
228,N,481,481,9349,230,7090,228,8868,N
228,O,659,659,10008,560,7650,228,9349,O
228,N,646,646,10654,725,8375,228,10008,N
228,O,885,885,11539,2174,10549,228,10654,O
228,P,530,530,12069,896,11445,228,11539,P
229,AEI,39,39,39,199,199,229,0,A
229,BEI,50,11,50,871,871,229,0,I
229,BEJ,198,148,198,230,230,229,0,E
229,BFJ,133,133,331,150,380,229,198,F
229,BGJ,354,62,393,240,439,229,39,B
229,CGJ,205,143,536,205,585,229,331,G
229,CHJ,174,31,567,295,734,229,393,C
229,DHJ,169,169,736,5100,5834,229,567,D
229,HJ,904,218,954,135,1006,229,50,J
229,HK,198,198,1152,300,1306,229,954,K
229,HL,60,60,1212,5100,6406,229,1152,L
229,H,2433,1757,2969,2850,3435,229,536,H
229,M,2402,2402,5371,3192,9598,229,2969,M
229,N,937,937,6308,180,9778,229,5371,N
229,O,963,963,7271,895,10673,229,6308,O
229,N,310,310,7581,405,11078,229,7271,N
229,O,691,691,8272,850,11928,229,7581,O
229,P,1742,1742,10014,2580,14508,229,8272,P
230,A,254,254,254,1005,1005,230,0,A
230,B,953,953,1207,240,1245,230,254,B
230,C,820,820,2027,1020,2265,230,1207,C
230,D,85,85,2112,4680,6945,230,2027,D
230,M,4475,4475,6587,4577,11522,230,2112,M
230,N,130,130,6717,90,11612,230,6587,N
230,O,466,466,7183,820,12432,230,6717,O
230,N,716,716,7899,350,12782,230,7183,N
230,O,615,615,8514,800,13582,230,7899,O
230,P,736,736,9250,3780,17362,230,8514,P
231,AEI,85,85,85,152,152,231,0,A
231,BEI,138,138,223,135,287,231,85,B
231,CEI,378,155,378,1069,1069,231,0,E
231,CFI,158,3,381,215,502,231,223,C
231,DFI,39,39,420,4890,5392,231,381,D
231,FI,456,36,456,1066,1066,231,0,I
231,FJ,796,718,1174,150,1219,231,378,F
231,GJ,720,2,1176,150,1216,231,456,J
231,GK,164,164,1340,185,1401,231,1176,K
231,GL,207,41,1381,190,1409,231,1174,G
231,HL,440,440,1821,4200,5609,231,1381,H
231,L,2165,1684,3505,4200,5601,231,1340,L
231,M,5303,5303,8808,5898,11507,231,3505,M
231,N,790,790,9598,240,11747,231,8808,N
231,O,842,842,10440,860,12607,231,9598,O
231,P,502,502,10942,3960,16567,231,10440,P
232,AEI,419,419,419,1324,1324,232,0,E
232,AFI,919,500,919,1322,1322,232,0,A
232,BFI,1137,218,1137,1211,1211,232,0,I
232,BFJ,175,175,1312,150,1361,232,1137,J
232,BFK,428,35,1347,90,1412,232,919,B
232,CFK,935,7,1354,90,1414,232,419,F
232,CGK,175,133,1487,135,1496,232,1312,K
232,CGJ,392,392,1879,410,1906,232,1487,J
232,CGK,978,453,2332,1200,2614,232,1354,G
232,CHK,1002,17,2349,1225,2637,232,1347,C
232,DHK,20,20,2369,3780,6417,232,2349,D
232,HK,808,318,2687,775,2681,232,1879,K
232,HL,368,13,2700,3780,6394,232,2332,H
232,L,90,77,2777,4230,6911,232,2687,L
232,M,1746,1746,4523,2575,9486,232,2777,M
232,N,861,861,5384,90,9576,232,4523,N
232,O,510,510,5894,905,10481,232,5384,O
232,P,6671,6671,12565,3780,14261,232,5894,P
233,A,314,314,314,1304,1304,233,0,A
233,B,1176,1176,1490,240,1544,233,314,B
233,C,857,857,2347,1020,2564,233,1490,C
233,D,73,73,2420,4680,7244,233,2347,D
233,M,2293,2293,4713,2304,9548,233,2420,M
233,N,190,190,4903,180,9728,233,4713,N
233,O,884,884,5787,930,10658,233,4903,O
233,P,5320,5320,11107,550,11208,233,5787,P
234,A,40,40,40,77,77,234,0,A
234,B,219,219,259,240,317,234,40,B
234,C,136,136,395,270,587,234,259,C
234,D,1140,1140,1535,5070,5657,234,395,D
234,M,159,159,1694,135,5792,234,1535,M
234,N,486,486,2180,570,6362,234,1694,N
234,O,81,81,2261,80,6442,234,2180,O
234,N,238,238,2499,240,6682,234,2261,N
234,O,117,117,2616,130,6812,234,2499,O
234,P,67,67,2683,2850,9662,234,2616,P
235,AE,1645,1645,1645,2955,2955,235,0,A
235,BE,1468,1468,3113,180,3135,235,1645,B
235,CE,758,758,3871,935,4070,235,3113,C
235,DE,6939,6939,10810,2220,6290,235,3871,D
235,E,37491,26681,37491,38286,38286,235,0,E
235,F,855,855,38346,90,38376,235,37491,F
235,G,679,679,39025,1105,39481,235,38346,G
235,H,4202,4202,43227,3780,43261,235,39025,H
235,M,157,157,43384,855,44116,235,43227,M
235,N,1004,1004,44388,300,44416,235,43384,N
235,O,971,971,45359,930,45346,235,44388,O
235,P,1257,1257,46616,2760,48106,235,45359,P
236,AE,439,439,439,955,955,236,0,A
236,BE,704,704,1143,240,1195,236,439,B
236,CE,184,184,1327,400,1595,236,1143,C
236,DE,368,368,1695,3960,5555,236,1327,D
236,E,2468,773,2468,2740,2740,236,0,E
236,F,448,448,2916,240,2980,236,2468,F
236,G,788,788,3704,855,3835,236,2916,G
236,H,179,179,3883,3960,7795,236,3704,H
236,M,829,829,4712,2802,10597,236,3883,M
236,N,2088,2088,6800,90,10687,236,4712,N
236,O,1248,1248,8048,1355,12042,236,6800,O
236,N,3758,3758,11806,3730,15772,236,8048,N
236,O,179,179,11985,585,16357,236,11806,O
236,P,1533,1533,13518,3780,20137,236,11985,P
237,AEI,596,596,596,750,750,237,0,A
237,BEI,486,486,1082,360,1110,237,596,B
237,CEI,708,708,1790,845,1955,237,1082,C
237,DEI,160,160,1950,1590,3545,237,1790,D
237,EI,2101,151,2101,2250,2250,237,0,I
237,EJ,223,223,2324,90,2340,237,2101,J
237,EK,614,614,2938,790,3130,237,2324,K
237,EJ,1060,1060,3998,325,3455,237,2938,J
237,EK,1382,1382,5380,1885,5340,237,3998,K
237,EL,5425,45,5425,4800,4800,237,0,E
237,FL,109,109,5534,780,5580,237,5425,F
237,GL,188,188,5722,395,5975,237,5534,G
237,HL,1943,1943,7665,1590,7565,237,5722,H
237,L,5446,3161,10826,3780,9120,237,5380,L
237,M,210,210,11036,765,9885,237,10826,M
237,N,822,822,11858,300,10185,237,11036,N
237,O,953,953,12811,930,11115,237,11858,O
237,P,2467,2467,15278,2760,13875,237,12811,P
238,AE,52,52,52,199,199,238,0,E
238,AF,237,237,289,150,349,238,52,F
238,AG,506,506,795,795,1144,238,289,G
238,AH,36,36,831,2880,4024,238,795,H
238,A,1192,361,1192,1552,1552,238,0,A
238,B,600,600,1792,300,1852,238,1192,B
238,C,633,633,2425,820,2672,238,1792,C
238,D,24,24,2449,5315,7987,238,2425,D
238,M,32,32,2481,53,8040,238,2449,M
238,N,113,113,2594,135,8175,238,2481,N
238,O,183,183,2777,295,8470,238,2594,O
238,P,112,112,2889,5220,13690,238,2777,P
239,AEI,66,66,66,150,150,239,0,I
239,AEJ,262,262,328,240,390,239,66,J
239,AEK,540,212,540,943,943,239,0,E
239,AFK,503,503,1043,150,1093,239,540,F
239,AGK,1122,79,1122,1470,1470,239,0,A
239,BGK,874,80,1202,970,1360,239,328,K
239,BGL,173,14,1216,120,1213,239,1043,G
239,BFL,378,284,1500,300,1770,239,1122,B
239,CFL,607,323,1823,660,1873,239,1216,F
239,CGL,729,108,1931,5160,6520,239,1202,L
239,CG,783,352,2283,720,2490,239,1500,C
239,BG,294,294,2577,120,2610,239,2283,B
239,CG,849,95,2672,945,2818,239,1823,G
239,CH,1045,950,3622,1335,3945,239,2577,C
239,DH,1088,1088,4710,3840,7785,239,3622,D
239,H,2115,77,4787,5160,7978,239,2672,H
239,M,34,34,4821,438,8416,239,4787,M
239,N,584,584,5405,240,8656,239,4821,N
239,O,892,892,6297,1075,9731,239,5405,O
239,N,3181,3181,9478,2990,12721,239,6297,N
239,O,181,181,9659,260,12981,239,9478,O
239,P,1145,1145,10804,5220,18201,239,9659,P
240,AEI,115,115,115,806,806,240,0,A
240,BEI,203,88,203,394,394,240,0,E
240,BFI,384,384,587,240,634,240,203,F
240,BGI,197,197,784,285,919,240,587,G
240,BHI,784,115,899,150,956,240,115,B
240,CHI,207,207,1106,285,1241,240,899,C
240,DHI,296,296,1402,5160,6401,240,1106,D
240,HI,4228,2826,4228,4415,4415,240,0,I
240,HJ,375,375,4603,240,4655,240,4228,J
240,HK,587,587,5190,770,5425,240,4603,K
240,HJ,547,547,5737,285,5710,240,5190,J
240,HK,823,823,6560,1260,6970,240,5737,K
240,HL,5824,48,6608,5160,6079,240,784,H
240,L,204,156,6764,3960,10930,240,6560,L
240,M,163,163,6927,305,11235,240,6764,M
240,N,483,483,7410,360,11595,240,6927,N
240,O,564,564,7974,750,12345,240,7410,O
240,P,7566,7566,15540,1140,13485,240,7974,P
241,AEI,49,49,49,140,140,241,0,A
241,BEI,82,33,82,174,174,241,0,E
241,BFI,93,11,93,207,207,241,0,I
241,BFJ,176,132,225,150,290,241,49,B
241,CFJ,189,57,282,150,357,241,93,J
241,CFK,207,7,289,150,324,241,82,F
241,CGK,500,436,725,775,1065,241,225,C
241,DGK,520,84,809,110,434,241,289,G
241,DHK,624,97,906,935,1292,241,282,K
241,DHL,1421,1240,2146,2880,3945,241,725,D
241,HL,1510,270,2416,6910,8202,241,906,L
241,H,3016,1409,3825,4230,4664,241,809,H
241,M,62,62,3887,132,8334,241,3825,M
241,N,245,245,4132,240,8574,241,3887,N
241,O,200,200,4332,515,9089,241,4132,O
241,P,840,840,5172,6150,15239,241,4332,P
242,A,1582,1582,1582,1898,1898,242,0,A
242,B,341,341,1923,90,1988,242,1582,B
242,C,773,773,2696,1100,3088,242,1923,C
242,B,801,801,3497,470,3558,242,2696,B
242,C,1708,1708,5205,1465,5023,242,3497,C
242,D,1,1,5206,3780,8803,242,5205,D
242,M,2287,2287,7493,3069,11872,242,5206,M
242,N,912,912,8405,180,12052,242,7493,N
242,O,782,782,9187,895,12947,242,8405,O
242,N,312,312,9499,25,12972,242,9187,N
242,O,668,668,10167,730,13702,242,9499,O
242,P,1,1,10168,4020,17722,242,10167,P
243,A,3805,3805,3805,4005,4005,243,0,A
243,B,247,247,4052,90,4095,243,3805,B
243,C,403,403,4455,815,4910,243,4052,C
243,D,5940,5940,10395,3780,8690,243,4455,D
243,M,757,757,11152,1459,10149,243,10395,M
243,N,751,751,11903,90,10239,243,11152,N
243,O,449,449,12352,805,11044,243,11903,O
243,N,3034,3034,15386,2680,13724,243,12352,N
243,O,708,708,16094,920,14644,243,15386,O
243,P,1226,1226,17320,3780,18424,243,16094,P
244,AE,248,248,248,1075,1075,244,0,E
244,AF,486,238,486,2250,2250,244,0,A
244,BF,917,679,1165,150,1225,244,248,F
244,BG,187,187,1352,220,1445,244,1165,G
244,BH,84,84,1436,2880,4325,244,1352,H
244,B,1817,867,2303,90,2340,244,486,B
244,C,820,820,3123,1270,3610,244,2303,C
244,D,291,291,3414,3780,7390,244,3123,D
244,M,4343,4343,7757,4466,11856,244,3414,M
244,N,303,303,8060,240,12096,244,7757,N
244,O,926,926,8986,1075,13171,244,8060,O
244,N,731,731,9717,585,13756,244,8986,N
244,O,971,971,10688,920,14676,244,9717,O
244,P,2474,2474,13162,775,15451,244,10688,P
245,A,113,113,113,189,189,245,0,A
245,B,165,165,278,120,309,245,113,B
245,C,167,167,445,375,684,245,278,C
245,D,692,692,1137,3180,3864,245,445,D
245,M,100,100,1237,715,4579,245,1137,M
245,N,805,805,2042,240,4819,245,1237,N
245,O,123,123,2165,215,5034,245,2042,O
245,P,335,335,2500,5690,10724,245,2165,P
246,AEI,66,66,66,761,761,246,0,A
246,BEI,126,60,126,866,866,246,0,I
246,BEJ,888,828,954,240,1001,246,66,B
246,CEJ,935,107,1061,240,1106,246,126,J
246,CEK,230,123,1184,290,1291,246,954,C
246,DEK,786,663,1847,1015,2121,246,1061,K
246,DEJ,771,108,1955,5160,6451,246,1184,D
246,EJ,887,779,2734,650,2771,246,1847,J
246,EK,269,269,3003,385,3156,246,2734,K
246,EL,2167,2167,5170,3960,7116,246,3003,L
246,E,5847,677,5847,5845,5845,246,0,E
246,F,336,336,6183,300,6145,246,5847,F
246,G,622,622,6805,700,6845,246,6183,G
246,H,1432,1432,8237,1140,7985,246,6805,H
246,M,807,807,9044,1571,9556,246,8237,M
246,N,795,795,9839,90,9646,246,9044,N
246,O,837,837,10676,1240,10886,246,9839,O
246,P,1145,1145,11821,3780,14666,246,10676,P
247,AEI,48,48,48,1058,1058,247,0,E
247,AFI,105,57,105,1085,1085,247,0,I
247,AFJ,446,341,446,566,566,247,0,A
247,BFJ,210,210,656,150,716,247,446,B
247,CFJ,470,470,1126,721,1437,247,656,C
247,BFJ,1196,118,1244,240,1298,247,48,F
247,BGJ,1162,23,1267,240,1325,247,105,J
247,BGK,806,806,2073,930,2255,247,1267,K
247,BGL,832,3,2076,930,2228,247,1244,G
247,BHL,262,262,2338,6990,9218,247,2076,H
247,BL,1778,566,2904,1510,2947,247,1126,B
247,CL,799,799,3703,930,3877,247,2904,C
247,DL,2936,2936,6639,6990,10867,247,3703,D
247,L,4601,35,6674,6990,9245,247,2073,L
247,M,17471,17471,24145,18996,29863,247,6674,M
247,N,2617,2617,26762,90,29953,247,24145,N
247,O,945,945,27707,1120,31073,247,26762,O
247,P,162,162,27869,3780,34853,247,27707,P
248,AE,112,112,112,861,861,248,0,A
248,BE,217,105,217,230,230,248,0,E
248,BF,215,215,432,240,470,248,217,F
248,BG,154,154,586,275,745,248,432,G
248,BH,932,458,1044,240,1101,248,112,B
248,CH,125,125,1169,265,1366,248,1044,C
248,DH,517,517,1686,5070,6436,248,1169,D
248,H,4855,3755,5441,5070,5815,248,586,H
248,M,241,241,5682,2393,8829,248,5441,M
248,N,2247,2247,7929,150,8979,248,5682,N
248,O,128,128,8057,100,9079,248,7929,O
248,N,781,781,8838,785,9864,248,8057,N
248,O,596,596,9434,605,10469,248,8838,O
248,P,11230,11230,20664,4230,14699,248,9434,P
249,A,1592,1592,1592,1697,1697,249,0,A
249,B,302,302,1894,240,1937,249,1592,B
249,C,744,744,2638,970,2907,249,1894,C
249,B,1068,1068,3706,760,3667,249,2638,B
249,C,4827,4827,8533,780,4447,249,3706,C
249,D,2513,2513,11046,3960,8407,249,8533,D
249,M,461,461,11507,582,8989,249,11046,M
249,N,178,178,11685,240,9229,249,11507,N
249,O,406,406,12091,1710,10939,249,11685,O
249,N,4724,4724,16815,3275,14214,249,12091,N
249,O,1255,1255,18070,1290,15504,249,16815,O
249,P,10379,10379,28449,3660,19164,249,18070,P
250,AE,130,130,130,1144,1144,250,0,E
250,AF,283,153,283,841,841,250,0,A
250,BF,689,689,972,150,991,250,283,B
250,CF,213,213,1185,165,1156,250,972,C
250,BF,1206,151,1336,240,1384,250,130,F
250,BG,790,790,2126,760,2144,250,1336,G
250,BH,15,15,2141,7680,9824,250,2126,H
250,B,1579,623,2764,1650,2806,250,1185,B
250,C,679,679,3443,555,3361,250,2764,C
250,D,3212,3212,6655,4230,7591,250,3443,D
250,M,230,230,6885,245,10069,250,6655,M
250,N,282,282,7167,300,10369,250,6885,N
250,O,463,463,7630,695,11064,250,7167,O
250,P,63,63,7693,1140,12204,250,7630,P
251,AEI,66,66,66,93,93,251,0,I
251,AEJ,67,1,67,244,244,251,0,A
251,BEJ,115,48,115,224,224,251,0,E
251,BFJ,124,75,190,135,228,251,66,J
251,BFK,200,125,315,150,374,251,115,F
251,BGK,150,25,340,285,513,251,190,K
251,BGL,289,16,356,135,379,251,67,B
251,CGL,192,176,532,5160,5673,251,340,L
251,CG,236,19,551,210,584,251,315,G
251,CH,366,171,722,290,669,251,356,C
251,DH,181,10,732,2880,3464,251,551,H
251,D,69,59,791,5160,5829,251,722,D
251,M,2102,2102,2893,2489,8318,251,791,M
251,N,524,524,3417,180,8498,251,2893,N
251,O,520,520,3937,885,9383,251,3417,O
251,N,1708,1708,5645,1360,10743,251,3937,N
251,O,564,564,6209,695,11438,251,5645,O
251,P,4013,4013,10222,6960,18398,251,6209,P
252,AE,347,347,347,1548,1548,252,0,A
252,BE,1479,1132,1479,1559,1559,252,0,E
252,BF,177,177,1656,150,1709,252,1479,F
252,BG,1438,129,1785,240,1788,252,347,B
252,CG,609,480,2265,615,2324,252,1656,G
252,CH,632,152,2417,910,2698,252,1785,C
252,DH,266,266,2683,3900,6598,252,2417,D
252,H,509,91,2774,4200,6524,252,2265,H
252,M,574,574,3348,2012,8610,252,2774,M
252,N,1468,1468,4816,90,8700,252,3348,N
252,O,1383,1383,6199,1630,10330,252,4816,O
252,P,226,226,6425,3780,14110,252,6199,P
253,AE,115,115,115,415,415,253,0,E
253,AF,365,365,480,90,505,253,115,F
253,AG,1372,1372,1852,1745,2250,253,480,G
253,AH,41,41,1893,3780,6030,253,1852,H
253,A,9374,7481,9374,12045,12045,253,0,A
253,B,2742,2742,12116,90,12135,253,9374,B
253,C,1221,1221,13337,1365,13500,253,12116,C
253,D,84,84,13421,3780,17280,253,13337,D
253,M,2267,2267,15688,2714,19994,253,13421,M
253,N,484,484,16172,90,20084,253,15688,N
253,O,189,189,16361,605,20689,253,16172,O
253,P,1718,1718,18079,3780,24469,253,16361,P
254,A,4789,4789,4789,5064,5064,254,0,A
254,B,492,492,5281,240,5304,254,4789,B
254,C,271,271,5552,435,5739,254,5281,C
254,D,574,574,6126,3960,9699,254,5552,D
254,M,20,20,6146,599,10298,254,6126,M
254,N,795,795,6941,240,10538,254,6146,N
254,O,649,649,7590,1050,11588,254,6941,O
254,P,3575,3575,11165,3960,15548,254,7590,P
255,AE,1,1,1,1426,1426,255,0,A
255,BE,181,180,181,519,519,255,0,E
255,BF,512,512,693,240,759,255,181,F
255,BG,784,784,1477,985,1744,255,693,G
255,BH,1686,210,1687,300,1726,255,1,B
255,CH,817,607,2294,5040,6784,255,1477,H
255,C,938,331,2625,815,2541,255,1687,C
255,D,26,26,2651,5590,8131,255,2625,D
255,M,23733,23733,26384,24649,32780,255,2651,M
255,N,946,946,27330,90,32870,255,26384,N
255,O,1056,1056,28386,1210,34080,255,27330,O
255,P,505,505,28891,3780,37860,255,28386,P
256,AEI,107,107,107,1023,1023,256,0,A
256,BEI,110,3,110,345,345,256,0,E
256,BFI,390,280,390,1008,1008,256,0,I
256,BFJ,618,338,728,420,765,256,110,F
256,BGJ,1107,486,1214,240,1263,256,107,B
256,CGJ,839,15,1229,270,1278,256,390,J
256,CGK,1175,674,1903,1160,1925,256,728,G
256,CHK,839,150,2053,890,2153,256,1214,C
256,DHK,1124,300,2353,1170,2448,256,1229,K
256,DHL,5116,5116,7469,695,3143,256,2353,L
256,DH,6302,736,8205,665,2590,256,1903,H
256,D,6157,5,8210,5160,7313,256,2053,D
256,M,157,157,8367,1238,8551,256,8210,M
256,N,1179,1179,9546,150,8701,256,8367,N
256,O,741,741,10287,725,9426,256,9546,O
256,N,1030,1030,11317,1050,10476,256,10287,N
256,O,139,139,11456,130,10606,256,11317,O
256,P,3075,3075,14531,4230,14836,256,11456,P
257,AE,1202,1202,1202,1732,1732,257,0,E
257,AF,1451,249,1451,1737,1737,257,0,A
257,BF,560,311,1762,90,1822,257,1202,F
257,BG,539,228,1990,300,2037,257,1451,B
257,CG,753,525,2515,1040,2862,257,1762,G
257,CH,1340,815,3330,1275,3312,257,1990,C
257,BH,832,17,3347,3780,6642,257,2515,H
257,B,1187,1170,4517,1065,4377,257,3330,B
257,C,175,175,4692,510,4887,257,4517,C
257,D,62,62,4754,4020,8907,257,4692,D
257,M,390,390,5144,303,9210,257,4754,M
257,N,547,547,5691,90,9300,257,5144,N
257,O,1094,1094,6785,1370,10670,257,5691,O
257,N,779,779,7564,1105,11775,257,6785,N
257,O,548,548,8112,935,12710,257,7564,O
257,P,1325,1325,9437,3780,16490,257,8112,P
258,AEI,28,28,28,2340,2340,258,0,A
258,BEI,709,681,709,1188,1188,258,0,E
258,BFI,920,211,920,980,980,258,0,I
258,BFJ,204,204,1124,180,1160,258,920,J
258,BFK,770,355,1479,180,1368,258,709,F
258,BGK,411,56,1535,570,1730,258,1124,K
258,BGL,285,285,1820,4080,5810,258,1535,L
258,BG,494,153,1973,895,2263,258,1479,G
258,BF,2513,568,2541,240,2580,258,28,B
258,CF,679,679,3220,960,3540,258,2541,C
258,DF,1361,114,3334,1105,3368,258,1973,F
258,DG,205,91,3425,3960,7500,258,3220,D
258,G,673,582,4007,850,4218,258,3334,G
258,H,17447,17447,21454,2580,6798,258,4007,H
258,M,200,200,21654,1069,8569,258,21454,M
258,N,989,989,22643,180,8749,258,21654,N
258,O,1445,1445,24088,1050,9799,258,22643,O
258,P,1722,1722,25810,5040,14839,258,24088,P
259,AEI,62,62,62,124,124,259,0,A
259,BEI,84,22,84,377,377,259,0,I
259,BEJ,234,212,296,240,364,259,62,B
259,CEJ,391,179,475,165,542,259,84,J
259,CEK,1065,590,1065,3809,3809,259,0,E
259,CFK,612,22,1087,850,1392,259,475,K
259,CFL,799,8,1095,975,1339,259,296,C
259,DFL,101,93,1188,5225,6617,259,1087,L
259,DF,756,663,1851,5040,6379,259,1095,D
259,F,2864,2078,3929,180,3989,259,1065,F
259,G,893,893,4822,1050,5039,259,3929,G
259,H,1467,1467,6289,5400,10439,259,4822,H
259,M,94,94,6383,1052,11491,259,6289,M
259,N,1139,1139,7522,240,11731,259,6383,N
259,O,1036,1036,8558,995,12726,259,7522,O
259,P,1236,1236,9794,4680,17406,259,8558,P
260,AEI,298,298,298,1123,1123,260,0,I
260,AEJ,455,157,455,2178,2178,260,0,A
260,BEJ,1061,606,1061,1500,1500,260,0,E
260,BFJ,858,95,1156,90,1213,260,298,J
260,BFK,469,374,1530,90,1590,260,1061,F
260,BGK,914,540,2070,1250,2463,260,1156,K
260,BGL,1754,139,2209,90,2268,260,455,B
260,CGL,1048,369,2578,1250,2840,260,1530,G
260,CHL,544,36,2614,3780,6243,260,2070,L
260,CH,553,148,2762,750,3018,260,2209,C
260,DH,632,632,3394,3780,6798,260,2762,D
260,H,1142,326,3720,3780,6620,260,2578,H
260,M,407,407,4127,841,7639,260,3720,M
260,N,471,471,4598,90,7729,260,4127,N
260,O,888,888,5486,1175,8904,260,4598,O
260,P,7593,7593,13079,3780,12684,260,5486,P
261,AE,43,43,43,68,68,261,0,E
261,AF,177,134,177,898,898,261,0,A
261,BF,202,68,245,240,308,261,43,F
261,BG,138,138,383,215,523,261,245,G
261,BH,688,688,1071,4890,5413,261,383,H
261,B,912,18,1089,240,1138,261,177,B
261,C,787,787,1876,1015,2153,261,1089,C
261,D,1551,1551,3427,3960,6113,261,1876,D
261,M,68,68,3495,620,6733,261,3427,M
261,N,755,755,4250,240,6973,261,3495,N
261,O,492,492,4742,785,7758,261,4250,O
261,P,1699,1699,6441,3960,11718,261,4742,P
262,AE,145,145,145,789,789,262,0,A
262,BE,748,748,893,150,939,262,145,B
262,CE,1570,677,1570,1866,1866,262,0,E
262,CF,416,416,1986,150,2016,262,1570,F
262,CG,1299,206,2192,110,1049,262,893,C
262,BG,325,325,2517,1500,2549,262,2192,B
262,CG,911,380,2897,860,2876,262,1986,G
262,CF,254,254,3151,310,3186,262,2897,F
262,CG,651,17,3168,705,3254,262,2517,C
262,DG,650,633,3801,705,3891,262,3151,G
262,DH,4243,3610,7411,4230,7484,262,3168,D
262,H,5779,2169,9580,4230,8121,262,3801,H
262,M,445,445,10025,95,8216,262,9580,M
262,N,200,200,10225,600,8816,262,10025,N
262,O,288,288,10513,420,9236,262,10225,O
262,N,333,333,10846,200,9436,262,10513,N
262,O,2446,2446,13292,2560,11996,262,10846,O
262,P,4333,4333,17625,1920,13916,262,13292,P
263,A,66,66,66,123,123,263,0,A
263,B,173,173,239,150,273,263,66,B
263,C,585,585,824,765,1038,263,239,C
263,D,306,306,1130,3600,4638,263,824,D
263,M,148,148,1278,695,5333,263,1130,M
263,N,637,637,1915,150,5483,263,1278,N
263,O,600,600,2515,500,5983,263,1915,O
263,P,243,243,2758,385,6368,263,2515,P
264,AEI,13,13,13,111,111,264,0,E
264,AFI,302,302,315,240,351,264,13,F
264,AGI,590,590,905,905,1256,264,315,G
264,AHI,292,292,1197,3960,5216,264,905,H
264,AI,1902,705,1902,2420,2420,264,0,I
264,AJ,1077,1077,2979,180,2600,264,1902,J
264,AK,432,432,3411,895,3495,264,2979,K
264,AJ,4177,766,4177,4843,4843,264,0,A
264,BJ,1221,455,4632,1140,4635,264,3411,J
264,BK,731,276,4908,90,4933,264,4177,B
264,CK,520,244,5152,750,5385,264,4632,K
264,CL,470,226,5378,860,5793,264,4908,C
264,DL,2743,2517,7895,1140,6525,264,5152,L
264,D,3859,1342,9237,3780,9573,264,5378,D
264,M,470,470,9707,576,10149,264,9237,M
264,N,194,194,9901,90,10239,264,9707,N
264,O,542,542,10443,870,11109,264,9901,O
264,N,2562,2562,13005,2290,13399,264,10443,N
264,O,1010,1010,14015,1340,14739,264,13005,O
264,P,1739,1739,15754,3780,18519,264,14015,P
265,A,70,70,70,111,111,265,0,A
265,B,116,116,186,135,246,265,70,B
265,C,188,188,374,195,441,265,186,C
265,D,525,525,899,5220,5661,265,374,D
265,M,35856,35856,36755,36913,42574,265,899,M
265,N,1187,1187,37942,90,42664,265,36755,N
265,O,1047,1047,38989,1450,44114,265,37942,O
265,N,877,877,39866,570,44684,265,38989,N
265,O,133,133,39999,585,45269,265,39866,O
265,P,5767,5767,45766,3780,49049,265,39999,P
266,A,258,258,258,1412,1412,266,0,A
266,B,1184,1184,1442,90,1502,266,258,B
266,C,993,993,2435,1210,2712,266,1442,C
266,D,907,907,3342,3780,6492,266,2435,D
266,M,4261,4261,7603,5036,11528,266,3342,M
266,N,800,800,8403,90,11618,266,7603,N
266,O,740,740,9143,1155,12773,266,8403,O
266,P,60,60,9203,3780,16553,266,9143,P
267,A,208,208,208,302,302,267,0,A
267,B,270,270,478,240,542,267,208,B
267,C,716,716,1194,975,1517,267,478,C
267,D,816,816,2010,5040,6557,267,1194,D
267,M,44,44,2054,219,6776,267,2010,M
267,N,355,355,2409,240,7016,267,2054,N
267,O,127,127,2536,190,7206,267,2409,O
267,P,816,816,3352,5160,12366,267,2536,P
268,AE,214,214,214,343,343,268,0,A
268,BE,249,249,463,180,523,268,214,B
268,CE,538,75,538,642,642,268,0,E
268,CF,214,214,752,170,812,268,538,F
268,CG,517,228,980,495,1018,268,463,C
268,DG,498,270,1250,495,1307,268,752,G
268,DH,634,634,1884,385,1692,268,1250,H
268,D,1958,1054,2938,550,1568,268,980,D
268,M,675,675,3613,1220,2912,268,2938,M
268,N,846,846,4459,330,3242,268,3613,N
268,O,994,994,5453,1339,4581,268,4459,O
268,P,934,934,6387,526,5107,268,5453,P
269,AEI,48,48,48,154,154,269,0,A
269,BEI,126,126,174,120,274,269,48,B
269,CEI,381,207,381,1318,1318,269,0,E
269,CFI,780,573,954,890,1164,269,174,C
269,DFI,1069,115,1069,1140,1140,269,0,I
269,DFJ,272,272,1341,240,1380,269,1069,J
269,DFK,1142,182,1523,240,1558,269,381,F
269,DGK,702,520,2043,960,2340,269,1341,K
269,DGL,145,145,2188,3960,6300,269,2043,L
269,DG,740,75,2263,960,2518,269,1523,G
269,DH,543,543,2806,3960,6478,269,2263,H
269,D,3532,1680,4486,5160,6324,269,954,D
269,M,164,164,4650,941,7419,269,4486,M
269,N,1033,1033,5683,300,7719,269,4650,N
269,O,1385,1385,7068,995,8714,269,5683,O
269,P,974,974,8042,3960,12674,269,7068,P
270,AE,24,24,24,1426,1426,270,0,A
270,BE,1697,1697,1721,240,1666,270,24,B
270,CE,751,751,2472,970,2636,270,1721,C
270,DE,204,204,2676,3960,6596,270,2472,D
270,E,5398,2722,5398,7645,7645,270,0,E
270,F,2624,2624,8022,420,8065,270,5398,F
270,G,837,837,8859,1069,9134,270,8022,G
270,H,22,22,8881,356,9490,270,8859,H
270,M,147,147,9028,958,10448,270,8881,M
270,N,993,993,10021,240,10688,270,9028,N
270,O,720,720,10741,1015,11703,270,10021,O
270,N,969,969,11710,650,12353,270,10741,N
270,O,172,172,11882,385,12738,270,11710,O
270,P,468,468,12350,3960,16698,270,11882,P
271,AE,76,76,76,268,268,271,0,A
271,BE,361,285,361,1037,1037,271,0,E
271,BF,398,113,474,270,538,271,76,B
271,CF,572,572,1046,735,1273,271,474,C
271,DF,39,39,1085,5315,6588,271,1046,D
271,F,766,42,1127,150,1187,271,361,F
271,G,790,790,1917,1055,2242,271,1127,G
271,H,2378,2378,4295,3490,5732,271,1917,H
271,M,60,60,4355,64,6652,271,4295,M
271,N,82,82,4437,135,6787,271,4355,N
271,O,304,304,4741,380,7167,271,4437,O
271,P,876,876,5617,5460,12627,271,4741,P
272,AEI,162,162,162,189,189,272,0,I
272,AEJ,227,65,227,2521,2521,272,0,A
272,BEJ,117,52,279,150,339,272,162,J
272,BEK,510,510,789,795,1134,272,279,K
272,BEL,347,347,1136,2880,4014,272,789,L
272,BE,1205,69,1205,2868,2868,272,0,E
272,BF,2414,1436,2641,180,2701,272,227,B
272,CF,1767,331,2972,180,3048,272,1205,F
272,CG,821,490,3462,1050,3751,272,2641,C
272,DG,695,205,3667,985,4033,272,2972,G
272,DH,3009,2804,6471,5400,9151,272,3462,D
272,H,3991,1187,7658,3495,7528,272,3667,H
272,M,32,32,7690,115,9266,272,7658,M
272,N,171,171,7861,135,9401,272,7690,N
272,O,248,248,8109,515,9916,272,7861,O
272,P,805,805,8914,6150,16066,272,8109,P
273,AE,117,117,117,1303,1303,273,0,A
273,BE,595,478,595,865,865,273,0,E
273,BF,600,600,1195,360,1225,273,595,F
273,BG,1371,293,1488,240,1543,273,117,B
273,CG,555,262,1750,715,1940,273,1195,G
273,CH,614,352,2102,620,2163,273,1488,C
273,DH,674,674,2776,6300,8463,273,2102,D
273,H,1673,647,3423,1140,3080,273,1750,H
273,M,134,134,3557,265,8728,273,3423,M
273,N,389,389,3946,300,9028,273,3557,N
273,O,437,437,4383,640,9668,273,3946,O
273,P,41,41,4424,1140,10808,273,4383,P
274,AEI,6,6,6,97,97,274,0,A
274,BEI,181,181,187,240,337,274,6,B
274,CEI,512,325,512,630,630,274,0,E
274,CFI,256,256,768,180,810,274,512,F
274,CGI,279,279,1047,460,1270,274,768,G
274,CFI,1286,239,1286,2257,2257,274,0,I
274,CFJ,307,68,1354,135,1405,274,1047,F
274,CGJ,1401,234,1588,1305,1642,274,187,C
274,BGJ,282,48,1636,2970,4375,274,1354,G
274,BHJ,1071,721,2357,150,2407,274,1286,J
274,BHK,180,180,2537,155,2562,274,2357,K
274,BHJ,1318,369,2906,1310,2952,274,1588,B
274,CHJ,378,9,2915,350,2912,274,2537,J
274,CHK,631,631,3546,710,3622,274,2915,K
274,CHL,177,177,3723,4230,7852,274,3546,L
274,CH,1226,409,4132,1339,4291,274,2906,C
274,DH,784,784,4916,526,4817,274,4132,D
274,H,5555,2275,7191,1440,5815,274,1636,H
274,M,4141,4141,11332,4527,12379,274,7191,M
274,N,583,583,11915,240,12619,274,11332,N
274,O,830,830,12745,920,13539,274,11915,O
274,P,88,88,12833,3960,17499,274,12745,P
275,AEI,500,500,500,1625,1625,275,0,A
275,BEI,1203,703,1203,1357,1357,275,0,I
275,BEJ,371,371,1574,240,1597,275,1203,J
275,BEK,1263,189,1763,150,1775,275,500,B
275,CEK,743,554,2317,855,2452,275,1574,K
275,CEL,707,153,2470,730,2505,275,1763,C
275,DEL,213,60,2530,4020,6472,275,2317,L
275,DE,887,827,3357,4200,6705,275,2470,D
275,E,4263,906,4263,5361,5361,275,0,E
275,F,1214,1214,5477,150,5511,275,4263,F
275,G,736,736,6213,730,6241,275,5477,G
275,H,857,857,7070,4200,10441,275,6213,H
275,M,203,203,7273,1036,11477,275,7070,M
275,N,1025,1025,8298,240,11717,275,7273,N
275,O,718,718,9016,895,12612,275,8298,O
275,P,1049,1049,10065,3960,16572,275,9016,P
276,AEI,72,72,72,191,191,276,0,E
276,AFI,332,332,404,270,461,276,72,F
276,AGI,639,639,1043,735,1196,276,404,G
276,AFI,1391,348,1391,2567,2567,276,0,I
276,AFJ,1025,677,2068,925,2121,276,1043,F
276,AGJ,136,136,2204,215,2336,276,2068,G
276,AHJ,1196,383,2587,90,2657,276,1391,J
276,AHK,416,33,2620,4890,7226,276,2204,H
276,AK,2832,212,2832,3035,3035,276,0,A
276,BK,377,377,3209,240,3275,276,2832,B
276,CK,883,261,3470,1205,3862,276,2587,K
276,CL,829,568,4038,995,4270,276,3209,C
276,DL,698,130,4168,3780,7642,276,3470,L
276,D,1352,1222,5390,3960,8230,276,4038,D
276,M,15,15,5405,104,8334,276,5390,M
276,N,194,194,5599,150,8484,276,5405,N
276,O,172,172,5771,150,8634,276,5599,O
276,P,892,892,6663,4230,12864,276,5771,P
277,AEI,918,918,918,1900,1900,277,0,E
277,AFI,1043,125,1043,1443,1443,277,0,A
277,BFI,608,608,1651,240,1683,277,1043,B
277,CFI,1789,138,1789,2299,2299,277,0,I
277,CFJ,1222,351,2140,300,2200,277,918,F
277,CGJ,546,57,2197,790,2473,277,1651,C
277,BGJ,735,327,2524,150,2449,277,1789,J
277,BGK,567,183,2707,660,2860,277,2140,G
277,BFK,217,217,2924,90,2950,277,2707,F
277,BGK,893,493,3417,840,3289,277,2524,K
277,BGJ,537,44,3461,770,3720,277,2924,G
277,BHJ,246,202,3663,420,3709,277,3417,J
277,BHK,604,604,4267,480,4189,277,3663,K
277,BHL,1125,319,4586,3960,7680,277,3461,H
277,BL,1341,1022,5608,4230,8419,277,4267,L
277,B,6091,2680,8288,1525,3998,277,2197,B
277,C,784,784,9072,1020,5018,277,8288,C
277,D,2738,2738,11810,3900,8918,277,9072,D
277,M,1244,1244,13054,4343,13261,277,11810,M
277,N,3279,3279,16333,240,13501,277,13054,N
277,O,705,705,17038,745,14246,277,16333,O
277,N,490,490,17528,455,14701,277,17038,N
277,O,327,327,17855,245,14946,277,17528,O
277,P,1424,1424,19279,5250,20196,277,17855,P
278,AEI,99,99,99,55,55,278,0,A
278,BEI,141,42,141,151,151,278,0,I
278,BEJ,51,9,150,155,210,278,99,B
278,CEJ,177,27,177,272,272,278,0,E
278,CFJ,91,64,241,100,310,278,150,C
278,BFJ,192,92,333,240,391,278,141,J
278,BFK,103,11,344,95,405,278,241,B
278,CFK,191,24,368,150,422,278,177,F
278,CGK,121,121,489,110,532,278,368,G
278,CHK,18,18,507,4230,4762,278,489,H
278,CK,171,8,515,180,585,278,344,C
278,DK,202,20,535,295,686,278,333,K
278,DL,133,113,648,2850,3435,278,515,D
278,L,254,141,789,5100,5786,278,535,L
278,M,4870,4870,5659,5479,11265,278,789,M
278,N,700,700,6359,90,11355,278,5659,N
278,O,1050,1050,7409,1380,12735,278,6359,O
278,N,760,760,8169,475,13210,278,7409,N
278,O,748,748,8917,900,14110,278,8169,O
278,P,11200,11200,20117,3780,17890,278,8917,P
279,AEI,213,213,213,245,245,279,0,E
279,AFI,336,336,549,300,545,279,213,F
279,AGI,627,627,1176,775,1320,279,549,G
279,AHI,225,225,1401,4020,5340,279,1176,H
279,AI,3047,1646,3047,3380,3380,279,0,I
279,AJ,595,595,3642,300,3680,279,3047,J
279,AK,543,543,4185,680,4360,279,3642,K
279,AL,210,210,4395,4020,8380,279,4185,L
279,A,4558,163,4558,6053,6053,279,0,A
279,B,257,257,4815,260,6313,279,4558,B
279,C,500,500,5315,1045,7358,279,4815,C
279,D,1643,1643,6958,600,7958,279,5315,D
279,M,71,71,7029,401,8781,279,6958,M
279,N,450,450,7479,180,8961,279,7029,N
279,O,52,52,7531,680,9641,279,7479,O
279,N,771,771,8302,145,9786,279,7531,N
279,O,327,327,8629,540,10326,279,8302,O
279,P,15856,15856,24485,2880,13206,279,8629,P
280,AE,279,279,279,735,735,280,0,A
280,BE,696,696,975,300,1035,280,279,B
280,CE,1613,638,1613,1187,1187,280,0,E
280,CF,783,145,1758,720,1755,280,975,C
280,DF,979,834,2592,1470,2657,280,1613,F
280,DG,545,545,3137,575,3232,280,2592,G
280,DH,2375,996,4133,310,2065,280,1758,D
280,H,4481,3485,7618,550,3782,280,3137,H
280,M,93,93,7711,631,4413,280,7618,M
280,N,752,752,8463,270,4683,280,7711,N
280,O,1011,1011,9474,930,5613,280,8463,O
280,P,2544,2544,12018,435,6048,280,9474,P
281,A,4604,4604,4604,7080,7080,281,0,A
281,B,2737,2737,7341,300,7380,281,4604,B
281,C,535,535,7876,645,8025,281,7341,C
281,D,2031,2031,9907,3960,11985,281,7876,D
281,M,4621,4621,14528,7613,19598,281,9907,M
281,N,326,326,14854,180,19778,281,14528,N
281,O,650,650,15504,1170,20948,281,14854,O
281,P,135,135,15639,600,21548,281,15504,P
282,AEI,1692,1692,1692,1933,1933,282,0,E
282,AFI,301,301,1993,90,2023,282,1692,F
282,AGI,490,490,2483,860,2883,282,1993,G
282,AHI,208,208,2691,3780,6663,282,2483,H
282,AI,6912,4221,6912,7036,7036,282,0,I
282,AJ,162,162,7074,90,7126,282,6912,J
282,AK,712,712,7786,1105,8231,282,7074,K
282,AL,949,949,8735,3780,12011,282,7786,L
282,A,20496,11761,20496,20680,20680,282,0,A
282,B,208,208,20704,90,20770,282,20496,B
282,C,750,750,21454,1130,21900,282,20704,C
282,D,253,253,21707,3780,25680,282,21454,D
282,M,2057,2057,23764,2298,27978,282,21707,M
282,N,318,318,24082,90,28068,282,23764,N
282,O,517,517,24599,860,28928,282,24082,O
282,P,53,53,24652,3780,32708,282,24599,P
283,A,1490,1490,1490,1390,1390,283,0,A
283,B,174,174,1664,315,1705,283,1490,B
283,C,693,693,2357,800,2505,283,1664,C
283,D,636,636,2993,1560,4065,283,2357,D
283,M,2498,2498,5491,2795,6860,283,2993,M
283,N,536,536,6027,300,7160,283,5491,N
283,O,668,668,6695,855,8015,283,6027,O
283,N,1230,1230,7925,1040,9055,283,6695,N
283,O,169,169,8094,255,9310,283,7925,O
283,P,140,140,8234,5160,14470,283,8094,P
284,AE,38,38,38,159,159,284,0,E
284,AF,184,146,184,164,164,284,0,A
284,BF,107,107,291,150,314,284,184,B
284,CF,293,40,331,240,399,284,38,F
284,CG,181,141,472,455,769,284,291,C
284,DG,847,706,1178,975,1374,284,331,G
284,DH,837,131,1309,3565,4334,284,472,D
284,H,2164,2033,3342,5040,6414,284,1178,H
284,M,123,123,3465,1209,7623,284,3342,M
284,N,1119,1119,4584,90,7713,284,3465,N
284,O,1044,1044,5628,1220,8933,284,4584,O
284,P,4,4,5632,3780,12713,284,5628,P
285,AE,2,2,2,74,74,285,0,A
285,BE,164,164,166,150,224,285,2,B
285,CE,130,130,296,130,354,285,166,C
285,BE,635,339,635,2516,2516,285,0,E
285,BF,1046,707,1342,1035,1389,285,296,B
285,CF,596,596,1938,575,1964,285,1342,C
285,DF,2101,798,2736,240,2756,285,635,F
285,DG,647,647,3383,860,3616,285,2736,G
285,DH,1529,84,3467,4230,6194,285,1938,D
285,H,1617,1533,5000,3960,7576,285,3383,H
285,M,1160,1160,6160,1260,8836,285,5000,M
285,N,387,387,6547,240,9076,285,6160,N
285,O,684,684,7231,835,9911,285,6547,O
285,N,498,498,7729,215,10126,285,7231,N
285,O,1479,1479,9208,1210,11336,285,7729,O
285,P,3600,3600,12808,3960,15296,285,9208,P
286,A,675,675,675,1182,1182,286,0,A
286,B,537,537,1212,90,1272,286,675,B
286,C,461,461,1673,820,2092,286,1212,C
286,B,1881,1881,3554,1505,3597,286,1673,B
286,C,1023,1023,4577,1240,4837,286,3554,C
286,D,1448,1448,6025,3780,8617,286,4577,D
286,M,1996,1996,8021,2909,11526,286,6025,M
286,N,945,945,8966,90,11616,286,8021,N
286,O,983,983,9949,1200,12816,286,8966,O
286,N,854,854,10803,630,13446,286,9949,N
286,O,670,670,11473,935,14381,286,10803,O
286,P,885,885,12358,3780,18161,286,11473,P
287,AE,55,55,55,80,80,287,0,A
287,BE,142,87,142,446,446,287,0,E
287,BF,114,27,169,150,230,287,55,B
287,CF,317,317,486,75,305,287,169,C
287,DF,1,1,487,2880,3185,287,486,D
287,F,408,63,550,150,596,287,142,F
287,G,587,587,1137,470,1066,287,550,G
287,F,1562,1562,2699,1690,2756,287,1137,F
287,G,189,189,2888,125,2881,287,2699,G
287,H,1275,1275,4163,4230,7111,287,2888,H
287,M,415,415,4578,840,7951,287,4163,M
287,N,609,609,5187,240,8191,287,4578,N
287,O,166,166,5353,400,8591,287,5187,O
287,N,333,333,5686,90,8681,287,5353,N
287,O,709,709,6395,809,9490,287,5686,O
287,P,20545,20545,26940,3840,13330,287,6395,P
288,A,826,826,826,900,900,288,0,A
288,B,304,304,1130,240,1140,288,826,B
288,C,691,691,1821,585,1725,288,1130,C
288,B,1624,1624,3445,1675,3400,288,1821,B
288,C,537,537,3982,905,4305,288,3445,C
288,D,346,346,4328,3960,8265,288,3982,D
288,M,1692,1692,6020,1913,10178,288,4328,M
288,N,291,291,6311,90,10268,288,6020,N
288,O,468,468,6779,860,11128,288,6311,O
288,N,409,409,7188,35,11163,288,6779,N
288,O,396,396,7584,790,11953,288,7188,O
288,P,986,986,8570,3780,15733,288,7584,P
289,A,316,316,316,873,873,289,0,A
289,B,590,590,906,90,963,289,316,B
289,C,339,339,1245,700,1663,289,906,C
289,D,178,178,1423,3780,5443,289,1245,D
289,M,405,405,1828,803,6246,289,1423,M
289,N,433,433,2261,90,6336,289,1828,N
289,O,541,541,2802,800,7136,289,2261,O
289,P,2970,2970,5772,3780,10916,289,2802,P
290,AE,217,217,217,514,514,290,0,A
290,BE,349,349,566,90,604,290,217,B
290,CE,1333,1333,1899,1865,2469,290,566,C
290,DE,4516,2617,4516,4794,4794,290,0,E
290,DF,317,317,4833,90,4884,290,4516,F
290,DG,1446,1446,6279,1935,6819,290,4833,G
290,DH,4466,86,6365,3780,6249,290,1899,D
290,H,1284,1198,7563,3780,10599,290,6279,H
290,M,1367,1367,8930,1529,12128,290,7563,M
290,N,395,395,9325,300,12428,290,8930,N
290,O,561,561,9886,765,13193,290,9325,O
290,N,1471,1471,11357,1260,14453,290,9886,N
290,O,499,499,11856,750,15203,290,11357,O
290,P,940,940,12796,3540,18743,290,11856,P
291,A,291,291,291,830,830,291,0,A
291,B,722,722,1013,240,1070,291,291,B
291,C,123,123,1136,265,1335,291,1013,C
291,D,3334,3334,4470,5070,6405,291,1136,D
291,M,34,34,4504,150,6555,291,4470,M
291,N,209,209,4713,150,6705,291,4504,N
291,O,78,78,4791,80,6785,291,4713,O
291,P,40,40,4831,2880,9665,291,4791,P
292,AEI,28,28,28,57,57,292,0,I
292,AEJ,45,17,45,150,150,292,0,E
292,AFJ,104,87,132,135,192,292,28,J
292,AFK,171,39,171,172,172,292,0,A
292,BFK,180,54,225,135,285,292,45,F
292,BGK,75,21,246,135,307,292,171,B
292,CGK,213,99,345,295,487,292,132,K
292,CGL,178,58,403,285,570,292,225,G
292,CHL,202,45,448,280,587,292,246,C
292,DHL,143,40,488,5160,5647,292,345,L
292,DH,162,77,565,5160,5730,292,403,H
292,D,1169,1052,1617,5160,5747,292,448,D
292,M,542,542,2159,955,6702,292,1617,M
292,N,564,564,2723,180,6882,292,2159,N
292,O,753,753,3476,885,7767,292,2723,O
292,P,793,793,4269,6680,14447,292,3476,P
293,A,1089,1089,1089,4386,4386,293,0,A
293,B,3495,3495,4584,240,4626,293,1089,B
293,C,926,926,5510,995,5621,293,4584,C
293,D,10189,10189,15699,3960,9581,293,5510,D
293,M,1664,1664,17363,2517,12098,293,15699,M
293,N,1083,1083,18446,240,12338,293,17363,N
293,O,1286,1286,19732,1050,13388,293,18446,O
293,N,522,522,20254,740,14128,293,19732,N
293,O,888,888,21142,1141,15269,293,20254,O
293,P,545,545,21687,3960,19229,293,21142,P
294,AE,111,111,111,285,285,294,0,A
294,BE,278,278,389,150,435,294,111,B
294,CE,161,161,550,125,560,294,389,C
294,BE,871,871,1421,890,1450,294,550,B
294,CE,356,356,1777,645,2095,294,1421,C
294,DE,2283,506,2283,2561,2561,294,0,E
294,DF,406,406,2689,180,2741,294,2283,F
294,DG,143,143,2832,210,2951,294,2689,G
294,DF,1852,797,3629,4230,6325,294,1777,D
294,F,1032,235,3864,835,3786,294,2832,F
294,G,263,263,4127,740,4526,294,3864,G
294,H,435,435,4562,4140,8666,294,4127,H
294,M,1397,1397,5959,1544,10210,294,4562,M
294,N,258,258,6217,150,10360,294,5959,N
294,O,620,620,6837,585,10945,294,6217,O
294,N,299,299,7136,340,11285,294,6837,N
294,O,592,592,7728,365,11650,294,7136,O
294,P,5546,5546,13274,4230,15880,294,7728,P
295,A,1292,1292,1292,1862,1862,295,0,A
295,B,613,613,1905,90,1952,295,1292,B
295,C,892,892,2797,1250,3202,295,1905,C
295,D,571,571,3368,3780,6982,295,2797,D
295,M,3732,3732,7100,4059,11041,295,3368,M
295,N,627,627,7727,360,11401,295,7100,N
295,O,1072,1072,8799,1000,12401,295,7727,O
295,P,5879,5879,14678,550,12951,295,8799,P
296,A,220,220,220,1215,1215,296,0,A
296,B,1178,1178,1398,240,1455,296,220,B
296,C,189,189,1587,265,1720,296,1398,C
296,D,5832,5832,7419,5460,7180,296,1587,D
296,M,37,37,7456,7,7187,296,7419,M
296,N,90,90,7546,180,7367,296,7456,N
296,O,270,270,7816,335,7702,296,7546,O
296,N,2572,2572,10388,2505,10207,296,7816,N
296,O,598,598,10986,555,10762,296,10388,O
296,P,1347,1347,12333,5100,15862,296,10986,P
297,A,162,162,162,247,247,297,0,A
297,B,173,173,335,150,397,297,162,B
297,C,871,871,1206,775,1172,297,335,C
297,D,33,33,1239,3955,5127,297,1206,D
297,M,106,106,1345,148,5275,297,1239,M
297,N,229,229,1574,240,5515,297,1345,N
297,O,390,390,1964,290,5805,297,1574,O
297,P,2003,2003,3967,5160,10965,297,1964,P
298,AE,20,20,20,84,84,298,0,A
298,BE,89,69,89,222,222,298,0,E
298,BF,152,83,172,150,234,298,20,B
298,CF,108,108,280,110,344,298,172,C
298,DF,41,41,321,2880,3224,298,280,D
298,F,239,7,328,150,372,298,89,F
298,G,156,156,484,110,482,298,328,G
298,H,29,29,513,4230,4712,298,484,H
298,M,4566,4566,5079,5582,10294,298,513,M
298,N,1046,1046,6125,90,10384,298,5079,N
298,O,809,809,6934,1200,11584,298,6125,O
298,N,1062,1062,7996,675,12259,298,6934,N
298,O,838,838,8834,945,13204,298,7996,O
298,P,1705,1705,10539,3780,16984,298,8834,P
299,AEI,40,40,40,112,112,299,0,A
299,BEI,47,7,47,68,68,299,0,E
299,BFI,219,219,266,240,308,299,47,F
299,BGI,263,37,303,240,352,299,40,B
299,CGI,722,685,988,970,1278,299,266,G
299,CHI,699,14,1002,970,1322,299,303,C
299,DHI,1063,61,1063,1311,1311,299,0,I
299,DHJ,215,154,1217,3960,5282,299,1002,D
299,HJ,271,42,1259,3960,5238,299,988,H
299,J,997,801,2060,780,2091,299,1063,J
299,K,1283,1283,3343,1434,3525,299,2060,K
299,L,834,834,4177,356,3881,299,3343,L
299,M,2068,2068,6245,2803,8085,299,4177,M
299,N,942,942,7187,240,8325,299,6245,N
299,O,953,953,8140,1030,9355,299,7187,O
299,N,1951,1951,10091,1985,11340,299,8140,N
299,O,269,269,10360,390,11730,299,10091,O
299,P,192,192,10552,3960,15690,299,10360,P
300,AE,63,63,63,184,184,300,0,A
300,BE,156,93,156,163,163,300,0,E
300,BF,102,102,258,150,313,300,156,F
300,BG,212,17,275,150,334,300,63,B
300,CG,120,103,378,385,698,300,258,G
300,CH,496,393,771,795,1129,300,275,C
300,DH,585,192,963,3160,3858,300,378,H
300,D,4503,4311,5274,3955,5084,300,771,D
300,M,1322,1322,6596,2514,7598,300,5274,M
300,N,1374,1374,7970,240,7838,300,6596,N
300,O,674,674,8644,780,8618,300,7970,O
300,P,2319,2319,10963,7680,16298,300,8644,P
301,AE,219,219,219,439,439,301,0,A
301,BE,491,272,491,1464,1464,301,0,E
301,BF,422,150,641,270,709,301,219,B
301,CF,671,671,1312,735,1444,301,641,C
301,BF,1475,654,1966,540,2004,301,491,F
301,BG,1051,397,2363,980,2424,301,1312,B
301,CG,125,125,2488,200,2624,301,2363,C
301,DG,720,198,2686,955,2959,301,1966,G
301,DF,1643,1643,4329,1515,4474,301,2686,F
301,DG,777,777,5106,708,5182,301,4329,G
301,DH,4661,2043,7149,3900,6524,301,2488,D
301,H,3206,1163,8312,402,5584,301,5106,H
301,M,1360,1360,9672,1443,7967,301,8312,M
301,N,233,233,9905,210,8177,301,9672,N
301,O,519,519,10424,450,8627,301,9905,O
301,N,36,36,10460,89,8716,301,10424,N
301,O,831,831,11291,901,9617,301,10460,O
301,N,1396,1396,12687,1325,10942,301,11291,N
301,O,633,633,13320,705,11647,301,12687,O
301,P,5417,5417,18737,5760,17407,301,13320,P
302,AE,236,236,236,902,902,302,0,E
302,AF,296,60,296,731,731,302,0,A
302,BF,846,786,1082,240,1142,302,236,F
302,BG,901,115,1197,510,1241,302,296,B
302,CG,197,82,1279,295,1437,302,1082,G
302,CF,547,465,1744,855,2096,302,1197,C
302,BF,1118,653,2397,1015,2452,302,1279,F
302,BG,732,79,2476,500,2596,302,1744,B
302,CG,177,98,2574,210,2662,302,2397,G
302,CH,227,227,2801,5700,8362,302,2574,H
302,C,1157,832,3633,1308,3904,302,2476,C
302,D,1374,1374,5007,402,4306,302,3633,D
302,M,383,383,5390,405,8767,302,5007,M
302,N,163,163,5553,240,9007,302,5390,N
302,O,1046,1046,6599,1560,10567,302,5553,O
302,N,2257,2257,8856,1676,12243,302,6599,N
302,O,802,802,9658,1314,13557,302,8856,O
302,P,900,900,10558,621,14178,302,9658,P
303,AE,278,278,278,1054,1054,303,0,A
303,BE,995,717,995,1475,1475,303,0,E
303,BF,959,242,1237,240,1294,303,278,B
303,CF,727,485,1722,300,1775,303,995,F
303,CG,742,257,1979,760,2054,303,1237,C
303,DG,821,564,2543,1050,2825,303,1722,G
303,DH,1522,1522,4065,1140,3965,303,2543,H
303,D,2503,417,4482,7680,9734,303,1979,D
303,M,7535,7535,12017,8530,18264,303,4482,M
303,N,1262,1262,13279,300,18564,303,12017,N
303,O,1295,1295,14574,1055,19619,303,13279,O
303,P,518,518,15092,1200,20819,303,14574,P
304,AE,9,9,9,437,437,304,0,A
304,BE,668,668,677,300,737,304,9,B
304,CE,831,831,1508,830,1567,304,677,C
304,BE,812,812,2320,800,2367,304,1508,B
304,CE,128,128,2448,300,2667,304,2320,C
304,DE,2,2,2450,5100,7767,304,2448,D
304,E,2468,18,2468,1629,1629,304,0,E
304,F,601,601,3069,1500,3129,304,2468,F
304,G,792,792,3861,1000,4129,304,3069,G
304,F,2451,2451,6312,2250,6379,304,3861,F
304,G,132,132,6444,290,6669,304,6312,G
304,H,19,19,6463,5100,11769,304,6444,H
304,M,426,426,6889,522,12291,304,6463,M
304,N,156,156,7045,120,12411,304,6889,N
304,O,144,144,7189,390,12801,304,7045,O
304,N,1470,1470,8659,1225,14026,304,7189,N
304,O,867,867,9526,830,14856,304,8659,O
304,P,2475,2475,12001,5400,20256,304,9526,P
305,AE,455,455,455,1460,1460,305,0,E
305,AF,1035,1035,1490,90,1550,305,455,F
305,AG,1047,1047,2537,1210,2760,305,1490,G
305,AF,564,564,3101,375,3135,305,2537,F
305,AG,812,812,3913,945,4080,305,3101,G
305,AH,1300,1300,5213,3780,7860,305,3913,H
305,A,8423,3210,8423,10241,10241,305,0,A
305,B,1848,1848,10271,90,10331,305,8423,B
305,C,1322,1322,11593,1345,11676,305,10271,C
305,B,216,216,11809,185,11861,305,11593,B
305,C,546,546,12355,955,12816,305,11809,C
305,D,776,776,13131,3780,16596,305,12355,D
305,M,2073,2073,15204,2924,19520,305,13131,M
305,N,1070,1070,16274,90,19610,305,15204,N
305,O,639,639,16913,665,20275,305,16274,O
305,P,335,335,17248,3780,24055,305,16913,P
306,AEI,232,232,232,967,967,306,0,I
306,AEJ,255,23,255,1245,1245,306,0,E
306,AFJ,320,65,320,221,221,306,0,A
306,BFJ,144,144,464,240,461,306,320,B
306,CFJ,1115,883,1347,420,1387,306,232,J
306,CFK,1180,88,1435,240,1485,306,255,F
306,CGK,881,881,2316,1020,2505,306,1435,G
306,CHK,1012,43,2359,1240,2627,306,1347,K
306,CHL,2,2,2361,335,2962,306,2359,L
306,CH,346,301,2662,4680,7185,306,2316,H
306,C,4044,1846,4508,1590,2051,306,464,C
306,B,2771,2771,7279,3840,5891,306,4508,B
306,C,831,831,8110,935,6826,306,7279,C
306,D,1,1,8111,3960,10786,306,8110,D
306,M,4902,4902,13013,5025,15811,306,8111,M
306,N,258,258,13271,180,15991,306,13013,N
306,O,2024,2024,15295,880,16871,306,13271,O
306,P,1429,1429,16724,6660,23531,306,15295,P
307,AE,2,2,2,214,214,307,0,A
307,BE,286,284,286,580,580,307,0,E
307,BF,301,17,303,135,349,307,2,B
307,CF,185,185,488,285,634,307,303,C
307,DF,304,102,590,120,700,307,286,F
307,DG,116,116,706,90,790,307,590,G
307,DF,321,103,809,5160,5794,307,488,D
307,F,622,519,1328,590,1380,307,706,F
307,G,196,196,1524,295,1675,307,1328,G
307,H,172,172,1696,5160,6835,307,1524,H
307,M,1139,1139,2835,1796,8631,307,1696,M
307,N,689,689,3524,90,8721,307,2835,N
307,O,893,893,4417,1240,9961,307,3524,O
307,P,66,66,4483,3780,13741,307,4417,P
308,AE,200,200,200,902,902,308,0,A
308,BE,889,889,1089,240,1142,308,200,B
308,CE,52,52,1141,415,1557,308,1089,C
308,DE,3050,1909,3050,3510,3510,308,0,E
308,DF,581,581,3631,180,3690,308,3050,F
308,DG,1360,1360,4991,715,4405,308,3631,G
308,DF,104,104,5095,735,5140,308,4991,F
308,DG,441,441,5536,715,5855,308,5095,G
308,DH,2115,2115,7651,6840,12695,308,5536,H
308,D,35042,28532,36183,6060,7617,308,1141,D
308,M,2296,2296,38479,3166,15861,308,36183,M
308,N,1057,1057,39536,240,16101,308,38479,N
308,O,258,258,39794,420,16521,308,39536,O
308,N,822,822,40616,650,17171,308,39794,N
308,O,257,257,40873,495,17666,308,40616,O
308,P,2443,2443,43316,3960,21626,308,40873,P
309,AEI,50,50,50,1566,1566,309,0,A
309,BEI,204,154,204,1246,1246,309,0,E
309,BFI,268,64,268,1174,1174,309,0,I
309,BFJ,1099,1099,1367,240,1414,309,268,J
309,BFK,1277,114,1481,240,1486,309,204,F
309,BGK,191,77,1558,265,1679,309,1367,K
309,BGL,188,111,1669,265,1751,309,1481,G
309,BHL,1759,140,1809,240,1806,309,50,B
309,CHL,907,907,2716,1180,2986,309,1809,C
309,BHL,2970,2970,5686,2800,5786,309,2716,B
309,CHL,2768,2768,8454,2826,8612,309,5686,C
309,DHL,5,5,8459,384,8996,309,8454,D
309,HL,7125,224,8683,5460,7139,309,1558,L
309,H,7122,108,8791,5460,7211,309,1669,H
309,M,1171,1171,9962,1265,10261,309,8791,M
309,N,211,211,10173,180,10441,309,9962,N
309,O,196,196,10369,335,10776,309,10173,O
309,N,1429,1429,11798,1285,12061,309,10369,N
309,O,2263,2263,14061,385,12446,309,11798,O
309,P,391,391,14452,6365,18811,309,14061,P
310,A,2769,2769,2769,3742,3742,310,0,A
310,B,1233,1233,4002,300,4042,310,2769,B
310,C,1080,1080,5082,1050,5092,310,4002,C
310,B,605,605,5687,720,5812,310,5082,B
310,C,581,581,6268,780,6592,310,5687,C
310,D,2021,2021,8289,3960,10552,310,6268,D
310,M,2288,2288,10577,2208,12760,310,8289,M
310,N,215,215,10792,330,13090,310,10577,N
310,O,776,776,11568,942,14032,310,10792,O
310,P,6060,6060,17628,348,14380,310,11568,P
311,A,239,239,239,440,440,311,0,A
311,B,367,367,606,90,530,311,239,B
311,C,690,690,1296,1040,1570,311,606,C
311,D,710,710,2006,3780,5350,311,1296,D
311,M,4406,4406,6412,4720,10070,311,2006,M
311,N,861,861,7273,90,10160,311,6412,N
311,O,500,500,7773,875,11035,311,7273,O
311,P,2373,2373,10146,3780,14815,311,7773,P
312,AEI,107,107,107,1087,1087,312,0,E
312,AFI,344,237,344,1010,1010,312,0,I
312,AFJ,753,753,1097,150,1160,312,344,J
312,AFK,65,65,1162,350,1510,312,1097,K
312,AFL,1100,45,1207,180,1267,312,107,F
312,AGL,246,201,1408,2880,4390,312,1162,L
312,AG,1519,111,1519,1937,1937,312,0,A
312,BG,450,450,1969,90,2027,312,1519,B
312,CG,998,236,2205,1055,2322,312,1207,G
312,CH,829,593,2798,1240,3267,312,1969,C
312,DH,94,94,2892,3780,7047,312,2798,D
312,H,730,43,2935,6460,8782,312,2205,H
312,M,354,354,3289,1429,10211,312,2935,M
312,N,1105,1105,4394,90,10301,312,3289,N
312,O,985,985,5379,1210,11511,312,4394,O
312,P,22,22,5401,3780,15291,312,5379,P
313,A,38,38,38,790,790,313,0,A
313,B,867,867,905,180,970,313,38,B
313,C,162,162,1067,390,1360,313,905,C
313,D,231,231,1298,5295,6655,313,1067,D
313,M,124,124,1422,1193,7848,313,1298,M
313,N,1255,1255,2677,240,8088,313,1422,N
313,O,875,875,3552,995,9083,313,2677,O
313,P,7,7,3559,4680,13763,313,3552,P
314,AE,61,61,61,92,92,314,0,E
314,AF,116,116,177,135,227,314,61,F
314,AG,234,57,234,552,552,314,0,A
314,BG,234,177,411,295,522,314,177,G
314,BH,128,128,539,5160,5682,314,411,H
314,B,328,23,562,120,672,314,234,B
314,C,84,84,646,90,762,314,562,C
314,B,646,646,1292,585,1347,314,646,B
314,C,204,204,1496,290,1637,314,1292,C
314,D,182,182,1678,5160,6797,314,1496,D
314,M,799,799,2477,1170,7967,314,1678,M
314,N,624,624,3101,300,8267,314,2477,N
314,O,621,621,3722,725,8992,314,3101,O
314,P,670,670,4392,3960,12952,314,3722,P
315,A,181,181,181,219,219,315,0,A
315,B,139,139,320,155,374,315,181,B
315,C,109,109,429,100,474,315,320,C
315,D,44,44,473,2880,3354,315,429,D
315,M,244,244,717,779,4133,315,473,M
315,N,663,663,1380,180,4313,315,717,N
315,O,140,140,1520,205,4518,315,1380,O
315,N,771,771,2291,690,5208,315,1520,N
315,O,688,688,2979,845,6053,315,2291,O
315,P,477,477,3456,4140,10193,315,2979,P
316,A,358,358,358,4138,4138,316,0,A
316,B,3971,3971,4329,240,4378,316,358,B
316,C,899,899,5228,1020,5398,316,4329,C
316,D,181,181,5409,4680,10078,316,5228,D
316,M,836,836,6245,920,10998,316,5409,M
316,N,244,244,6489,180,11178,316,6245,N
316,O,1004,1004,7493,930,12108,316,6489,O
316,P,5842,5842,13335,550,12658,316,7493,P
317,A,82,82,82,292,292,317,0,A
317,B,387,387,469,240,532,317,82,B
317,C,255,255,724,195,727,317,469,C
317,D,672,672,1396,5220,5947,317,724,D
317,M,2037,2037,3433,3172,9119,317,1396,M
317,N,1183,1183,4616,90,9209,317,3433,N
317,O,1129,1129,5745,1375,10584,317,4616,O
317,N,2869,2869,8614,1280,11864,317,5745,N
317,O,44,44,8658,730,12594,317,8614,O
317,P,3541,3541,12199,3780,16374,317,8658,P
318,AEI,189,189,189,975,975,318,0,A
318,BEI,1049,1049,1238,300,1275,318,189,B
318,CEI,854,854,2092,895,2170,318,1238,C
318,DEI,3120,1028,3120,3315,3315,318,0,I
318,DEJ,1078,50,3170,2040,4210,318,2092,D
318,EJ,462,412,3582,300,3615,318,3120,J
318,EK,809,809,4391,1015,4630,318,3582,K
318,EL,2889,2889,7280,2820,7450,318,4391,L
318,E,13548,6268,13548,13620,13620,318,0,E
318,F,399,399,13947,360,13980,318,13548,F
318,G,832,832,14779,845,14825,318,13947,G
318,H,51,51,14830,1590,16415,318,14779,H
318,M,306,306,15136,3584,19999,318,14830,M
318,N,3282,3282,18418,90,20089,318,15136,N
318,O,746,746,19164,1040,21129,318,18418,O
318,P,541,541,19705,3780,24909,318,19164,P
319,AEI,140,140,140,215,215,319,0,I
319,AEJ,157,17,157,672,672,319,0,E
319,AFJ,236,79,236,1373,1373,319,0,A
319,BFJ,175,79,315,150,365,319,140,J
319,BFK,693,535,850,240,912,319,157,F
319,BGK,587,52,902,620,985,319,315,K
319,BGL,195,143,1045,225,1137,319,850,G
319,BHL,124,124,1169,4890,6027,319,1045,H
319,BL,1268,335,1504,150,1523,319,236,B
319,CL,808,206,1710,4200,5185,319,902,L
319,C,688,482,2192,730,2253,319,1504,C
319,D,1044,1044,3236,4200,6453,319,2192,D
319,M,1982,1982,5218,5819,12272,319,3236,M
319,N,3877,3877,9095,90,12362,319,5218,N
319,O,998,998,10093,1220,13582,319,9095,O
319,P,4617,4617,14710,3780,17362,319,10093,P
320,AEI,132,132,132,69,69,320,0,I
320,AEJ,70,70,202,180,249,320,132,J
320,AEK,262,60,262,1205,1205,320,0,A
320,BEK,121,61,323,220,469,320,202,K
320,BEJ,911,911,1234,810,1279,320,323,J
320,BEK,987,15,1249,90,1295,320,262,B
320,CEK,345,330,1579,740,2019,320,1234,K
320,CEL,1757,178,1757,2607,2607,320,0,E
320,CFL,532,24,1781,880,2175,320,1249,C
320,BFL,478,478,2259,110,2285,320,1781,B
320,CFL,877,375,2634,90,2697,320,1757,F
320,CGL,546,546,3180,905,3602,320,2634,G
320,CFL,1958,357,3537,4140,6159,320,1579,L
320,CF,451,94,3631,90,3692,320,3180,F
320,CG,1410,38,3669,2315,4600,320,2259,C
320,DG,1517,1479,5148,2320,6012,320,3631,G
320,DH,1640,1640,6788,3420,9432,320,5148,H
320,D,26069,22950,29738,3420,8020,320,3669,D
320,M,1340,1340,31078,1450,10882,320,29738,M
320,N,238,238,31316,180,11062,320,31078,N
320,O,756,756,32072,670,11732,320,31316,O
320,P,1441,1441,33513,4140,15872,320,32072,P
321,AE,53,53,53,209,209,321,0,E
321,AF,116,116,169,150,359,321,53,F
321,AG,324,324,493,490,849,321,169,G
321,AH,596,103,596,1605,1605,321,0,A
321,BH,537,434,1030,720,1569,321,493,H
321,B,1264,830,1860,300,1905,321,596,B
321,C,652,652,2512,805,2710,321,1860,C
321,D,3117,3117,5629,2940,5650,321,2512,D
321,M,4384,4384,10013,5360,11010,321,5629,M
321,N,1263,1263,11276,240,11250,321,10013,N
321,O,944,944,12220,1255,12505,321,11276,O
321,P,111,111,12331,3960,16465,321,12220,P
322,A,29,29,29,108,108,322,0,A
322,B,256,256,285,240,348,322,29,B
322,C,736,736,1021,975,1323,322,285,C
322,D,840,840,1861,5040,6363,322,1021,D
322,M,52,52,1913,692,7055,322,1861,M
322,N,821,821,2734,240,7295,322,1913,N
322,O,125,125,2859,290,7585,322,2734,O
322,P,77,77,2936,5100,12685,322,2859,P
323,AE,726,726,726,882,882,323,0,A
323,BE,244,244,970,90,972,323,726,B
323,CE,985,15,985,1756,1756,323,0,E
323,CF,680,665,1650,815,1787,323,970,C
323,DF,796,131,1781,90,1846,323,985,F
323,DG,882,882,2663,1250,3096,323,1781,G
323,DH,1025,12,2675,3780,5567,323,1650,D
323,H,585,573,3248,3780,6876,323,2663,H
323,M,546,546,3794,967,7843,323,3248,M
323,N,463,463,4257,90,7933,323,3794,N
323,O,207,207,4464,625,8558,323,4257,O
323,P,1811,1811,6275,3780,12338,323,4464,P
324,AE,970,970,970,1494,1494,324,0,A
324,BE,1320,350,1320,1388,1388,324,0,E
324,BF,368,368,1688,360,1748,324,1320,F
324,BG,731,13,1701,290,1784,324,970,B
324,CG,643,643,2344,555,2339,324,1701,C
324,DG,883,227,2571,700,2448,324,1688,G
324,DH,2088,2088,4659,550,2998,324,2571,H
324,D,3030,715,5374,550,2889,324,2344,D
324,M,488,488,5862,1017,4015,324,5374,M
324,N,636,636,6498,150,4165,324,5862,N
324,O,67,67,6565,50,4215,324,6498,O
324,N,742,742,7307,775,4990,324,6565,N
324,O,697,697,8004,810,5800,324,7307,O
324,P,5923,5923,13927,5040,10840,324,8004,P
325,AE,42,42,42,124,124,325,0,E
325,AF,219,177,219,263,263,325,0,A
325,BF,279,102,321,240,364,325,42,F
325,BG,144,42,363,150,413,325,219,B
325,CG,206,206,569,130,543,325,363,C
325,BG,595,347,916,925,1289,325,321,G
325,BH,194,194,1110,3960,5249,325,916,H
325,B,1409,868,1978,1350,1893,325,569,B
325,C,585,585,2563,635,2528,325,1978,C
325,D,150,150,2713,4230,6758,325,2563,D
325,M,1817,1817,4530,2237,8995,325,2713,M
325,N,464,464,4994,90,9085,325,4530,N
325,O,813,813,5807,885,9970,325,4994,O
325,N,1182,1182,6989,1125,11095,325,5807,N
325,O,858,858,7847,1080,12175,325,6989,O
325,P,24,24,7871,3780,15955,325,7847,P
326,AEI,3,3,3,1460,1460,326,0,A
326,BEI,528,525,528,915,915,326,0,I
326,BEJ,504,504,1032,150,1065,326,528,J
326,BEK,534,534,1566,596,1661,326,1032,K
326,BEL,1848,285,1851,480,1940,326,3,B
326,CEL,696,411,2262,794,2455,326,1566,L
326,CE,746,335,2597,990,2930,326,1851,C
326,BE,1255,1255,3852,965,3895,326,2597,B
326,CE,717,717,4569,835,4730,326,3852,C
326,DE,5690,1121,5690,6960,6960,326,0,E
326,DF,1717,596,6286,350,5080,326,4569,D
326,F,2400,1804,8090,1190,8150,326,5690,F
326,G,806,806,8896,1065,9215,326,8090,G
326,F,1153,1153,10049,720,9935,326,8896,F
326,G,703,703,10752,1310,11245,326,10049,G
326,H,3275,3275,14027,1175,12420,326,10752,H
326,M,1630,1630,15657,1783,14203,326,14027,M
326,N,612,612,16269,540,14743,326,15657,N
326,O,861,861,17130,790,15533,326,16269,O
326,P,373,373,17503,550,16083,326,17130,P
327,A,4634,4634,4634,4983,4983,327,0,A
327,B,530,530,5164,240,5223,327,4634,B
327,C,136,136,5300,390,5613,327,5164,C
327,B,564,564,5864,280,5893,327,5300,B
327,C,725,725,6589,935,6828,327,5864,C
327,D,13072,13072,19661,3960,10788,327,6589,D
327,M,3691,3691,23352,3979,14767,327,19661,M
327,N,661,661,24013,90,14857,327,23352,N
327,O,554,554,24567,815,15672,327,24013,O
327,N,1149,1149,25716,1045,16717,327,24567,N
327,O,690,690,26406,935,17652,327,25716,O
327,P,728,728,27134,3780,21432,327,26406,P
328,AEI,28,28,28,235,235,328,0,E
328,AFI,327,327,355,180,415,328,28,F
328,AGI,395,40,395,395,395,328,0,I
328,AGJ,120,120,515,180,575,328,395,J
328,AGK,570,55,570,645,645,328,0,A
328,BGK,276,61,631,660,1075,328,355,G
328,BFK,195,134,765,180,825,328,570,B
328,CFK,258,8,773,660,1235,328,515,K
328,CFJ,280,272,1045,840,1665,328,765,C
328,BFJ,1116,844,1889,690,1925,328,773,J
328,BFK,756,756,2645,825,2750,328,1889,K
328,BFL,76,76,2721,3000,5750,328,2645,L
328,BF,2510,420,3141,2110,3185,328,631,F
328,BG,2553,457,3598,1930,3595,328,1045,B
328,CG,759,302,3900,830,4015,328,3141,G
328,CH,173,173,4073,2940,6955,328,3900,H
328,C,782,307,4380,830,4425,328,3598,C
328,D,51,51,4431,2940,7365,328,4380,D
328,M,1378,1378,5809,1345,8710,328,4431,M
328,N,230,230,6039,300,9010,328,5809,N
328,O,566,566,6605,750,9760,328,6039,O
328,N,323,323,6928,155,9915,328,6605,N
328,O,439,439,7367,415,10330,328,6928,O
328,P,7451,7451,14818,1140,11470,328,7367,P
329,AE,42,42,42,99,99,329,0,E
329,AF,143,143,185,150,249,329,42,F
329,AG,61,61,246,80,329,329,185,G
329,AH,1893,1647,1893,2201,2201,329,0,A
329,BH,359,359,2252,90,2291,329,1893,B
329,CH,1038,1038,3290,1240,3531,329,2252,C
329,DH,2758,2758,6048,3780,7311,329,3290,D
329,H,15543,9741,15789,2880,3209,329,246,H
329,M,314,314,16103,863,8174,329,15789,M
329,N,650,650,16753,150,8324,329,16103,N
329,O,137,137,16890,115,8439,329,16753,O
329,N,513,513,17403,535,8974,329,16890,N
329,O,137,137,17540,665,9639,329,17403,O
329,P,4096,4096,21636,4140,13779,329,17540,P
330,AE,3426,3426,3426,3757,3757,330,0,E
330,AF,704,704,4130,90,3847,330,3426,F
330,AG,525,525,4655,815,4662,330,4130,G
330,AF,8086,3431,8086,8343,8343,330,0,A
330,BF,3646,215,8301,3695,8357,330,4655,F
330,BG,293,78,8379,90,8433,330,8086,B
330,CG,571,571,8950,815,9248,330,8379,C
330,BG,1346,697,9647,1840,10197,330,8301,G
330,BH,1069,372,10019,825,10073,330,8950,B
330,CH,1118,746,10765,3780,13977,330,9647,H
330,C,1346,600,11365,1840,11913,330,10019,C
330,D,1239,1239,12604,3780,15693,330,11365,D
330,M,1560,1560,14164,1490,17183,330,12604,M
330,N,193,193,14357,300,17483,330,14164,N
330,O,198,198,14555,770,18253,330,14357,O
330,N,606,606,15161,45,18298,330,14555,N
330,O,429,429,15590,2895,21193,330,15161,O
330,P,2454,2454,18044,1575,22768,330,15590,P
331,AEI,287,287,287,427,427,331,0,A
331,BEI,173,173,460,90,517,331,287,B
331,CEI,407,407,867,690,1207,331,460,C
331,BEI,334,334,1201,45,1252,331,867,B
331,CEI,507,507,1708,735,1987,331,1201,C
331,DEI,265,265,1973,3780,5767,331,1708,D
331,EI,2226,253,2226,2379,2379,331,0,I
331,EJ,222,222,2448,90,2469,331,2226,J
331,EK,589,589,3037,815,3284,331,2448,K
331,EJ,1668,1668,4705,1475,4759,331,3037,J
331,EK,438,438,5143,740,5499,331,4705,K
331,EL,912,912,6055,3780,9279,331,5143,L
331,E,6922,867,6922,9303,9303,331,0,E
331,F,2402,2402,9324,90,9393,331,6922,F
331,G,1448,1448,10772,1680,11073,331,9324,G
331,H,515,515,11287,3780,14853,331,10772,H
331,M,342,342,11629,651,15504,331,11287,M
331,N,339,339,11968,90,15594,331,11629,N
331,O,633,633,12601,625,16219,331,11968,O
331,P,589,589,13190,550,16769,331,12601,P
332,AEI,70,70,70,85,85,332,0,E
332,AFI,92,22,92,675,675,332,0,A
332,BFI,88,66,158,135,220,332,70,F
332,BGI,230,230,388,380,600,332,158,G
332,BHI,700,312,700,700,700,332,0,I
332,BHJ,120,120,820,180,880,332,700,J
332,BHK,764,36,856,240,915,332,92,B
332,CHK,250,250,1106,385,1300,332,856,C
332,DHK,967,249,1355,5460,6060,332,388,H
332,DK,790,255,1610,660,1540,332,820,K
332,DJ,334,334,1944,450,1990,332,1610,J
332,DK,776,776,2720,805,2795,332,1944,K
332,DL,80,80,2800,1260,4055,332,2720,L
332,D,2695,1001,3801,5460,6760,332,1106,D
332,M,1227,1227,5028,2251,9011,332,3801,M
332,N,1288,1288,6316,300,9311,332,5028,N
332,O,638,638,6954,765,10076,332,6316,O
332,P,54582,54582,61536,4080,14156,332,6954,P
333,AE,55,55,55,132,132,333,0,A
333,BE,60,5,60,1227,1227,333,0,E
333,BF,166,161,221,150,282,333,55,B
333,CF,172,172,393,455,737,333,221,C
333,DF,876,876,1269,3565,4302,333,393,D
333,F,1360,151,1420,180,1407,333,60,F
333,G,382,382,1802,545,1952,333,1420,G
333,H,5345,5345,7147,5400,7352,333,1802,H
333,M,105,105,7252,1180,8532,333,7147,M
333,N,1105,1105,8357,90,8622,333,7252,N
333,O,977,977,9334,1220,9842,333,8357,O
333,P,31,31,9365,3780,13622,333,9334,P
334,A,154,154,154,863,863,334,0,A
334,B,893,893,1047,240,1103,334,154,B
334,C,134,134,1181,270,1373,334,1047,C
334,B,503,503,1684,370,1743,334,1181,B
334,C,201,201,1885,290,2033,334,1684,C
334,D,2917,2917,4802,5160,7193,334,1885,D
334,M,562,562,5364,654,7847,334,4802,M
334,N,195,195,5559,150,7997,334,5364,N
334,O,35,35,5594,115,8112,334,5559,O
334,N,277,277,5871,210,8322,334,5594,N
334,O,204,204,6075,225,8547,334,5871,O
334,P,1444,1444,7519,4740,13287,334,6075,P
335,A,3910,3910,3910,4763,4763,335,0,A
335,B,883,883,4793,90,4853,335,3910,B
335,C,170,170,4963,535,5388,335,4793,C
335,D,1315,1315,6278,3780,9168,335,4963,D
335,M,285,285,6563,328,9496,335,6278,M
335,N,144,144,6707,150,9646,335,6563,N
335,O,1006,1006,7713,965,10611,335,6707,O
335,P,1050,1050,8763,385,10996,335,7713,P
336,AE,281,281,281,404,404,336,0,A
336,BE,323,323,604,240,644,336,281,B
336,CE,149,149,753,150,794,336,604,C
336,DE,2799,2046,2799,3746,3746,336,0,E
336,DF,1207,1207,4006,300,4046,336,2799,F
336,DG,1080,1080,5086,1050,5096,336,4006,G
336,DF,605,605,5691,720,5816,336,5086,F
336,DG,5343,405,6096,550,1344,336,753,D
336,G,581,176,6272,780,6596,336,5691,G
336,H,2021,2021,8293,3960,10556,336,6272,H
336,M,172,172,8465,207,10763,336,8293,M
336,N,394,394,8859,420,11183,336,8465,N
336,O,424,424,9283,790,11973,336,8859,O
336,P,1791,1791,11074,1265,13238,336,9283,P
337,A,423,423,423,1305,1305,337,0,A
337,B,96,96,519,155,1460,337,423,B
337,C,176,176,695,90,1550,337,519,C
337,D,746,746,1441,2880,4430,337,695,D
337,M,1115,1115,2556,1235,5665,337,1441,M
337,N,219,219,2775,150,5815,337,2556,N
337,O,144,144,2919,150,5965,337,2775,O
337,N,1241,1241,4160,1215,7180,337,2919,N
337,O,642,642,4802,705,7885,337,4160,O
337,P,6982,6982,11784,4230,12115,337,4802,P
338,AE,1030,1030,1030,1378,1378,338,0,A
338,BE,412,412,1442,90,1468,338,1030,B
338,CE,1537,95,1537,2377,2377,338,0,E
338,CF,883,788,2325,1250,2718,338,1442,C
338,DF,45,45,2370,3780,6498,338,2325,D
338,F,928,95,2465,150,2527,338,1537,F
338,G,202,202,2667,435,2962,338,2465,G
338,F,733,733,3400,460,3422,338,2667,F
338,G,798,798,4198,765,4187,338,3400,G
338,H,273,273,4471,4230,8417,338,4198,H
338,M,2484,2484,6955,3188,11605,338,4471,M
338,N,732,732,7687,90,11695,338,6955,N
338,O,786,786,8473,1240,12935,338,7687,O
338,P,193,193,8666,3780,16715,338,8473,P
339,AE,339,339,339,639,639,339,0,E
339,AF,587,248,587,519,519,339,0,A
339,BF,116,116,703,240,759,339,587,B
339,CF,620,256,959,360,999,339,339,F
339,CG,552,296,1255,630,1389,339,703,C
339,BG,125,125,1380,50,1439,339,1255,B
339,CG,584,163,1543,750,1749,339,959,G
339,CH,579,416,1959,730,2169,339,1380,C
339,DH,385,385,2344,4140,6309,339,1959,D
339,H,1766,965,3309,1140,2889,339,1543,H
339,M,1207,1207,4516,1543,7852,339,3309,M
339,N,575,575,5091,300,8152,339,4516,N
339,O,684,684,5775,825,8977,339,5091,O
339,N,1198,1198,6973,1045,10022,339,5775,N
339,O,555,555,7528,760,10782,339,6973,O
339,P,8541,8541,16069,5160,15942,339,7528,P
340,A,41,41,41,5,5,340,0,A
340,B,227,227,268,300,305,340,41,B
340,C,825,825,1093,1005,1310,340,268,C
340,D,771,771,1864,1200,2510,340,1093,D
340,M,845,845,2709,1550,4060,340,1864,M
340,N,957,957,3666,300,4360,340,2709,N
340,O,1338,1338,5004,1220,5580,340,3666,O
340,N,117,117,5121,235,5815,340,5004,N
340,O,345,345,5466,535,6350,340,5121,O
340,N,3168,3168,8634,2975,9325,340,5466,N
340,O,652,652,9286,870,10195,340,8634,O
340,P,318,318,9604,1620,11815,340,9286,P
341,AE,65,65,65,149,149,341,0,A
341,BE,154,154,219,135,284,341,65,B
341,CE,580,580,799,390,674,341,219,C
341,DE,247,247,1046,8990,9664,341,799,D
341,E,2953,1907,2953,3751,3751,341,0,E
341,F,978,978,3931,240,3991,341,2953,F
341,G,796,796,4727,1030,5021,341,3931,G
341,F,1057,1057,5784,810,5831,341,4727,F
341,G,132,132,5916,380,6211,341,5784,G
341,H,146,146,6062,3960,10171,341,5916,H
341,M,259,259,6321,771,10942,341,6062,M
341,N,708,708,7029,240,11182,341,6321,N
341,O,113,113,7142,385,11567,341,7029,O
341,N,453,453,7595,180,11747,341,7142,N
341,O,521,521,8116,750,12497,341,7595,O
341,P,100,100,8216,3960,16457,341,8116,P
342,AEI,75,75,75,419,419,342,0,I
342,AEJ,89,14,89,242,242,342,0,A
342,BEJ,577,563,652,300,719,342,75,J
342,BEK,1110,458,1110,1433,1433,342,0,E
342,BFK,725,267,1377,825,1544,342,652,K
342,BFJ,555,288,1665,300,1733,342,1110,F
342,BGJ,1593,17,1682,1500,1742,342,89,B
342,CGJ,769,752,2434,820,2553,342,1665,G
342,CFJ,1120,63,2497,1035,2579,342,1377,J
342,CFK,885,70,2567,1000,2742,342,1682,C
342,BFK,368,298,2865,540,3119,342,2497,K
342,BFL,1330,899,3764,1265,3818,342,2434,F
342,BGL,35,35,3799,180,3998,342,3764,G
342,BHL,1394,460,4259,5280,8399,342,2865,L
342,BH,1743,51,4310,1510,4252,342,2567,B
342,CH,1503,992,5302,5280,9278,342,3799,H
342,C,1373,381,5683,400,4652,342,4310,C
342,D,1228,1228,6911,5280,9932,342,5683,D
342,M,326,326,7237,359,10291,342,6911,M
342,N,118,118,7355,150,10441,342,7237,N
342,O,898,898,8253,765,11206,342,7355,O
342,N,494,494,8747,605,11811,342,8253,N
342,O,1022,1022,9769,1055,12866,342,8747,O
342,P,850,850,10619,350,13216,342,9769,P
343,AE,2,2,2,245,245,343,0,E
343,AF,138,136,138,205,205,343,0,A
343,BF,121,121,259,120,325,343,138,B
343,CF,194,194,453,210,535,343,259,C
343,DF,631,180,633,300,545,343,2,F
343,DG,509,509,1142,695,1240,343,633,G
343,DH,258,258,1400,3960,5200,343,1142,H
343,D,960,13,1413,2880,3415,343,453,D
343,M,176,176,1589,953,6153,343,1413,M
343,N,928,928,2517,180,6333,343,1589,N
343,O,670,670,3187,885,7218,343,2517,O
343,P,794,794,3981,6680,13898,343,3187,P
344,AEI,70,70,70,718,718,344,0,E
344,AFI,203,133,203,220,220,344,0,A
344,BFI,302,302,505,300,520,344,203,B
344,CFI,895,460,965,270,988,344,70,F
344,CGI,530,70,1035,890,1410,344,505,C
344,BGI,1651,616,1651,3146,3146,344,0,I
344,BGJ,804,188,1839,480,1890,344,1035,B
344,CGJ,1010,136,1975,1042,2030,344,965,G
344,CHJ,3,3,1978,333,2363,344,1975,H
344,CJ,833,694,2672,1005,2895,344,1839,C
344,DJ,611,611,3283,1200,4095,344,2672,D
344,J,2079,447,3730,630,3776,344,1651,J
344,K,847,847,4577,825,4601,344,3730,K
344,J,844,844,5421,730,5331,344,4577,J
344,K,780,780,6201,947,6278,344,5421,K
344,L,209,209,6410,348,6626,344,6201,L
344,M,8285,8285,14695,8765,15391,344,6410,M
344,N,718,718,15413,300,15691,344,14695,N
344,O,952,952,16365,1045,16736,344,15413,O
344,N,951,951,17316,795,17531,344,16365,N
344,O,300,300,17616,415,17946,344,17316,O
344,N,1499,1499,19115,1070,19016,344,17616,N
344,O,251,251,19366,1400,20416,344,19115,O
344,P,9339,9339,28705,3030,23446,344,19366,P
345,AEI,112,112,112,1287,1287,345,0,A
345,BEI,404,292,404,1041,1041,345,0,E
345,BFI,674,674,1078,90,1131,345,404,F
345,BGI,1381,415,1493,240,1527,345,112,B
345,CGI,532,117,1610,860,1991,345,1078,G
345,CHI,36,36,1646,3780,5771,345,1610,H
345,CI,642,489,2135,749,2276,345,1493,C
345,DI,2807,672,2807,3257,3257,345,0,I
345,DJ,788,788,3595,240,3497,345,2807,J
345,DK,1845,385,3980,411,2687,345,2135,D
345,K,1160,775,4755,1005,4502,345,3595,K
345,J,2691,2691,7446,2980,7482,345,4755,J
345,K,631,631,8077,925,8407,345,7446,K
345,L,385,385,8462,3960,12367,345,8077,L
345,M,377,377,8839,519,12886,345,8462,M
345,N,187,187,9026,90,12976,345,8839,N
345,O,516,516,9542,870,13846,345,9026,O
345,N,1240,1240,10782,850,14696,345,9542,N
345,O,923,923,11705,1340,16036,345,10782,O
345,P,225,225,11930,3780,19816,345,11705,P
346,A,96,96,96,86,86,346,0,A
346,B,195,195,291,240,326,346,96,B
346,C,82,82,373,115,441,346,291,C
346,D,64,64,437,4230,4671,346,373,D
346,M,77,77,514,140,4811,346,437,M
346,N,141,141,655,135,4946,346,514,N
346,O,188,188,843,285,5231,346,655,O
346,P,128,128,971,5160,10391,346,843,P
347,A,393,393,393,1340,1340,347,0,A
347,B,1455,1455,1848,540,1880,347,393,B
347,C,757,757,2605,975,2855,347,1848,C
347,B,1811,1811,4416,1660,4515,347,2605,B
347,C,583,583,4999,565,5080,347,4416,C
347,D,275,275,5274,400,5480,347,4999,D
347,M,1416,1416,6690,2001,7481,347,5274,M
347,N,1395,1395,8085,900,8381,347,6690,N
347,O,485,485,8570,630,9011,347,8085,O
347,N,1229,1229,9799,1055,10066,347,8570,N
347,O,1074,1074,10873,1206,11272,347,9799,O
347,P,208,208,11081,414,11686,347,10873,P
348,AEI,416,416,416,678,678,348,0,I
348,AEJ,298,298,714,90,768,348,416,J
348,AEK,1872,1158,1872,2306,2306,348,0,A
348,BEK,2010,138,2010,2792,2792,348,0,E
348,BFK,1413,117,2127,1935,2703,348,714,K
348,BFL,686,431,2558,300,2606,348,1872,B
348,CFL,542,542,3100,710,3316,348,2558,C
348,CFL,1090,0,3100,300,3092,348,2010,F
348,DGL,672,672,3772,695,3787,348,3100,G
348,DHL,1971,326,4098,3780,6483,348,2127,L
348,DH,8554,7556,11654,4080,7396,348,3100,D
348,H,12686,4804,16458,4080,7867,348,3772,H
348,M,113,113,16571,1727,9594,348,16458,M
348,N,1643,1643,18214,90,9684,348,16571,N
348,O,1450,1450,19664,1780,11464,348,18214,O
348,P,85,85,19749,3780,15244,348,19664,P
349,A,227,227,227,1004,1004,349,0,A
349,B,1067,1067,1294,300,1304,349,227,B
349,C,962,962,2256,1050,2354,349,1294,C
349,D,6148,6148,8404,7200,9554,349,2256,D
349,M,1583,1583,9987,2930,12484,349,8404,M
349,N,1548,1548,11535,240,12724,349,9987,N
349,O,704,704,12239,905,13629,349,11535,O
349,P,1357,1357,13596,3960,17589,349,12239,P
350,A,186,186,186,192,192,350,0,A
350,B,96,96,282,150,342,350,186,B
350,C,185,185,467,455,797,350,282,C
350,D,3854,3854,4321,3685,4482,350,467,D
350,M,43,43,4364,136,4618,350,4321,M
350,N,291,291,4655,240,4858,350,4364,N
350,O,183,183,4838,285,5143,350,4655,O
350,P,1462,1462,6300,5160,10303,350,4838,P
351,A,1973,1973,1973,2168,2168,351,0,A
351,B,316,316,2289,90,2258,351,1973,B
351,C,530,530,2819,820,3078,351,2289,C
351,B,1399,1399,4218,1200,4278,351,2819,B
351,C,242,242,4460,605,4883,351,4218,C
351,D,10296,10296,14756,3780,8663,351,4460,D
351,M,4404,4404,19160,5987,14650,351,14756,M
351,N,1835,1835,20995,300,14950,351,19160,N
351,O,933,933,21928,935,15885,351,20995,O
351,P,5720,5720,27648,550,16435,351,21928,P
352,AE,67,67,67,999,999,352,0,E
352,AF,75,8,75,1049,1049,352,0,A
352,BF,1114,1106,1181,240,1239,352,67,F
352,BG,1155,49,1230,240,1289,352,75,B
352,CG,797,797,2027,995,2284,352,1230,C
352,DG,946,100,2127,1020,2259,352,1181,G
352,DH,285,185,2312,4680,6964,352,2027,D
352,H,324,139,2451,4680,6939,352,2127,H
352,M,1919,1919,4370,2420,9384,352,2451,M
352,N,580,580,4950,120,9504,352,4370,N
352,O,921,921,5871,890,10394,352,4950,O
352,N,1682,1682,7553,1800,12194,352,5871,N
352,O,743,743,8296,680,12874,352,7553,O
352,P,4563,4563,12859,355,13229,352,8296,P
353,AEI,38,38,38,1000,1000,353,0,E
353,AFI,199,161,199,1035,1035,353,0,I
353,AFJ,1012,851,1050,165,1165,353,38,F
353,AGJ,888,37,1087,90,1125,353,199,J
353,AGK,486,486,1573,860,1985,353,1087,K
353,AGL,88,88,1661,3780,5765,353,1573,L
353,AG,712,101,1762,885,2050,353,1050,G
353,AH,1932,170,1932,2570,2570,353,0,A
353,BH,329,159,2091,3960,6010,353,1762,H
353,B,500,341,2432,180,2750,353,1932,B
353,C,647,647,3079,885,3635,353,2432,C
353,B,1325,1325,4404,815,4450,353,3079,B
353,C,487,487,4891,760,5210,353,4404,C
353,D,4574,4574,9465,1140,6350,353,4891,D
353,M,6134,6134,15599,6326,12676,353,9465,M
353,N,250,250,15849,90,12766,353,15599,N
353,O,566,566,16415,860,13626,353,15849,O
353,P,707,707,17122,3780,17406,353,16415,P
354,AEI,37,37,37,698,698,354,0,A
354,BEI,251,214,251,334,334,354,0,I
354,BEJ,201,201,452,180,514,354,251,J
354,BEK,202,202,654,265,779,354,452,K
354,BEJ,802,185,839,180,878,354,37,B
354,CEJ,268,268,1107,265,1143,354,839,C
354,BEJ,513,60,1167,430,1209,354,654,J
354,BEK,1360,193,1360,1487,1487,354,0,E
354,BFK,337,84,1444,360,1503,354,1107,B
354,CFK,395,118,1562,205,1414,354,1167,K
354,CFL,280,162,1724,195,1698,354,1444,C
354,DFL,402,38,1762,240,1727,354,1360,F
354,DGL,277,77,1839,5585,6999,354,1562,L
354,DG,720,643,2482,1055,2782,354,1762,G
354,DF,1189,431,2913,7875,9573,354,1724,D
354,F,660,229,3142,250,3032,354,2482,F
354,G,543,543,3685,900,3932,354,3142,G
354,H,371,371,4056,3960,7892,354,3685,H
354,M,266,266,4322,728,10301,354,4056,M
354,N,1267,1267,5589,900,11201,354,4322,N
354,O,1487,1487,7076,2202,13403,354,5589,O
354,P,502,502,7578,353,13756,354,7076,P
355,A,355,355,355,1194,1194,355,0,A
355,B,886,886,1241,90,1284,355,355,B
355,C,130,130,1371,585,1869,355,1241,C
355,D,1604,1604,2975,3780,5649,355,1371,D
355,M,1887,1887,4862,2941,8590,355,2975,M
355,N,1184,1184,6046,180,8770,355,4862,N
355,O,815,815,6861,950,9720,355,6046,O
355,N,1667,1667,8528,1535,11255,355,6861,N
355,O,472,472,9000,610,11865,355,8528,O
355,P,1282,1282,10282,6960,18825,355,9000,P
356,AE,594,594,594,1352,1352,356,0,E
356,AF,878,878,1472,120,1472,356,594,F
356,AG,4630,3158,4630,4917,4917,356,0,A
356,BG,3173,15,4645,1110,2582,356,1472,G
356,BF,407,392,5037,180,5097,356,4630,B
356,CF,1284,892,5929,3295,5877,356,4645,F
356,CG,1577,685,6614,2010,7107,356,5037,C
356,BG,954,269,6883,1285,7162,356,5929,G
356,BH,176,176,7059,3960,11122,356,6883,H
356,B,6186,5741,12800,5705,12812,356,6614,B
356,C,1058,1058,13858,1100,13912,356,12800,C
356,D,461,461,14319,420,14332,356,13858,D
356,M,1574,1574,15893,1879,16211,356,14319,M
356,N,361,361,16254,90,16301,356,15893,N
356,O,600,600,16854,870,17171,356,16254,O
356,N,1062,1062,17916,820,17991,356,16854,N
356,O,491,491,18407,705,18696,356,17916,O
356,P,9144,9144,27551,3780,22476,356,18407,P
357,AE,142,142,142,245,245,357,0,E
357,AF,208,208,350,150,395,357,142,F
357,AG,147,147,497,110,505,357,350,G
357,AF,1406,909,1406,1496,1496,357,0,A
357,BF,987,78,1484,1015,1520,357,497,F
357,BG,110,110,1594,135,1655,357,1484,G
357,BH,193,5,1599,150,1646,357,1406,B
357,CH,625,625,2224,585,2231,357,1599,C
357,BH,297,297,2521,340,2571,357,2224,B
357,CH,1082,155,2676,4230,5885,357,1594,H
357,C,198,43,2719,130,2701,357,2521,C
357,D,5359,5359,8078,4230,6931,357,2719,D
357,M,169,169,8247,934,7865,357,8078,M
357,N,865,865,9112,150,8015,357,8247,N
357,O,241,241,9353,410,8425,357,9112,O
357,N,692,692,10045,505,8930,357,9353,N
357,O,704,704,10749,700,9630,357,10045,O
357,P,2655,2655,13404,4230,13860,357,10749,P
358,A,831,831,831,1136,1136,358,0,A
358,B,485,485,1316,240,1376,358,831,B
358,C,708,708,2024,715,2091,358,1316,C
358,D,1260,1260,3284,385,2476,358,2024,D
358,M,5969,5969,9253,6886,9362,358,3284,M
358,N,1689,1689,10942,804,10166,358,9253,N
358,O,985,985,11927,1159,11325,358,10942,O
358,P,589,589,12516,341,11666,358,11927,P
359,A,506,506,506,639,639,359,0,A
359,B,253,253,759,180,819,359,506,B
359,C,774,774,1533,780,1599,359,759,C
359,D,970,970,2503,550,2149,359,1533,D
359,M,146,146,2649,775,2924,359,2503,M
359,N,866,866,3515,270,3194,359,2649,N
359,O,1199,1199,4714,1042,4236,359,3515,O
359,P,4,4,4718,333,4569,359,4714,P
360,AE,93,93,93,924,924,360,0,A
360,BE,316,223,316,735,735,360,0,E
360,BF,584,584,900,150,885,360,316,F
360,BG,175,175,1075,220,1105,360,900,G
360,BF,1014,32,1107,240,1164,360,93,B
360,CF,214,214,1321,265,1429,360,1107,C
360,DF,657,411,1732,670,1775,360,1075,F
360,DG,386,386,2118,3649,5424,360,1732,G
360,DH,4305,3508,5626,5460,6889,360,1321,D
360,H,3840,332,5958,770,6194,360,2118,H
360,M,57,57,6015,209,7098,360,5958,M
360,N,245,245,6260,150,7248,360,6015,N
360,O,178,178,6438,455,7703,360,6260,O
360,P,888,888,7326,3565,11268,360,6438,P
361,A,392,392,392,1460,1460,361,0,A
361,B,1103,1103,1495,90,1550,361,392,B
361,C,857,857,2352,1225,2775,361,1495,C
361,D,106,106,2458,3780,6555,361,2352,D
361,M,556,556,3014,1335,7890,361,2458,M
361,N,819,819,3833,90,7980,361,3014,N
361,O,356,356,4189,800,8780,361,3833,O
361,P,1767,1767,5956,3780,12560,361,4189,P
362,AE,1425,1425,1425,2476,2476,362,0,E
362,AF,1584,159,1584,5432,5432,362,0,A
362,BF,1285,1126,2710,300,2776,362,1425,F
362,BG,1229,103,2813,300,5732,362,1584,B
362,CG,407,304,3117,1095,3871,362,2710,G
362,CH,532,228,3345,1095,6827,362,2813,C
362,DH,260,32,3377,6120,9991,362,3117,H
362,D,126,94,3471,6630,13457,362,3345,D
362,M,1,1,3472,169,13626,362,3471,M
362,N,375,375,3847,240,13866,362,3472,N
362,O,832,832,4679,1045,14911,362,3847,O
362,N,2154,2154,6833,1220,16131,362,4679,N
362,O,303,303,7136,1210,17341,362,6833,O
362,P,4254,4254,11390,3960,21301,362,7136,P
363,AE,1091,1091,1091,871,871,363,0,E
363,AF,40,40,1131,300,1171,363,1091,F
363,AG,687,687,1818,820,1991,363,1131,G
363,AH,2678,2678,4496,4080,6071,363,1818,H
363,A,7174,2678,7174,8837,8837,363,0,A
363,B,1792,1792,8966,150,8987,363,7174,B
363,C,791,791,9757,2165,11152,363,8966,C
363,D,2085,2085,11842,2880,14032,363,9757,D
363,M,497,497,12339,1506,15538,363,11842,M
363,N,1266,1266,13605,300,15838,363,12339,N
363,O,594,594,14199,715,16553,363,13605,O
363,P,4227,4227,18426,4080,20633,363,14199,P
364,A,718,718,718,2725,2725,364,0,A
364,B,2479,2479,3197,420,3145,364,718,B
364,C,856,856,4053,1160,4305,364,3197,C
364,D,2548,2548,6601,665,4970,364,4053,D
364,M,153,153,6754,5998,10968,364,6601,M
364,N,6018,6018,12772,220,11188,364,6754,N
364,O,1187,1187,13959,1080,12268,364,12772,O
364,N,386,386,14345,475,12743,364,13959,N
364,O,789,789,15134,2174,14917,364,14345,O
364,P,1130,1130,16264,886,15803,364,15134,P
365,AE,150,150,150,374,374,365,0,E
365,AF,321,321,471,150,524,365,150,F
365,AG,161,161,632,125,649,365,471,G
365,AF,1473,1473,2105,1505,2154,365,632,F
365,AG,970,970,3075,775,2929,365,2105,G
365,AH,25,25,3100,4230,7159,365,3075,H
365,A,36456,33356,36456,39492,39492,365,0,A
365,B,3067,3067,39523,90,39582,365,36456,B
365,C,1038,1038,40561,1220,40802,365,39523,C
365,D,1265,1265,41826,4625,45427,365,40561,D
365,M,1159,1159,42985,1636,47063,365,41826,M
365,N,533,533,43518,90,47153,365,42985,N
365,O,734,734,44252,1080,48233,365,43518,O
365,P,915,915,45167,3780,52013,365,44252,P
366,A,54,54,54,241,241,366,0,A
366,B,387,387,441,150,391,366,54,B
366,C,133,133,574,165,556,366,441,C
366,D,1115,1115,1689,4260,4816,366,574,D
366,M,12,12,1701,158,4974,366,1689,M
366,N,359,359,2060,240,5214,366,1701,N
366,O,837,837,2897,1045,6259,366,2060,O
366,P,1,1,2898,3960,10219,366,2897,P
367,A,229,229,229,877,877,367,0,A
367,B,834,834,1063,240,1117,367,229,B
367,C,773,773,1836,1015,2132,367,1063,C
367,B,915,915,2751,650,2782,367,1836,B
367,C,282,282,3033,385,3167,367,2751,C
367,D,451,451,3484,3960,7127,367,3033,D
367,M,4054,4054,7538,7571,14698,367,3484,M
367,N,3537,3537,11075,90,14788,367,7538,N
367,O,900,900,11975,1240,16028,367,11075,O
367,N,3823,3823,15798,3475,19503,367,11975,N
367,O,852,852,16650,1080,20583,367,15798,O
367,P,139,139,16789,3780,24363,367,16650,P
368,AEI,50,50,50,72,72,368,0,A
368,BEI,172,172,222,210,282,368,50,B
368,CEI,241,19,241,926,926,368,0,I
368,CEJ,655,414,655,959,959,368,0,E
368,CFJ,492,59,714,470,752,368,222,C
368,DFJ,829,356,1070,180,1106,368,241,J
368,DFK,601,186,1256,360,1319,368,655,F
368,DGK,634,448,1704,665,1771,368,1070,K
368,DGL,597,597,2301,385,2156,368,1704,L
368,DG,1096,51,2352,1125,2444,368,1256,G
368,DF,112,112,2464,80,2524,368,2352,F
368,DG,161,161,2625,120,2644,368,2464,G
368,DH,2389,2389,5014,550,3194,368,2625,H
368,D,4907,607,5621,475,1227,368,714,D
368,M,553,553,6174,1471,4665,368,5621,M
368,N,1217,1217,7391,330,4995,368,6174,N
368,O,986,986,8377,980,5975,368,7391,O
368,P,765,765,9142,350,6325,368,8377,P
369,A,40,40,40,3157,3157,369,0,A
369,B,1397,1397,1437,180,3337,369,40,B
369,C,447,447,1884,600,3937,369,1437,C
369,B,2571,2571,4455,580,4517,369,1884,B
369,C,921,921,5376,1282,5799,369,4455,C
369,D,2787,2787,8163,358,6157,369,5376,D
369,M,18,18,8181,129,6286,369,8163,M
369,N,277,277,8458,240,6526,369,8181,N
369,O,915,915,9373,975,7501,369,8458,O
369,P,3618,3618,12991,5040,12541,369,9373,P
370,A,243,243,243,1179,1179,370,0,A
370,B,1116,1116,1359,240,1419,370,243,B
370,C,762,762,2121,685,2104,370,1359,C
370,D,1041,1041,3162,5760,7864,370,2121,D
370,M,1219,1219,4381,1532,9396,370,3162,M
370,N,433,433,4814,180,9576,370,4381,N
370,O,752,752,5566,910,10486,370,4814,O
370,P,1037,1037,6603,5315,15801,370,5566,P
371,AE,1754,1754,1754,4486,4486,371,0,E
371,AF,3103,1349,3103,3905,3905,371,0,A
371,BF,1001,1001,4104,240,4145,371,3103,B
371,CF,2933,583,4687,240,4726,371,1754,F
371,CG,1153,570,5257,1050,5195,371,4104,C
371,BG,922,352,5609,910,5636,371,4687,G
371,BH,563,211,5820,1140,6335,371,5257,B
371,CH,697,697,6517,420,6755,371,5820,C
371,DH,835,835,7352,3900,10655,371,6517,D
371,H,3885,2142,9494,550,6186,371,5609,H
371,M,572,572,10066,1406,12061,371,9494,M
371,N,1233,1233,11299,420,12481,371,10066,N
371,O,849,849,12148,1159,13640,371,11299,O
371,P,157,157,12305,341,13981,371,12148,P
372,AEI,113,113,113,187,187,372,0,A
372,BEI,193,193,306,150,337,372,113,B
372,CEI,115,115,421,620,957,372,306,C
372,DEI,1268,847,1268,1319,1319,372,0,I
372,DEJ,157,157,1425,150,1469,372,1268,J
372,DEK,1430,5,1430,1680,1680,372,0,E
372,DFK,176,171,1601,155,1624,372,1425,K
372,DFJ,350,179,1780,150,1830,372,1430,F
372,DGJ,190,190,1970,150,1980,372,1780,G
372,DFJ,857,488,2458,885,2509,372,1601,J
372,DFK,102,102,2560,135,2644,372,2458,K
372,DFL,138,138,2698,4230,6874,372,2560,L
372,DF,955,227,2925,990,2970,372,1970,F
372,DG,95,95,3020,135,3105,372,2925,G
372,DH,1293,1293,4313,4290,7395,372,3020,H
372,D,5577,1685,5998,3740,4697,372,421,D
372,M,173,173,6171,870,8265,372,5998,M
372,N,797,797,6968,150,8415,372,6171,N
372,O,156,156,7124,135,8550,372,6968,O
372,N,421,421,7545,400,8950,372,7124,N
372,O,572,572,8117,470,9420,372,7545,O
372,P,1298,1298,9415,4290,13710,372,8117,P
373,AE,91,91,91,174,174,373,0,A
373,BE,162,71,162,215,215,373,0,E
373,BF,159,159,321,150,365,373,162,F
373,BG,263,33,354,240,414,373,91,B
373,CG,140,140,494,215,629,373,354,C
373,DG,576,403,897,620,985,373,321,G
373,DH,696,293,1190,4890,5519,373,494,D
373,H,719,426,1616,4200,5185,373,897,H
373,M,23,23,1639,459,5978,373,1616,M
373,N,532,532,2171,150,6128,373,1639,N
373,O,774,774,2945,680,6808,373,2171,O
373,P,374,374,3319,3690,10498,373,2945,P
374,AE,38,38,38,202,202,374,0,A
374,BE,373,373,411,240,442,374,38,B
374,CE,100,100,511,275,717,374,411,C
374,DE,954,954,1465,5070,5787,374,511,D
374,E,1647,182,1647,2306,2306,374,0,E
374,F,795,795,2442,180,2486,374,1647,F
374,G,862,862,3304,1160,3646,374,2442,G
374,F,824,824,4128,520,4166,374,3304,F
374,G,70,70,4198,220,4386,374,4128,G
374,H,1484,1484,5682,370,4756,374,4198,H
374,M,127,127,5809,769,6556,374,5682,M
374,N,739,739,6548,150,6706,374,5809,N
374,O,120,120,6668,100,6806,374,6548,O
374,N,582,582,7250,595,7401,374,6668,N
374,O,863,863,8113,590,7991,374,7250,O
374,P,1825,1825,9938,4230,12221,374,8113,P
375,A,93,93,93,718,718,375,0,A
375,B,811,811,904,240,958,375,93,B
375,C,230,230,1134,405,1363,375,904,C
375,B,654,654,1788,470,1833,375,1134,B
375,C,832,832,2620,1045,2878,375,1788,C
375,D,422,422,3042,4020,6898,375,2620,D
375,M,4019,4019,7061,4692,11590,375,3042,M
375,N,705,705,7766,90,11680,375,7061,N
375,O,349,349,8115,705,12385,375,7766,O
375,P,1027,1027,9142,3780,16165,375,8115,P
376,AE,330,330,330,1240,1240,376,0,E
376,AF,383,53,383,1235,1235,376,0,A
376,BF,943,943,1326,150,1385,376,383,B
376,CF,1003,7,1333,150,1390,376,330,F
376,CG,782,775,2108,1030,2415,376,1326,C
376,BG,791,16,2124,1030,2420,376,1333,G
376,BF,310,294,2418,60,2475,376,2108,B
376,CF,304,10,2428,60,2480,376,2124,F
376,CG,79,69,2497,95,2570,376,2418,C
376,DG,533,464,2961,95,2575,376,2428,G
376,DH,231,231,3192,4230,6805,376,2961,H
376,D,2035,1340,4532,4230,6800,376,2497,D
376,M,108,108,4640,380,7185,376,4532,M
376,N,362,362,5002,180,7365,376,4640,N
376,O,366,366,5368,660,8025,376,5002,O
376,P,367,367,5735,3960,11985,376,5368,P
377,A,4104,4104,4104,4216,4216,377,0,A
377,B,340,340,4444,300,4516,377,4104,B
377,C,923,923,5367,1035,5551,377,4444,C
377,D,1590,1590,6957,4080,9631,377,5367,D
377,M,571,571,7528,582,10213,377,6957,M
377,N,143,143,7671,240,10453,377,7528,N
377,O,1145,1145,8816,1055,11508,377,7671,O
377,P,739,739,9555,600,12108,377,8816,P
378,AEI,19,19,19,235,235,378,0,A
378,BEI,86,67,86,106,106,378,0,E
378,BFI,96,96,182,135,241,378,86,F
378,BGI,234,52,234,474,474,378,0,I
378,BGJ,287,72,306,135,370,378,19,B
378,CGJ,184,60,366,390,631,378,182,G
378,CHJ,45,45,411,6290,6921,378,366,H
378,CJ,515,338,749,300,774,378,234,J
378,CK,580,137,886,390,760,378,306,C
378,DK,45,45,931,7550,8310,378,886,D
378,K,1113,931,1862,1070,1844,378,749,K
378,J,1355,1355,3217,1425,3269,378,1862,J
378,K,1276,1276,4493,1220,4489,378,3217,K
378,L,404,404,4897,3120,7609,378,4493,L
378,M,137,137,5034,545,8855,378,4897,M
378,N,598,598,5632,240,9095,378,5034,N
378,O,192,192,5824,380,9475,378,5632,O
378,N,464,464,6288,180,9655,378,5824,N
378,O,515,515,6803,740,10395,378,6288,O
378,P,1052,1052,7855,3960,14355,378,6803,P
379,AEI,5305,5305,5305,4705,4705,379,0,A
379,BEI,139,139,5444,780,5485,379,5305,B
379,CEI,223,223,5667,395,5880,379,5444,C
379,DEI,1473,1473,7140,1590,7470,379,5667,D
379,EI,12539,5399,12539,12674,12674,379,0,E
379,FI,464,464,13003,360,13034,379,12539,F
379,GI,13324,321,13324,13430,13430,379,0,I
379,GJ,631,310,13634,1835,14869,379,13003,G
379,HJ,428,118,13752,360,13790,379,13324,J
379,HK,737,737,14489,845,14635,379,13752,K
379,HL,71,71,14560,1590,16225,379,14489,L
379,H,2585,1659,16219,1890,16759,379,13634,H
379,M,147,147,16366,675,17434,379,16219,M
379,N,770,770,17136,300,17734,379,16366,N
379,O,944,944,18080,925,18659,379,17136,O
379,P,1528,1528,19608,2760,21419,379,18080,P
380,A,1125,1125,1125,1411,1411,380,0,A
380,B,395,395,1520,150,1561,380,1125,B
380,C,1165,1165,2685,1245,2806,380,1520,C
380,D,3206,3206,5891,3670,6476,380,2685,D
380,M,1419,1419,7310,1553,8029,380,5891,M
380,N,269,269,7579,195,8224,380,7310,N
380,O,713,713,8292,670,8894,380,7579,O
380,N,1193,1193,9485,1240,10134,380,8292,N
380,O,281,281,9766,298,10432,380,9485,O
380,P,646,646,10412,347,10779,380,9766,P
381,AEI,21,21,21,531,531,381,0,E
381,AFI,66,45,66,93,93,381,0,A
381,BFI,156,90,156,505,505,381,0,I
381,BFJ,120,30,186,150,243,381,66,B
381,CFJ,175,175,361,455,698,381,186,C
381,DFJ,454,249,610,180,685,381,156,J
381,DFK,636,47,657,180,711,381,21,F
381,DGK,187,187,844,375,1086,381,657,G
381,DHK,76,76,920,5470,6556,381,844,H
381,DK,464,154,1074,735,1420,381,610,K
381,DL,135,135,1209,2880,4300,381,1074,L
381,D,871,23,1232,3565,4263,381,361,D
381,M,118,118,1350,805,7361,381,1232,M
381,N,868,868,2218,240,7601,381,1350,N
381,O,514,514,2732,740,8341,381,2218,O
381,P,15177,15177,17909,5100,13441,381,2732,P
382,AE,226,226,226,753,753,382,0,A
382,BE,616,616,842,150,903,382,226,B
382,CE,146,146,988,370,1273,382,842,C
382,BE,542,542,1530,300,1573,382,988,B
382,CE,2108,578,2108,4127,4127,382,0,E
382,CF,750,172,2280,660,2233,382,1530,C
382,DF,1131,1131,3411,4230,6463,382,2280,D
382,F,2051,748,4159,90,4217,382,2108,F
382,G,353,353,4512,795,5012,382,4159,G
382,H,1786,1786,6298,3780,8792,382,4512,H
382,M,850,850,7148,2073,10865,382,6298,M
382,N,1343,1343,8491,180,11045,382,7148,N
382,O,836,836,9327,915,11960,382,8491,O
382,P,788,788,10115,360,12320,382,9327,P
383,A,81,81,81,149,149,383,0,A
383,B,245,245,326,240,389,383,81,B
383,C,805,805,1131,975,1364,383,326,C
383,D,782,782,1913,5160,6524,383,1131,D
383,M,49,49,1962,311,6835,383,1913,M
383,N,335,335,2297,135,6970,383,1962,N
383,O,208,208,2505,380,7350,383,2297,O
383,P,2161,2161,4666,5460,12810,383,2505,P
384,A,1507,1507,1507,1570,1570,384,0,A
384,B,158,158,1665,150,1720,384,1507,B
384,C,93,93,1758,375,2095,384,1665,C
384,D,4001,4001,5759,3260,5355,384,1758,D
384,M,162,162,5921,1345,6700,384,5759,M
384,N,1366,1366,7287,240,6940,384,5921,N
384,O,700,700,7987,780,7720,384,7287,O
384,P,1354,1354,9341,7740,15460,384,7987,P
385,A,94,94,94,258,258,385,0,A
385,B,271,271,365,150,408,385,94,B
385,C,133,133,498,410,818,385,365,C
385,B,842,842,1340,370,1188,385,498,B
385,C,1075,1075,2415,1215,2403,385,1340,C
385,D,454,454,2869,4230,6633,385,2415,D
385,M,1534,1534,4403,2649,9282,385,2869,M
385,N,1154,1154,5557,90,9372,385,4403,N
385,O,385,385,5942,795,10167,385,5557,O
385,P,1032,1032,6974,3780,13947,385,5942,P
386,AEI,150,150,150,910,910,386,0,A
386,BEI,1024,1024,1174,300,1210,386,150,B
386,CEI,651,651,1825,755,1965,386,1174,C
386,BEI,252,252,2077,160,2125,386,1825,B
386,CEI,229,229,2306,1010,3135,386,2077,C
386,DEI,2889,583,2889,3900,3900,386,0,E
386,DFI,584,1,2890,2820,5955,386,2306,D
386,FI,3590,700,3590,3625,3625,386,0,I
386,FJ,287,287,3877,300,3925,386,3590,J
386,FK,249,249,4126,400,4325,386,3877,K
386,FL,1390,153,4279,300,4200,386,2889,F
386,GL,404,251,4530,1590,5915,386,4126,L
386,G,900,649,5179,1825,6025,386,4279,G
386,H,2279,2279,7458,1890,7915,386,5179,H
386,M,1760,1760,9218,1794,9709,386,7458,M
386,N,311,311,9529,300,10009,386,9218,N
386,O,733,733,10262,880,10889,386,9529,O
386,P,90,90,10352,1620,12509,386,10262,P
387,AE,114,114,114,166,166,387,0,A
387,BE,136,22,136,375,375,387,0,E
387,BF,122,100,236,135,301,387,114,B
387,CF,190,190,426,270,571,387,236,C
387,DF,438,148,574,240,615,387,136,F
387,DG,85,85,659,250,865,387,574,G
387,DH,637,637,1296,660,1525,387,659,H
387,D,1226,356,1652,5070,5641,387,426,D
387,M,179,179,1831,260,5901,387,1652,M
387,N,165,165,1996,150,6051,387,1831,N
387,O,51,51,2047,80,6131,387,1996,O
387,N,154,154,2201,120,6251,387,2047,N
387,O,175,175,2376,490,6741,387,2201,O
387,P,20,20,2396,2765,9506,387,2376,P
388,AEI,1,1,1,427,427,388,0,A
388,BEI,627,627,628,240,667,388,1,B
388,CEI,931,303,931,1059,1059,388,0,I
388,CEJ,1192,261,1192,1278,1278,388,0,E
388,CFJ,334,73,1265,240,1299,388,931,J
388,CFK,741,104,1369,960,1627,388,628,C
388,DFK,1,1,1370,3960,5587,388,1369,D
388,FK,445,267,1637,420,1698,388,1192,F
388,GK,615,243,1880,960,2259,388,1265,K
388,GL,644,644,2524,3960,6219,388,1880,L
388,G,1008,121,2645,1282,2980,388,1637,G
388,H,2575,2575,5220,358,3338,388,2645,H
388,M,1035,1035,6255,3207,9426,388,5220,M
388,N,3649,3649,9904,90,9516,388,6255,N
388,O,698,698,10602,1120,10636,388,9904,O
388,N,11674,11674,22276,12675,23311,388,10602,N
388,O,663,663,22939,1130,24441,388,22276,O
388,P,19169,19169,42108,3780,28221,388,22939,P
389,A,55,55,55,480,480,389,0,A
389,B,547,547,602,180,660,389,55,B
389,C,885,885,1487,885,1545,389,602,C
389,B,1420,1420,2907,1350,2895,389,1487,B
389,C,551,551,3458,620,3515,389,2907,C
389,D,150,150,3608,6960,10475,389,3458,D
389,M,474,474,4082,442,10917,389,3608,M
389,N,97,97,4179,180,11097,389,4082,N
389,O,958,958,5137,935,12032,389,4179,O
389,P,809,809,5946,385,12417,389,5137,P
390,A,182,182,182,181,181,390,0,A
390,B,99,99,281,150,331,390,182,B
390,C,143,143,424,385,716,390,281,C
390,D,546,546,970,3160,3876,390,424,D
390,M,54,54,1024,1119,4995,390,970,M
390,N,1255,1255,2279,240,5235,390,1024,N
390,O,704,704,2983,760,5995,390,2279,O
390,P,792,792,3775,7680,13675,390,2983,P
391,AE,132,132,132,148,148,391,0,E
391,AF,70,70,202,120,268,391,132,F
391,AG,155,155,357,75,343,391,202,G
391,AF,447,90,447,1387,1387,391,0,A
391,BF,859,769,1216,935,1278,391,357,F
391,BG,1126,357,1573,240,1627,391,447,B
391,CG,648,291,1864,705,1983,391,1216,G
391,CH,726,435,2299,685,2312,391,1573,C
391,DH,947,512,2811,5760,7743,391,1864,H
391,D,3796,3284,6095,5760,8072,391,2299,D
391,M,12105,12105,18200,13479,21551,391,6095,M
391,N,1625,1625,19825,300,21851,391,18200,N
391,O,649,649,20474,740,22591,391,19825,O
391,P,5,5,20479,1560,24151,391,20474,P
392,AE,510,510,510,1389,1389,392,0,E
392,AF,581,71,581,907,907,392,0,A
392,BF,515,515,1096,240,1147,392,581,B
392,CF,170,170,1266,385,1532,392,1096,C
392,BF,1079,323,1589,240,1629,392,510,F
392,BG,363,40,1629,135,1667,392,1266,B
392,CG,711,711,2340,970,2637,392,1629,C
392,DG,800,49,2389,970,2599,392,1589,G
392,DH,341,341,2730,3960,6559,392,2389,H
392,D,10378,9988,12718,3960,6597,392,2340,D
392,M,29133,29133,41851,29840,36437,392,12718,M
392,N,739,739,42590,90,36527,392,41851,N
392,O,526,526,43116,880,37407,392,42590,O
392,N,474,474,43590,110,37517,392,43116,N
392,O,4343,4343,47933,2315,39832,392,43590,O
392,P,1499,1499,49432,3420,43252,392,47933,P
393,AEI,8,8,8,38,38,393,0,E
393,AFI,93,85,93,94,94,393,0,A
393,BFI,153,60,153,754,754,393,0,I
393,BFJ,129,69,222,180,274,393,93,B
393,CFJ,217,3,225,240,278,393,8,F
393,CGJ,114,111,336,167,441,393,222,C
393,DGJ,138,27,363,270,548,393,225,G
393,DHJ,784,574,937,240,994,393,153,J
393,DHK,106,106,1043,265,1259,393,937,K
393,DHL,725,18,1061,773,1214,393,336,D
393,HL,2167,1469,2530,5190,5738,393,363,H
393,L,1530,43,2573,5590,6849,393,1043,L
393,M,152,152,2725,772,7621,393,2573,M
393,N,716,716,3441,150,7771,393,2725,N
393,O,106,106,3547,100,7871,393,3441,O
393,N,786,786,4333,785,8656,393,3547,N
393,O,630,630,4963,605,9261,393,4333,O
393,P,14085,14085,19048,4230,13491,393,4963,P
394,AEI,67,67,67,60,60,394,0,A
394,BEI,92,92,159,150,210,394,67,B
394,CEI,127,127,286,125,335,394,159,C
394,BEI,320,34,320,542,542,394,0,E
394,BFI,251,251,571,90,632,394,320,F
394,BGI,338,53,624,280,615,394,286,B
394,CGI,1067,443,1067,1830,1830,394,0,I
394,CGJ,792,349,1416,765,1380,394,624,C
394,DGJ,854,9,1425,1250,1882,394,571,G
394,DHJ,224,224,1649,3780,5662,394,1425,H
394,DJ,790,208,1857,90,1920,394,1067,J
394,DK,912,912,2769,1240,3160,394,1857,K
394,DL,1462,109,2878,4230,5610,394,1416,D
394,L,2776,2667,5545,3780,6940,394,2769,L
394,M,673,673,6218,1403,8343,394,5545,M
394,N,793,793,7011,90,8433,394,6218,N
394,O,995,995,8006,1285,9718,394,7011,O
394,P,847,847,8853,3780,13498,394,8006,P
395,A,83,83,83,146,146,395,0,A
395,B,153,153,236,150,296,395,83,B
395,C,147,147,383,130,426,395,236,C
395,B,856,856,1239,860,1286,395,383,B
395,C,109,109,1348,120,1406,395,1239,C
395,D,285,285,1633,4230,5636,395,1348,D
395,M,74,74,1707,849,6485,395,1633,M
395,N,868,868,2575,135,6620,395,1707,N
395,O,257,257,2832,300,6920,395,2575,O
395,P,239,239,3071,5100,12020,395,2832,P
396,AE,20,20,20,271,271,396,0,A
396,BE,455,435,455,734,734,396,0,E
396,BF,880,445,900,270,541,396,20,B
396,CF,473,28,928,240,974,396,455,F
396,CG,746,746,1674,970,1944,396,928,G
396,CH,1263,489,2163,1170,1711,396,900,C
396,DH,2841,2352,4515,3960,5904,396,1674,H
396,D,5858,3506,8021,435,2146,396,2163,D
396,M,342,342,8363,927,6831,396,8021,M
396,N,778,778,9141,240,7071,396,8363,N
396,O,1423,1423,10564,1015,8086,396,9141,O
396,P,1008,1008,11572,3960,12046,396,10564,P
397,AEI,1,1,1,1017,1017,397,0,A
397,BEI,1228,1228,1229,240,1257,397,1,B
397,CEI,1287,58,1287,1458,1458,397,0,I
397,CEJ,425,425,1712,300,1758,397,1287,J
397,CEK,815,332,2044,1040,2297,397,1229,C
397,DEK,951,619,2663,970,2728,397,1712,K
397,DEL,2755,92,2755,2965,2965,397,0,E
397,DFL,882,171,2926,3960,6257,397,2044,D
397,FL,393,222,3148,240,3205,397,2755,F
397,GL,651,651,3799,855,4060,397,3148,G
397,HL,1183,47,3846,3960,6688,397,2663,L
397,H,615,568,4414,3960,8020,397,3799,H
397,M,16,16,4430,147,8167,397,4414,M
397,N,344,344,4774,240,8407,397,4430,N
397,O,821,821,5595,1045,9452,397,4774,O
397,P,5,5,5600,3960,13412,397,5595,P
398,AEI,222,222,222,1364,1364,398,0,I
398,AEJ,785,563,785,1378,1378,398,0,A
398,BEJ,632,632,1417,90,1468,398,785,B
398,CEJ,1508,313,1730,420,1784,398,222,J
398,CEK,1773,43,1773,2610,2610,398,0,E
398,CFK,724,368,2141,880,2348,398,1417,C
398,DFK,1098,687,2828,1160,2944,398,1730,K
398,DFL,1098,43,2871,300,2910,398,1773,F
398,DGL,902,902,3773,905,3815,398,2871,G
398,DHL,3903,2271,6044,3780,6128,398,2141,D
398,HL,3967,751,6795,635,3579,398,2828,L
398,H,6994,3972,10767,2760,6575,398,3773,H
398,M,197,197,10964,1121,7696,398,10767,M
398,N,1044,1044,12008,180,7876,398,10964,N
398,O,970,970,12978,1050,8926,398,12008,O
398,P,729,729,13707,6460,15386,398,12978,P
399,AE,318,318,318,969,969,399,0,A
399,BE,578,260,578,1269,1269,399,0,E
399,BF,831,571,1149,240,1209,399,318,B
399,CF,135,135,1284,380,1589,399,1149,C
399,DF,871,165,1449,240,1509,399,578,F
399,DG,136,136,1585,395,1904,399,1449,G
399,DH,1551,1250,2835,9760,11349,399,1284,D
399,H,1416,166,3001,9700,11604,399,1585,H
399,M,387,387,3388,1122,12726,399,3001,M
399,N,831,831,4219,150,12876,399,3388,N
399,O,181,181,4400,190,13066,399,4219,O
399,N,435,435,4835,350,13416,399,4400,N
399,O,546,546,5381,780,14196,399,4835,O
399,P,691,691,6072,4230,18426,399,5381,P
400,AEI,39,39,39,62,62,400,0,E
400,AEI,39,0,39,47,47,400,0,I
400,AFJ,106,67,106,163,163,400,0,A
400,BFJ,129,62,168,180,227,400,39,J
400,BFK,142,13,181,150,212,400,39,F
400,BGK,144,69,250,150,313,400,106,B
400,CGK,127,45,295,385,612,400,168,K
400,CGL,172,58,353,400,612,400,181,G
400,CHL,186,83,436,455,768,400,250,C
400,DHL,604,463,899,5160,5772,400,295,L
400,DH,1871,1325,2224,3160,3772,400,353,H
400,D,3772,1984,4208,3565,4333,400,436,D
400,M,55,55,4263,141,5913,400,4208,M
400,N,266,266,4529,240,6153,400,4263,N
400,O,184,184,4713,215,6368,400,4529,O
400,P,827,827,5540,4890,11258,400,4713,P
401,A,5981,5981,5981,6426,6426,401,0,A
401,B,641,641,6622,240,6666,401,5981,B
401,C,691,691,7313,920,7586,401,6622,C
401,D,154,154,7467,3960,11546,401,7313,D
401,M,896,896,8363,1317,12863,401,7467,M
401,N,469,469,8832,90,12953,401,8363,N
401,O,842,842,9674,1230,14183,401,8832,O
401,P,141,141,9815,3780,17963,401,9674,P
402,AE,111,111,111,342,342,402,0,E
402,AF,509,398,509,1365,1365,402,0,A
402,BF,494,96,605,240,582,402,111,F
402,BG,922,826,1431,90,1455,402,509,B
402,CG,868,42,1473,1040,1622,402,605,G
402,CH,362,362,1835,3960,5582,402,1473,H
402,C,481,77,1912,855,2310,402,1431,C
402,D,1074,1074,2986,3780,6090,402,1912,D
402,M,702,702,3688,1411,7501,402,2986,M
402,N,748,748,4436,90,7591,402,3688,N
402,O,222,222,4658,605,8196,402,4436,O
402,P,11637,11637,16295,3780,11976,402,4658,P
403,AE,111,111,111,343,343,403,0,E
403,AF,424,424,535,240,583,403,111,F
403,AG,661,661,1196,735,1318,403,535,G
403,AH,317,317,1513,3960,5278,403,1196,H
403,A,6417,4904,6417,9107,9107,403,0,A
403,B,2874,2874,9291,240,9347,403,6417,B
403,C,835,835,10126,850,10197,403,9291,C
403,D,2948,2948,13074,3960,14157,403,10126,D
403,M,272,272,13346,1069,15226,403,13074,M
403,N,1007,1007,14353,240,15466,403,13346,N
403,O,738,738,15091,880,16346,403,14353,O
403,P,1166,1166,16257,3960,20306,403,15091,P
404,AE,462,462,462,1399,1399,404,0,A
404,BE,1904,1904,2366,90,1489,404,462,B
404,CE,3258,892,3258,4412,4412,404,0,E
404,CF,1314,422,3680,1430,2919,404,2366,C
404,BF,1174,752,4432,90,4502,404,3258,F
404,BG,1251,499,4931,2070,4989,404,3680,B
404,CG,959,460,5391,1250,5752,404,4432,G
404,CF,918,458,5849,1080,6069,404,4931,C
404,DF,280,280,6129,3780,9849,404,5849,D
404,F,1815,1077,7206,1510,7262,404,5391,F
404,G,947,947,8153,1275,8537,404,7206,G
404,H,480,480,8633,3780,12317,404,8153,H
404,M,3164,3164,11797,3413,15730,404,8633,M
404,N,281,281,12078,90,15820,404,11797,N
404,O,741,741,12819,1105,16925,404,12078,O
404,P,56,56,12875,3780,20705,404,12819,P
405,AE,19,19,19,172,172,405,0,A
405,BE,273,273,292,180,352,405,19,B
405,CE,492,200,492,1993,1993,405,0,E
405,CF,274,74,566,600,952,405,292,C
405,BF,626,626,1192,300,1252,405,566,B
405,CF,552,552,1744,740,1992,405,1192,C
405,BF,1621,369,2113,180,2173,405,492,F
405,BG,678,309,2422,480,2472,405,1744,B
405,CG,201,201,2623,255,2727,405,2422,C
405,DG,24,24,2647,5280,8007,405,2623,D
405,G,1728,1194,3841,1345,3518,405,2113,G
405,F,397,397,4238,780,4298,405,3841,F
405,G,510,510,4748,750,5048,405,4238,G
405,H,5878,5878,10626,2580,7628,405,4748,H
405,M,1721,1721,12347,2806,10813,405,10626,M
405,N,1145,1145,13492,180,10993,405,12347,N
405,O,147,147,13639,130,11123,405,13492,O
405,N,544,544,14183,495,11618,405,13639,N
405,O,731,731,14914,845,12463,405,14183,O
405,P,1670,1670,16584,5220,17683,405,14914,P
406,A,136,136,136,823,823,406,0,A
406,B,880,880,1016,240,1063,406,136,B
406,C,995,995,2011,1015,2078,406,1016,C
406,B,2883,2883,4894,2795,4873,406,2011,B
406,C,1383,1383,6277,1620,6493,406,4894,C
406,D,912,912,7189,3960,10453,406,6277,D
406,M,4593,4593,11782,4584,15037,406,7189,M
406,N,172,172,11954,240,15277,406,11782,N
406,O,158,158,12112,390,15667,406,11954,O
406,N,888,888,13000,575,16242,406,12112,N
406,O,234,234,13234,505,16747,406,13000,O
406,P,1283,1283,14517,3960,20707,406,13234,P
407,A,63,63,63,131,131,407,0,A
407,B,270,270,333,240,371,407,63,B
407,C,831,831,1164,860,1231,407,333,C
407,B,355,355,1519,335,1566,407,1164,B
407,C,475,475,1994,900,2466,407,1519,C
407,D,442,442,2436,3960,6426,407,1994,D
407,M,1339,1339,3775,1995,8421,407,2436,M
407,N,1485,1485,5260,900,9321,407,3775,N
407,O,500,500,5760,630,9951,407,5260,O
407,N,395,395,6155,255,10206,407,5760,N
407,O,1326,1326,7481,1454,11660,407,6155,O
407,P,1225,1225,8706,361,12021,407,7481,P
408,A,35851,35851,35851,35769,35769,408,0,A
408,B,465,465,36316,90,35859,408,35851,B
408,C,1113,1113,37429,1385,37244,408,36316,C
408,B,1501,1501,38930,1740,38984,408,37429,B
408,C,939,939,39869,1060,40044,408,38930,C
408,D,241,241,40110,3780,43824,408,39869,D
408,M,1801,1801,41911,1960,45784,408,40110,M
408,N,186,186,42097,90,45874,408,41911,N
408,O,697,697,42794,1105,46979,408,42097,O
408,P,32,32,42826,3780,50759,408,42794,P
409,AEI,45,45,45,250,250,409,0,E
409,AFI,93,48,93,171,171,409,0,A
409,BFI,255,255,348,240,411,409,93,B
409,CFI,532,184,532,1273,1273,409,0,I
409,CFJ,491,4,536,90,340,409,45,F
409,CGJ,202,14,550,215,626,409,348,C
409,DGJ,7,7,557,4890,5516,409,550,D
409,GJ,763,738,1295,90,1363,409,532,J
409,GK,919,160,1455,1005,1345,409,536,G
409,HK,1050,890,2345,1195,2558,409,1295,K
409,HL,1275,385,2730,3780,5125,409,1455,H
409,L,1919,1534,4264,3780,6338,409,2345,L
409,M,1843,1843,6107,3097,9435,409,4264,M
409,N,1358,1358,7465,90,9525,409,6107,N
409,O,951,951,8416,1135,10660,409,7465,O
409,P,19959,19959,28375,3780,14440,409,8416,P
410,AE,139,139,139,142,142,410,0,E
410,AF,173,173,312,135,277,410,139,F
410,AG,226,226,538,285,562,410,312,G
410,AH,128,128,666,5160,5722,410,538,H
410,A,1134,468,1134,1577,1577,410,0,A
410,B,672,672,1806,240,1817,410,1134,B
410,C,1067,1067,2873,1320,3137,410,1806,C
410,B,520,520,3393,285,3422,410,2873,B
410,C,195,195,3588,385,3807,410,3393,C
410,D,1262,1262,4850,3960,7767,410,3588,D
410,M,17,17,4867,555,8322,410,4850,M
410,N,660,660,5527,150,8472,410,4867,N
410,O,167,167,5694,390,8862,410,5527,O
410,P,157,157,5851,3960,12822,410,5694,P
411,A,79,79,79,178,178,411,0,A
411,B,278,278,357,240,418,411,79,B
411,C,202,202,559,280,698,411,357,C
411,D,1584,1584,2143,5160,5858,411,559,D
411,M,911,911,3054,985,6843,411,2143,M
411,N,180,180,3234,150,6993,411,3054,N
411,O,486,486,3720,175,7168,411,3234,O
411,P,5763,5763,9483,1520,8688,411,3720,P
412,AE,2365,2365,2365,2486,2486,412,0,E
412,AF,195,195,2560,90,2576,412,2365,F
412,AG,647,647,3207,790,3366,412,2560,G
412,AH,366,366,3573,3780,7146,412,3207,H
412,A,11618,8045,11618,12192,12192,412,0,A
412,B,641,641,12259,90,12282,412,11618,B
412,C,808,808,13067,1215,13497,412,12259,C
412,D,300,300,13367,3780,17277,412,13067,D
412,M,4518,4518,17885,4713,21990,412,13367,M
412,N,245,245,18130,90,22080,412,17885,N
412,O,307,307,18437,705,22785,412,18130,O
412,P,2501,2501,20938,3780,26565,412,18437,P
413,AEI,45,45,45,739,739,413,0,E
413,AFI,402,357,402,765,765,413,0,I
413,AFJ,452,50,452,1167,1167,413,0,A
413,BFJ,895,488,940,240,979,413,45,F
413,BGJ,596,58,998,270,1035,413,402,J
413,BGK,757,699,1697,970,1949,413,940,G
413,BHK,1290,45,1742,180,1347,413,452,B
413,CHK,249,204,1946,3960,5909,413,1697,H
413,CK,259,55,2001,465,1812,413,1742,C
413,BK,1030,27,2028,930,1965,413,998,K
413,BL,2386,2359,4387,2607,4419,413,2001,B
413,CL,867,867,5254,1675,6094,413,4387,C
413,DL,11,11,5265,3315,9409,413,5254,D
413,L,7891,4654,9919,435,2400,413,2028,L
413,M,1789,1789,11708,2604,12013,413,9919,M
413,N,840,840,12548,90,12103,413,11708,N
413,O,539,539,13087,880,12983,413,12548,O
413,N,915,915,14002,525,13508,413,13087,N
413,O,1094,1094,15096,1625,15133,413,14002,O
413,P,46205,46205,61301,3780,18913,413,15096,P
414,A,89,89,89,1006,1006,414,0,A
414,B,1099,1099,1188,240,1246,414,89,B
414,C,945,945,2133,1020,2266,414,1188,C
414,D,386,386,2519,4680,6946,414,2133,D
414,M,119,119,2638,558,7504,414,2519,M
414,N,676,676,3314,180,7684,414,2638,N
414,O,862,862,4176,1435,9119,414,3314,O
414,N,1341,1341,5517,885,10004,414,4176,N
414,O,614,614,6131,615,10619,414,5517,O
414,P,80,80,6211,6960,17579,414,6131,P
415,AE,98,98,98,213,213,415,0,A
415,BE,76,76,174,120,333,415,98,B
415,CE,206,32,206,203,203,415,0,E
415,CF,114,114,320,150,353,415,206,F
415,CG,104,104,424,110,463,415,320,G
415,CF,786,786,1210,795,1258,415,424,F
415,CG,1214,1214,2424,1245,2503,415,1210,G
415,CH,2469,219,2643,2670,3003,415,174,C
415,BH,1626,1407,4050,3670,6173,415,2424,H
415,B,5430,4023,8073,3605,6608,415,2643,B
415,C,792,792,8865,1046,7654,415,8073,C
415,D,1097,1097,9962,1049,8703,415,8865,D
415,M,338,338,10300,638,9341,415,9962,M
415,N,398,398,10698,150,9491,415,10300,N
415,O,714,714,11412,706,10197,415,10698,O
415,N,289,289,11701,280,10477,415,11412,N
415,O,548,548,12249,480,10957,415,11701,O
415,P,825,825,13074,4230,15187,415,12249,P
416,AEI,212,212,212,228,228,416,0,E
416,AFI,112,112,324,150,378,416,212,F
416,AGI,127,127,451,130,508,416,324,G
416,AFI,809,358,809,1055,1055,416,0,A
416,BFI,447,447,1256,240,1295,416,809,B
416,CFI,942,137,1393,930,1438,416,451,F
416,CGI,176,39,1432,375,1670,416,1256,C
416,BGI,400,361,1793,645,2083,416,1393,G
416,BHI,1570,1209,3002,1345,3015,416,1432,B
416,CHI,335,335,3337,920,3935,416,3002,C
416,DHI,1675,131,3468,4230,6313,416,1793,H
416,DI,4350,882,4350,4310,4310,416,0,I
416,DJ,299,299,4649,380,4690,416,4350,J
416,DK,1292,1292,5941,895,5585,416,4649,K
416,DJ,289,289,6230,705,6290,416,5941,J
416,DK,634,634,6864,780,7070,416,6230,K
416,DL,6068,2541,9405,3960,7895,416,3337,D
416,L,4406,1865,11270,4020,11090,416,6864,L
416,M,1278,1278,12548,1457,12547,416,11270,M
416,N,275,275,12823,150,12697,416,12548,N
416,O,592,592,13415,580,13277,416,12823,O
416,N,366,366,13781,370,13647,416,13415,N
416,O,150,150,13931,1055,14702,416,13781,O
416,P,2478,2478,16409,3300,18002,416,13931,P
417,A,37,37,37,95,95,417,0,A
417,B,170,170,207,180,275,417,37,B
417,C,115,115,322,145,420,417,207,C
417,D,89,89,411,2880,3300,417,322,D
417,M,230,230,641,1951,5251,417,411,M
417,N,1825,1825,2466,90,5341,417,641,N
417,O,1093,1093,3559,1345,6686,417,2466,O
417,P,226,226,3785,3780,10466,417,3559,P
418,A,60,60,60,1011,1011,418,0,A
418,B,1071,1071,1131,180,1191,418,60,B
418,C,1019,1019,2150,1055,2246,418,1131,C
418,D,2155,2155,4305,5040,7286,418,2150,D
418,M,92,92,4397,203,7489,418,4305,M
418,N,321,321,4718,240,7729,418,4397,N
418,O,179,179,4897,290,8019,418,4718,O
418,P,1821,1821,6718,5160,13179,418,4897,P
419,A,50,50,50,113,113,419,0,A
419,B,143,143,193,135,248,419,50,B
419,C,128,128,321,195,443,419,193,C
419,D,3517,3517,3838,5220,5663,419,321,D
419,M,2023,2023,5861,3083,8746,419,3838,M
419,N,1082,1082,6943,90,8836,419,5861,N
419,O,1176,1176,8119,1365,10201,419,6943,O
419,N,1530,1530,9649,1340,11541,419,8119,N
419,O,485,485,10134,860,12401,419,9649,O
419,P,486,486,10620,3780,16181,419,10134,P
420,AEI,111,111,111,87,87,420,0,A
420,BEI,102,102,213,180,267,420,111,B
420,CEI,339,126,339,450,450,420,0,E
420,CFI,163,37,376,220,487,420,213,C
420,DFI,321,284,660,240,690,420,339,F
420,DGI,1180,896,1556,4140,4627,420,376,D
420,GI,960,64,1620,970,1660,420,660,G
420,HI,1645,25,1645,2520,2520,420,0,I
420,HJ,302,277,1922,3960,5620,420,1620,H
420,J,1105,828,2750,240,2760,420,1645,J
420,K,1286,1286,4036,1050,3810,420,2750,K
420,L,754,754,4790,3960,7770,420,4036,L
420,M,728,728,5518,1240,9010,420,4790,M
420,N,709,709,6227,240,9250,420,5518,N
420,O,461,461,6688,815,10065,420,6227,O
420,P,485,485,7173,3840,13905,420,6688,P
421,AEI,154,154,154,1493,1493,421,0,E
421,AFI,306,152,306,2727,2727,421,0,I
421,AFJ,1366,1214,1520,90,1583,421,154,F
421,AGJ,896,896,2416,1225,2808,421,1520,G
421,AHJ,86,86,2502,3780,6588,421,2416,H
421,AJ,2451,255,2757,90,2817,421,306,J
421,AK,3223,466,3223,3507,3507,421,0,A
421,BK,304,304,3527,90,3597,421,3223,B
421,CK,971,201,3728,1210,4027,421,2757,K
421,CL,37,37,3765,3780,7807,421,3728,L
421,C,872,634,4399,1025,4622,421,3527,C
421,D,36,36,4435,3840,8462,421,4399,D
421,M,313,313,4748,666,9128,421,4435,M
421,N,474,474,5222,150,9278,421,4748,N
421,O,837,837,6059,800,10078,421,5222,O
421,N,368,368,6427,410,10488,421,6059,N
421,O,637,637,7064,710,11198,421,6427,O
421,P,3088,3088,10152,4230,15428,421,7064,P
422,A,2672,2672,2672,4299,4299,422,0,A
422,B,2140,2140,4812,540,4839,422,2672,B
422,C,777,777,5589,1065,5904,422,4812,C
422,B,2537,2537,8126,2270,8174,422,5589,B
422,C,692,692,8818,835,9009,422,8126,C
422,D,6156,6156,14974,350,9359,422,8818,D
422,M,2140,2140,17114,2775,12134,422,14974,M
422,N,1090,1090,18204,180,12314,422,17114,N
422,O,841,841,19045,920,13234,422,18204,O
422,N,356,356,19401,570,13804,422,19045,N
422,O,1085,1085,20486,1050,14854,422,19401,O
422,P,743,743,21229,6960,21814,422,20486,P
423,AEI,609,609,609,3534,3534,423,0,I
423,AEJ,1050,441,1050,1210,1210,423,0,A
423,BEJ,250,250,1300,150,1360,423,1050,B
423,CEJ,1639,339,1639,2965,2965,423,0,E
423,CFJ,745,406,2045,730,2090,423,1300,C
423,BFJ,411,411,2456,424,2514,423,2045,B
423,CFJ,1558,741,3197,300,3265,423,1639,F
423,CGJ,1112,371,3568,1231,3745,423,2456,C
423,DGJ,556,185,3753,735,4000,423,3197,G
423,DFJ,3388,244,3997,540,4074,423,609,J
423,DFK,287,43,4040,40,4040,423,3753,F
423,DGK,305,305,4345,780,4820,423,4040,G
423,DHK,554,206,4551,845,4919,423,3997,K
423,DHJ,649,443,4994,3720,8540,423,4345,H
423,DJ,1515,89,5083,1335,5080,423,3568,D
423,J,1037,505,5588,805,5724,423,4551,J
423,K,1188,1188,6776,1350,7074,423,5588,K
423,L,1660,1660,8436,360,7434,423,6776,L
423,M,596,596,9032,980,9520,423,8436,M
423,N,503,503,9535,180,9700,423,9032,N
423,O,409,409,9944,210,9910,423,9535,O
423,N,517,517,10461,700,10610,423,9944,N
423,O,100,100,10561,600,11210,423,10461,O
423,P,2153,2153,12714,3750,14960,423,10561,P
424,AE,29,29,29,89,89,424,0,E
424,AF,131,131,160,135,224,424,29,F
424,AG,206,46,206,700,700,424,0,A
424,BG,189,143,349,285,509,424,160,G
424,BH,220,220,569,5160,5669,424,349,H
424,B,521,158,727,90,790,424,206,B
424,C,944,944,1671,1330,2120,424,727,C
424,D,2321,2321,3992,3780,5900,424,1671,D
424,M,926,926,4918,1101,7001,424,3992,M
424,N,218,218,5136,90,7091,424,4918,N
424,O,964,964,6100,1250,8341,424,5136,O
424,P,174,174,6274,3780,12121,424,6100,P
425,A,1266,1266,1266,2051,2051,425,0,A
425,B,913,913,2179,90,2141,425,1266,B
425,C,1591,1591,3770,1045,3186,425,2179,C
425,D,117,117,3887,3780,6966,425,3770,D
425,M,1796,1796,5683,2996,9962,425,3887,M
425,N,1232,1232,6915,90,10052,425,5683,N
425,O,1240,1240,8155,1430,11482,425,6915,O
425,N,1570,1570,9725,1375,12857,425,8155,N
425,O,759,759,10484,1080,13937,425,9725,O
425,P,816,816,11300,3780,17717,425,10484,P
426,AEI,622,622,622,1665,1665,426,0,A
426,BEI,1424,802,1424,1572,1572,426,0,E
426,BFI,173,173,1597,90,1662,426,1424,F
426,BGI,1236,261,1858,240,1905,426,622,B
426,CGI,796,535,2393,1105,2767,426,1597,G
426,CFI,688,153,2546,925,2830,426,1858,C
426,DFI,67,67,2613,3960,6790,426,2546,D
426,FI,575,355,2968,255,3022,426,2393,F
426,GI,136,136,3104,625,3647,426,2968,G
426,HI,280,280,3384,3780,7427,426,3104,H
426,I,5701,2317,5701,6036,6036,426,0,I
426,J,512,512,6213,240,6276,426,5701,J
426,K,763,763,6976,830,7106,426,6213,K
426,L,1399,1399,8375,5400,12506,426,6976,L
426,M,144,144,8519,1519,14025,426,8375,M
426,N,1565,1565,10084,240,14265,426,8519,N
426,O,1369,1369,11453,1225,15490,426,10084,O
426,P,789,789,12242,550,16040,426,11453,P
427,AEI,372,372,372,964,964,427,0,E
427,AFI,419,47,419,1378,1378,427,0,I
427,AFJ,622,575,994,90,1054,427,372,F
427,AGJ,1036,42,1036,1529,1529,427,0,A
427,BGJ,994,377,1413,90,1468,427,419,J
427,BGK,522,145,1558,90,1619,427,1036,B
427,CGK,1201,637,2195,1345,2399,427,994,G
427,CHK,1000,218,2413,1220,2688,427,1413,K
427,CHL,881,26,2439,1250,2869,427,1558,C
427,DHL,36,36,2475,3780,6649,427,2439,D
427,HL,409,129,2604,3780,6179,427,2195,H
427,L,3628,3437,6041,3780,6468,427,2413,L
427,M,203,203,6244,778,7427,427,6041,M
427,N,607,607,6851,90,7517,427,6244,N
427,O,779,779,7630,860,8377,427,6851,O
427,P,1495,1495,9125,3780,12157,427,7630,P
428,AEI,244,244,244,704,704,428,0,A
428,BEI,371,127,371,1371,1371,428,0,E
428,BFI,588,461,832,180,884,428,244,B
428,CFI,855,23,855,1460,1460,428,0,I
428,CFJ,129,106,961,195,1079,428,832,C
428,BFJ,649,543,1504,90,1550,428,855,J
428,BFK,550,7,1511,480,1559,428,961,B
428,CFK,1191,51,1562,240,1611,428,371,F
428,CGK,356,298,1860,795,2345,428,1504,K
428,CGL,755,406,2266,750,2309,428,1511,C
428,DGL,91,91,2357,4140,6449,428,2266,D
428,GL,1032,237,2594,1020,2631,428,1562,G
428,HL,3,3,2597,4680,7311,428,2594,H
428,L,896,159,2756,3780,6125,428,1860,L
428,M,2204,2204,4960,2474,9785,428,2756,M
428,N,426,426,5386,90,9875,428,4960,N
428,O,425,425,5811,795,10670,428,5386,O
428,N,1187,1187,6998,425,11095,428,5811,N
428,O,1373,1373,8371,1885,12980,428,6998,O
428,P,1006,1006,9377,3780,16760,428,8371,P
429,AE,439,439,439,1121,1121,429,0,A
429,BE,782,782,1221,180,1301,429,439,B
429,CE,615,615,1836,550,1851,429,1221,C
429,BE,1262,1262,3098,1365,3216,429,1836,B
429,CE,3532,434,3532,4246,4246,429,0,E
429,CF,612,178,3710,530,3746,429,3098,C
429,DF,1488,1310,5020,780,5026,429,3532,F
429,DG,1470,160,5180,370,4116,429,3710,D
429,G,1270,1110,6290,1620,6646,429,5020,G
429,F,1288,1288,7578,1050,7696,429,6290,F
429,G,654,654,8232,590,8286,429,7578,G
429,H,1428,1428,9660,355,8641,429,8232,H
429,M,358,358,10018,1022,9663,429,9660,M
429,N,756,756,10774,150,9813,429,10018,N
429,O,159,159,10933,85,9898,429,10774,O
429,N,521,521,11454,585,10483,429,10933,N
429,O,667,667,12121,665,11148,429,11454,O
429,P,1193,1193,13314,4230,15378,429,12121,P
430,AE,101,101,101,170,170,430,0,A
430,BE,163,62,163,279,279,430,0,E
430,BF,165,103,266,150,320,430,101,B
430,CF,201,98,364,150,429,430,163,F
430,CG,133,35,399,385,705,430,266,C
430,DG,107,72,471,385,814,430,364,G
430,DH,494,422,893,3160,3865,430,399,D
430,H,762,340,1233,3160,3974,430,471,H
430,M,43,43,1276,139,4113,430,1233,M
430,N,177,177,1453,135,4248,430,1276,N
430,O,202,202,1655,295,4543,430,1453,O
430,P,63,63,1718,5100,9643,430,1655,P
431,AEI,38,38,38,1108,1108,431,0,I
431,AEJ,52,14,52,2390,2390,431,0,A
431,BEJ,714,662,714,1493,1493,431,0,E
431,BFJ,1200,524,1238,165,1273,431,38,J
431,BFK,919,395,1633,180,1673,431,714,F
431,BGK,842,447,2080,1035,2308,431,1238,K
431,BGL,329,329,2409,3960,6268,431,2080,L
431,BG,2372,15,2424,165,2555,431,52,B
431,CG,860,69,2493,885,2558,431,1633,G
431,CF,867,798,3291,1035,3590,431,2424,C
431,DF,836,38,3329,815,3373,431,2493,F
431,DG,590,552,3881,3960,7550,431,3291,D
431,DG,552,0,3881,760,4133,431,3329,G
431,H,3071,3071,6952,1140,5273,431,3881,H
431,M,4114,4114,11066,4032,11582,431,6952,M
431,N,188,188,11254,330,11912,431,11066,N
431,O,782,782,12036,730,12642,431,11254,O
431,P,1064,1064,13100,550,13192,431,12036,P
432,AEI,31,31,31,125,125,432,0,E
432,AFI,48,17,48,174,174,432,0,A
432,BFI,98,50,98,136,136,432,0,I
432,BFJ,262,195,293,240,365,432,31,F
432,BGJ,204,9,302,240,376,432,98,J
432,BGK,298,44,346,240,414,432,48,B
432,CGK,754,701,1047,975,1340,432,293,G
432,CHK,749,4,1051,975,1351,432,302,K
432,CHL,19,15,1066,6465,7805,432,1047,H
432,CL,873,153,1219,975,1389,432,346,C
432,DL,2170,2170,3389,5040,6429,432,1219,D
432,L,3745,1407,4796,5040,6391,432,1051,L
432,M,958,958,5754,1020,8825,432,4796,M
432,N,257,257,6011,240,9065,432,5754,N
432,O,902,902,6913,890,9955,432,6011,O
432,P,187,187,7100,5160,15115,432,6913,P
433,AE,1,1,1,501,501,433,0,A
433,BE,218,217,218,269,269,433,0,E
433,BF,256,256,474,270,539,433,218,F
433,BG,625,152,626,150,651,433,1,B
433,CG,510,358,984,735,1274,433,474,G
433,CF,771,413,1397,775,1426,433,626,C
433,BF,504,91,1488,205,1479,433,984,F
433,BG,834,834,2322,1120,2599,433,1488,G
433,BH,961,36,2358,960,2386,433,1397,B
433,CH,101,101,2459,115,2501,433,2358,C
433,DH,2017,1880,4339,5160,7759,433,2322,H
433,D,4907,3027,7366,4230,6731,433,2459,D
433,M,229,229,7595,766,8525,433,7366,M
433,N,701,701,8296,210,8735,433,7595,N
433,O,177,177,8473,233,8968,433,8296,O
433,P,141,141,8614,402,9370,433,8473,P
434,AEI,411,411,411,871,871,434,0,A
434,BEI,605,194,605,1157,1157,434,0,E
434,BFI,556,362,967,150,1021,434,411,B
434,CFI,128,128,1095,130,1151,434,967,C
434,BFI,649,159,1254,150,1307,434,605,F
434,BGI,234,234,1488,140,1447,434,1254,G
434,BFI,1515,27,1515,2467,2467,434,0,I
434,BFJ,982,982,2497,90,2557,434,1515,J
434,BFK,1569,167,2664,1565,2716,434,1095,B
434,CFK,1471,295,2959,1555,3002,434,1488,F
434,CGK,507,45,3004,880,3437,434,2497,K
434,CGJ,432,92,3096,650,3366,434,2664,C
434,DGJ,391,254,3350,645,3647,434,2959,G
434,DHJ,497,151,3501,110,3547,434,3004,J
434,DHK,454,303,3804,4230,7877,434,3350,H
434,DK,1441,1138,4942,2315,5862,434,3501,K
434,DL,196,196,5138,3420,9282,434,4942,L
434,D,6015,3973,9111,4230,7596,434,3096,D
434,M,1404,1404,10515,1508,10790,434,9111,M
434,N,215,215,10730,150,10940,434,10515,N
434,O,595,595,11325,580,11520,434,10730,O
434,N,706,706,12031,730,12250,434,11325,N
434,O,110,110,12141,120,12370,434,12031,O
434,P,681,681,12822,4230,16600,434,12141,P
435,AEI,2,2,2,449,449,435,0,E
435,AFI,268,266,268,1157,1157,435,0,A
435,BFI,291,23,291,929,929,435,0,I
435,BFJ,656,367,658,270,719,435,2,F
435,BGJ,757,390,1048,150,1079,435,291,J
435,BGK,718,328,1376,735,1454,435,658,G
435,BFK,359,31,1407,1020,2099,435,1048,K
435,BFL,1369,230,1637,540,1697,435,268,B
435,CFL,566,566,2203,895,2592,435,1637,C
435,BFL,998,171,2374,980,2434,435,1376,F
435,BGL,110,110,2484,200,2634,435,2374,G
435,BHL,1571,494,2978,2570,4669,435,1407,L
435,BH,1620,1126,4104,3780,6414,435,2484,H
435,B,3259,1358,5462,3000,5592,435,2203,B
435,C,814,814,6276,708,6300,435,5462,C
435,D,267,267,6543,402,6702,435,6276,D
435,M,137,137,6680,209,6911,435,6543,M
435,N,227,227,6907,210,7121,435,6680,N
435,O,126,126,7033,255,7376,435,6907,O
435,N,752,752,7785,620,7996,435,7033,N
435,O,390,390,8175,465,8461,435,7785,O
435,P,8227,8227,16402,5760,14221,435,8175,P
436,A,269,269,269,1662,1662,436,0,A
436,B,1587,1587,1856,250,1912,436,269,B
436,C,1198,1198,3054,1125,3037,436,1856,C
436,D,1033,1033,4087,550,3587,436,3054,D
436,M,941,941,5028,1537,5124,436,4087,M
436,N,706,706,5734,150,5274,436,5028,N
436,O,437,437,6171,483,5757,436,5734,O
436,P,575,575,6746,697,6454,436,6171,P
437,A,34,34,34,30,30,437,0,A
437,B,76,76,110,135,165,437,34,B
437,C,300,300,410,285,450,437,110,C
437,D,304,304,714,5160,5610,437,410,D
437,M,864,864,1578,664,6274,437,714,M
437,N,169,169,1747,420,6694,437,1578,N
437,O,128,128,1875,290,6984,437,1747,O
437,N,995,995,2870,850,7834,437,1875,N
437,O,199,199,3069,515,8349,437,2870,O
437,P,1572,1572,4641,6150,14499,437,3069,P
438,AEI,174,174,174,997,997,438,0,A
438,BEI,199,25,199,801,801,438,0,E
438,BFI,785,785,984,240,1041,438,199,F
438,BGI,137,137,1121,215,1256,438,984,G
438,BHI,1005,58,1179,240,1237,438,174,B
438,CHI,132,74,1253,4890,6146,438,1121,H
438,CI,173,99,1352,215,1452,438,1179,C
438,DI,1416,1416,2768,4890,6342,438,1352,D
438,I,5399,2631,5399,5837,5837,438,0,I
438,J,692,692,6091,240,6077,438,5399,J
438,K,778,778,6869,920,6997,438,6091,K
438,L,174,174,7043,3960,10957,438,6869,L
438,M,53,53,7096,31,10988,438,7043,M
438,N,191,191,7287,240,11228,438,7096,N
438,O,166,166,7453,110,11338,438,7287,O
438,P,19,19,7472,4230,15568,438,7453,P
439,AEI,103,103,103,240,240,439,0,A
439,BEI,235,132,235,515,515,439,0,E
439,BFI,299,64,299,1530,1530,439,0,I
439,BFJ,255,59,358,150,390,439,103,B
439,CFJ,230,230,588,740,1130,439,358,C
439,DFJ,459,106,694,245,760,439,235,F
439,DGJ,573,573,1267,525,1285,439,694,G
439,DHJ,129,129,1396,2880,4165,439,1267,H
439,DJ,1410,313,1709,240,1770,439,299,J
439,DK,785,785,2494,985,2755,439,1709,K
439,DJ,830,830,3324,625,3380,439,2494,J
439,DK,209,209,3533,290,3670,439,3324,K
439,DL,208,208,3741,5100,8770,439,3533,L
439,D,3480,327,4068,3600,4730,439,588,D
439,M,241,241,4309,484,9254,439,4068,M
439,N,327,327,4636,150,9404,439,4309,N
439,O,125,125,4761,720,10124,439,4636,O
439,P,2739,2739,7500,2760,12884,439,4761,P
440,AE,60,60,60,150,150,440,0,E
440,AF,210,210,270,180,330,440,60,F
440,AG,487,487,757,545,875,440,270,G
440,AH,1247,490,1247,1443,1443,440,0,A
440,BH,303,303,1550,180,1623,440,1247,B
440,CH,1519,726,2276,5400,6275,440,757,H
440,C,742,16,2292,975,2598,440,1550,C
440,D,1090,1090,3382,3495,6093,440,2292,D
440,M,354,354,3736,1489,7764,440,3382,M
440,N,1165,1165,4901,90,7854,440,3736,N
440,O,954,954,5855,1210,9064,440,4901,O
440,P,47,47,5902,3780,12844,440,5855,P
441,A,233,233,233,368,368,441,0,A
441,B,246,246,479,150,518,441,233,B
441,C,170,170,649,400,918,441,479,C
441,D,35,35,684,3920,4838,441,649,D
441,M,50,50,734,143,4981,441,684,M
441,N,266,266,1000,240,5221,441,734,N
441,O,125,125,1125,215,5436,441,1000,O
441,P,90,90,1215,4890,10326,441,1125,P
442,AEI,30,30,30,215,215,442,0,I
442,AEJ,70,40,70,945,945,442,0,E
442,AFJ,140,70,140,240,240,442,0,A
442,BFJ,271,161,301,150,365,442,30,J
442,BFK,202,41,342,150,390,442,140,B
442,CFK,81,40,382,80,445,442,301,K
442,CFL,167,127,509,155,545,442,342,C
442,BFL,956,517,1026,150,1095,442,70,F
442,BGL,754,110,1136,2880,3325,442,382,L
442,BG,119,9,1145,130,1225,442,1026,G
442,BH,1193,557,1702,1215,1760,442,509,B
442,CH,135,135,1837,285,2045,442,1702,C
442,DH,1076,1076,2913,5100,7145,442,1837,D
442,H,2701,933,3846,2880,4105,442,1145,H
442,M,6098,6098,9944,7896,15041,442,3846,M
442,N,1845,1845,11789,90,15131,442,9944,N
442,O,1185,1185,12974,1360,16491,442,11789,O
442,N,2325,2325,15299,2150,18641,442,12974,N
442,O,428,428,15727,815,19456,442,15299,O
442,P,985,985,16712,3780,23236,442,15727,P
443,AEI,24,24,24,297,297,443,0,I
443,AEJ,127,103,127,844,844,443,0,A
443,BEJ,383,280,407,180,477,443,24,J
443,BEK,455,48,455,657,657,443,0,E
443,BFK,498,450,905,735,1212,443,407,K
443,BFL,482,32,937,330,987,443,455,F
443,BGL,139,139,1076,375,1362,443,937,G
443,BHL,1000,51,1127,300,1144,443,127,B
443,CHL,349,127,1254,2880,4092,443,905,L
443,CH,1089,962,2216,910,2054,443,1127,C
443,BH,1555,415,2631,5470,6832,443,1076,H
443,B,3303,2888,5519,2765,4819,443,2216,B
443,C,935,935,6454,1500,6319,443,5519,C
443,D,758,758,7212,3960,10279,443,6454,D
443,M,202,202,7414,1268,11547,443,7212,M
443,N,1257,1257,8671,240,11787,443,7414,N
443,O,588,588,9259,620,12407,443,8671,O
443,P,5649,5649,14908,6300,18707,443,9259,P
444,AE,319,319,319,1025,1025,444,0,A
444,BE,981,662,981,962,962,444,0,E
444,BF,218,218,1199,240,1202,444,981,F
444,BG,890,10,1209,240,1265,444,319,B
444,CG,696,686,1895,995,2197,444,1199,G
444,CH,831,145,2040,1015,2280,444,1209,C
444,DH,486,341,2381,3900,6097,444,1895,H
444,D,1570,1229,3610,3960,6240,444,2040,D
444,M,400,400,4010,1662,7902,444,3610,M
444,N,1495,1495,5505,240,8142,444,4010,N
444,O,732,732,6237,970,9112,444,5505,O
444,P,16,16,6253,3960,13072,444,6237,P
445,AE,52,52,52,1192,1192,445,0,E
445,AF,387,335,387,1630,1630,445,0,A
445,BF,1261,926,1313,165,1357,445,52,F
445,BG,1433,507,1820,240,1870,445,387,B
445,CG,772,265,2085,1035,2392,445,1313,G
445,CH,186,186,2271,3960,6352,445,2085,H
445,C,524,73,2344,765,2635,445,1820,C
445,D,325,325,2669,9700,12335,445,2344,D
445,M,594,594,3263,1662,13997,445,2669,M
445,N,1225,1225,4488,150,14147,445,3263,N
445,O,724,724,5212,700,14847,445,4488,O
445,N,1227,1227,6439,1095,15942,445,5212,N
445,O,441,441,6880,690,16632,445,6439,O
445,P,1210,1210,8090,4230,20862,445,6880,P
446,AEI,157,157,157,130,130,446,0,A
446,BEI,225,225,382,300,430,446,157,B
446,CEI,379,379,761,880,1310,446,382,C
446,DEI,1047,286,1047,1091,1091,446,0,E
446,DFI,1174,127,1174,1392,1392,446,0,I
446,DFJ,287,160,1334,300,1391,446,1047,F
446,DGJ,368,208,1542,210,1602,446,1174,J
446,DGK,356,356,1898,450,2052,446,1542,K
446,DGJ,66,66,1964,89,2141,446,1898,J
446,DGK,993,363,2327,1025,2416,446,1334,G
446,DFK,948,585,2912,901,3042,446,1964,K
446,DFJ,2214,63,2975,1560,2870,446,761,D
446,FJ,1359,711,3686,1390,3806,446,2327,F
446,GJ,1400,626,4312,1325,4367,446,2912,J
446,GK,1055,429,4741,1140,4946,446,3686,G
446,HK,754,325,5066,685,5052,446,4312,K
446,HL,4382,4057,9123,8400,13346,446,4741,H
446,L,5197,1140,10263,5760,10812,446,5066,L
446,M,14553,14553,24816,14854,28200,446,10263,M
446,N,577,577,25393,300,28500,446,24816,N
446,O,690,690,26083,735,29235,446,25393,O
446,P,1229,1229,27312,1560,30795,446,26083,P
447,A,74,74,74,184,184,447,0,A
447,B,279,279,353,240,424,447,74,B
447,C,774,774,1127,975,1399,447,353,C
447,D,22,22,1149,5040,6439,447,1127,D
447,M,48,48,1197,1083,7522,447,1149,M
447,N,1222,1222,2419,240,7762,447,1197,N
447,O,858,858,3277,1020,8782,447,2419,O
447,P,320,320,3597,4680,13462,447,3277,P
448,AE,134,134,134,1097,1097,448,0,A
448,BE,846,712,846,1449,1449,448,0,E
448,BF,996,284,1130,90,1187,448,134,B
448,CF,639,355,1485,90,1539,448,846,F
448,CG,1074,719,2204,1220,2407,448,1130,C
448,DG,1010,291,2495,1240,2779,448,1485,G
448,DH,1397,1106,3601,3780,6187,448,2204,D
448,H,1833,727,4328,3780,6559,448,2495,H
448,M,740,740,5068,2038,8597,448,4328,M
448,N,1568,1568,6636,300,8897,448,5068,N
448,O,972,972,7608,1070,9967,448,6636,O
448,N,809,809,8417,530,10497,448,7608,N
448,O,586,586,9003,900,11397,448,8417,O
448,P,103,103,9106,4020,15417,448,9003,P
449,AE,2874,2874,2874,2900,2900,449,0,A
449,BE,3120,246,3120,3620,3620,449,0,E
449,BF,301,55,3175,300,3200,449,2874,B
449,CF,597,542,3717,150,3770,449,3120,F
449,CG,708,166,3883,895,4095,449,3175,C
449,BG,182,16,3899,120,3890,449,3717,G
449,BF,857,841,4740,705,4800,449,3883,B
449,CF,706,706,5446,780,5580,449,4740,C
449,DF,1550,3,5449,1585,5475,449,3899,F
449,DG,667,667,6116,645,6120,449,5449,G
449,DH,3185,2515,8631,1620,7200,449,5446,D
449,H,2821,306,8937,4230,10350,449,6116,H
449,M,2943,2943,11880,3027,13377,449,8937,M
449,N,281,281,12161,240,13617,449,11880,N
449,O,1123,1123,13284,855,14472,449,12161,O
449,N,1052,1052,14336,1260,15732,449,13284,N
449,O,576,576,14912,840,16572,449,14336,O
449,P,2223,2223,17135,3960,20532,449,14912,P
450,A,72,72,72,136,136,450,0,A
450,B,244,244,316,240,376,450,72,B
450,C,697,697,1013,980,1356,450,316,C
450,D,23,23,1036,5530,6886,450,1013,D
450,M,43,43,1079,992,7878,450,1036,M
450,N,1132,1132,2211,240,8118,450,1079,N
450,O,824,824,3035,890,9008,450,2211,O
450,P,291,291,3326,5160,14168,450,3035,P
451,AEI,61,61,61,105,105,451,0,A
451,BEI,161,100,161,178,178,451,0,E
451,BFI,153,53,214,150,255,451,61,B
451,CFI,223,9,223,219,219,451,0,I
451,CFJ,117,55,278,150,328,451,161,F
451,CGJ,83,28,306,150,369,451,223,J
451,CGK,112,20,326,540,795,451,214,C
451,DGK,118,98,424,720,1089,451,306,K
451,DGL,151,5,429,620,948,451,278,G
451,DHL,944,944,1373,3740,4688,451,429,H
451,DL,1161,114,1487,2850,3645,451,326,D
451,L,3616,2553,4040,2760,3849,451,424,L
451,M,271,271,4311,293,4981,451,4040,M
451,N,129,129,4440,150,5131,451,4311,N
451,O,216,216,4656,130,5261,451,4440,O
451,N,1018,1018,5674,1090,6351,451,4656,N
451,O,630,630,6304,690,7041,451,5674,O
451,P,2822,2822,9126,4230,11271,451,6304,P
452,A,180,180,180,250,250,452,0,A
452,B,339,339,519,300,550,452,180,B
452,C,584,584,1103,805,1355,452,519,C
452,D,102,102,1205,1560,2915,452,1103,D
452,M,324,324,1529,315,3230,452,1205,M
452,N,264,264,1793,300,3530,452,1529,N
452,O,755,755,2548,840,4370,452,1793,O
452,P,1341,1341,3889,1140,5510,452,2548,P
453,A,1938,1938,1938,3916,3916,453,0,A
453,B,2069,2069,4007,90,4006,453,1938,B
453,C,1138,1138,5145,1380,5386,453,4007,C
453,B,499,499,5644,320,5706,453,5145,B
453,C,596,596,6240,970,6676,453,5644,C
453,D,1326,1326,7566,3780,10456,453,6240,D
453,M,1621,1621,9187,2027,12483,453,7566,M
453,N,442,442,9629,90,12573,453,9187,N
453,O,581,581,10210,970,13543,453,9629,O
453,N,4008,4008,14218,3615,17158,453,10210,N
453,O,932,932,15150,1325,18483,453,14218,O
453,P,2753,2753,17903,3780,22263,453,15150,P
454,AE,372,372,372,757,757,454,0,E
454,AF,660,660,1032,330,1087,454,372,F
454,AG,1081,49,1081,2776,2776,454,0,A
454,BG,122,73,1154,375,1462,454,1032,G
454,BH,354,354,1508,5470,6932,454,1154,H
454,B,1986,1559,3067,240,3016,454,1081,B
454,C,598,598,3665,745,3761,454,3067,C
454,D,1261,1261,4926,5585,9346,454,3665,D
454,M,1511,1511,6437,2485,11831,454,4926,M
454,N,1157,1157,7594,240,12071,454,6437,N
454,O,904,904,8498,1020,13091,454,7594,O
454,P,171,171,8669,4680,17771,454,8498,P
455,AE,87,87,87,174,174,455,0,A
455,BE,138,51,138,233,233,455,0,E
455,BF,148,97,235,120,294,455,87,B
455,CF,96,96,331,105,399,455,235,C
455,BF,215,22,353,180,413,455,138,F
455,BG,206,184,537,195,594,455,331,B
455,CG,571,571,1108,500,1094,455,537,C
455,DG,840,85,1193,930,1343,455,353,G
455,DF,1275,1275,2468,1185,2528,455,1193,F
455,DG,478,478,2946,1115,3643,455,2468,G
455,DH,3086,1248,4194,2880,3974,455,1108,D
455,H,1491,243,4437,1330,4973,455,2946,H
455,M,150,150,4587,445,5418,455,4437,M
455,N,415,415,5002,180,5598,455,4587,N
455,O,268,268,5270,660,6258,455,5002,O
455,P,469,469,5739,4080,10338,455,5270,P
456,A,1122,1122,1122,1156,1156,456,0,A
456,B,123,123,1245,150,1306,456,1122,B
456,C,182,182,1427,455,1761,456,1245,C
456,D,891,891,2318,3565,5326,456,1427,D
456,M,238,238,2556,543,5869,456,2318,M
456,N,395,395,2951,135,6004,456,2556,N
456,O,779,779,3730,945,6949,456,2951,O
456,P,730,730,4460,5160,12109,456,3730,P
457,AEI,146,146,146,194,194,457,0,A
457,BEI,213,67,213,953,953,457,0,E
457,BFI,162,95,308,180,374,457,146,B
457,CFI,638,638,946,850,1224,457,308,C
457,BFI,1039,306,1252,300,1253,457,213,F
457,BGI,521,215,1467,270,1494,457,946,B
457,CGI,188,188,1655,190,1684,457,1467,C
457,DGI,1781,126,1781,3281,3281,457,0,I
457,DGJ,633,104,1885,920,2173,457,1252,G
457,DFJ,499,269,2154,5220,6904,457,1655,D
457,FJ,668,399,2553,495,2668,457,1885,F
457,GJ,449,449,3002,510,3178,457,2553,G
457,HJ,161,161,3163,3960,7138,457,3002,H
457,J,1528,146,3309,90,3371,457,1781,J
457,K,763,763,4072,1040,4411,457,3309,K
457,L,867,867,4939,3840,8251,457,4072,L
457,M,35249,35249,40188,39273,47524,457,4939,M
457,N,4075,4075,44263,90,47614,457,40188,N
457,O,1060,1060,45323,1385,48999,457,44263,O
457,N,709,709,46032,395,49394,457,45323,N
457,O,122,122,46154,585,49979,457,46032,O
457,P,20204,20204,66358,3780,53759,457,46154,P
458,AEI,23,23,23,564,564,458,0,A
458,BEI,35,12,35,338,338,458,0,E
458,BFI,380,380,415,135,473,458,35,F
458,BGI,198,198,613,295,768,458,415,G
458,BHI,619,29,642,135,699,458,23,B
458,CHI,81,52,694,5100,5868,458,613,H
458,CI,152,100,794,300,999,458,642,C
458,DI,801,7,801,3305,3305,458,0,I
458,DJ,293,286,1087,5100,6099,458,794,D
458,J,2884,2598,3685,180,3485,458,801,J
458,K,2350,2350,6035,890,4375,458,3685,K
458,J,594,594,6629,2300,6675,458,6035,J
458,K,2364,2364,8993,655,7330,458,6629,K
458,L,1,1,8994,6960,14290,458,8993,L
458,M,2013,2013,11007,2951,17241,458,8994,M
458,N,829,829,11836,180,17421,458,11007,N
458,O,484,484,12320,895,18316,458,11836,O
458,N,1086,1086,13406,420,18736,458,12320,N
458,O,449,449,13855,540,19276,458,13406,O
458,P,2985,2985,16840,6960,26236,458,13855,P
459,AEI,207,207,207,1046,1046,459,0,A
459,BEI,370,163,370,1191,1191,459,0,E
459,BFI,1039,876,1246,240,1286,459,207,B
459,CFI,941,65,1311,180,1371,459,370,F
459,CGI,1328,17,1328,3399,3399,459,0,I
459,CGJ,162,80,1408,200,1486,459,1246,C
459,DGJ,102,102,1510,5340,6826,459,1408,D
459,GJ,1005,806,2316,1050,2421,459,1311,G
459,FJ,677,677,2993,630,3051,459,2316,F
459,GJ,167,167,3160,195,3246,459,2993,G
459,HJ,180,180,3340,5220,8466,459,3160,H
459,J,2160,148,3488,90,3489,459,1328,J
459,K,964,964,4452,1045,4534,459,3488,K
459,L,738,738,5190,3780,8314,459,4452,L
459,M,470,470,5660,4640,13106,459,5190,M
459,N,4369,4369,10029,90,13196,459,5660,N
459,O,757,757,10786,1295,14491,459,10029,O
459,P,5567,5567,16353,3780,18271,459,10786,P
460,A,41,41,41,128,128,460,0,A
460,B,173,173,214,135,263,460,41,B
460,C,242,242,456,285,548,460,214,C
460,D,131,131,587,5160,5708,460,456,D
460,M,317,317,904,839,6547,460,587,M
460,N,555,555,1459,90,6637,460,904,N
460,O,963,963,2422,1240,7877,460,1459,O
460,P,4,4,2426,3780,11657,460,2422,P
461,AE,65,65,65,79,79,461,0,E
461,AF,261,196,261,551,551,461,0,A
461,BF,224,28,289,270,349,461,65,F
461,BG,383,383,672,810,1159,461,289,G
461,BH,650,239,911,420,971,461,261,B
461,CH,697,458,1369,3810,4969,461,672,H
461,C,898,440,1809,1160,2131,461,911,C
461,B,1377,1377,3186,1145,3276,461,1809,B
461,C,686,686,3872,815,4091,461,3186,C
461,D,2001,2001,5873,475,4566,461,3872,D
461,M,509,509,6382,1068,6037,461,5873,M
461,N,653,653,7035,150,6187,461,6382,N
461,O,149,149,7184,95,6282,461,7035,O
461,N,2202,2202,9386,2235,8517,461,7184,N
461,O,576,576,9962,585,9102,461,9386,O
461,P,12833,12833,22795,4290,13392,461,9962,P
462,A,2621,2621,2621,2694,2694,462,0,A
462,B,242,242,2863,210,2904,462,2621,B
462,C,803,803,3666,785,3689,462,2863,C
462,D,680,680,4346,550,4239,462,3666,D
462,M,508,508,4854,1193,5432,462,4346,M
462,N,1045,1045,5899,420,5852,462,4854,N
462,O,234,234,6133,235,6087,462,5899,O
462,N,552,552,6685,545,6632,462,6133,N
462,O,467,467,7152,480,7112,462,6685,O
462,P,8558,8558,15710,5160,12272,462,7152,P
463,A,241,241,241,331,331,463,0,A
463,B,191,191,432,150,481,463,241,B
463,C,126,126,558,150,631,463,432,C
463,D,1031,1031,1589,4200,4831,463,558,D
463,M,11855,11855,13444,12729,17560,463,1589,M
463,N,1065,1065,14509,240,17800,463,13444,N
463,O,682,682,15191,1050,18850,463,14509,O
463,P,521,521,15712,3960,22810,463,15191,P
464,A,184,184,184,252,252,464,0,A
464,B,246,246,430,240,492,464,184,B
464,C,180,180,610,215,707,464,430,C
464,D,696,696,1306,4890,5597,464,610,D
464,M,3388,3388,4694,4552,10149,464,1306,M
464,N,1699,1699,6393,90,10239,464,4694,N
464,O,1075,1075,7468,1405,11644,464,6393,O
464,P,168,168,7636,3780,15424,464,7468,P
465,A,972,972,972,1942,1942,465,0,A
465,B,1012,1012,1984,90,2032,465,972,B
465,C,1145,1145,3129,1395,3427,465,1984,C
465,B,2785,2785,5914,2540,5967,465,3129,B
465,C,271,271,6185,735,6702,465,5914,C
465,D,7846,7846,14031,3780,10482,465,6185,D
465,M,1532,1532,15563,2375,12857,465,14031,M
465,N,1051,1051,16614,240,13097,465,15563,N
465,O,761,761,17375,1040,14137,465,16614,O
465,N,1401,1401,18776,1040,15177,465,17375,N
465,O,2638,2638,21414,2590,17767,465,18776,O
465,P,1542,1542,22956,3960,21727,465,21414,P
466,AEI,29,29,29,1086,1086,466,0,A
466,BEI,574,545,574,1033,1033,466,0,E
466,BFI,555,555,1129,150,1183,466,574,F
466,BGI,128,128,1257,130,1313,466,1129,G
466,BFI,1250,22,1279,240,1326,466,29,B
466,CFI,254,232,1511,250,1563,466,1257,F
466,CGI,1772,261,1772,2255,2255,466,0,I
466,CGJ,755,262,2034,760,2086,466,1279,C
466,DGJ,631,108,2142,555,2118,466,1511,G
466,DHJ,140,32,2174,7680,9766,466,2034,D
466,HJ,578,176,2350,150,2405,466,1772,J
466,HK,168,168,2518,130,2535,466,2350,K
466,HJ,225,225,2743,250,2785,466,2518,J
466,HK,938,337,3080,4230,6348,466,2142,H
466,K,785,448,3528,555,3340,466,2743,K
466,L,1493,1493,5021,4230,7570,466,3528,L
466,M,4,4,5025,410,10176,466,5021,M
466,N,649,649,5674,300,10476,466,5025,N
466,O,644,644,6318,825,11301,466,5674,O
466,P,1194,1194,7512,5310,16611,466,6318,P
467,AEI,350,350,350,368,368,467,0,I
467,AEJ,393,43,393,962,962,467,0,E
467,AFJ,223,180,573,240,608,467,350,J
467,AFK,602,422,995,90,1052,467,393,F
467,AGK,650,228,1223,960,1568,467,573,K
467,AGL,603,375,1598,795,1847,467,995,G
467,AFL,348,348,1946,150,1997,467,1598,F
467,AGL,1021,1021,2967,1510,3507,467,1946,G
467,AHL,4348,1381,4348,4859,4859,467,0,A
467,BHL,536,536,4884,90,4949,467,4348,B
467,CHL,438,438,5322,600,5549,467,4884,C
467,BHL,2421,66,5388,3780,7287,467,2967,H
467,BL,829,763,6151,660,6209,467,5322,B
467,CL,5850,922,7073,3960,5528,467,1223,L
467,C,1148,226,7299,1510,7719,467,6151,C
467,D,2579,2579,9878,3780,11499,467,7299,D
467,M,431,431,10309,905,12404,467,9878,M
467,N,638,638,10947,180,12584,467,10309,N
467,O,282,282,11229,450,13034,467,10947,O
467,N,375,375,11604,245,13279,467,11229,N
467,O,696,696,12300,880,14159,467,11604,O
467,P,218,218,12518,1620,15779,467,12300,P
468,AE,64,64,64,185,185,468,0,A
468,BE,193,129,193,707,707,468,0,E
468,BF,289,160,353,240,425,468,64,B
468,CF,634,474,827,180,887,468,193,F
468,CG,690,216,1043,975,1400,468,353,C
468,DG,55,55,1098,5040,6440,468,1043,D
468,G,301,30,1128,265,1152,468,827,G
468,H,2848,2848,3976,5425,6577,468,1128,H
468,M,373,373,4349,1433,8010,468,3976,M
468,N,1090,1090,5439,90,8100,468,4349,N
468,O,1024,1024,6463,1210,9310,468,5439,O
468,P,175,175,6638,3780,13090,468,6463,P
469,AE,107,107,107,314,314,469,0,E
469,AF,457,457,564,270,584,469,107,F
469,AG,883,883,1447,940,1524,469,564,G
469,AH,4501,3054,4501,5473,5473,469,0,A
469,BH,1351,1351,5852,420,5893,469,4501,B
469,CH,5441,1036,6888,435,1959,469,1447,H
469,C,1308,272,7160,1434,7327,469,5852,C
469,D,1984,1984,9144,356,7683,469,7160,D
469,M,1897,1897,11041,2768,10451,469,9144,M
469,N,981,981,12022,150,10601,469,11041,N
469,O,769,769,12791,760,11361,469,12022,O
469,N,1204,1204,13995,1195,12556,469,12791,N
469,O,638,638,14633,705,13261,469,13995,O
469,P,3149,3149,17782,4230,17491,469,14633,P
470,A,123,123,123,184,184,470,0,A
470,B,354,354,477,300,484,470,123,B
470,C,473,473,950,685,1169,470,477,C
470,D,1883,1883,2833,3960,5129,470,950,D
470,M,13674,13674,16507,13680,18809,470,2833,M
470,N,359,359,16866,360,19169,470,16507,N
470,O,664,664,17530,860,20029,470,16866,O
470,P,258,258,17788,2700,22729,470,17530,P
471,A,217,217,217,227,227,471,0,A
471,B,100,100,317,150,377,471,217,B
471,C,566,566,883,795,1172,471,317,C
471,D,70,70,953,5395,6567,471,883,D
471,M,27,27,980,228,6795,471,953,M
471,N,383,383,1363,240,7035,471,980,N
471,O,176,176,1539,285,7320,471,1363,O
471,P,869,869,2408,5160,12480,471,1539,P
472,AEI,434,434,434,1048,1048,472,0,I
472,AEJ,551,117,551,934,934,472,0,A
472,BEJ,719,602,1153,150,1198,472,434,J
472,BEK,1369,216,1369,3883,3883,472,0,E
472,BFK,221,5,1374,170,1368,472,1153,K
472,BFL,840,17,1391,511,1445,472,551,B
472,CFL,248,248,1639,190,1635,472,1391,C
472,DFL,309,309,1948,2850,4485,472,1639,D
472,FL,2541,1962,3910,90,3973,472,1369,F
472,GL,2914,378,4288,4200,5568,472,1374,L
472,G,667,289,4577,935,4908,472,3910,G
472,F,1629,1629,6206,1325,6233,472,4577,F
472,G,1056,1056,7262,1310,7543,472,6206,G
472,H,288,288,7550,3780,11323,472,7262,H
472,M,2863,2863,10413,4583,15906,472,7550,M
472,N,1860,1860,12273,90,15996,472,10413,N
472,O,1276,1276,13549,1415,17411,472,12273,O
472,P,183,183,13732,3780,21191,472,13549,P
473,AEI,219,219,219,437,437,473,0,I
473,AEJ,226,7,226,1152,1152,473,0,E
473,AFJ,244,237,463,90,527,473,219,J
473,AFK,890,427,890,1045,1045,473,0,A
473,BFK,490,63,953,880,1407,473,463,K
473,BFL,181,118,1071,90,1135,473,890,B
473,CFL,952,107,1178,90,1242,473,226,F
473,CGL,489,382,1560,735,1870,473,1071,C
473,DGL,856,249,1809,3780,5187,473,953,L
473,DG,278,29,1838,3780,5650,473,1560,D
473,G,852,192,2030,1200,2442,473,1178,G
473,H,511,511,2541,3780,6222,473,2030,H
473,M,822,822,3363,1364,7586,473,2541,M
473,N,605,605,3968,90,7676,473,3363,N
473,O,367,367,4335,800,8476,473,3968,O
473,P,1676,1676,6011,3780,12256,473,4335,P
474,AEI,996,996,996,1319,1319,474,0,I
474,AEJ,378,378,1374,90,1409,474,996,J
474,AEK,1410,36,1410,1904,1904,474,0,E
474,AFK,1668,258,1668,1886,1886,474,0,A
474,BFK,256,256,1924,90,1976,474,1668,B
474,CFK,899,349,2273,1250,2659,474,1374,K
474,CFL,69,69,2342,3780,6439,474,2273,L
474,CF,1097,679,3021,1355,3331,474,1924,C
474,DF,1688,77,3098,90,1994,474,1410,F
474,DG,590,513,3611,3780,7111,474,3021,D
474,G,1370,857,4468,1745,3739,474,3098,G
474,H,430,430,4898,3780,7519,474,4468,H
474,M,1504,1504,6402,2702,10221,474,4898,M
474,N,1264,1264,7666,90,10311,474,6402,N
474,O,538,538,8204,905,11216,474,7666,O
474,P,3786,3786,11990,3780,14996,474,8204,P
475,A,299,299,299,1341,1341,475,0,A
475,B,1072,1072,1371,90,1431,475,299,B
475,C,1038,1038,2409,1220,2651,475,1371,C
475,D,125,125,2534,3780,6431,475,2409,D
475,M,331,331,2865,544,6975,475,2534,M
475,N,251,251,3116,90,7065,475,2865,N
475,O,752,752,3868,1135,8200,475,3116,O
475,P,39298,39298,43166,3780,11980,475,3868,P
476,AEI,685,685,685,1410,1410,476,0,I
476,AEJ,755,755,1440,90,1500,476,685,J
476,AEK,226,226,1666,605,2105,476,1440,K
476,AEL,3322,1656,3322,3933,3933,476,0,A
476,BEL,644,644,3966,90,4023,476,3322,B
476,CEL,239,239,4205,605,4628,476,3966,C
476,DEL,4501,4501,8706,3780,8408,476,4205,D
476,EL,12765,5725,14431,3780,5885,476,1666,L
476,E,36869,22438,36869,37992,37992,476,0,E
476,F,1153,1153,38022,90,38082,476,36869,F
476,G,1011,1011,39033,1210,39292,476,38022,G
476,F,443,443,39476,220,39512,476,39033,F
476,G,217,217,39693,605,40117,476,39476,G
476,H,4043,4043,43736,3780,43897,476,39693,H
476,M,60,60,43796,1554,45451,476,43736,M
476,N,1644,1644,45440,210,45661,476,43796,N
476,O,253,253,45693,395,46056,476,45440,O
476,N,632,632,46325,485,46541,476,45693,N
476,O,1009,1009,47334,1130,47671,476,46325,O
476,P,1037,1037,48371,1140,48811,476,47334,P
477,AEI,94,94,94,2776,2776,477,0,A
477,BEI,483,389,483,1219,1219,477,0,I
477,BEJ,1124,1124,1607,420,1639,477,483,J
477,BEK,1978,371,1978,1156,1156,477,0,E
477,BFK,855,484,2462,845,2484,477,1607,K
477,BFL,594,110,2572,1470,2626,477,1978,F
477,BGL,391,281,2853,525,3009,477,2462,L
477,BG,2896,137,2990,270,3046,477,94,B
477,CG,548,130,3120,845,3471,477,2572,G
477,CF,762,632,3752,835,3881,477,2990,C
477,DF,1332,1332,5084,350,4231,477,3752,D
477,F,2670,706,5790,2375,5846,477,3120,F
477,G,762,762,6552,835,6681,477,5790,G
477,H,1332,1332,7884,350,7031,477,6552,H
477,M,3103,3103,10987,3398,10429,477,7884,M
477,N,373,373,11360,120,10549,477,10987,N
477,O,1119,1119,12479,1025,11574,477,11360,O
477,N,483,483,12962,595,12169,477,12479,N
477,O,249,249,13211,300,12469,477,12962,O
477,P,4400,4400,17611,670,13139,477,13211,P
478,A,447,447,447,347,347,478,0,A
478,B,94,94,541,240,587,478,447,B
478,C,120,120,661,380,967,478,541,C
478,B,1105,1105,1766,820,1787,478,661,B
478,C,557,557,2323,740,2527,478,1766,C
478,D,3920,3920,6243,3960,6487,478,2323,D
478,M,66,66,6309,280,6767,478,6243,M
478,N,482,482,6791,300,7067,478,6309,N
478,O,481,481,7272,710,7777,478,6791,O
478,P,433,433,7705,3960,11737,478,7272,P
479,AEI,60,60,60,100,100,479,0,A
479,BEI,221,221,281,180,280,479,60,B
479,CEI,402,121,402,821,821,479,0,E
479,CFI,259,138,540,545,825,479,281,C
479,BFI,550,10,550,482,482,479,0,I
479,BFJ,596,448,998,180,1001,479,402,F
479,BGJ,607,149,1147,630,1455,479,540,B
479,CGJ,817,220,1367,965,1447,479,550,J
479,CGK,721,501,1868,580,2035,479,1147,C
479,BGK,925,55,1923,1180,2181,479,998,G
479,BFK,597,41,1964,850,2297,479,1367,K
479,BFJ,297,201,2165,190,2225,479,1868,B
479,CFJ,473,473,2638,840,3065,479,2165,C
479,DFJ,1280,606,3244,1065,3362,479,1964,J
479,DFK,1574,253,3497,1420,3601,479,1923,F
479,DGK,654,401,3898,590,3952,479,3244,K
479,DGL,579,178,4076,580,4181,479,3497,G
479,DHL,2794,1356,5432,5160,8225,479,2638,D
479,HL,2773,1239,6671,355,4307,479,3898,L
479,H,3565,970,7641,365,4546,479,4076,H
479,M,1760,1760,9401,1915,10140,479,7641,M
479,N,245,245,9646,150,10290,479,9401,N
479,O,385,385,10031,530,10820,479,9646,O
479,N,479,479,10510,315,11135,479,10031,N
479,O,790,790,11300,1032,12167,479,10510,O
479,P,171,171,11471,333,12500,479,11300,P
480,AEI,279,279,279,379,379,480,0,E
480,AFI,594,315,594,948,948,480,0,A
480,BFI,398,398,992,90,1038,480,594,B
480,CFI,1052,60,1052,1226,1226,480,0,I
480,CFJ,394,334,1386,800,1838,480,992,C
480,DFJ,879,545,1931,210,1436,480,1052,J
480,DFK,290,290,2221,530,1966,480,1931,K
480,DFL,453,453,2674,1410,3376,480,2221,L
480,DF,2517,122,2796,270,649,480,279,F
480,DG,2281,871,3667,3780,5618,480,1386,D
480,G,1014,143,3810,857,1506,480,2796,G
480,H,196,196,4006,333,1839,480,3810,H
480,M,3296,3296,7302,3638,9256,480,4006,M
480,N,371,371,7673,90,9346,480,7302,N
480,O,653,653,8326,795,10141,480,7673,O
480,N,650,650,8976,460,10601,480,8326,N
480,O,1627,1627,10603,1885,12486,480,8976,O
480,P,2822,2822,13425,3780,16266,480,10603,P
481,AEI,123,123,123,2353,2353,481,0,A
481,BEI,254,131,254,685,685,481,0,E
481,BFI,383,129,383,999,999,481,0,I
481,BFJ,595,466,849,150,835,481,254,F
481,BGJ,212,212,1061,220,1055,481,849,G
481,BFJ,828,150,1211,240,1239,481,383,J
481,BFK,207,207,1418,460,1699,481,1211,K
481,BFJ,613,256,1674,670,1725,481,1061,F
481,BGJ,719,463,2137,470,2169,481,1418,J
481,BGK,194,194,2331,755,2924,481,2137,K
481,BGL,720,63,2394,2229,3954,481,1674,G
481,BHL,2413,142,2536,240,2593,481,123,B
481,CHL,186,186,2722,265,2858,481,2536,C
481,DHL,892,501,3223,3670,6594,481,2331,L
481,DH,1833,1004,4227,2190,6144,481,2394,H
481,D,5773,4268,8495,5460,8318,481,2722,D
481,M,215,215,8710,233,8551,481,8495,M
481,N,103,103,8813,150,8701,481,8710,N
481,O,149,149,8962,455,9156,481,8813,O
481,P,918,918,9880,3565,12721,481,8962,P
482,AEI,1295,1295,1295,1409,1409,482,0,E
482,AFI,1535,240,1535,1647,1647,482,0,I
482,AFJ,333,93,1628,240,1649,482,1295,F
482,AGJ,313,220,1848,240,1887,482,1535,J
482,AGK,704,484,2332,855,2504,482,1628,G
482,AHK,610,126,2458,795,2682,482,1848,K
482,AHL,2516,58,2516,2643,2643,482,0,A
482,BHL,254,70,2586,3960,6464,482,2332,H
482,BL,293,165,2751,3900,6582,482,2458,L
482,B,324,89,2840,240,2883,482,2516,B
482,C,677,677,3517,855,3738,482,2840,C
482,D,2845,2845,6362,3960,7698,482,3517,D
482,M,47,47,6409,1186,8884,482,6362,M
482,N,1259,1259,7668,165,9049,482,6409,N
482,O,999,999,8667,1275,10324,482,7668,O
482,P,200,200,8867,3960,14284,482,8667,P
483,A,6974,6974,6974,7054,7054,483,0,A
483,B,281,281,7255,240,7294,483,6974,B
483,C,527,527,7782,740,8034,483,7255,C
483,B,231,231,8013,20,8054,483,7782,B
483,C,169,169,8182,380,8434,483,8013,C
483,D,1280,1280,9462,3960,12394,483,8182,D
483,M,70,70,9532,270,12664,483,9462,M
483,N,292,292,9824,150,12814,483,9532,N
483,O,285,285,10109,255,13069,483,9824,O
483,P,1144,1144,11253,2880,15949,483,10109,P
484,A,2649,2649,2649,3066,3066,484,0,A
484,B,540,540,3189,240,3306,484,2649,B
484,C,898,898,4087,1055,4361,484,3189,C
484,D,842,842,4929,600,4961,484,4087,D
484,M,9184,9184,14113,9996,14957,484,4929,M
484,N,1024,1024,15137,240,15197,484,14113,N
484,O,1408,1408,16545,3050,18247,484,15137,O
484,P,1767,1767,18312,2400,20647,484,16545,P
485,A,618,618,618,838,838,485,0,A
485,B,299,299,917,90,928,485,618,B
485,C,1424,1424,2341,1935,2863,485,917,C
485,D,2805,2805,5146,3780,6643,485,2341,D
485,M,707,707,5853,794,7437,485,5146,M
485,N,277,277,6130,180,7617,485,5853,N
485,O,943,943,7073,1245,8862,485,6130,O
485,P,1107,1107,8180,6680,15542,485,7073,P
486,AE,141,141,141,68,68,486,0,E
486,AF,20,20,161,150,218,486,141,F
486,AG,164,164,325,155,373,486,161,G
486,AH,329,4,329,329,329,486,0,A
486,BH,226,226,555,90,419,486,329,B
486,CH,1003,773,1328,4200,4573,486,325,H
486,C,878,105,1433,1005,1424,486,555,C
486,D,43,43,1476,3780,5204,486,1433,D
486,M,399,399,1875,1536,6740,486,1476,M
486,N,1334,1334,3209,240,6980,486,1875,N
486,O,746,746,3955,975,7955,486,3209,O
486,P,985,985,4940,3960,11915,486,3955,P
487,AE,142,142,142,960,960,487,0,E
487,AF,1003,1003,1145,240,1200,487,142,F
487,AG,199,199,1344,290,1490,487,1145,G
487,AH,1508,164,1508,1644,1644,487,0,A
487,BH,317,317,1825,240,1884,487,1508,B
487,CH,181,181,2006,295,2179,487,1825,C
487,BH,638,638,2644,515,2694,487,2006,B
487,CH,174,174,2818,290,2984,487,2644,C
487,DH,1965,1965,4783,5160,8144,487,2818,D
487,H,19727,16288,21071,5280,6770,487,1344,H
487,M,53,53,21124,179,8323,487,21071,M
487,N,216,216,21340,150,8473,487,21124,N
487,O,158,158,21498,410,8883,487,21340,O
487,P,840,840,22338,3445,12328,487,21498,P
488,AEI,265,265,265,280,280,488,0,A
488,BEI,340,75,340,350,350,488,0,E
488,BFI,264,189,529,300,580,488,265,B
488,CFI,313,124,653,300,650,488,340,F
488,CGI,738,614,1267,840,1420,488,529,C
488,DGI,706,92,1359,895,1545,488,653,G
488,DHI,2583,1224,2583,3011,3011,488,0,I
488,DHJ,632,632,3215,240,3251,488,2583,J
488,DHK,741,741,3956,785,4036,488,3215,K
488,DHL,1137,1137,5093,3960,7996,488,3956,L
488,DH,4861,1127,6220,1140,2685,488,1359,H
488,D,7473,2520,8740,1140,2560,488,1267,D
488,M,2836,2836,11576,3340,11336,488,8740,M
488,N,762,762,12338,300,11636,488,11576,N
488,O,610,610,12948,1940,13576,488,12338,O
488,P,1315,1315,14263,2760,16336,488,12948,P
489,AEI,40,40,40,20,20,489,0,A
489,BEI,50,10,50,139,139,489,0,I
489,BEJ,166,156,206,240,260,489,40,B
489,CEJ,188,32,238,150,289,489,50,J
489,CEK,149,117,355,175,435,489,206,C
489,DEK,44,44,399,4230,4665,489,355,D
489,EK,186,25,424,805,1094,489,238,K
489,EL,603,179,603,3693,3693,489,0,E
489,FL,835,656,1259,3600,4694,489,424,L
489,F,3250,2594,3853,180,3873,489,603,F
489,G,893,893,4746,1215,5088,489,3853,G
489,F,1097,1097,5843,985,6073,489,4746,F
489,G,2829,2829,8672,2930,9003,489,5843,G
489,H,16,16,8688,355,9358,489,8672,H
489,M,515,515,9203,1777,11135,489,8688,M
489,N,1448,1448,10651,240,11375,489,9203,N
489,O,338,338,10989,455,11830,489,10651,O
489,N,2786,2786,13775,2645,14475,489,10989,N
489,O,953,953,14728,1230,15705,489,13775,O
489,P,5771,5771,20499,3960,19665,489,14728,P
490,A,35680,35680,35680,38054,38054,490,0,A
490,B,2402,2402,38082,90,38144,490,35680,B
490,C,1010,1010,39092,1220,39364,490,38082,C
490,D,1228,1228,40320,4625,43989,490,39092,D
490,M,439,439,40759,1491,45480,490,40320,M
490,N,1083,1083,41842,90,45570,490,40759,N
490,O,764,764,42606,1195,46765,490,41842,O
490,P,70,70,42676,3780,50545,490,42606,P
491,AEI,213,213,213,1077,1077,491,0,E
491,AFI,777,564,777,1217,1217,491,0,I
491,AFJ,901,337,1114,90,1167,491,213,F
491,AGJ,471,134,1248,90,1307,491,777,J
491,AGK,832,698,1946,1200,2367,491,1114,G
491,AHK,280,280,2226,3780,6147,491,1946,H
491,AK,1076,98,2324,1240,2547,491,1248,K
491,AL,342,342,2666,3780,6327,491,2324,L
491,A,4425,1759,4425,5618,5618,491,0,A
491,B,1223,1223,5648,90,5708,491,4425,B
491,C,966,966,6614,1210,6918,491,5648,C
491,D,228,228,6842,3780,10698,491,6614,D
491,M,4524,4524,11366,4723,15421,491,6842,M
491,N,246,246,11612,90,15511,491,11366,N
491,O,334,334,11946,705,16216,491,11612,O
491,P,1035,1035,12981,3780,19996,491,11946,P
492,AEI,9,9,9,70,70,492,0,I
492,AEJ,286,286,295,240,310,492,9,J
492,AEK,545,545,840,855,1165,492,295,K
492,AEL,1010,170,1010,1110,1110,492,0,E
492,AFL,355,355,1365,300,1410,492,1010,F
492,AGL,891,366,1731,4020,5185,492,840,L
492,AG,893,527,2258,810,2220,492,1365,G
492,AH,2970,712,2970,3000,3000,492,0,A
492,BH,292,292,3262,300,3300,492,2970,B
492,CH,586,586,3848,750,4050,492,3262,C
492,DH,4262,2672,6520,1560,3780,492,2258,H
492,D,3167,495,7015,1560,5610,492,3848,D
492,M,254,254,7269,250,5860,492,7015,M
492,N,255,255,7524,300,6160,492,7269,N
492,O,635,635,8159,770,6930,492,7524,O
492,P,273,273,8432,4020,10950,492,8159,P
493,A,5207,5207,5207,5478,5478,493,0,A
493,B,310,310,5517,90,5568,493,5207,B
493,C,461,461,5978,735,6303,493,5517,C
493,D,80033,80033,86011,3780,10083,493,5978,D
493,M,1800,1800,87811,2213,12296,493,86011,M
493,N,510,510,88321,155,12451,493,87811,N
493,O,1047,1047,89368,1195,13646,493,88321,O
493,N,627,627,89995,540,14186,493,89368,N
493,O,306,306,90301,390,14576,493,89995,O
493,P,759,759,91060,485,15061,493,90301,P
494,A,22,22,22,1444,1444,494,0,A
494,B,1822,1822,1844,420,1864,494,22,B
494,C,790,790,2634,1046,2910,494,1844,C
494,D,1368,1368,4002,1049,3959,494,2634,D
494,M,1143,1143,5145,1375,5334,494,4002,M
494,N,367,367,5512,195,5529,494,5145,N
494,O,702,702,6214,665,6194,494,5512,O
494,N,486,486,6700,555,6749,494,6214,N
494,O,228,228,6928,377,7126,494,6700,O
494,P,1545,1545,8473,863,7989,494,6928,P
495,AE,64,64,64,215,215,495,0,A
495,BE,212,148,212,496,496,495,0,E
495,BF,261,113,325,150,365,495,64,B
495,CF,231,231,556,135,500,495,325,C
495,DF,374,30,586,150,646,495,212,F
495,DG,136,136,722,400,1046,495,586,G
495,DH,585,419,1141,2880,3380,495,556,D
495,H,3088,2669,3810,2880,3926,495,722,H
495,M,132,132,3942,1144,5070,495,3810,M
495,N,1039,1039,4981,90,5160,495,3942,N
495,O,974,974,5955,1220,6380,495,4981,O
495,N,263,263,6218,15,6395,495,5955,N
495,O,231,231,6449,695,7090,495,6218,O
495,P,5692,5692,12141,3780,10870,495,6449,P
496,A,1491,1491,1491,1714,1714,496,0,A
496,B,423,423,1914,240,1954,496,1491,B
496,C,831,831,2745,770,2724,496,1914,C
496,B,413,413,3158,285,3009,496,2745,B
496,C,367,367,3525,1260,4269,496,3158,C
496,D,565,565,4090,3960,8229,496,3525,D
496,M,68,68,4158,115,8344,496,4090,M
496,N,182,182,4340,180,8524,496,4158,N
496,O,218,218,4558,150,8674,496,4340,O
496,P,37,37,4595,385,9059,496,4558,P
497,AE,61,61,61,90,90,497,0,E
497,AF,166,105,166,196,196,497,0,A
497,BF,117,12,178,150,240,497,61,F
497,BG,116,104,282,150,346,497,166,B
497,CG,151,47,329,455,695,497,178,G
497,CH,180,133,462,410,756,497,282,C
497,DH,917,784,1246,5005,5700,497,329,H
497,D,822,38,1284,3480,4236,497,462,D
497,M,30,30,1314,45,5745,497,1284,M
497,N,104,104,1418,135,5880,497,1314,N
497,O,153,153,1571,295,6175,497,1418,O
497,P,57,57,1628,5100,11275,497,1571,P
498,AEI,1004,1004,1004,2293,2293,498,0,E
498,AFI,1834,830,1834,1947,1947,498,0,I
498,AFJ,304,304,2138,240,2187,498,1834,J
498,AFK,2152,14,2152,2681,2681,498,0,A
498,BFK,1409,261,2413,180,2473,498,1004,F
498,BGK,524,249,2662,725,2912,498,2138,K
498,BGJ,668,158,2820,180,2861,498,2152,B
498,CGJ,391,233,3053,170,3082,498,2662,J
498,CGK,987,347,3400,1050,3523,498,2413,G
498,CFK,665,318,3718,1080,4162,498,3053,K
498,CFL,1068,170,3888,1170,4031,498,2820,C
498,BFL,846,358,4246,830,4353,498,3400,F
498,BGL,557,557,4803,530,4883,498,4246,G
498,BHL,1857,942,5745,1795,5826,498,3888,B
498,CHL,1244,302,6047,5250,10133,498,4803,H
498,CL,353,51,6098,413,6239,498,5745,C
498,DL,2784,2784,8882,1532,7771,498,6098,D
498,L,17710,12546,21428,3960,8122,498,3718,L
498,M,292,292,21720,302,10435,498,21428,M
498,N,105,105,21825,140,10575,498,21720,N
498,O,264,264,22089,330,10905,498,21825,O
498,N,773,773,22862,715,11620,498,22089,N
498,O,965,965,23827,905,12525,498,22862,O
498,N,1223,1223,25050,1350,13875,498,23827,N
498,O,853,853,25903,1125,15000,498,25050,O
498,P,719,719,26622,315,15315,498,25903,P
499,AEI,21,21,21,326,326,499,0,E
499,AFI,303,282,303,330,330,499,0,I
499,AFJ,172,172,475,150,480,499,303,J
499,AFK,497,43,518,240,566,499,21,F
499,AGK,332,289,807,450,930,499,475,K
499,AGJ,571,282,1089,860,1426,499,518,G
499,AHJ,634,352,1441,580,1510,499,807,J
499,AHK,477,125,1566,3960,5386,499,1089,H
499,AK,1667,101,1667,2556,2556,499,0,A
499,BK,459,233,1900,145,1655,499,1441,K
499,BL,1005,772,2672,150,2706,499,1667,B
499,CL,757,757,3429,790,3496,499,2672,C
499,DL,1431,1431,4860,4200,7696,499,3429,D
499,L,5133,2173,7033,2850,4505,499,1900,L
499,M,329,329,7362,1570,9266,499,7033,M
499,N,1434,1434,8796,240,9506,499,7362,N
499,O,736,736,9532,975,10481,499,8796,O
499,P,1049,1049,10581,3960,14441,499,9532,P
500,AE,5,5,5,397,397,500,0,A
500,BE,211,206,211,223,223,500,0,E
500,BF,103,103,314,150,373,500,211,F
500,BG,187,187,501,455,828,500,314,G
500,BH,625,129,630,300,697,500,5,B
500,CH,869,740,1370,5005,5833,500,501,H
500,C,780,40,1410,820,1517,500,630,C
500,D,15,15,1425,5315,6832,500,1410,D
500,M,79,79,1504,1201,8033,500,1425,M
500,N,1153,1153,2657,90,8123,500,1504,N
500,O,1005,1005,3662,1210,9333,500,2657,O
500,P,273,273,3935,3780,13113,500,3662,P
501,AEI,80,80,80,147,147,501,0,A
501,BEI,212,212,292,210,357,501,80,B
501,CEI,104,104,396,255,612,501,292,C
501,BEI,1752,1356,1752,1823,1823,501,0,E
501,BFI,1577,221,1973,1395,2007,501,396,B
501,CFI,247,26,1999,240,2063,501,1752,F
501,CGI,683,657,2656,810,2817,501,1973,C
501,DGI,966,309,2965,1680,3743,501,1999,G
501,DFI,1390,1081,4046,5040,7857,501,2656,D
501,FI,2287,1206,5252,1556,5299,501,2965,F
501,GI,788,788,6040,1334,6633,501,5252,G
501,HI,821,821,6861,621,7254,501,6040,H
501,I,10400,3539,10400,11660,11660,501,0,I
501,J,1872,1872,12272,540,12200,501,10400,J
501,K,772,772,13044,1065,13265,501,12272,K
501,J,1880,1880,14924,1690,14955,501,13044,J
501,K,862,862,15786,1938,16893,501,14924,K
501,L,1063,1063,16849,1367,18260,501,15786,L
501,M,446,446,17295,1665,19925,501,16849,M
501,N,1232,1232,18527,90,20015,501,17295,N
501,O,447,447,18974,725,20740,501,18527,O
501,P,5429,5429,24403,3780,24520,501,18974,P
502,A,58,58,58,1011,1011,502,0,A
502,B,1136,1136,1194,240,1251,502,58,B
502,C,802,802,1996,995,2246,502,1194,C
502,D,370,370,2366,4680,6926,502,1996,D
502,M,1638,1638,4004,2133,9059,502,2366,M
502,N,619,619,4623,150,9209,502,4004,N
502,O,761,761,5384,1010,10219,502,4623,O
502,N,1902,1902,7286,1600,11819,502,5384,N
502,O,663,663,7949,615,12434,502,7286,O
502,P,986,986,8935,4230,16664,502,7949,P
503,AE,138,138,138,283,283,503,0,E
503,AF,265,265,403,90,373,503,138,F
503,AG,723,723,1126,1005,1378,503,403,G
503,AH,168,168,1294,3780,5158,503,1126,H
503,A,7540,6246,7540,10861,10861,503,0,A
503,B,3949,3949,11489,90,10951,503,7540,B
503,C,801,801,12290,1245,12196,503,11489,C
503,D,2245,2245,14535,3780,15976,503,12290,D
503,M,332,332,14867,417,16393,503,14535,M
503,N,189,189,15056,150,16543,503,14867,N
503,O,213,213,15269,185,16728,503,15056,O
503,P,524,524,15793,4230,20958,503,15269,P
504,AEI,263,263,263,1251,1251,504,0,I
504,AEJ,1166,1166,1429,240,1491,504,263,J
504,AEK,1663,234,1663,1843,1843,504,0,A
504,BEK,653,419,2082,705,2196,504,1429,K
504,BEL,434,15,2097,300,2143,504,1663,B
504,CEL,2809,712,2809,2910,2910,504,0,E
504,CFL,762,50,2859,750,2893,504,2097,C
504,DFL,850,73,2932,5760,7956,504,2082,L
504,DF,359,236,3168,300,3210,504,2809,F
504,DG,613,613,3781,750,3960,504,3168,G
504,DH,3234,3234,7015,1560,5520,504,3781,H
504,D,8782,4626,11641,1560,4453,504,2859,D
504,M,14852,14852,26493,14854,22810,504,11641,M
504,N,264,264,26757,300,23110,504,26493,N
504,O,625,625,27382,735,23845,504,26757,O
504,P,158,158,27540,1560,25405,504,27382,P
505,AEI,470,470,470,1875,1875,505,0,I
505,AEJ,1429,1429,1899,90,1965,505,470,J
505,AEK,1908,9,1908,2700,2700,505,0,E
505,AFK,841,841,2749,90,2790,505,1908,F
505,AGK,508,508,3257,855,3645,505,2749,G
505,AHK,83,83,3340,3780,7425,505,3257,H
505,AK,1505,64,3404,1745,3710,505,1899,K
505,AL,56,56,3460,3780,7490,505,3404,L
505,A,6993,3533,6993,7129,7129,505,0,A
505,B,162,162,7155,90,7219,505,6993,B
505,C,750,750,7905,1105,8324,505,7155,C
505,D,492,492,8397,3780,12104,505,7905,D
505,M,724,724,9121,809,12913,505,8397,M
505,N,143,143,9264,90,13003,505,9121,N
505,O,397,397,9661,800,13803,505,9264,O
505,P,1395,1395,11056,3780,17583,505,9661,P
506,AE,145,145,145,166,166,506,0,E
506,AF,288,143,288,1059,1059,506,0,A
506,BF,144,1,289,150,316,506,145,F
506,BG,172,172,461,805,1121,506,289,G
506,BH,82,82,543,3600,4721,506,461,H
506,B,951,696,1239,240,1299,506,288,B
506,C,155,155,1394,395,1694,506,1239,C
506,D,4394,4394,5788,9700,11394,506,1394,D
506,M,940,940,6728,1224,12618,506,5788,M
506,N,388,388,7116,150,12768,506,6728,N
506,O,240,240,7356,180,12948,506,7116,O
506,N,1564,1564,8920,1600,14548,506,7356,N
506,O,681,681,9601,510,15058,506,8920,O
506,P,9586,9586,19187,4230,19288,506,9601,P
507,A,46,46,46,34,34,507,0,A
507,B,104,104,150,180,214,507,46,B
507,C,148,148,298,225,439,507,150,C
507,B,1079,1079,1377,990,1429,507,298,B
507,C,269,269,1646,2805,4234,507,1377,C
507,D,4749,4749,6395,1620,5854,507,1646,D
507,M,1387,1387,7782,1428,7282,507,6395,M
507,N,128,128,7910,150,7432,507,7782,N
507,O,188,188,8098,155,7587,507,7910,O
507,N,875,875,8973,905,8492,507,8098,N
507,O,125,125,9098,285,8777,507,8973,O
507,P,119,119,9217,5100,13877,507,9098,P
508,AEI,336,336,336,1263,1263,508,0,A
508,BEI,899,563,899,1123,1123,508,0,E
508,BFI,256,256,1155,90,1213,508,899,F
508,BGI,957,138,1293,90,1353,508,336,B
508,CGI,932,794,2087,1240,2453,508,1155,G
508,CHI,14,14,2101,3780,6233,508,2087,H
508,CI,1030,222,2323,1200,2553,508,1293,C
508,DI,94,94,2417,3780,6333,508,2323,D
508,I,36988,34571,36988,37994,37994,508,0,I
508,J,1036,1036,38024,90,38084,508,36988,J
508,K,912,912,38936,1210,39294,508,38024,K
508,L,6,6,38942,3780,43074,508,38936,L
508,M,4394,4394,43336,4715,47789,508,38942,M
508,N,348,348,43684,90,47879,508,43336,N
508,O,299,299,43983,705,48584,508,43684,O
508,P,1081,1081,45064,3780,52364,508,43983,P
509,AEI,194,194,194,88,88,509,0,I
509,AEJ,82,82,276,240,328,509,194,J
509,AEK,156,156,432,380,708,509,276,K
509,AEJ,814,382,814,1065,1065,509,0,A
509,BEJ,1145,331,1145,1515,1515,509,0,E
509,BFJ,717,4,1149,460,1168,509,432,J
509,BFK,525,190,1339,300,1365,509,814,B
509,CFK,557,367,1706,790,1958,509,1149,K
509,CFL,575,14,1720,240,1755,509,1145,F
509,CGL,632,632,2352,785,2540,509,1720,G
509,CHL,1015,2,2354,835,2200,509,1339,C
509,DHL,371,371,2725,3960,6160,509,2354,D
509,HL,834,461,3186,3960,6500,509,2352,H
509,L,2811,1331,4517,3960,5918,509,1706,L
509,M,393,393,4910,520,7020,509,4517,M
509,N,431,431,5341,300,7320,509,4910,N
509,O,706,706,6047,910,8230,509,5341,O
509,P,170,170,6217,3960,12190,509,6047,P
510,A,210,210,210,1109,1109,510,0,A
510,B,1019,1019,1229,180,1289,510,210,B
510,C,902,902,2131,1050,2339,510,1229,C
510,D,781,781,2912,6460,8799,510,2131,D
510,M,37012,37012,39924,37993,46792,510,2912,M
510,N,1011,1011,40935,90,46882,510,39924,N
510,O,979,979,41914,1210,48092,510,40935,O
510,P,8,8,41922,3780,51872,510,41914,P
511,A,29,29,29,904,904,511,0,A
511,B,1079,1079,1108,240,1144,511,29,B
511,C,791,791,1899,970,2114,511,1108,C
511,D,1369,1369,3268,3960,6074,511,1899,D
511,M,444,444,3712,1425,7499,511,3268,M
511,N,1007,1007,4719,90,7589,511,3712,N
511,O,511,511,5230,880,8469,511,4719,O
511,N,497,497,5727,110,8579,511,5230,N
511,O,1418,1418,7145,2315,10894,511,5727,O
511,P,1512,1512,8657,3420,14314,511,7145,P
512,A,47,47,47,140,140,512,0,A
512,B,273,273,320,240,380,512,47,B
512,C,762,762,1082,975,1355,512,320,C
512,D,2227,2227,3309,5040,6395,512,1082,D
512,M,59,59,3368,1051,7446,512,3309,M
512,N,1416,1416,4784,240,7686,512,3368,N
512,O,776,776,5560,940,8626,512,4784,O
512,P,3670,3670,9230,6990,15616,512,5560,P
513,AEI,266,266,266,1734,1734,513,0,A
513,BEI,954,688,954,1254,1254,513,0,E
513,BFI,437,437,1391,180,1434,513,954,F
513,BGI,1672,547,1938,250,1984,513,266,B
513,CGI,889,342,2280,900,2334,513,1391,G
513,CHI,2645,365,2645,3683,3683,513,0,I
513,CHJ,938,231,2876,910,2894,513,1938,C
513,DHJ,400,400,3276,550,3444,513,2876,D
513,HJ,1309,678,3954,300,3983,513,2645,J
513,HK,1144,1144,5098,1050,5033,513,3954,K
513,HJ,501,501,5599,720,5753,513,5098,J
513,HK,3388,69,5668,550,2884,513,2280,H
513,K,752,683,6351,780,6533,513,5599,K
513,L,2034,2034,8385,3960,10493,513,6351,L
513,M,257,257,8642,404,10897,513,8385,M
513,N,389,389,9031,270,11167,513,8642,N
513,O,1276,1276,10307,1115,12282,513,9031,O
513,P,6633,6633,16940,335,12617,513,10307,P
514,AE,3089,3089,3089,4310,4310,514,0,A
514,BE,1716,1716,4805,90,4400,514,3089,B
514,CE,1114,1114,5919,1430,5830,514,4805,C
514,DE,233,233,6152,3780,9610,514,5919,D
514,E,20566,14414,20566,20648,20648,514,0,E
514,F,440,440,21006,90,20738,514,20566,F
514,G,874,874,21880,1110,21848,514,21006,G
514,H,2877,2877,24757,3780,25628,514,21880,H
514,M,4011,4011,28768,4322,29950,514,24757,M
514,N,361,361,29129,90,30040,514,28768,N
514,O,531,531,29660,845,30885,514,29129,O
514,P,549,549,30209,3780,34665,514,29660,P
515,A,917,917,917,1109,1109,515,0,A
515,B,388,388,1305,240,1349,515,917,B
515,C,836,836,2141,915,2264,515,1305,C
515,D,1849,1849,3990,3960,6224,515,2141,D
515,M,12,12,4002,85,6309,515,3990,M
515,N,210,210,4212,150,6459,515,4002,N
515,O,201,201,4413,475,6934,515,4212,O
515,P,7,7,4420,3960,10894,515,4413,P
516,AEI,165,165,165,2092,2092,516,0,A
516,BEI,263,98,263,1326,1326,516,0,E
516,BFI,576,313,576,1255,1255,516,0,I
516,BFJ,709,709,1285,90,1345,516,576,J
516,BFK,1241,219,1504,240,1566,516,263,F
516,BGK,440,221,1725,820,2165,516,1285,K
516,BGJ,786,565,2290,930,2496,516,1504,G
516,BHJ,2154,29,2319,240,2332,516,165,B
516,CHJ,944,350,2669,560,2725,516,1725,J
516,CHK,687,337,3006,960,3292,516,2319,C
516,DHK,73,73,3079,3960,7252,516,3006,D
516,HK,1101,312,3391,6990,9486,516,2290,H
516,K,1153,431,3822,1625,4350,516,2669,K
516,L,1235,1235,5057,3780,8130,516,3822,L
516,M,20113,20113,25170,21935,31421,516,5057,M
516,N,2847,2847,28017,90,31511,516,25170,N
516,O,1886,1886,29903,2250,33761,516,28017,O
516,N,2056,2056,31959,2670,36431,516,29903,N
516,O,513,513,32472,890,37321,516,31959,O
516,P,192,192,32664,3780,41101,516,32472,P
517,AEI,9,9,9,42,42,517,0,E
517,AFI,42,33,42,132,132,517,0,A
517,BFI,137,104,146,150,192,517,9,F
517,BGI,172,68,214,135,267,517,42,B
517,CGI,120,52,266,120,312,517,146,G
517,CHI,30,30,296,4230,4542,517,266,H
517,CI,185,103,399,285,552,517,214,C
517,DI,431,32,431,459,459,517,0,I
517,DJ,99,67,498,5160,5712,517,399,D
517,J,130,63,561,150,609,517,431,J
517,K,203,203,764,280,889,517,561,K
517,L,903,903,1667,5160,6049,517,764,L
517,M,724,724,2391,1032,7081,517,1667,M
517,N,343,343,2734,90,7171,517,2391,N
517,O,892,892,3626,1240,8411,517,2734,O
517,P,19,19,3645,3780,12191,517,3626,P
518,AEI,261,261,261,888,888,518,0,E
518,AFI,288,27,288,779,779,518,0,I
518,AFJ,671,671,959,240,1019,518,288,J
518,AFK,991,32,991,999,999,518,0,A
518,BFK,807,77,1068,240,1128,518,261,F
518,BGK,131,22,1090,380,1399,518,959,K
518,BGL,188,89,1179,240,1239,518,991,B
518,CGL,149,38,1217,395,1523,518,1068,G
518,CHL,142,104,1321,395,1634,518,1179,C
518,DHL,1383,1279,2600,9700,11223,518,1217,H
518,DL,1771,261,2861,9700,11099,518,1090,L
518,D,2848,1308,4169,9700,11334,518,1321,D
518,M,331,331,4500,1042,12376,518,4169,M
518,N,807,807,5307,150,12526,518,4500,N
518,O,236,236,5543,190,12716,518,5307,O
518,N,324,324,5867,350,13066,518,5543,N
518,O,618,618,6485,780,13846,518,5867,O
518,P,629,629,7114,4230,18076,518,6485,P
519,AE,524,524,524,823,823,519,0,E
519,AF,356,356,880,90,913,519,524,F
519,AG,1365,1365,2245,1865,2778,519,880,G
519,AH,2910,2910,5155,3780,6558,519,2245,H
519,A,6740,1585,6740,6875,6875,519,0,A
519,B,449,449,7189,360,7235,519,6740,B
519,C,666,666,7855,725,7960,519,7189,C
519,D,489,489,8344,1140,9100,519,7855,D
519,M,116,116,8460,262,9362,519,8344,M
519,N,336,336,8796,180,9542,519,8460,N
519,O,943,943,9739,1245,10787,519,8796,O
519,P,1107,1107,10846,6680,17467,519,9739,P
520,AEI,180,180,180,916,916,520,0,E
520,AFI,283,103,283,314,314,520,0,I
520,AFJ,122,122,405,150,464,520,283,J
520,AFK,170,170,575,405,869,520,405,K
520,AFL,488,488,1063,3170,4039,520,575,L
520,AF,916,33,1096,240,1156,520,180,F
520,AG,1161,65,1161,1194,1194,520,0,A
520,BG,122,122,1283,150,1344,520,1161,B
520,CG,214,27,1310,415,1571,520,1096,G
520,CH,56,56,1366,5160,6731,520,1310,H
520,C,181,98,1464,455,1799,520,1283,C
520,D,891,891,2355,3565,5364,520,1464,D
520,M,32296,32296,34651,37993,44724,520,2355,M
520,N,5723,5723,40374,90,44814,520,34651,N
520,O,934,934,41308,1220,46034,520,40374,O
520,P,1281,1281,42589,4625,50659,520,41308,P
521,AEI,25,25,25,1266,1266,521,0,I
521,AEJ,177,152,177,1170,1170,521,0,E
521,AFJ,556,379,556,466,466,521,0,A
521,BFJ,103,103,659,240,706,521,556,B
521,CFJ,129,129,788,380,1086,521,659,C
521,BFJ,1436,673,1461,240,1506,521,25,J
521,BFK,729,56,1517,460,1546,521,788,B
521,CFK,1382,42,1559,420,1590,521,177,F
521,CGK,470,372,1931,785,2291,521,1461,K
521,CGL,541,127,2058,790,2336,521,1517,C
521,DGL,248,121,2179,3960,6251,521,1931,L
521,DG,1175,555,2734,830,2420,521,1559,G
521,DH,216,216,2950,3960,6380,521,2734,H
521,D,1216,324,3274,3960,6296,521,2058,D
521,M,271,271,3545,364,6744,521,3274,M
521,N,389,389,3934,300,7044,521,3545,N
521,O,624,624,4558,775,7819,521,3934,O
521,P,7421,7421,11979,3960,11779,521,4558,P
522,AE,456,456,456,1884,1884,522,0,E
522,AF,1129,673,1129,1335,1335,522,0,A
522,BF,481,481,1610,300,1635,522,1129,B
522,CF,1212,58,1668,240,2124,522,456,F
522,CG,676,618,2286,2035,3670,522,1610,C
522,DG,2024,1406,3692,900,3024,522,1668,G
522,DH,2161,755,4447,2760,6430,522,2286,D
522,H,1085,330,4777,840,3864,522,3692,H
522,M,51,51,4828,121,6551,522,4777,M
522,N,265,265,5093,240,6791,522,4828,N
522,O,126,126,5219,370,7161,522,5093,O
522,P,637,637,5856,6225,13386,522,5219,P
523,A,37704,37704,37704,37750,37750,523,0,A
523,B,643,643,38347,90,37840,523,37704,B
523,C,1141,1141,39488,1420,39260,523,38347,C
523,D,79,79,39567,3780,43040,523,39488,D
523,M,242,242,39809,1409,44449,523,39567,M
523,N,1197,1197,41006,90,44539,523,39809,N
523,O,470,470,41476,850,45389,523,41006,O
523,P,25905,25905,67381,3780,49169,523,41476,P
524,A,111,111,111,907,907,524,0,A
524,B,887,887,998,110,1017,524,111,B
524,C,195,195,1193,285,1302,524,998,C
524,D,263,263,1456,5160,6462,524,1193,D
524,M,166,166,1622,144,6606,524,1456,M
524,N,232,232,1854,300,6906,524,1622,N
524,O,339,339,2193,470,7376,524,1854,O
524,P,7790,7790,9983,4020,11396,524,2193,P
525,AEI,82,82,82,231,231,525,0,E
525,AFI,157,75,157,1087,1087,525,0,A
525,BFI,376,301,458,300,531,525,82,F
525,BGI,671,213,671,619,619,525,0,I
525,BGJ,333,333,1004,420,1039,525,671,J
525,BGK,570,24,1028,775,1306,525,458,G
525,BHK,143,119,1147,415,1454,525,1004,K
525,BHL,28,28,1175,5160,6614,525,1147,L
525,BH,1050,32,1207,180,1267,525,157,B
525,CH,1092,913,2120,5320,6626,525,1028,H
525,C,1010,97,2217,1050,2317,525,1207,C
525,D,705,705,2922,5040,7357,525,2217,D
525,M,89,89,3011,1124,8481,525,2922,M
525,N,1079,1079,4090,90,8571,525,3011,N
525,O,979,979,5069,1220,9791,525,4090,O
525,P,2,2,5071,3780,13571,525,5069,P
526,AE,164,164,164,833,833,526,0,A
526,BE,247,83,247,890,890,526,0,E
526,BF,717,717,964,120,1010,526,247,F
526,BG,819,19,983,210,1043,526,164,B
526,CG,136,117,1100,355,1365,526,964,G
526,CH,785,668,1768,1000,2043,526,983,C
526,DH,694,694,2462,5165,7208,526,1768,D
526,H,2799,1437,3899,5510,6875,526,1100,H
526,M,1659,1659,5558,4029,11237,526,3899,M
526,N,2431,2431,7989,90,11327,526,5558,N
526,O,1093,1093,9082,1210,12537,526,7989,O
526,N,523,523,9605,430,12967,526,9082,N
526,O,741,741,10346,1060,14027,526,9605,O
526,P,130,130,10476,3780,17807,526,10346,P
527,A,2991,2991,2991,3624,3624,527,0,A
527,B,661,661,3652,90,3714,527,2991,B
527,C,747,747,4399,1130,4844,527,3652,C
527,D,114,114,4513,3780,8624,527,4399,D
527,M,453,453,4966,732,9356,527,4513,M
527,N,305,305,5271,90,9446,527,4966,N
527,O,432,432,5703,860,10306,527,5271,O
527,P,46,46,5749,3780,14086,527,5703,P
528,AEI,3,3,3,34,34,528,0,I
528,AEJ,128,128,131,150,184,528,3,J
528,AEK,109,109,240,125,309,528,131,K
528,AEJ,324,84,324,877,877,528,0,E
528,AFJ,419,95,419,1264,1264,528,0,A
528,BFJ,748,653,1072,240,1117,528,324,F
528,BGJ,205,205,1277,410,1527,528,1072,G
528,BFJ,1121,84,1361,1085,1394,528,240,J
528,BFK,947,5,1366,150,1414,528,419,B
528,CFK,350,345,1711,650,2044,528,1361,K
528,CFL,750,405,2116,1030,2444,528,1366,C
528,BFL,1493,654,2770,1285,2812,528,1277,F
528,BGL,368,368,3138,915,3727,528,2770,G
528,BHL,1146,124,3262,850,3294,528,2116,B
528,CHL,398,398,3660,650,3944,528,3262,C
528,DHL,3010,1061,4721,4230,6274,528,1711,L
528,DH,1784,723,5444,4230,8174,528,3660,D
528,H,6163,3857,9301,3960,7687,528,3138,H
528,M,1800,1800,11101,3191,11365,528,9301,M
528,N,1421,1421,12522,90,11455,528,11101,N
528,O,1545,1545,14067,1875,13330,528,12522,O
528,N,654,654,14721,300,13630,528,14067,N
528,O,387,387,15108,790,14420,528,14721,O
528,P,882,882,15990,3780,18200,528,15108,P
529,AE,264,264,264,1294,1294,529,0,E
529,AF,1063,1063,1327,90,1384,529,264,F
529,AG,833,833,2160,1200,2584,529,1327,G
529,AH,1973,1973,4133,3780,6364,529,2160,H
529,A,37066,32933,37066,38054,38054,529,0,A
529,B,1019,1019,38085,90,38144,529,37066,B
529,C,986,986,39071,1220,39364,529,38085,C
529,D,212,212,39283,3780,43144,529,39071,D
529,M,505,505,39788,602,43746,529,39283,M
529,N,213,213,40001,150,43896,529,39788,N
529,O,1005,1005,41006,845,44741,529,40001,O
529,N,421,421,41427,520,45261,529,41006,N
529,O,609,609,42036,735,45996,529,41427,O
529,P,4485,4485,46521,4230,50226,529,42036,P
530,AE,636,636,636,1273,1273,530,0,E
530,AF,1217,581,1217,2219,2219,530,0,A
530,BF,884,303,1520,240,1513,530,636,F
530,BG,221,221,1741,4105,5618,530,1520,G
530,BH,137,137,1878,320,5938,530,1741,H
530,B,1197,536,2414,240,2459,530,1217,B
530,C,184,184,2598,265,2724,530,2414,C
530,D,7163,7163,9761,5460,8184,530,2598,D
530,M,206,206,9967,235,8419,530,9761,M
530,N,114,114,10081,150,8569,530,9967,N
530,O,148,148,10229,455,9024,530,10081,O
530,P,923,923,11152,3565,12589,530,10229,P
531,AE,18,18,18,471,471,531,0,A
531,BE,503,503,521,120,591,531,18,B
531,CE,658,137,658,816,816,531,0,E
531,CF,207,70,728,390,981,531,521,C
531,BF,210,140,868,90,906,531,658,F
531,BG,536,536,1404,820,1726,531,868,G
531,BF,1417,741,2145,1225,2206,531,728,B
531,CF,1032,291,2436,765,2491,531,1404,F
531,CG,690,399,2835,810,3016,531,2145,C
531,DG,173,173,3008,5100,8116,531,2835,D
531,G,672,100,3108,1115,3606,531,2436,G
531,H,188,188,3296,3780,7386,531,3108,H
531,M,4012,4012,7308,4215,12331,531,3296,M
531,N,234,234,7542,90,12421,531,7308,N
531,O,836,836,8378,1110,13531,531,7542,O
531,P,45,45,8423,3780,17311,531,8378,P
532,AEI,114,114,114,349,349,532,0,I
532,AEJ,171,57,171,350,350,532,0,A
532,BEJ,245,74,245,430,430,532,0,E
532,BFJ,257,183,428,135,485,532,171,B
532,CFJ,328,14,442,150,499,532,114,J
532,CFK,442,245,687,300,730,532,245,F
532,CGK,726,467,1154,845,1330,532,428,C
532,DGK,733,21,1175,845,1344,532,442,K
532,DGL,554,66,1241,735,1465,532,687,G
532,DHL,214,214,1455,1560,3025,532,1241,H
532,DL,1673,1372,2827,5220,6550,532,1154,D
532,L,1792,140,2967,5220,6564,532,1175,L
532,M,4387,4387,7354,4536,11100,532,2967,M
532,N,515,515,7869,395,11495,532,7354,N
532,O,1079,1079,8948,830,12325,532,7869,O
532,N,1489,1489,10437,1750,14075,532,8948,N
532,O,738,738,11175,1570,15645,532,10437,O
532,P,1168,1168,12343,7350,22995,532,11175,P
533,AEI,1,1,1,447,447,533,0,I
533,AEJ,634,634,635,240,687,533,1,J
533,AEK,895,895,1530,1035,1722,533,635,K
533,AEJ,1719,189,1719,2623,2623,533,0,A
533,BEJ,1901,182,1901,2095,2095,533,0,E
533,BFJ,404,404,2305,240,2335,533,1901,F
533,BGJ,999,413,2718,150,2773,533,1719,B
533,CGJ,801,388,3106,970,3305,533,2305,G
533,CFJ,321,321,3427,30,3335,533,3106,F
533,CGJ,845,136,3563,725,3498,533,2718,C
533,BGJ,2683,650,4213,2610,4332,533,1530,J
533,BGK,942,292,4505,1055,4553,533,3563,B
533,CGK,209,209,4714,145,4698,533,4505,C
533,DGK,2279,992,5706,2700,6035,533,3427,G
533,DHK,1111,119,5825,4230,8928,533,4714,D
533,HK,2530,918,6743,2700,7032,533,4213,K
533,HL,1342,1342,8085,3960,10992,533,6743,L
533,H,2870,491,8576,3960,9995,533,5706,H
533,M,52,52,8628,1098,12090,533,8576,M
533,N,1244,1244,9872,240,12330,533,8628,N
533,O,184,184,10056,435,12765,533,9872,O
533,N,329,329,10385,75,12840,533,10056,N
533,O,753,753,11138,965,13805,533,10385,O
533,P,3100,3100,14238,3960,17765,533,11138,P
534,AE,943,943,943,1409,1409,534,0,E
534,AF,506,506,1449,90,1499,534,943,F
534,AG,1012,1012,2461,1240,2739,534,1449,G
534,AH,60,60,2521,3780,6519,534,2461,H
534,A,32266,29745,32266,33285,33285,534,0,A
534,B,1049,1049,33315,90,33375,534,32266,B
534,C,1010,1010,34325,1210,34585,534,33315,C
534,D,9,9,34334,3780,38365,534,34325,D
534,M,335,335,34669,808,39173,534,34334,M
534,N,506,506,35175,90,39263,534,34669,N
534,O,1458,1458,36633,1935,41198,534,35175,O
534,P,1317,1317,37950,3780,44978,534,36633,P
535,AE,103,103,103,147,147,535,0,E
535,AF,131,131,234,150,297,535,103,F
535,AG,168,168,402,455,752,535,234,G
535,AH,1044,642,1044,1477,1477,535,0,A
535,BH,891,249,1293,3565,4317,535,402,H
535,B,673,424,1717,300,1777,535,1044,B
535,C,740,740,2457,830,2607,535,1717,C
535,D,69,69,2526,5310,7917,535,2457,D
535,M,96,96,2622,1072,8989,535,2526,M
535,N,1159,1159,3781,240,9229,535,2622,N
535,O,856,856,4637,1020,10249,535,3781,O
535,P,385,385,5022,4680,14929,535,4637,P
536,A,429,429,429,630,630,536,0,A
536,B,227,227,656,90,720,536,429,B
536,C,549,549,1205,845,1565,536,656,C
536,D,784,784,1989,3780,5345,536,1205,D
536,M,250,250,2239,980,6325,536,1989,M
536,N,976,976,3215,300,6625,536,2239,N
536,O,673,673,3888,920,7545,536,3215,O
536,N,285,285,4173,75,7620,536,3888,N
536,O,823,823,4996,1080,8700,536,4173,O
536,P,1514,1514,6510,3960,12660,536,4996,P
537,A,50,50,50,250,250,537,0,A
537,B,304,304,354,135,385,537,50,B
537,C,248,248,602,285,670,537,354,C
537,D,180,180,782,5160,5830,537,602,D
537,M,788,788,1570,1394,7224,537,782,M
537,N,783,783,2353,240,7464,537,1570,N
537,O,409,409,2762,775,8239,537,2353,O
537,P,3580,3580,6342,3600,11839,537,2762,P
538,AEI,138,138,138,39,39,538,0,A
538,BEI,189,51,189,50,50,538,0,E
538,BFI,85,34,223,240,279,538,138,B
538,CFI,111,77,300,300,350,538,189,F
538,CGI,121,44,344,380,659,538,223,C
538,BGI,287,243,587,395,745,538,300,G
538,BHI,83,83,670,2040,2785,538,587,H
538,BI,1509,839,1509,1841,1841,538,0,I
538,BJ,447,447,1956,150,1991,538,1509,J
538,BK,209,209,2165,185,2176,538,1956,K
538,BJ,2243,422,2587,1975,2634,538,344,B
538,CJ,824,402,2989,865,3041,538,2165,J
538,CK,682,280,3269,920,3554,538,2587,C
538,DK,162,162,3431,3960,7514,538,3269,D
538,K,722,280,3711,650,3691,538,2989,K
538,L,14871,14871,18582,4230,7921,538,3711,L
538,M,154,154,18736,675,8596,538,18582,M
538,N,781,781,19517,300,8896,538,18736,N
538,O,917,917,20434,925,9821,538,19517,O
538,P,212,212,20646,2760,12581,538,20434,P
539,AE,8,8,8,207,207,539,0,E
539,AF,167,159,167,428,428,539,0,A
539,BF,379,220,387,240,447,539,8,F
539,BG,363,143,530,165,593,539,167,B
539,CG,603,603,1133,855,1448,539,530,C
539,DG,81,81,1214,3780,5228,539,1133,D
539,G,901,74,1288,1075,1522,539,387,G
539,H,1509,1509,2797,5400,6922,539,1288,H
539,M,35,35,2832,44,6966,539,2797,M
539,N,84,84,2916,135,7101,539,2832,N
539,O,159,159,3075,280,7381,539,2916,O
539,P,95,95,3170,5160,12541,539,3075,P
540,AEI,8,8,8,468,468,540,0,I
540,AEJ,84,76,84,169,169,540,0,A
540,BEJ,188,188,272,165,334,540,84,B
540,CEJ,592,320,592,1416,1416,540,0,E
540,CFJ,669,85,677,270,738,540,8,J
540,CFK,603,198,875,855,1189,540,272,C
540,DFK,139,139,1014,5220,6409,540,875,D
540,FK,605,268,1282,735,1473,540,677,K
540,FL,944,254,1536,180,1596,540,592,F
540,GL,1102,848,2384,5315,6788,540,1282,L
540,G,981,133,2517,1050,2646,540,1536,G
540,H,2206,2206,4723,5040,7686,540,2517,H
540,M,339,339,5062,1319,9005,540,4723,M
540,N,1010,1010,6072,90,9095,540,5062,N
540,O,1005,1005,7077,1210,10305,540,6072,O
540,N,2043,2043,9120,1815,12120,540,7077,N
540,O,691,691,9811,945,13065,540,9120,O
540,P,1741,1741,11552,3780,16845,540,9811,P
541,A,338,338,338,672,672,541,0,A
541,B,402,402,740,90,762,541,338,B
541,C,1378,1378,2118,1935,2697,541,740,C
541,D,7618,7618,9736,3780,6477,541,2118,D
541,M,379,379,10115,354,6831,541,9736,M
541,N,215,215,10330,300,7131,541,10115,N
541,O,545,545,10875,795,7926,541,10330,O
541,N,1505,1505,12380,1250,9176,541,10875,N
541,O,813,813,13193,740,9916,541,12380,O
541,P,4793,4793,17986,5100,15016,541,13193,P
542,A,898,898,898,1158,1158,542,0,A
542,B,441,441,1339,180,1338,542,898,B
542,C,904,904,2243,1200,2538,542,1339,C
542,B,3051,3051,5294,2795,5333,542,2243,B
542,C,806,806,6100,2049,7382,542,5294,C
542,D,1089,1089,7189,846,8228,542,6100,D
542,M,1287,1287,8476,1513,9741,542,7189,M
542,N,809,809,9285,600,10341,542,8476,N
542,O,1313,1313,10598,1345,11686,542,9285,O
542,P,331,331,10929,385,12071,542,10598,P
543,AE,362,362,362,934,934,543,0,E
543,AF,721,721,1083,180,1114,543,362,F
543,AG,1555,472,1555,3594,3594,543,0,A
543,BG,1286,814,2369,710,1824,543,1083,G
543,BF,505,505,2874,1110,2934,543,2369,F
543,BG,585,585,3459,585,3519,543,2874,G
543,BH,2155,251,3710,180,3774,543,1555,B
543,CH,1405,1405,5115,685,4459,543,3710,C
543,BH,2352,696,5811,6960,10479,543,3459,H
543,B,708,12,5823,1415,5874,543,5115,B
543,C,481,481,6304,565,6439,543,5823,C
543,D,3774,3774,10078,7020,13459,543,6304,D
543,M,352,352,10430,861,14320,543,10078,M
543,N,616,616,11046,150,14470,543,10430,N
543,O,173,173,11219,140,14610,543,11046,O
543,N,448,448,11667,470,15080,543,11219,N
543,O,700,700,12367,660,15740,543,11667,O
543,P,217,217,12584,4230,19970,543,12367,P
544,AE,299,299,299,1322,1322,544,0,E
544,AF,1053,1053,1352,90,1412,544,299,F
544,AG,1601,249,1601,1731,1731,544,0,A
544,BG,211,211,1812,90,1821,544,1601,B
544,CG,989,529,2341,1210,2622,544,1352,G
544,CH,22,22,2363,3780,6402,544,2341,H
544,C,613,62,2425,860,2681,544,1812,C
544,D,1691,1691,4116,3780,6461,544,2425,D
544,M,160,160,4276,953,7414,544,4116,M
544,N,824,824,5100,90,7504,544,4276,N
544,O,597,597,5697,845,8349,544,5100,O
544,P,1146,1146,6843,3780,12129,544,5697,P
545,A,1253,1253,1253,1422,1422,545,0,A
545,B,401,401,1654,150,1572,545,1253,B
545,C,645,645,2299,585,2157,545,1654,C
545,B,154,154,2453,340,2497,545,2299,B
545,C,119,119,2572,130,2627,545,2453,C
545,D,4079,4079,6651,4230,6857,545,2572,D
545,M,241,241,6892,1738,8595,545,6651,M
545,N,1583,1583,8475,150,8745,545,6892,N
545,O,148,148,8623,140,8885,545,8475,O
545,N,942,942,9565,845,9730,545,8623,N
545,O,1424,1424,10989,800,10530,545,9565,O
545,P,14522,14522,25511,4230,14760,545,10989,P
546,AE,1264,1264,1264,1614,1614,546,0,E
546,AF,1735,1735,2999,420,2034,546,1264,F
546,AG,373,373,3372,517,2551,546,2999,G
546,AH,3533,161,3533,3863,3863,546,0,A
546,BH,630,469,4002,318,2869,546,3372,H
546,B,703,234,4236,90,3953,546,3533,B
546,C,557,557,4793,815,4768,546,4236,C
546,B,3614,3614,8407,3695,8463,546,4793,B
546,C,1346,1346,9753,1840,10303,546,8407,C
546,D,1118,1118,10871,3780,14083,546,9753,D
546,M,2771,2771,13642,5163,19246,546,10871,M
546,N,890,890,14532,90,19336,546,13642,N
546,O,3577,3577,18109,1040,20376,546,14532,O
546,P,650,650,18759,3780,24156,546,18109,P
547,A,227,227,227,963,963,547,0,A
547,B,936,936,1163,240,1203,547,227,B
547,C,769,769,1932,970,2173,547,1163,C
547,D,51,51,1983,3960,6133,547,1932,D
547,M,549,549,2532,721,6854,547,1983,M
547,N,200,200,2732,90,6944,547,2532,N
547,O,586,586,3318,905,7849,547,2732,O
547,P,150,150,3468,3780,11629,547,3318,P
548,AEI,135,135,135,203,203,548,0,E
548,AFI,174,39,174,1065,1065,548,0,I
548,AFJ,151,112,286,150,353,548,135,F
548,AGJ,612,612,898,795,1148,548,286,G
548,AHJ,1174,276,1174,1505,1505,548,0,A
548,BHJ,1011,11,1185,180,1245,548,174,J
548,BHK,568,557,1742,300,1805,548,1174,B
548,CHK,979,422,2164,1050,2295,548,1185,K
548,CHL,637,215,2379,820,2625,548,1742,C
548,DHL,143,143,2522,5315,7940,548,2379,D
548,HL,2784,1160,3682,2880,4028,548,898,H
548,L,1577,59,3741,5400,7695,548,2164,L
548,M,71,71,3812,1205,9145,548,3741,M
548,N,1163,1163,4975,90,9235,548,3812,N
548,O,944,944,5919,1220,10455,548,4975,O
548,N,485,485,6404,195,10650,548,5919,N
548,O,151,151,6555,585,11235,548,6404,O
548,P,1276,1276,7831,3780,15015,548,6555,P
549,A,35,35,35,35,35,549,0,A
549,B,61,61,96,120,155,549,35,B
549,C,124,124,220,125,280,549,96,C
549,D,2480,2480,2700,3000,3280,549,220,D
549,M,286,286,2986,932,4212,549,2700,M
549,N,774,774,3760,180,4392,549,2986,N
549,O,146,146,3906,220,4612,549,3760,O
549,N,680,680,4586,595,5207,549,3906,N
549,O,143,143,4729,655,5862,549,4586,O
549,P,1009,1009,5738,3710,9572,549,4729,P
550,A,1060,1060,1060,1726,1726,550,0,A
550,B,1058,1058,2118,420,2146,550,1060,B
550,C,784,784,2902,945,3091,550,2118,C
550,D,811,811,3713,350,3441,550,2902,D
550,M,4457,4457,8170,4702,8143,550,3713,M
550,N,302,302,8472,90,8233,550,8170,N
550,O,285,285,8757,705,8938,550,8472,O
550,P,1075,1075,9832,3780,12718,550,8757,P
551,A,1741,1741,1741,2021,2021,551,0,A
551,B,328,328,2069,90,2111,551,1741,B
551,C,1090,1090,3159,1315,3426,551,2069,C
551,D,3278,3278,6437,3780,7206,551,3159,D
551,M,491,491,6928,1451,8657,551,6437,M
551,N,1145,1145,8073,240,8897,551,6928,N
551,O,1490,1490,9563,1820,10717,551,8073,O
551,P,298,298,9861,3840,14557,551,9563,P
552,AEI,1085,1085,1085,1463,1463,552,0,A
552,BEI,403,403,1488,90,1553,552,1085,B
552,CEI,436,436,1924,805,2358,552,1488,C
552,BEI,4703,2779,4703,5966,5966,552,0,E
552,BFI,1282,1282,5985,90,6056,552,4703,F
552,BGI,4500,439,6424,4120,6478,552,1924,B
552,CGI,709,709,7133,920,7398,552,6424,C
552,DGI,1233,85,7218,1370,7426,552,5985,G
552,DFI,7427,209,7427,8883,8883,552,0,I
552,DFJ,596,387,7814,440,7866,552,7218,F
552,DGJ,863,182,7996,3780,11178,552,7133,D
552,GJ,618,436,8432,935,8801,552,7814,G
552,HJ,388,388,8820,3780,12581,552,8432,H
552,J,1609,216,9036,180,9063,552,7427,J
552,K,623,623,9659,885,9948,552,9036,K
552,J,2114,2114,11773,1885,11833,552,9659,J
552,K,958,958,12731,1070,12903,552,11773,K
552,L,510,510,13241,6900,19803,552,12731,L
552,M,553,553,13794,1407,21210,552,13241,M
552,N,884,884,14678,90,21300,552,13794,N
552,O,612,612,15290,960,22260,552,14678,O
552,N,745,745,16035,390,22650,552,15290,N
552,O,1432,1432,17467,1390,24040,552,16035,O
552,P,564,564,18031,3780,27820,552,17467,P
553,AEI,616,616,616,1370,1370,553,0,I
553,AEJ,720,104,720,1350,1350,553,0,E
553,AFJ,678,678,1398,90,1440,553,720,F
553,AGJ,892,110,1508,180,1550,553,616,J
553,AGK,423,313,1821,800,2240,553,1398,G
553,AHK,2323,502,2323,2650,2650,553,0,A
553,BHK,949,134,2457,1060,2610,553,1508,K
553,BHL,843,207,2664,3780,6020,553,1821,H
553,BL,360,19,2683,90,2740,553,2323,B
553,CL,856,856,3539,1110,3850,553,2683,C
553,BL,1183,101,3640,4080,6690,553,2457,L
553,B,410,309,3949,135,3985,553,3539,B
553,C,415,415,4364,795,4780,553,3949,C
553,D,1844,1844,6208,3780,8560,553,4364,D
553,M,1392,1392,7600,1562,10122,553,6208,M
553,N,209,209,7809,90,10212,553,7600,N
553,O,508,508,8317,800,11012,553,7809,O
553,N,1129,1129,9446,850,11862,553,8317,N
553,O,380,380,9826,735,12597,553,9446,O
553,P,2258,2258,12084,3780,16377,553,9826,P
554,AEI,116,116,116,677,677,554,0,E
554,AFI,460,344,460,506,506,554,0,I
554,AFJ,536,76,536,1154,1154,554,0,A
554,BFJ,396,320,856,385,891,554,460,J
554,BFK,757,17,873,240,917,554,116,F
554,BGK,833,496,1369,240,1394,554,536,B
554,CGK,519,23,1392,815,1732,554,873,G
554,CHK,666,130,1522,835,1726,554,856,K
554,CHJ,529,376,1898,815,2209,554,1369,C
554,DHJ,454,78,1976,520,2246,554,1522,J
554,DHK,1099,1021,2997,3960,6169,554,1898,D
554,HK,4266,2661,5658,3960,5692,554,1392,H
554,K,4169,487,6145,3960,6206,554,1976,K
554,L,1230,1230,7375,5280,11486,554,6145,L
554,M,101,101,7476,255,11741,554,7375,M
554,N,276,276,7752,180,11921,554,7476,N
554,O,520,520,8272,505,12426,554,7752,O
554,P,173,173,8445,2880,15306,554,8272,P
555,A,1522,1522,1522,1699,1699,555,0,A
555,B,238,238,1760,90,1789,555,1522,B
555,C,502,502,2262,800,2589,555,1760,C
555,B,1129,1129,3391,850,3439,555,2262,B
555,C,476,476,3867,735,4174,555,3391,C
555,D,750,750,4617,3780,7954,555,3867,D
555,M,686,686,5303,969,8923,555,4617,M
555,N,313,313,5616,90,9013,555,5303,N
555,O,672,672,6288,625,9638,555,5616,O
555,P,749,749,7037,385,10023,555,6288,P
556,AEI,166,166,166,2606,2606,556,0,I
556,AEJ,322,156,322,767,767,556,0,E
556,AFJ,749,427,749,1353,1353,556,0,A
556,BFJ,544,117,866,150,917,556,322,F
556,BGJ,249,249,1115,115,1032,556,866,G
556,BFJ,649,283,1398,90,1443,556,749,B
556,CFJ,366,366,1764,800,2243,556,1398,C
556,DFJ,707,58,1822,810,1842,556,1115,F
556,DGJ,703,703,2525,665,2507,556,1822,G
556,DHJ,36,36,2561,4230,6737,556,2525,H
556,DJ,2623,228,2789,240,2846,556,166,J
556,DK,1671,646,3435,3780,6023,556,1764,D
556,K,908,262,3697,1020,3866,556,2789,K
556,L,207,207,3904,4680,8546,556,3697,L
556,M,2249,2249,6153,2360,10906,556,3904,M
556,N,130,130,6283,90,10996,556,6153,N
556,O,478,478,6761,815,11811,556,6283,O
556,N,399,399,7160,45,11856,556,6761,N
556,O,528,528,7688,740,12596,556,7160,O
556,P,836,836,8524,3780,16376,556,7688,P
557,A,89,89,89,970,970,557,0,A
557,B,959,959,1048,150,1120,557,89,B
557,C,144,144,1192,130,1250,557,1048,C
557,D,400,400,1592,2880,4130,557,1192,D
557,M,137,137,1729,156,4286,557,1592,M
557,N,104,104,1833,150,4436,557,1729,N
557,O,130,130,1963,405,4841,557,1833,O
557,P,721,721,2684,3140,7981,557,1963,P
558,A,627,627,627,843,843,558,0,A
558,B,282,282,909,90,933,558,627,B
558,C,357,357,1266,800,1733,558,909,C
558,D,1406,1406,2672,3780,5513,558,1266,D
558,M,2296,2296,4968,2306,7819,558,2672,M
558,N,189,189,5157,180,7999,558,4968,N
558,O,884,884,6041,930,8929,558,5157,O
558,P,3103,3103,9144,550,9479,558,6041,P
559,A,1092,1092,1092,1248,1248,559,0,A
559,B,278,278,1370,150,1398,559,1092,B
559,C,630,630,2000,565,1963,559,1370,C
559,B,432,432,2432,510,2473,559,2000,B
559,C,102,102,2534,110,2583,559,2432,C
559,D,42,42,2576,4230,6813,559,2534,D
559,M,312,312,2888,204,7017,559,2576,M
559,N,97,97,2985,260,7277,559,2888,N
559,O,97,97,3082,430,7707,559,2985,O
559,P,2,2,3084,2850,10557,559,3082,P
560,A,1548,1548,1548,2502,2502,560,0,A
560,B,1051,1051,2599,150,2652,560,1548,B
560,C,755,755,3354,1030,3682,560,2599,C
560,D,1326,1326,4680,3960,7642,560,3354,D
560,M,688,688,5368,1585,9227,560,4680,M
560,N,1107,1107,6475,240,9467,560,5368,N
560,O,688,688,7163,1020,10487,560,6475,O
560,P,230,230,7393,3960,14447,560,7163,P
561,A,58,58,58,206,206,561,0,A
561,B,323,323,381,240,446,561,58,B
561,C,887,887,1268,975,1421,561,381,C
561,D,684,684,1952,5040,6461,561,1268,D
561,M,7379,7379,9331,8406,14867,561,1952,M
561,N,1060,1060,10391,90,14957,561,9331,N
561,O,1026,1026,11417,1220,16177,561,10391,O
561,P,93,93,11510,3780,19957,561,11417,P
562,A,1578,1578,1578,2173,2173,562,0,A
562,B,702,702,2280,150,2323,562,1578,B
562,C,108,108,2388,115,2438,562,2280,C
562,B,410,410,2798,405,2843,562,2388,B
562,C,700,700,3498,700,3543,562,2798,C
562,D,1873,1873,5371,4230,7773,562,3498,D
562,M,494,494,5865,1080,8853,562,5371,M
562,N,772,772,6637,240,9093,562,5865,N
562,O,952,952,7589,1015,10108,562,6637,O
562,P,1414,1414,9003,3960,14068,562,7589,P
563,AE,101,101,101,155,155,563,0,A
563,BE,109,8,109,203,203,563,0,E
563,BF,184,184,293,150,353,563,109,F
563,BG,251,59,352,240,395,563,101,B
563,CG,204,145,497,385,738,563,293,G
563,CH,469,469,966,3160,3898,563,497,H
563,C,894,280,1246,985,1380,563,352,C
563,D,2077,2077,3323,5040,6420,563,1246,D
563,M,138,138,3461,881,7301,563,3323,M
563,N,925,925,4386,240,7541,563,3461,N
563,O,239,239,4625,255,7796,563,4386,O
563,P,313,313,4938,5250,13046,563,4625,P
564,AE,115,115,115,225,225,564,0,A
564,BE,123,8,123,292,292,564,0,E
564,BF,203,195,318,150,375,564,115,B
564,CF,279,84,402,165,457,564,123,F
564,CG,495,411,813,795,1170,564,318,C
564,DG,48,48,861,3955,5125,564,813,D
564,G,550,91,952,850,1307,564,402,G
564,H,127,127,1079,2880,4187,564,952,H
564,M,26,26,1105,1096,6221,564,1079,M
564,N,1262,1262,2367,240,6461,564,1105,N
564,O,691,691,3058,760,7221,564,2367,O
564,P,1294,1294,4352,7680,14901,564,3058,P
565,AE,30,30,30,101,101,565,0,E
565,AF,190,160,190,273,273,565,0,A
565,BF,180,20,210,150,251,565,30,F
565,BG,111,111,321,110,361,565,210,G
565,BH,174,43,364,150,423,565,190,B
565,CH,523,523,887,795,1218,565,364,C
565,DH,571,5,892,4230,4591,565,321,H
565,D,1424,1419,2311,2880,4098,565,887,D
565,M,59,59,2370,90,4681,565,2311,M
565,N,120,120,2490,135,4816,565,2370,N
565,O,173,173,2663,295,5111,565,2490,O
565,P,170,170,2833,5100,10211,565,2663,P
566,AEI,1704,1704,1704,2578,2578,566,0,I
566,AEJ,933,933,2637,90,2668,566,1704,J
566,AEK,530,530,3167,680,3348,566,2637,K
566,AEL,565,565,3732,3780,7128,566,3167,L
566,AE,6301,2569,6301,7045,7045,566,0,E
566,AF,836,836,7137,90,7135,566,6301,F
566,AG,1108,1108,8245,1380,8515,566,7137,G
566,AF,1223,1223,9468,1015,9530,566,8245,F
566,AG,840,840,10308,1080,10610,566,9468,G
566,AH,152,152,10460,3780,14390,566,10308,H
566,A,25513,15053,25513,27992,27992,566,0,A
566,B,3116,3116,28629,90,28082,566,25513,B
566,C,1187,1187,29816,1365,29447,566,28629,C
566,B,2227,2227,32043,2645,32092,566,29816,B
566,C,994,994,33037,1280,33372,566,32043,C
566,D,464,464,33501,3780,37152,566,33037,D
566,M,8721,8721,42222,8901,46053,566,33501,M
566,N,210,210,42432,90,46143,566,42222,N
566,O,293,293,42725,725,46868,566,42432,O
566,P,8,8,42733,3780,50648,566,42725,P
567,AE,81,81,81,142,142,567,0,E
567,AF,166,166,247,135,277,567,81,F
567,AG,153,153,400,215,492,567,247,G
567,AH,442,42,442,1021,1021,567,0,A
567,BH,366,324,766,4890,5382,567,400,H
567,B,797,473,1239,240,1261,567,442,B
567,C,176,176,1415,400,1661,567,1239,C
567,D,188,188,1603,3960,5621,567,1415,D
567,M,223,223,1826,1556,7177,567,1603,M
567,N,1366,1366,3192,90,7267,567,1826,N
567,O,997,997,4189,1230,8497,567,3192,O
567,P,27,27,4216,3780,12277,567,4189,P
568,AE,989,989,989,1131,1131,568,0,A
568,BE,327,327,1316,240,1371,568,989,B
568,CE,1683,367,1683,2320,2320,568,0,E
568,CF,890,523,2206,915,2286,568,1316,C
568,BF,153,153,2359,165,2451,568,2206,B
568,CF,904,228,2587,300,2620,568,1683,F
568,CG,720,492,3079,1260,3711,568,2359,C
568,DG,700,208,3287,920,3540,568,2587,G
568,DF,384,176,3463,3960,7671,568,3079,D
568,F,881,705,4168,660,4200,568,3287,F
568,G,181,181,4349,385,4585,568,4168,G
568,H,423,423,4772,3960,8545,568,4349,H
568,M,830,830,5602,3083,11628,568,4772,M
568,N,2294,2294,7896,90,11718,568,5602,N
568,O,878,878,8774,1240,12958,568,7896,O
568,P,523,523,9297,3780,16738,568,8774,P
569,A,3131,3131,3131,4026,4026,569,0,A
569,B,919,919,4050,90,4116,569,3131,B
569,C,551,551,4601,905,5021,569,4050,C
569,B,828,828,5429,465,5486,569,4601,B
569,C,913,913,6342,1080,6566,569,5429,C
569,D,60,60,6402,3780,10346,569,6342,D
569,M,3942,3942,10344,4088,14434,569,6402,M
569,N,180,180,10524,90,14524,569,10344,N
569,O,720,720,11244,1130,15654,569,10524,O
569,P,132,132,11376,3780,19434,569,11244,P
570,A,519,519,519,961,961,570,0,A
570,B,597,597,1116,150,1111,570,519,B
570,C,201,201,1317,220,1331,570,1116,C
570,B,186,186,1503,205,1536,570,1317,B
570,C,142,142,1645,2665,4201,570,1503,C
570,D,3079,3079,4724,1760,5961,570,1645,D
570,M,119,119,4843,110,6071,570,4724,M
570,N,81,81,4924,150,6221,570,4843,N
570,O,197,197,5121,455,6676,570,4924,O
570,P,860,860,5981,3565,10241,570,5121,P
571,AEI,215,215,215,230,230,571,0,A
571,BEI,415,415,630,300,530,571,215,B
571,CEI,1149,519,1149,1500,1500,571,0,E
571,CFI,1185,36,1185,3480,3480,571,0,I
571,CFJ,579,24,1209,810,1340,571,630,C
571,DFJ,186,186,1395,1620,2960,571,1209,D
571,FJ,627,381,1776,300,1800,571,1149,F
571,GJ,739,739,2515,865,2665,571,1776,G
571,HJ,185,185,2700,1620,4285,571,2515,H
571,J,2671,1156,3856,420,3900,571,1185,J
571,K,1154,1154,5010,1274,5174,571,3856,K
571,L,1940,1940,6950,486,5660,571,5010,L
571,M,4448,4448,11398,7535,13195,571,6950,M
571,N,3477,3477,14875,420,13615,571,11398,N
571,O,1005,1005,15880,985,14600,571,14875,O
571,P,3638,3638,19518,550,15150,571,15880,P
572,AE,34,34,34,73,73,572,0,E
572,AF,138,138,172,150,223,572,34,F
572,AG,188,16,188,590,590,572,0,A
572,BG,179,163,351,155,378,572,172,G
572,BH,520,357,708,180,770,572,188,B
572,CH,542,185,893,4230,4608,572,351,H
572,C,195,10,903,210,980,572,708,C
572,D,418,418,1321,2850,3830,572,903,D
572,M,342,342,1663,3255,7863,572,1321,M
572,N,3005,3005,4668,155,8018,572,1663,N
572,O,200,200,4868,210,8228,572,4668,O
572,P,935,935,5803,2850,11078,572,4868,P
573,A,594,594,594,1000,1000,573,0,A
573,B,774,774,1368,420,1420,573,594,B
573,C,1147,1147,2515,1240,2660,573,1368,C
573,D,9,9,2524,335,2995,573,2515,D
573,M,826,826,3350,1259,4254,573,2524,M
573,N,592,592,3942,180,4434,573,3350,N
573,O,895,895,4837,900,5334,573,3942,O
573,P,3258,3258,8095,550,5884,573,4837,P
574,AE,41,41,41,124,124,574,0,E
574,AF,64,23,64,179,179,574,0,A
574,BF,207,207,271,135,314,574,64,B
574,CF,263,33,304,240,364,574,41,F
574,CG,155,155,459,255,619,574,304,G
574,CF,645,457,916,705,1019,574,271,C
574,DF,866,409,1325,755,1374,574,459,F
574,DG,867,458,1783,5760,6779,574,916,D
574,G,718,260,2043,705,2079,574,1325,G
574,H,10900,10900,12943,5760,7839,574,2043,H
574,M,1407,1407,14350,1475,9314,574,12943,M
574,N,339,339,14689,300,9614,574,14350,N
574,O,635,635,15324,760,10374,574,14689,O
574,P,154,154,15478,4020,14394,574,15324,P
575,A,4183,4183,4183,4557,4557,575,0,A
575,B,753,753,4936,420,4977,575,4183,B
575,C,954,954,5890,2342,7319,575,4936,C
575,D,464,464,6354,918,8237,575,5890,D
575,M,1609,1609,7963,2640,10877,575,6354,M
575,N,1446,1446,9409,600,11477,575,7963,N
575,O,1365,1365,10774,1345,12822,575,9409,O
575,P,3584,3584,14358,385,13207,575,10774,P
576,A,95,95,95,239,239,576,0,A
576,B,324,324,419,240,479,576,95,B
576,C,127,127,546,255,734,576,419,C
576,D,2953,2953,3499,5160,5894,576,546,D
576,M,2589,2589,6088,2507,8401,576,3499,M
576,N,172,172,6260,300,8701,576,6088,N
576,O,568,568,6828,695,9396,576,6260,O
576,P,1111,1111,7939,4080,13476,576,6828,P
577,A,769,769,769,1475,1475,577,0,A
577,B,960,960,1729,270,1745,577,769,B
577,C,506,506,2235,580,2325,577,1729,C
577,D,2888,2888,5123,300,2625,577,2235,D
577,M,1422,1422,6545,1660,4285,577,5123,M
577,N,303,303,6848,90,4375,577,6545,N
577,O,1372,1372,8220,1745,6120,577,6848,O
577,P,43,43,8263,3780,9900,577,8220,P
578,AEI,98,98,98,189,189,578,0,I
578,AEJ,126,28,126,712,712,578,0,E
578,AFJ,152,26,152,345,345,578,0,A
578,BFJ,221,167,319,150,339,578,98,J
578,BFK,290,123,442,150,495,578,152,B
578,CFK,682,366,808,150,862,578,126,F
578,CGK,550,184,992,515,1010,578,442,C
578,DGK,706,33,1025,620,959,578,319,K
578,DGL,234,17,1042,230,1092,578,808,G
578,DHL,338,321,1363,4200,5159,578,1025,L
578,DH,564,243,1606,4200,5292,578,1042,H
578,D,689,75,1681,4200,5210,578,992,D
578,M,5464,5464,7145,7843,13135,578,1681,M
578,N,2586,2586,9731,240,13375,578,7145,N
578,O,716,716,10447,1120,14495,578,9731,O
578,P,725,725,11172,3960,18455,578,10447,P
579,AE,239,239,239,880,880,579,0,E
579,AF,830,830,1069,240,1120,579,239,F
579,AG,953,953,2022,1030,2150,579,1069,G
579,AH,1382,1382,3404,3960,6110,579,2022,H
579,A,4658,1254,4658,4788,4788,579,0,A
579,B,353,353,5011,240,5028,579,4658,B
579,C,748,748,5759,995,6023,579,5011,C
579,D,492,492,6251,3960,9983,579,5759,D
579,M,83,83,6334,221,10204,579,6251,M
579,N,256,256,6590,150,10354,579,6334,N
579,O,230,230,6820,740,11094,579,6590,O
579,P,1852,1852,8672,3600,14694,579,6820,P
580,AEI,79,79,79,105,105,580,0,E
580,AFI,112,112,191,150,255,580,79,F
580,AGI,110,110,301,135,390,580,191,G
580,AHI,40,40,341,2900,3290,580,301,H
580,AI,382,41,382,3179,3179,580,0,A
580,BI,428,46,428,792,792,580,0,I
580,BJ,721,721,1149,420,1212,580,428,J
580,BK,138,138,1287,140,1352,580,1149,K
580,BL,195,195,1482,5060,6412,580,1287,L
580,B,3117,2017,3499,180,3359,580,382,B
580,C,1542,1542,5041,680,4039,580,3499,C
580,B,413,413,5454,1475,5514,580,5041,B
580,C,598,598,6052,555,6069,580,5454,C
580,D,5498,5498,11550,6960,13029,580,6052,D
580,M,1306,1306,12856,1540,14569,580,11550,M
580,N,334,334,13190,150,14719,580,12856,N
580,O,91,91,13281,230,14949,580,13190,O
580,N,680,680,13961,515,15464,580,13281,N
580,O,192,192,14153,390,15854,580,13961,O
580,P,350,350,14503,6905,22759,580,14153,P
581,AE,29,29,29,55,55,581,0,A
581,BE,75,75,104,150,205,581,29,B
581,CE,454,350,454,2980,2980,581,0,E
581,CF,612,262,716,490,695,581,104,C
581,DF,1,1,717,2870,3565,581,716,D
581,F,2766,2503,3220,300,3280,581,454,F
581,G,736,736,3956,715,3995,581,3220,G
581,H,596,596,4552,4050,8045,581,3956,H
581,M,149,149,4701,194,8239,581,4552,M
581,N,136,136,4837,155,8394,581,4701,N
581,O,252,252,5089,90,8484,581,4837,O
581,P,3493,3493,8582,3380,11864,581,5089,P
582,AEI,166,166,166,255,255,582,0,E
582,AFI,178,12,178,514,514,582,0,A
582,BFI,268,90,268,448,448,582,0,I
582,BFJ,259,157,425,240,495,582,166,F
582,BGJ,281,124,549,165,613,582,268,J
582,BGK,428,57,606,150,664,582,178,B
582,CGK,168,168,774,400,1064,582,606,C
582,DGK,34,34,808,3920,4984,582,774,D
582,GK,739,356,1164,985,1480,582,425,G
582,HK,653,38,1202,855,1468,582,549,K
582,HL,852,814,2016,5040,6520,582,1164,H
582,L,2517,1703,3719,2880,4348,582,1202,L
582,M,378,378,4097,998,7518,582,3719,M
582,N,853,853,4950,240,7758,582,4097,N
582,O,144,144,5094,240,7998,582,4950,O
582,P,1776,1776,6870,5100,13098,582,5094,P
583,AEI,127,127,127,219,219,583,0,I
583,AEJ,92,92,219,300,519,583,127,J
583,AEK,251,32,251,1716,1716,583,0,A
583,BEK,750,718,969,690,1209,583,219,K
583,BEJ,599,599,1568,390,1599,583,969,J
583,BEK,1679,362,1930,240,1956,583,251,B
583,CEK,595,233,2163,750,2349,583,1568,K
583,CEL,1102,869,3032,1105,3061,583,1930,C
583,DEL,3354,322,3354,4308,4308,583,0,E
583,DFL,982,982,4336,90,4398,583,3354,F
583,DGL,633,633,4969,905,5303,583,4336,G
583,DFL,2038,101,5070,550,3611,583,3032,D
583,FL,1043,942,6012,770,6073,583,4969,F
583,GL,818,818,6830,1300,7373,583,6012,G
583,HL,3239,3239,10069,3780,11153,583,6830,H
583,L,10064,2158,12227,3960,6309,583,2163,L
583,M,100,100,12327,260,11413,583,12227,M
583,N,372,372,12699,270,11683,583,12327,N
583,O,1084,1084,13783,1100,12783,583,12699,O
583,P,3685,3685,17468,335,13118,583,13783,P
584,AEI,197,197,197,482,482,584,0,A
584,BEI,400,400,597,150,632,584,197,B
584,CEI,695,695,1292,976,1608,584,597,C
584,BEI,1549,257,1549,1530,1530,584,0,E
584,BFI,282,25,1574,10,1618,584,1292,B
584,CFI,1668,94,1668,3230,3230,584,0,I
584,CFJ,253,134,1802,300,1830,584,1549,F
584,CGJ,316,182,1984,240,3470,584,1668,J
584,CGK,593,183,2167,480,2098,584,1574,C
584,DGK,735,370,2537,840,2670,584,1802,G
584,DFK,979,426,2963,1180,4650,584,1984,K
584,DFJ,718,292,3255,645,3315,584,2537,F
584,DGJ,1209,121,3376,4230,6328,584,2167,D
584,GJ,681,268,3644,1140,5790,584,2963,J
584,GK,178,178,3822,370,6160,584,3644,K
584,GL,812,245,4067,900,4215,584,3255,G
584,HL,558,558,4625,2640,6855,584,4067,H
584,L,2735,1932,6557,3960,10120,584,3822,L
584,M,49,49,6606,285,10405,584,6557,M
584,N,347,347,6953,300,10705,584,6606,N
584,O,465,465,7418,695,11400,584,6953,O
584,P,383,383,7801,3960,15360,584,7418,P
585,AEI,23,23,23,47,47,585,0,I
585,AEJ,150,150,173,135,182,585,23,J
585,AEK,209,36,209,208,208,585,0,A
585,BEK,73,73,282,135,343,585,209,B
585,CEK,242,133,415,295,477,585,173,K
585,CEL,203,70,485,280,623,585,282,C
585,DEL,806,321,806,1338,1338,585,0,E
585,DFL,576,576,1382,90,1428,585,806,F
585,DGL,1607,640,2022,5160,5637,585,415,L
585,DG,1010,370,2392,1285,2713,585,1382,G
585,DH,3165,1258,3650,5160,5783,585,485,D
585,H,1751,493,4143,3780,6493,585,2392,H
585,M,1230,1230,5373,1606,8099,585,4143,M
585,N,505,505,5878,180,8279,585,5373,N
585,O,706,706,6584,885,9164,585,5878,O
585,N,1262,1262,7846,1075,10239,585,6584,N
585,O,492,492,8338,635,10874,585,7846,O
585,P,1498,1498,9836,6960,17834,585,8338,P
586,AE,369,369,369,1298,1298,586,0,A
586,BE,600,231,600,2106,2106,586,0,E
586,BF,954,723,1323,90,1388,586,369,B
586,CF,649,649,1972,1040,2428,586,1323,C
586,DF,50,50,2022,3780,6208,586,1972,D
586,F,1806,384,2406,360,2466,586,600,F
586,G,1002,1002,3408,1495,3961,586,2406,G
586,F,1187,1187,4595,750,4711,586,3408,F
586,G,451,451,5046,677,5388,586,4595,G
586,H,651,651,5697,343,5731,586,5046,H
586,M,35739,35739,41436,35713,41921,586,5697,M
586,N,1365,1365,42801,90,42011,586,41436,N
586,O,1185,1185,43986,1385,43396,586,42801,O
586,N,136,136,44122,1295,44691,586,43986,N
586,O,837,837,44959,920,45611,586,44122,O
586,P,756,756,45715,3780,49391,586,44959,P
587,AEI,252,252,252,1245,1245,587,0,A
587,BEI,665,413,665,1228,1228,587,0,I
587,BEJ,675,675,1340,120,1348,587,665,J
587,BEK,1257,169,1509,300,1545,587,252,B
587,CEK,445,276,1785,230,1578,587,1340,K
587,CEL,674,398,2183,805,2350,587,1509,C
587,DEL,359,359,2542,2940,5290,587,2183,D
587,EL,2896,354,2896,3350,3350,587,0,E
587,FL,718,718,3614,300,3650,587,2896,F
587,GL,492,492,4106,1940,5590,587,3614,G
587,HL,1510,1510,5616,2760,8350,587,4106,H
587,L,4391,560,6176,1520,3098,587,1785,L
587,M,1280,1280,7456,1030,9380,587,6176,M
587,N,33,33,7489,300,9680,587,7456,N
587,O,788,788,8277,895,10575,587,7489,O
587,P,5474,5474,13751,2700,13275,587,8277,P
588,A,15892,15892,15892,16375,16375,588,0,A
588,B,604,604,16496,180,16555,588,15892,B
588,C,1098,1098,17594,830,17385,588,16496,C
588,B,460,460,18054,705,18090,588,17594,B
588,C,580,580,18634,695,18785,588,18054,C
588,D,44292,44292,62926,6960,25745,588,18634,D
588,M,2667,2667,65593,2864,28609,588,62926,M
588,N,438,438,66031,270,28879,588,65593,N
588,O,989,989,67020,995,29874,588,66031,O
588,P,3998,3998,71018,550,30424,588,67020,P
589,AEI,12,12,12,182,182,589,0,A
589,BEI,319,307,319,1308,1308,589,0,I
589,BEJ,388,81,400,240,422,589,12,B
589,CEJ,477,77,477,1219,1219,589,0,E
589,CFJ,190,113,590,195,617,589,400,C
589,DFJ,701,701,1291,5220,5837,589,590,D
589,FJ,1039,67,1358,90,1398,589,319,J
589,FK,934,53,1411,240,1459,589,477,F
589,GK,298,298,1709,395,1854,589,1411,G
589,HK,608,257,1966,960,2358,589,1358,K
589,HJ,738,738,2704,390,2748,589,1966,J
589,HK,1250,255,2959,9700,11554,589,1709,H
589,K,1420,1165,4124,1390,4138,589,2704,K
589,L,648,648,4772,3780,7918,589,4124,L
589,M,1677,1677,6449,2354,13908,589,4772,M
589,N,837,837,7286,180,14088,589,6449,N
589,O,1012,1012,8298,855,14943,589,7286,O
589,P,3004,3004,11302,6680,21623,589,8298,P
590,AE,64,64,64,431,431,590,0,E
590,AF,730,730,794,420,851,590,64,F
590,AG,964,170,964,1028,1028,590,0,A
590,BG,258,258,1222,240,1268,590,964,B
590,CG,872,444,1666,1069,1920,590,794,G
590,CH,752,308,1974,970,2238,590,1222,C
590,DH,66,66,2040,3960,6198,590,1974,D
590,H,4785,4411,6451,356,2276,590,1666,H
590,M,7054,7054,13505,7825,14023,590,6451,M
590,N,962,962,14467,240,14263,590,13505,N
590,O,840,840,15307,1015,15278,590,14467,O
590,N,594,594,15901,485,15763,590,15307,N
590,O,383,383,16284,1590,17353,590,15901,O
590,N,1588,1588,17872,240,17593,590,16284,N
590,O,185,185,18057,360,17953,590,17872,O
590,P,4091,4091,22148,3960,21913,590,18057,P
591,AEI,37,37,37,54,54,591,0,A
591,BEI,132,95,132,387,387,591,0,E
591,BFI,159,64,196,180,234,591,37,B
591,CFI,168,168,364,335,569,591,196,C
591,BFI,297,65,429,90,477,591,132,F
591,BGI,510,81,510,550,550,591,0,I
591,BGJ,302,302,812,300,850,591,510,J
591,BGK,657,657,1469,835,1685,591,812,K
591,BGL,1235,130,1599,1075,1644,591,364,B
591,CGL,1441,271,1870,1935,2412,591,429,G
591,CHL,679,408,2278,650,2294,591,1599,C
591,DHL,4385,3977,6255,3780,6192,591,1870,H
591,DL,7666,2880,9135,1140,2825,591,1469,L
591,D,18167,11310,20445,5370,7664,591,2278,D
591,M,540,540,20985,1635,9299,591,20445,M
591,N,1361,1361,22346,300,9599,591,20985,N
591,O,513,513,22859,820,10419,591,22346,O
591,P,276,276,23135,2940,13359,591,22859,P
592,A,133,133,133,194,194,592,0,A
592,B,176,176,309,150,344,592,133,B
592,C,123,123,432,140,484,592,309,C
592,D,1421,1421,1853,4200,4684,592,432,D
592,M,1,1,1854,456,5140,592,1853,M
592,N,665,665,2519,240,5380,592,1854,N
592,O,387,387,2906,700,6080,592,2519,O
592,P,11111,11111,14017,3960,10040,592,2906,P
593,AE,218,218,218,1404,1404,593,0,A
593,BE,868,650,868,1441,1441,593,0,E
593,BF,622,622,1490,90,1531,593,868,F
593,BG,1367,95,1585,240,1644,593,218,B
593,CG,397,302,1887,800,2331,593,1490,G
593,CH,1031,729,2616,995,2639,593,1585,C
593,DH,845,116,2732,3780,6111,593,1887,H
593,D,120,4,2736,4680,7319,593,2616,D
593,M,868,868,3604,989,8308,593,2736,M
593,N,274,274,3878,180,8488,593,3604,N
593,O,1659,1659,5537,1430,9918,593,3878,O
593,N,1028,1028,6565,1290,11208,593,5537,N
593,O,344,344,6909,210,11418,593,6565,O
593,P,1967,1967,8876,7080,18498,593,6909,P
594,AE,576,576,576,979,979,594,0,A
594,BE,589,589,1165,240,1219,594,576,B
594,CE,215,215,1380,400,1619,594,1165,C
594,BE,1743,363,1743,2398,2398,594,0,E
594,BF,428,65,1808,235,1854,594,1380,B
594,CF,692,627,2435,90,2488,594,1743,F
594,CG,793,166,2601,965,2819,594,1808,C
594,DG,525,359,2960,880,3368,594,2435,G
594,DH,3773,3773,6733,3780,7148,594,2960,H
594,D,4382,250,6983,3960,6779,594,2601,D
594,M,357,357,7340,1102,8250,594,6983,M
594,N,835,835,8175,150,8400,594,7340,N
594,O,786,786,8961,1050,9450,594,8175,O
594,P,4304,4304,13265,3490,12940,594,8961,P
595,AE,19,19,19,56,56,595,0,A
595,BE,197,197,216,240,296,595,19,B
595,CE,258,42,258,1032,1032,595,0,E
595,CF,701,659,917,975,1271,595,216,C
595,DF,6,6,923,6465,7736,595,917,D
595,F,994,329,1252,240,1272,595,258,F
595,G,186,186,1438,445,1717,595,1252,G
595,H,84,84,1522,5160,6877,595,1438,H
595,M,139,139,1661,211,7947,595,1522,M
595,N,148,148,1809,135,8082,595,1661,N
595,O,103,103,1912,385,8467,595,1809,O
595,P,73,73,1985,9245,17712,595,1912,P
596,A,24,24,24,82,82,596,0,A
596,B,253,253,277,240,322,596,24,B
596,C,850,850,1127,1035,1357,596,277,C
596,D,4,4,1131,3960,5317,596,1127,D
596,M,193,193,1324,1023,6340,596,1131,M
596,N,866,866,2190,90,6430,596,1324,N
596,O,676,676,2866,920,7350,596,2190,O
596,P,400,400,3266,3780,11130,596,2866,P
597,AEI,35,35,35,1498,1498,597,0,I
597,AEJ,69,34,69,1111,1111,597,0,A
597,BEJ,1018,949,1018,1548,1548,597,0,E
597,BFJ,1086,137,1155,90,1201,597,69,B
597,CFJ,1496,376,1531,90,1588,597,35,J
597,CFK,790,277,1808,90,1638,597,1018,F
597,CGK,1033,380,2188,1220,2421,597,1155,C
597,DGK,60,60,2248,3780,6201,597,2188,D
597,GK,858,141,2389,1220,2808,597,1531,K
597,GL,87,87,2476,3780,6588,597,2389,L
597,G,939,271,2747,1240,2878,597,1808,G
597,H,753,753,3500,3780,6658,597,2747,H
597,M,394,394,3894,1020,7678,597,3500,M
597,N,653,653,4547,90,7768,597,3894,N
597,O,492,492,5039,850,8618,597,4547,O
597,P,441,441,5480,3780,12398,597,5039,P
598,AEI,37,37,37,176,176,598,0,E
598,AFI,317,317,354,240,416,598,37,F
598,AGI,452,98,452,578,578,598,0,I
598,AGJ,266,266,718,150,728,598,452,J
598,AGK,160,160,878,415,1143,598,718,K
598,AGL,18,18,896,2880,4023,598,878,L
598,AG,852,310,1206,985,1401,598,354,G
598,AH,754,754,1960,5040,6441,598,1206,H
598,A,2590,630,2590,2949,2949,598,0,A
598,B,592,592,3182,300,3249,598,2590,B
598,C,735,735,3917,825,4074,598,3182,C
598,D,16,16,3933,5325,9399,598,3917,D
598,M,48,48,3981,1278,10677,598,3933,M
598,N,1407,1407,5388,240,10917,598,3981,N
598,O,558,558,5946,630,11547,598,5388,O
598,P,83225,83225,89171,6300,17847,598,5946,P
599,AEI,68,68,68,189,189,599,0,A
599,BEI,238,238,306,180,369,599,68,B
599,CEI,523,217,523,635,635,599,0,I
599,CEJ,687,164,687,1327,1327,599,0,E
599,CFJ,224,60,747,180,815,599,523,J
599,CFK,743,302,1049,975,1344,599,306,C
599,DFK,733,371,1420,150,1477,599,687,F
599,DGK,674,1,1421,865,1680,599,747,K
599,DGL,136,135,1556,400,1877,599,1420,G
599,DHL,218,83,1639,2880,4560,599,1421,L
599,DH,886,296,1935,5055,6399,599,1049,D
599,H,1360,981,2916,2880,4757,599,1556,H
599,M,1541,1541,4457,2665,9064,599,2916,M
599,N,1154,1154,5611,90,9154,599,4457,N
599,O,1043,1043,6654,1220,10374,599,5611,O
599,P,429,429,7083,3780,14154,599,6654,P
600,AE,48,48,48,118,118,600,0,E
600,AF,250,250,298,240,358,600,48,F
600,AG,381,83,381,1235,1235,600,0,A
600,BG,208,125,506,515,873,600,298,G
600,BH,945,820,1326,150,1385,600,381,B
600,CH,782,782,2108,1030,2415,600,1326,C
600,BH,1849,247,2355,6150,7023,600,506,H
600,B,267,20,2375,10,2425,600,2108,B
600,C,239,239,2614,710,3135,600,2375,C
600,D,592,592,3206,3740,6875,600,2614,D
600,M,437,437,3643,2814,9837,600,3206,M
600,N,2399,2399,6042,90,9927,600,3643,N
600,O,1208,1208,7250,1255,11182,600,6042,O
600,N,262,262,7512,205,11387,600,7250,N
600,O,362,362,7874,795,12182,600,7512,O
600,P,486,486,8360,3780,15962,600,7874,P
601,A,1105,1105,1105,1211,1211,601,0,A
601,B,254,254,1359,180,1391,601,1105,B
601,C,1328,1328,2687,710,2101,601,1359,C
601,B,529,529,3216,1175,3276,601,2687,B
601,C,940,940,4156,1020,4296,601,3216,C
601,D,3734,3734,7890,6960,11256,601,4156,D
601,M,1502,1502,9392,1650,12906,601,7890,M
601,N,430,430,9822,300,13206,601,9392,N
601,O,736,736,10558,910,14116,601,9822,O
601,P,1558,1558,12116,3960,18076,601,10558,P
602,AE,218,218,218,397,397,602,0,E
602,AF,222,222,440,90,487,602,218,F
602,AG,1456,1456,1896,1780,2267,602,440,G
602,AH,91,91,1987,3780,6047,602,1896,H
602,A,37159,35172,37159,38007,38007,602,0,A
602,B,878,878,38037,90,38097,602,37159,B
602,C,1384,1384,39421,1240,39337,602,38037,C
602,D,699,699,40120,3780,43117,602,39421,D
602,M,5317,5317,45437,5471,48588,602,40120,M
602,N,200,200,45637,90,48678,602,45437,N
602,O,380,380,46017,735,49413,602,45637,O
602,P,16663,16663,62680,3780,53193,602,46017,P
603,A,258,258,258,654,654,603,0,A
603,B,420,420,678,90,744,603,258,B
603,C,734,734,1412,950,1694,603,678,C
603,B,910,910,2322,685,2379,603,1412,B
603,C,999,999,3321,1240,3619,603,2322,C
603,D,77,77,3398,3780,7399,603,3321,D
603,M,109,109,3507,1113,8512,603,3398,M
603,N,1034,1034,4541,90,8602,603,3507,N
603,O,1030,1030,5571,1210,9812,603,4541,O
603,P,294,294,5865,3780,13592,603,5571,P
604,AE,256,256,256,3169,3169,604,0,A
604,BE,2297,2041,2297,2307,2307,604,0,E
604,BF,189,189,2486,180,2487,604,2297,F
604,BG,870,870,3356,930,3417,604,2486,G
604,BH,3170,70,3426,240,3409,604,256,B
604,CH,1119,1119,4545,1105,4514,604,3426,C
604,DH,3116,1927,6472,550,3967,604,3356,H
604,D,2701,774,7246,550,5064,604,4545,D
604,M,1038,1038,8284,1722,6786,604,7246,M
604,N,1433,1433,9717,780,7566,604,8284,N
604,O,964,964,10681,1717,9283,604,9717,O
604,P,11745,11745,22426,338,9621,604,10681,P
605,AEI,19,19,19,566,566,605,0,I
605,AEJ,632,632,651,135,701,605,19,J
605,AEK,175,175,826,295,996,605,651,K
605,AEL,291,291,1117,5160,6156,605,826,L
605,AE,1495,378,1495,2200,2200,605,0,A
605,BE,1640,145,1640,1517,1517,605,0,E
605,BF,374,374,2014,540,2057,605,1640,F
605,BG,896,377,2391,180,2380,605,1495,B
605,CG,718,341,2732,1000,3057,605,2014,G
605,CH,107,107,2839,720,3777,605,2732,H
605,C,487,39,2878,430,2810,605,2391,C
605,D,1625,1625,4503,4080,6890,605,2878,D
605,M,741,741,5244,1101,7991,605,4503,M
605,N,394,394,5638,90,8081,605,5244,N
605,O,939,939,6577,1250,9331,605,5638,O
605,P,87,87,6664,3780,13111,605,6577,P
606,AE,67,67,67,78,78,606,0,A
606,BE,87,87,154,135,213,606,67,B
606,CE,168,168,322,285,498,606,154,C
606,DE,423,423,745,5280,5778,606,322,D
606,E,1174,429,1174,1462,1462,606,0,E
606,F,384,384,1558,150,1612,606,1174,F
606,G,188,188,1746,280,1892,606,1558,G
606,H,1301,1301,3047,5160,7052,606,1746,H
606,M,413,413,3460,590,7642,606,3047,M
606,N,270,270,3730,150,7792,606,3460,N
606,O,34,34,3764,100,7892,606,3730,O
606,N,454,454,4218,390,8282,606,3764,N
606,O,176,176,4394,225,8507,606,4218,O
606,P,2387,2387,6781,4740,13247,606,4394,P
607,A,1559,1559,1559,1631,1631,607,0,A
607,B,263,263,1822,240,1871,607,1559,B
607,C,876,876,2698,970,2841,607,1822,C
607,B,1403,1403,4101,330,3171,607,2698,B
607,C,494,494,4595,780,3951,607,4101,C
607,D,1534,1534,6129,3960,7911,607,4595,D
607,M,2772,2772,8901,2857,10768,607,6129,M
607,N,280,280,9181,240,11008,607,8901,N
607,O,481,481,9662,725,11733,607,9181,O
607,N,465,465,10127,330,12063,607,9662,N
607,O,2758,2758,12885,2420,14483,607,10127,O
607,N,267,267,13152,1050,15533,607,12885,N
607,O,833,833,13985,540,16073,607,13152,O
607,P,1306,1306,15291,3900,19973,607,13985,P
608,AEI,69,69,69,3143,3143,608,0,I
608,AEJ,164,95,164,1704,1704,608,0,E
608,AFJ,668,504,668,959,959,608,0,A
608,BFJ,323,323,991,90,1049,608,668,B
608,CFJ,1660,833,1824,180,1884,608,164,F
608,CGJ,871,38,1862,1275,2324,608,991,C
608,DGJ,13,13,1875,3780,6104,608,1862,D
608,GJ,1215,1164,3039,1140,3024,608,1824,G
608,HJ,3314,344,3383,300,3443,608,69,J
608,HK,570,570,3953,795,4238,608,3383,K
608,HL,48,48,4001,5485,9723,608,3953,L
608,H,2297,1335,5336,5370,8394,608,3039,H
608,M,8,8,5344,54,9777,608,5336,M
608,N,126,126,5470,135,9912,608,5344,N
608,O,310,310,5780,295,10207,608,5470,O
608,P,161,161,5941,5160,15367,608,5780,P
609,A,125,125,125,390,390,609,0,A
609,B,451,451,576,240,630,609,125,B
609,C,235,235,811,245,875,609,576,C
609,D,1258,1258,2069,5250,6125,609,811,D
609,M,2421,2421,4490,2855,8980,609,2069,M
609,N,738,738,5228,300,9280,609,4490,N
609,O,524,524,5752,805,10085,609,5228,O
609,N,1404,1404,7156,1145,11230,609,5752,N
609,O,221,221,7377,420,11650,609,7156,O
609,P,2399,2399,9776,3960,15610,609,7377,P
610,AE,2707,2707,2707,2283,2283,610,0,E
610,AF,363,363,3070,90,2373,610,2707,F
610,AG,3311,241,3311,4810,4810,610,0,A
610,BG,567,326,3637,815,3188,610,3070,G
610,BF,617,617,4254,1075,4263,610,3637,F
610,BG,1859,916,5170,420,5230,610,3311,B
610,CG,1244,328,5498,1790,6053,610,4254,G
610,CH,1050,722,6220,1332,6562,610,5170,C
610,DH,992,270,6490,3780,9833,610,5498,H
610,D,5881,5611,12101,973,7535,610,6220,D
610,M,1297,1297,13398,1715,11548,610,12101,M
610,N,658,658,14056,300,11848,610,13398,N
610,O,758,758,14814,725,12573,610,14056,O
610,P,1026,1026,15840,310,12883,610,14814,P
611,AEI,595,595,595,1455,1455,611,0,E
611,AFI,1120,1120,1715,300,1755,611,595,F
611,AGI,2439,724,2439,2400,2400,611,0,I
611,AGJ,802,78,2517,805,2560,611,1715,G
611,AHJ,341,263,2780,420,2820,611,2439,J
611,AHK,669,406,3186,3960,6520,611,2517,H
611,AK,964,558,3744,845,3665,611,2780,K
611,AL,1873,1873,5617,3960,7625,611,3744,L
611,A,8228,2611,8228,8644,8644,611,0,A
611,B,633,633,8861,240,8884,611,8228,B
611,C,548,548,9409,780,9664,611,8861,C
611,D,6350,6350,15759,3960,13624,611,9409,D
611,M,290,290,16049,390,14014,611,15759,M
611,N,199,199,16248,150,14164,611,16049,N
611,O,514,514,16762,470,14634,611,16248,O
611,N,223,223,16985,260,14894,611,16762,N
611,O,122,122,17107,135,15029,611,16985,O
611,P,1763,1763,18870,4230,19259,611,17107,P
612,A,254,254,254,195,195,612,0,A
612,B,151,151,405,300,495,612,254,B
612,C,465,465,870,690,1185,612,405,C
612,B,672,672,1542,390,1575,612,870,B
612,C,582,582,2124,750,2325,612,1542,C
612,D,4071,4071,6195,3960,6285,612,2124,D
612,M,250,250,6445,464,6749,612,6195,M
612,N,599,599,7044,420,7169,612,6445,N
612,O,880,880,7924,1079,8248,612,7044,O
612,P,1165,1165,9089,356,8604,612,7924,P
613,AE,61,61,61,166,166,613,0,A
613,BE,85,24,85,1039,1039,613,0,E
613,BF,298,274,359,180,346,613,61,B
613,CF,324,324,683,545,891,613,359,C
613,BF,1202,604,1287,240,1279,613,85,F
613,BG,908,304,1591,760,1651,613,683,B
613,CG,619,315,1906,610,1889,613,1287,G
613,CH,580,265,2171,610,2261,613,1591,C
613,DH,1180,915,3086,5100,6989,613,1906,H
613,D,16800,15885,18971,5100,7361,613,2171,D
613,M,4283,4283,23254,4599,11960,613,18971,M
613,N,492,492,23746,240,12200,613,23254,N
613,O,570,570,24316,745,12945,613,23746,O
613,P,104,104,24420,5585,18530,613,24316,P
614,AE,60,60,60,140,140,614,0,E
614,AF,316,256,316,425,425,614,0,A
614,BF,403,147,463,360,500,614,60,F
614,BG,364,217,680,300,725,614,316,B
614,CG,602,385,1065,720,1220,614,463,G
614,CF,657,272,1337,810,1535,614,680,C
614,DF,328,56,1393,200,1420,614,1065,F
614,DG,284,284,1677,430,1850,614,1393,G
614,DH,468,128,1805,1560,3095,614,1337,D
614,DH,128,0,1805,1560,3410,614,1677,H
614,M,1068,1068,2873,1513,4923,614,1805,M
614,N,552,552,3425,165,5088,614,2873,N
614,O,373,373,3798,550,5638,614,3425,O
614,N,428,428,4226,255,5893,614,3798,N
614,O,149,149,4375,225,6118,614,4226,O
614,P,6,6,4381,4740,10858,614,4375,P
615,AE,1172,1172,1172,1315,1315,615,0,A
615,BE,1730,558,1730,4085,4085,615,0,E
615,BF,872,314,2044,780,2095,615,1172,B
615,CF,1027,1027,3071,1160,3255,615,2044,C
615,DF,2623,1282,4353,300,4385,615,1730,F
615,DG,1012,1012,5365,910,5295,615,4353,G
615,DH,4056,1762,7127,665,3920,615,3071,D
615,H,5321,3559,10686,2760,8055,615,5365,H
615,M,198,198,10884,1106,9161,615,10686,M
615,N,1028,1028,11912,180,9341,615,10884,N
615,O,950,950,12862,1050,10391,615,11912,O
615,P,3652,3652,16514,5040,15431,615,12862,P
616,A,65,65,65,170,170,616,0,A
616,B,638,638,703,570,740,616,65,B
616,C,87,87,790,80,820,616,703,C
616,D,66,66,856,2880,3700,616,790,D
616,M,194,194,1050,833,4533,616,856,M
616,N,735,735,1785,150,4683,616,1050,N
616,O,197,197,1982,115,4798,616,1785,O
616,N,725,725,2707,780,5578,616,1982,N
616,O,748,748,3455,755,6333,616,2707,O
616,P,1226,1226,4681,4230,10563,616,3455,P
617,AE,116,116,116,336,336,617,0,E
617,AF,236,120,236,752,752,617,0,A
617,BF,343,223,459,90,426,617,116,F
617,BG,645,422,881,180,932,617,236,B
617,CG,138,138,1019,205,1137,617,881,C
617,DG,587,27,1046,1010,1436,617,459,G
617,DH,98,98,1144,3780,5216,617,1046,H
617,D,459,334,1478,4140,5277,617,1019,D
617,M,464,464,1942,1434,6711,617,1478,M
617,N,1170,1170,3112,240,6951,617,1942,N
617,O,701,701,3813,965,7916,617,3112,O
617,P,270,270,4083,3960,11876,617,3813,P
618,A,84,84,84,1099,1099,618,0,A
618,B,1195,1195,1279,240,1339,618,84,B
618,C,774,774,2053,780,2119,618,1279,C
618,D,770,770,2823,7680,9799,618,2053,D
618,M,1459,1459,4282,1638,11437,618,2823,M
618,N,367,367,4649,240,11677,618,4282,N
618,O,512,512,5161,770,12447,618,4649,O
618,N,622,622,5783,285,12732,618,5161,N
618,O,823,823,6606,1260,13992,618,5783,O
618,P,204,204,6810,3960,17952,618,6606,P
619,A,135,135,135,164,164,620,0,A
619,B,164,164,299,150,314,620,135,B
619,C,121,121,420,385,699,620,299,C
619,D,1130,1130,1550,3160,3859,620,420,D
619,M,38,38,1588,71,3930,620,1550,M
619,N,110,110,1698,135,4065,620,1588,N
619,O,209,209,1907,295,4360,620,1698,O
619,P,1440,1440,3347,5100,9460,620,1907,P
620,AEI,174,174,174,129,129,621,0,E
620,AFI,10,10,184,120,249,621,174,F
620,AGI,317,317,501,225,474,621,184,G
620,AFI,1175,674,1175,1655,1655,621,0,I
620,AFJ,739,65,1240,825,1299,621,501,F
620,AGJ,1719,479,1719,2022,2022,621,0,A
620,BGJ,590,111,1830,635,1934,621,1240,G
620,BHJ,748,93,1923,300,1955,621,1175,J
620,BHK,214,10,1933,90,2112,621,1719,B
620,CHK,583,583,2516,1171,3283,621,1933,C
620,BHK,923,330,2846,1045,3000,621,1923,K
620,BHL,92,92,2938,1140,4140,621,2846,L
620,BH,1904,796,3734,2880,4814,621,1830,H
620,B,2042,824,4558,1280,4563,621,2516,B
620,C,736,736,5294,1005,5568,621,4558,C
620,D,1041,1041,6335,660,6228,621,5294,D
620,M,7577,7577,13912,8460,14688,621,6335,M
620,N,1143,1143,15055,300,14988,621,13912,N
620,O,901,901,15956,905,15893,621,15055,O
620,P,5320,5320,21276,2760,18653,621,15956,P
621,A,1221,1221,1221,1185,1185,622,0,A
621,B,222,222,1443,300,1485,622,1221,B
621,C,862,862,2305,1005,2490,622,1443,C
621,D,631,631,2936,1200,3690,622,2305,D
621,M,874,874,3810,1230,4920,622,2936,M
621,N,476,476,4286,180,5100,622,3810,N
621,O,1770,1770,6056,1170,6270,622,4286,O
621,N,1415,1415,7471,2085,8355,622,6056,N
621,O,937,937,8408,653,9008,622,7471,O
621,P,773,773,9181,1092,10100,622,8408,P
622,AE,211,211,211,1585,1585,623,0,A
622,BE,889,678,889,1314,1314,623,0,E
622,BF,555,555,1444,180,1494,623,889,F
622,BG,1511,278,1722,180,1765,623,211,B
622,CG,870,870,2592,875,2640,623,1722,C
622,DG,1327,179,2771,885,2379,623,1444,G
622,DH,4233,4054,6825,6680,9320,623,2592,D
622,H,4573,519,7344,6680,9059,623,2771,H
622,M,13,13,7357,663,9983,623,7344,M
622,N,770,770,8127,180,10163,623,7357,N
622,O,345,345,8472,370,10533,623,8127,O
622,P,4063,4063,12535,6960,17493,623,8472,P
623,AE,48,48,48,1385,1385,624,0,E
623,AF,638,590,638,1049,1049,624,0,A
623,BF,789,789,1427,420,1469,624,638,B
623,CF,1524,145,1572,240,1625,624,48,F
623,CG,884,739,2311,1250,2719,624,1427,C
623,DG,856,117,2428,995,2620,624,1572,G
623,DH,71,71,2499,4680,7300,624,2428,H
623,D,199,11,2510,335,3054,624,2311,D
623,M,980,980,3490,1350,8650,624,2510,M
623,N,613,613,4103,300,8950,624,3490,N
623,O,995,995,5098,1045,9995,624,4103,O
623,P,132,132,5230,1140,11135,624,5098,P
624,A,971,971,971,1325,1325,625,0,A
624,B,599,599,1570,300,1625,625,971,B
624,C,1051,1051,2621,1275,2900,625,1570,C
624,B,654,654,3275,445,3345,625,2621,B
624,C,1200,1200,4475,1340,4685,625,3275,C
624,D,4385,4385,8860,3960,8645,625,4475,D
624,M,512,512,9372,600,9245,625,8860,M
624,N,98,98,9470,180,9425,625,9372,N
624,O,59,59,9529,480,9905,625,9470,O
624,N,662,662,10191,130,10035,625,9529,N
624,O,94,94,10285,80,10115,625,10191,O
624,P,261,261,10546,2880,12995,625,10285,P
625,AEI,204,204,204,235,235,626,0,E
625,AFI,232,28,232,327,327,626,0,A
625,BFI,121,93,325,150,385,626,204,F
625,BGI,356,31,356,333,333,626,0,I
625,BGJ,172,48,404,150,477,626,232,B
625,CGJ,95,47,451,180,513,626,356,J
625,CGK,176,50,501,455,840,626,325,G
625,CHK,501,404,905,765,1242,626,404,C
625,DHK,27,27,932,5235,6477,626,905,D
625,HK,507,26,958,795,1308,626,451,K
625,HL,145,145,1103,5395,6703,626,958,L
625,H,841,239,1342,5005,5845,626,501,H
625,M,31,31,1373,1329,8032,626,1342,M
625,N,1381,1381,2754,135,8167,626,1373,N
625,O,767,767,3521,890,9057,626,2754,O
625,P,126,126,3647,5160,14217,626,3521,P
626,AEI,1,1,1,339,339,627,0,E
626,AFI,38,37,38,64,64,627,0,A
626,BFI,56,18,56,94,94,627,0,I
626,BFJ,101,83,139,135,199,627,38,B
626,CFJ,120,37,176,120,214,627,56,J
626,CFK,214,177,353,295,494,627,139,C
626,DFK,265,88,441,210,424,627,176,K
626,DFL,139,51,492,5160,5654,627,353,D
626,FL,524,33,525,240,579,627,1,F
626,GL,200,200,725,285,864,627,525,G
626,HL,794,510,1235,2880,3304,627,441,L
626,H,1744,1234,2469,5160,6024,627,725,H
626,M,951,951,3420,1806,7830,627,2469,M
626,N,914,914,4334,90,7920,627,3420,N
626,O,909,909,5243,1250,9170,627,4334,O
626,P,380,380,5623,3780,12950,627,5243,P
627,A,1647,1647,1647,1694,1694,628,0,A
627,B,301,301,1948,300,1994,628,1647,B
627,C,1554,1554,3502,1275,3269,628,1948,C
627,B,705,705,4207,1065,4334,628,3502,B
627,C,591,591,4798,510,4844,628,4207,C
627,D,1307,1307,6105,3960,8804,628,4798,D
627,M,35356,35356,41461,39381,48185,628,6105,M
627,N,4076,4076,45537,90,48275,628,41461,N
627,O,1061,1061,46598,1385,49660,628,45537,O
627,P,815,815,47413,3780,53440,628,46598,P
628,AE,114,114,114,20,20,629,0,A
628,BE,166,166,280,300,320,629,114,B
628,CE,862,862,1142,970,1290,629,280,C
628,DE,1459,1459,2601,4020,5310,629,1142,D
628,E,4367,1766,4367,4868,4868,629,0,E
628,F,531,531,4898,90,4958,629,4367,F
628,G,948,948,5846,1140,6098,629,4898,G
628,H,868,868,6714,3780,9878,629,5846,H
628,M,1150,1150,7864,2769,12647,629,6714,M
628,N,1822,1822,9686,240,12887,629,7864,N
628,O,1692,1692,11378,2470,15357,629,9686,O
628,P,717,717,12095,3960,19317,629,11378,P
629,AEI,85,85,85,200,200,630,0,E
629,AFI,136,51,136,229,229,630,0,I
629,AFJ,197,61,197,1013,1013,630,0,A
629,BFJ,205,93,290,150,350,630,85,F
629,BGJ,288,134,424,150,379,630,136,J
629,BGK,5,5,429,110,489,630,424,K
629,BGL,511,372,801,795,1145,630,290,G
629,BHL,70,70,871,2880,4025,630,801,H
629,BL,1106,432,1303,300,1313,630,197,B
629,CL,1286,1286,2589,1050,2363,630,1303,C
629,BL,2397,237,2826,4230,4719,630,429,L
629,B,2387,2150,4976,3040,5403,630,2589,B
629,C,877,877,5853,1080,6483,630,4976,C
629,D,1721,1721,7574,3960,10443,630,5853,D
629,M,264,264,7838,344,10787,630,7574,M
629,N,268,268,8106,240,11027,630,7838,N
629,O,717,717,8823,850,11877,630,8106,O
629,P,503,503,9326,5220,17097,630,8823,P
630,AE,1642,1642,1642,2020,2020,631,0,A
630,BE,430,430,2072,90,2110,631,1642,B
630,CE,941,941,3013,1275,3385,631,2072,C
630,DE,3146,133,3146,3272,3272,631,0,E
630,DF,191,58,3204,3780,7165,631,3013,D
630,F,349,291,3495,240,3512,631,3146,F
630,G,789,789,4284,1055,4567,631,3495,G
630,H,1078,1078,5362,3900,8467,631,4284,H
630,M,62,62,5424,128,8595,631,5362,M
630,N,265,265,5689,240,8835,631,5424,N
630,O,716,716,6405,970,9805,631,5689,O
630,P,147,147,6552,3960,13765,631,6405,P
631,AEI,607,607,607,1046,1046,632,0,I
631,AEJ,505,505,1112,90,1136,632,607,J
631,AEK,1338,226,1338,2157,2157,632,0,E
631,AFK,901,675,2013,1250,2386,632,1112,K
631,AFL,21,21,2034,3780,6166,632,2013,L
631,AF,946,250,2284,90,2247,632,1338,F
631,AG,3316,1032,3316,4540,4540,632,0,A
631,BG,2077,1045,4361,2335,4582,632,2284,G
631,BH,1471,426,4787,90,4630,632,3316,B
631,CH,1279,1279,6066,1405,6035,632,4787,C
631,DH,248,248,6314,3780,9815,632,6066,D
631,H,2215,262,6576,3780,8362,632,4361,H
631,M,301,301,6877,401,10216,632,6576,M
631,N,136,136,7013,90,10306,632,6877,N
631,O,239,239,7252,695,11001,632,7013,O
631,P,2662,2662,9914,3780,14781,632,7252,P
632,AE,417,417,417,1731,1731,633,0,E
632,AF,1584,1584,2001,300,2031,633,417,F
632,AG,2157,156,2157,3240,3240,633,0,A
632,BG,829,673,2830,790,2821,633,2001,G
632,BH,1335,662,3492,300,3540,633,2157,B
632,CH,714,714,4206,880,4420,633,3492,C
632,DH,1453,77,4283,4080,6901,633,2830,H
632,D,134,57,4340,1620,6040,633,4206,D
632,M,1826,1826,6166,2282,9183,633,4340,M
632,N,831,831,6997,420,9603,633,6166,N
632,O,992,992,7989,980,10583,633,6997,O
632,P,470,470,8459,550,11133,633,7989,P
633,A,499,499,499,508,508,634,0,A
633,B,145,145,644,240,748,634,499,B
633,C,1192,1192,1836,1560,2308,634,644,C
633,B,3450,3450,5286,3049,5357,634,1836,B
633,C,166,166,5452,386,5743,634,5286,C
633,D,3335,3335,8787,1454,7197,634,5452,D
633,M,1150,1150,9937,1331,8528,634,8787,M
633,N,301,301,10238,180,8708,634,9937,N
633,O,292,292,10530,260,8968,634,10238,O
633,P,2078,2078,12608,375,9343,634,10530,P
634,AE,1,1,1,155,155,635,0,A
634,BE,39,38,39,193,193,635,0,E
634,BF,257,219,258,150,305,635,1,B
634,CF,107,107,365,145,450,635,258,C
634,DF,332,6,371,240,433,635,39,F
634,DG,138,138,509,255,688,635,371,G
634,DF,607,607,1116,460,1148,635,509,F
634,DG,166,166,1282,215,1363,635,1116,G
634,DH,1472,555,1837,4200,4650,635,365,D
634,H,581,26,1863,4890,6253,635,1282,H
634,M,19,19,1882,632,6885,635,1863,M
634,N,816,816,2698,240,7125,635,1882,N
634,O,726,726,3424,970,8095,635,2698,O
634,P,337,337,3761,3960,12055,635,3424,P
635,AE,6,6,6,559,559,636,0,A
635,BE,764,764,770,240,799,636,6,B
635,CE,672,672,1442,960,1759,636,770,C
635,DE,202,202,1644,3960,5719,636,1442,D
635,E,2502,858,2502,2272,2272,636,0,E
635,F,157,157,2659,90,2362,636,2502,F
635,G,529,529,3188,725,3087,636,2659,G
635,F,1046,1046,4234,1205,4292,636,3188,F
635,G,962,962,5196,1425,5717,636,4234,G
635,H,1575,1575,6771,3780,9497,636,5196,H
635,M,74,74,6845,181,9678,636,6771,M
635,N,295,295,7140,240,9918,636,6845,N
635,O,761,761,7901,975,10893,636,7140,O
635,P,790,790,8691,5040,15933,636,7901,P
636,A,24945,24945,24945,25592,25592,637,0,A
636,B,714,714,25659,90,25682,637,24945,B
636,C,1190,1190,26849,1385,27067,637,25659,C
636,B,312,312,27161,130,27197,637,26849,B
636,C,365,365,27526,800,27997,637,27161,C
636,D,413,413,27939,3780,31777,637,27526,D
636,M,678,678,28617,978,32755,637,27939,M
636,N,437,437,29054,180,32935,637,28617,N
636,O,889,889,29943,900,33835,637,29054,O
636,P,3423,3423,33366,550,34385,637,29943,P
637,A,295,295,295,372,372,638,0,A
637,B,164,164,459,150,522,638,295,B
637,C,509,509,968,470,992,638,459,C
637,B,414,414,1382,425,1417,638,968,B
637,C,218,218,1600,135,1552,638,1382,C
637,D,938,938,2538,4230,5782,638,1600,D
637,M,734,734,3272,1177,6959,638,2538,M
637,N,545,545,3817,150,7109,638,3272,N
637,O,158,158,3975,140,7249,638,3817,O
637,N,330,330,4305,340,7589,638,3975,N
637,O,548,548,4853,815,8404,638,4305,O
637,P,5317,5317,10170,3840,12244,638,4853,P
638,AE,89,89,89,198,198,639,0,E
638,AF,266,177,266,310,310,639,0,A
638,BF,221,44,310,150,348,639,89,F
638,BG,167,167,477,455,803,639,310,G
638,BH,285,74,551,300,610,639,266,B
638,CH,598,598,1149,775,1385,639,551,C
638,DH,53,53,1202,5320,6705,639,1149,D
638,H,833,108,1310,3565,4368,639,477,H
638,M,87,87,1397,214,6919,639,1310,M
638,N,216,216,1613,135,7054,639,1397,N
638,O,180,180,1793,285,7339,639,1613,O
638,P,324,324,2117,5160,12499,639,1793,P
639,AEI,27,27,27,276,276,640,0,I
639,AEJ,291,264,291,578,578,640,0,A
639,BEJ,268,4,295,90,366,640,27,J
639,BEK,383,379,674,150,728,640,291,B
639,CEK,568,189,863,1010,1376,640,295,K
639,CEL,254,254,1117,3780,5156,640,863,L
639,CE,507,64,1181,495,1223,640,674,C
639,DE,1240,59,1240,1442,1442,640,0,E
639,DF,317,258,1498,4200,5423,640,1181,D
639,F,429,171,1669,240,1682,640,1240,F
639,G,667,667,2336,850,2532,640,1669,G
639,H,2849,2849,5185,4800,7332,640,2336,H
639,M,132,132,5317,935,8267,640,5185,M
639,N,1023,1023,6340,240,8507,640,5317,N
639,O,676,676,7016,960,9467,640,6340,O
639,P,25,25,7041,3960,13427,640,7016,P
640,AE,1541,1541,1541,1790,1790,641,0,A
640,BE,1581,40,1581,1912,1912,641,0,E
640,BF,450,410,1991,240,2030,641,1541,B
640,CF,525,115,2106,240,2152,641,1581,F
640,CG,525,410,2516,700,2730,641,1991,C
640,DG,417,417,2933,3960,6690,641,2516,D
640,G,971,144,3077,1065,3217,641,2106,G
640,H,322,322,3399,3900,7117,641,3077,H
640,M,1350,1350,4749,1313,8430,641,3399,M
640,N,164,164,4913,240,8670,641,4749,N
640,O,698,698,5611,960,9630,641,4913,O
640,P,193,193,5804,3960,13590,641,5611,P
641,AEI,354,354,354,545,545,642,0,A
641,BEI,483,483,837,300,845,642,354,B
641,CEI,720,720,1557,735,1580,642,837,C
641,DEI,43,43,1600,1560,3140,642,1557,D
641,EI,13230,11630,13230,13479,13479,642,0,I
641,EJ,588,588,13818,300,13779,642,13230,J
641,EK,546,546,14364,740,14519,642,13818,K
641,EL,90,90,14454,1560,16079,642,14364,L
641,E,14895,441,14895,14855,14855,642,0,E
641,F,257,257,15152,300,15155,642,14895,F
641,G,561,561,15713,735,15890,642,15152,G
641,H,107,107,15820,1560,17450,642,15713,H
641,M,225,225,16045,245,17695,642,15820,M
641,N,297,297,16342,300,17995,642,16045,N
641,O,654,654,16996,750,18745,642,16342,O
641,P,3534,3534,20530,1560,20305,642,16996,P
642,AE,2295,2295,2295,2500,2500,643,0,E
642,AF,335,335,2630,180,2680,643,2295,F
642,AG,535,535,3165,731,3411,643,2630,G
642,AF,210,210,3375,334,3745,643,3165,F
642,AG,3902,527,3902,4378,4378,643,0,A
642,BG,840,840,4742,90,4468,643,3902,B
642,CG,599,599,5341,1413,5881,643,4742,C
642,DG,2513,547,5888,2340,6085,643,3375,G
642,DH,4182,4182,10070,4080,10165,643,5888,H
642,D,7902,3173,13243,3780,9661,643,5341,D
642,M,10391,10391,23634,11300,21465,643,13243,M
642,N,1163,1163,24797,300,21765,643,23634,N
642,O,777,777,25574,805,22570,643,24797,O
642,P,5959,5959,31533,1260,23830,643,25574,P
643,AE,50,50,50,1675,1675,644,0,A
643,BE,183,133,183,966,966,644,0,E
643,BF,875,875,1058,150,1116,644,183,F
643,BG,164,164,1222,120,1236,644,1058,G
643,BF,538,538,1760,550,1786,644,1222,F
643,BG,1771,61,1821,165,1840,644,50,B
643,CG,568,507,2328,635,2421,644,1760,G
643,CH,605,98,2426,910,2750,644,1821,C
643,DH,111,111,2537,3960,6710,644,2426,D
643,H,295,86,2623,4230,6651,644,2328,H
643,M,2508,2508,5131,2754,9464,644,2623,M
643,N,357,357,5488,150,9614,644,5131,N
643,O,697,697,6185,700,10314,644,5488,O
643,N,1101,1101,7286,1095,11409,644,6185,N
643,O,643,643,7929,690,12099,644,7286,O
643,P,1250,1250,9179,4230,16329,644,7929,P
644,AE,502,502,502,768,768,645,0,A
644,BE,281,281,783,90,858,645,502,B
644,CE,584,584,1367,905,1763,645,783,C
644,DE,146,146,1513,3780,5543,645,1367,D
644,E,7700,6187,7700,8409,8409,645,0,E
644,F,757,757,8457,90,8499,645,7700,F
644,G,842,842,9299,1230,9729,645,8457,G
644,H,337,337,9636,3780,13509,645,9299,H
644,M,324,324,9960,577,14086,645,9636,M
644,N,295,295,10255,90,14176,645,9960,N
644,O,483,483,10738,860,15036,645,10255,O
644,P,3161,3161,13899,3780,18816,645,10738,P
645,AEI,142,142,142,1045,1045,646,0,A
645,BEI,1033,1033,1175,180,1225,646,142,B
645,CEI,1336,161,1336,1709,1709,646,0,E
645,CFI,166,5,1341,225,1450,646,1175,C
645,BFI,401,396,1737,90,1799,646,1336,F
645,BGI,736,340,2077,650,2100,646,1341,B
645,CGI,801,461,2538,1060,2859,646,1737,G
645,CHI,51,51,2589,3780,6639,646,2538,H
645,CI,854,342,2931,865,2965,646,2077,C
645,DI,291,291,3222,4140,7105,646,2931,D
645,I,10385,7163,10385,10601,10601,646,0,I
645,J,269,269,10654,90,10691,646,10385,J
645,K,693,693,11347,1130,11821,646,10654,K
645,L,503,503,11850,3780,15601,646,11347,L
645,M,1647,1647,13497,1860,17461,646,11850,M
645,N,359,359,13856,90,17551,646,13497,N
645,O,1142,1142,14998,1590,19141,646,13856,O
645,P,22427,22427,37425,3780,22921,646,14998,P
646,A,831,831,831,1310,1310,647,0,A
646,B,741,741,1572,300,1610,647,831,B
646,C,950,950,2522,920,2530,647,1572,C
646,B,745,745,3267,885,3415,647,2522,B
646,C,1083,1083,4350,1141,4556,647,3267,C
646,D,514,514,4864,3960,8516,647,4350,D
646,M,714,714,5578,921,9437,647,4864,M
646,N,412,412,5990,240,9677,647,5578,N
646,O,121,121,6111,150,9827,647,5990,O
646,P,1154,1154,7265,550,10377,647,6111,P
647,AEI,3,3,3,47,47,648,0,E
647,AFI,132,129,132,182,182,648,0,I
647,AFJ,284,155,287,300,347,648,3,F
647,AGJ,165,10,297,150,332,648,132,J
647,AGK,179,179,476,455,787,648,297,K
647,AGL,651,462,938,770,1117,648,287,G
647,AHL,12,12,950,5325,6442,648,938,H
647,AL,1118,168,1118,1475,1475,648,0,A
647,BL,597,597,1715,300,1775,648,1118,B
647,CL,766,766,2481,820,2595,648,1715,C
647,DL,13,13,2494,5315,7910,648,2481,D
647,L,3734,1716,4210,3565,4352,648,476,L
647,M,39,39,4249,1359,9269,648,4210,M
647,N,1503,1503,5752,240,9509,648,4249,N
647,O,887,887,6639,890,10399,648,5752,O
647,P,14554,14554,21193,5160,15559,648,6639,P
648,AE,251,251,251,354,354,649,0,E
648,AF,330,330,581,300,654,649,251,F
648,AG,566,566,1147,775,1429,649,581,G
648,AH,1539,392,1539,1600,1600,649,0,A
648,BH,147,147,1686,150,1750,649,1539,B
648,CH,161,161,1847,455,2205,649,1686,C
648,DH,1106,406,2253,5320,6749,649,1147,H
648,D,3775,3369,5622,3565,5770,649,1847,D
648,M,74,74,5696,1029,7778,649,5622,M
648,N,1165,1165,6861,240,8018,649,5696,N
648,O,180,180,7041,215,8233,649,6861,O
648,P,1096,1096,8137,5490,13723,649,7041,P
649,AE,668,668,668,1345,1345,650,0,A
649,BE,726,726,1394,120,1465,650,668,B
649,CE,150,150,1544,145,1610,650,1394,C
649,BE,1600,56,1600,1754,1754,650,0,E
649,BF,107,51,1651,105,1715,650,1544,B
649,CF,67,67,1718,50,1765,650,1651,C
649,DF,255,137,1855,150,1904,650,1600,F
649,DG,252,252,2107,240,2144,650,1855,G
649,DF,1157,768,2875,2880,4645,650,1718,D
649,F,956,188,3063,965,3109,650,2107,F
649,G,105,105,3168,135,3244,650,3063,G
649,H,1393,1393,4561,4230,7474,650,3168,H
649,M,1745,1745,6306,1961,9435,650,4561,M
649,N,336,336,6642,180,9615,650,6306,N
649,O,1582,1582,8224,2010,11625,650,6642,O
649,N,2667,2667,10891,2135,13760,650,8224,N
649,O,1759,1759,12650,1930,15690,650,10891,O
649,P,293,293,12943,420,16110,650,12650,P
650,AE,234,234,234,1088,1088,651,0,A
650,BE,957,957,1191,150,1238,651,234,B
650,CE,761,761,1952,790,2028,651,1191,C
650,DE,2277,325,2277,2353,2353,651,0,E
650,DF,287,287,2564,240,2593,651,2277,F
650,DG,959,347,2911,4200,6228,651,1952,D
650,G,463,116,3027,585,3178,651,2564,G
650,H,492,492,3519,3960,7138,651,3027,H
650,M,90,90,3609,152,7290,651,3519,M
650,N,163,163,3772,150,7440,651,3609,N
650,O,100,100,3872,115,7555,651,3772,O
650,P,613,613,4485,4230,11785,651,3872,P
651,AE,330,330,330,1380,1380,652,0,A
651,BE,1140,1140,1470,150,1530,652,330,B
651,CE,599,599,2069,635,2165,652,1470,C
651,DE,2084,15,2084,3205,3205,652,0,E
651,DF,1159,1159,3243,90,3295,652,2084,F
651,DG,440,440,3683,805,4100,652,3243,G
651,DF,1821,207,3890,2880,5045,652,2069,D
651,F,1539,1332,5222,940,5040,652,3683,F
651,G,1762,1762,6984,2035,7075,652,5222,G
651,H,2456,2456,9440,3780,10855,652,6984,H
651,M,13321,13321,22761,14445,25300,652,9440,M
651,N,1478,1478,24239,300,25600,652,22761,N
651,O,1194,1194,25433,1045,26645,652,24239,O
651,P,607,607,26040,1200,27845,652,25433,P
652,A,1267,1267,1267,1952,1952,653,0,A
652,B,715,715,1982,90,2042,653,1267,B
652,C,960,960,2942,1255,3297,653,1982,C
652,D,804,804,3746,3780,7077,653,2942,D
652,M,35776,35776,39522,36338,43415,653,3746,M
652,N,1206,1206,40728,90,43505,653,39522,N
652,O,1181,1181,41909,1385,44890,653,40728,O
652,N,292,292,42201,670,45560,653,41909,N
652,O,767,767,42968,920,46480,653,42201,O
652,P,787,787,43755,3780,50260,653,42968,P
653,AE,215,215,215,259,259,654,0,A
653,BE,239,239,454,240,499,654,215,B
653,CE,1056,602,1056,1644,1644,654,0,E
653,CF,902,300,1356,1180,1679,654,454,C
653,BF,888,588,1944,330,1974,654,1056,F
653,BG,550,550,2494,735,2709,654,1944,G
653,BF,1143,1143,3637,985,3694,654,2494,F
653,BG,105,105,3742,200,3894,654,3637,G
653,BH,2836,450,4192,2620,4299,654,1356,B
653,CH,637,637,4829,798,5097,654,4192,C
653,DH,1496,409,5238,3780,7674,654,3742,H
653,D,1027,618,5856,1002,6099,654,4829,D
653,M,60,60,5916,212,7886,654,5856,M
653,N,362,362,6278,270,8156,654,5916,N
653,O,640,640,6918,780,8936,654,6278,O
653,N,1051,1051,7969,925,9861,654,6918,N
653,O,896,896,8865,1162,11023,654,7969,O
653,P,1933,1933,10798,473,11496,654,8865,P
654,AEI,145,145,145,150,150,655,0,A
654,BEI,95,95,240,150,300,655,145,B
654,CEI,364,124,364,1082,1082,655,0,E
654,CFI,182,58,422,410,710,655,240,C
654,DFI,511,89,511,933,933,655,0,I
654,DFJ,572,572,1083,210,1143,655,511,J
654,DFK,808,89,1172,150,1232,655,364,F
654,DGK,832,82,1254,3450,4160,655,422,D
654,GK,741,570,1824,1000,2143,655,1083,K
654,GL,832,180,2004,1050,2282,655,1172,G
654,HL,754,574,2578,5165,7308,655,1824,L
654,H,2808,2234,4812,3490,5772,655,2004,H
654,M,142,142,4954,337,7645,655,4812,M
654,N,404,404,5358,240,7885,655,4954,N
654,O,280,280,5638,285,8170,655,5358,O
654,P,1026,1026,6664,5160,13330,655,5638,P
655,AEI,62,62,62,177,177,656,0,I
655,AEJ,198,198,260,135,312,656,62,J
655,AEK,625,625,885,705,1017,656,260,K
655,AEL,94,94,979,5760,6777,656,885,L
655,AE,1469,490,1469,1516,1516,656,0,A
655,BE,197,197,1666,210,1726,656,1469,B
655,CE,520,520,2186,450,2176,656,1666,C
655,BE,52,52,2238,89,2265,656,2186,B
655,CE,761,761,2999,901,3166,656,2238,C
655,BE,1472,1472,4471,1325,4491,656,2999,B
655,CE,744,744,5215,705,5196,656,4471,C
655,DE,8401,3186,8401,8320,8320,656,0,E
655,DF,170,170,8571,300,8620,656,8401,F
655,DG,406,406,8977,885,9505,656,8571,G
655,DH,3826,64,9041,5760,10956,656,5215,D
655,H,114,50,9091,1560,11065,656,8977,H
655,M,1226,1226,10317,3135,14200,656,9091,M
655,N,2162,2162,12479,300,14500,656,10317,N
655,O,606,606,13085,740,15240,656,12479,O
655,P,71,71,13156,1560,16800,656,13085,P
656,AEI,206,206,206,499,499,657,0,A
656,BEI,301,95,301,2401,2401,657,0,I
656,BEJ,411,316,617,180,679,657,206,B
656,CEJ,685,68,685,1234,1234,657,0,E
656,CFJ,113,45,730,235,914,657,617,C
656,BFJ,411,411,1141,295,1209,657,730,B
656,CFJ,113,113,1254,290,1499,657,1141,C
656,DFJ,5,5,1259,5100,6599,657,1254,D
656,FJ,789,215,1474,300,1534,657,685,F
656,GJ,236,236,1710,315,1849,657,1474,G
656,FJ,2511,1102,2812,480,2881,657,301,J
656,FK,690,690,3502,995,3876,657,2812,K
656,FJ,2399,607,4109,2330,4179,657,1710,F
656,GJ,117,117,4226,290,4469,657,4109,G
656,HJ,30,30,4256,5100,9569,657,4226,H
656,J,2104,1350,5606,1805,5681,657,3502,J
656,K,475,475,6081,830,6511,657,5606,K
656,L,30,30,6111,340,6851,657,6081,L
656,M,6821,6821,12932,8115,17684,657,6111,M
656,N,1354,1354,14286,120,17804,657,12932,N
656,O,177,177,14463,420,18224,657,14286,O
656,N,705,705,15168,460,18684,657,14463,N
656,O,816,816,15984,945,19629,657,15168,O
656,P,714,714,16698,5160,24789,657,15984,P
657,A,625,625,625,1511,1511,658,0,A
657,B,1046,1046,1671,240,1751,658,625,B
657,C,766,766,2437,800,2551,658,1671,C
657,D,281,281,2718,3960,6511,658,2437,D
657,M,1,1,2719,90,6601,658,2718,M
657,N,179,179,2898,150,6751,658,2719,N
657,O,639,639,3537,475,7226,658,2898,O
657,P,163,163,3700,475,7701,658,3537,P
658,AEI,18,18,18,306,306,659,0,E
658,AFI,487,487,505,240,546,659,18,F
658,AGI,1099,1099,1604,785,1331,659,505,G
658,AHI,805,805,2409,3960,5291,659,1604,H
658,AI,4263,1854,4263,4245,4245,659,0,A
658,BI,234,234,4497,300,4545,659,4263,B
658,CI,712,712,5209,890,5435,659,4497,C
658,DI,7165,1956,7165,7115,7115,659,0,I
658,DJ,212,212,7377,300,7415,659,7165,J
658,DK,759,759,8136,890,8305,659,7377,K
658,DL,5056,2129,10265,1140,6575,659,5209,D
658,L,9409,7280,17545,1140,9445,659,8136,L
658,M,104,104,17649,316,9761,659,17545,M
658,N,233,233,17882,90,9851,659,17649,N
658,O,1439,1439,19321,1780,11631,659,17882,O
658,N,702,702,20023,345,11976,659,19321,N
658,O,621,621,20644,965,12941,659,20023,O
658,P,1182,1182,21826,3780,16721,659,20644,P
659,AE,6,6,6,47,47,660,0,E
659,AF,89,89,95,90,137,660,6,F
659,AG,686,591,686,1211,1211,660,0,A
659,BG,694,103,789,815,952,660,95,G
659,BH,228,228,1017,3960,4912,660,789,H
659,B,723,392,1409,240,1451,660,686,B
659,C,929,929,2338,1015,2466,660,1409,C
659,D,1119,1119,3457,3960,6426,660,2338,D
659,M,1566,1566,5023,2086,8512,660,3457,M
659,N,558,558,5581,90,8602,660,5023,N
659,O,1074,1074,6655,1400,10002,660,5581,O
659,P,51,51,6706,3780,13782,660,6655,P
660,AEI,748,748,748,1378,1378,661,0,I
660,AEJ,806,58,806,1441,1441,661,0,E
660,AFJ,1053,247,1053,1344,1344,661,0,A
660,BFJ,319,319,1372,90,1434,661,1053,B
660,CFJ,667,43,1415,90,1468,661,748,J
660,CFK,671,62,1477,90,1531,661,806,F
660,CGK,379,274,1751,800,2234,661,1372,C
660,DGK,355,19,1770,800,2268,661,1415,K
660,DGL,356,63,1833,800,2331,661,1477,G
660,DHL,894,831,2664,3780,6048,661,1770,L
660,DH,931,100,2764,3780,6111,661,1833,H
660,D,1715,702,3466,3780,6014,661,1751,D
660,M,6058,6058,9524,6297,12408,661,3466,M
660,N,274,274,9798,90,12498,661,9524,N
660,O,414,414,10212,820,13318,661,9798,O
660,N,702,702,10914,300,13618,661,10212,N
660,O,210,210,11124,630,14248,661,10914,O
660,P,6699,6699,17823,3780,18028,661,11124,P
661,A,1175,1175,1175,1601,1601,662,0,A
661,B,545,545,1720,150,1751,662,1175,B
661,C,730,730,2450,675,2426,662,1720,C
661,B,1296,1296,3746,1360,3786,662,2450,B
661,C,773,773,4519,700,4486,662,3746,C
661,D,40,40,4559,4230,8716,662,4519,D
661,M,3276,3276,7835,4250,12966,662,4559,M
661,N,1004,1004,8839,90,13056,662,7835,N
661,O,577,577,9416,905,13961,662,8839,O
661,N,1695,1695,11111,1365,15326,662,9416,N
661,O,613,613,11724,900,16226,662,11111,O
661,P,1299,1299,13023,3780,20006,662,11724,P
662,AEI,148,148,148,1341,1341,663,0,A
662,BEI,188,40,188,1161,1161,663,0,I
662,BEJ,522,334,522,1345,1345,663,0,E
662,BFJ,1019,685,1207,90,1251,663,188,J
662,BFK,1223,164,1371,90,1431,663,148,B
662,CFK,859,10,1381,90,1435,663,522,F
662,CGK,915,741,2122,1200,2451,663,1207,K
662,CGL,854,113,2235,1240,2675,663,1381,G
662,CHL,42,42,2277,3780,6455,663,2235,H
662,CL,1040,134,2411,1220,2651,663,1371,C
662,DL,1115,1115,3526,3780,6431,663,2411,D
662,L,1621,217,3743,3780,6231,663,2122,L
662,M,5252,5252,8995,5454,11909,663,3743,M
662,N,240,240,9235,90,11999,663,8995,N
662,O,358,358,9593,735,12734,663,9235,O
662,P,8242,8242,17835,3780,16514,663,9593,P
663,AEI,116,116,116,281,281,664,0,I
663,AEJ,194,194,310,90,371,664,116,J
663,AEK,686,376,686,1373,1373,664,0,A
663,BEK,461,85,771,695,1066,664,310,K
663,BEL,66,66,837,3780,4846,664,771,L
663,BE,726,575,1412,90,1463,664,686,B
663,CE,1647,235,1647,1948,1948,664,0,E
663,CF,458,223,1870,855,2318,664,1412,C
663,DF,341,118,1988,90,2038,664,1647,F
663,DG,523,523,2511,860,2898,664,1988,G
663,DH,1024,1024,3535,3780,6678,664,2511,H
663,D,2314,649,4184,3780,6098,664,1870,D
663,M,476,476,4660,837,7515,664,4184,M
663,N,394,394,5054,90,7605,664,4660,N
663,O,583,583,5637,850,8455,664,5054,O
663,P,638,638,6275,3840,12295,664,5637,P
664,A,456,456,456,697,697,665,0,A
664,B,363,363,819,180,877,665,456,B
664,C,157,157,976,265,1142,665,819,C
664,D,1325,1325,2301,6445,7587,665,976,D
664,M,75,75,2376,132,7719,665,2301,M
664,N,234,234,2610,240,7959,665,2376,N
664,O,818,818,3428,945,8904,665,2610,O
664,P,719,719,4147,5160,14064,665,3428,P
665,AEI,172,172,172,1008,1008,666,0,A
665,BEI,1261,1089,1261,1946,1946,666,0,E
665,BFI,1134,45,1306,300,1308,666,172,B
665,CFI,1526,220,1526,1482,1482,666,0,I
665,CFJ,221,221,1747,300,1782,666,1526,J
665,CFK,737,251,1998,90,2036,666,1261,F
665,CGK,1186,494,2492,995,2303,666,1306,C
665,DGK,865,120,2612,1000,2782,666,1747,K
665,DGL,881,267,2879,1275,3311,666,1998,G
665,DHL,569,569,3448,3780,7091,666,2879,H
665,DL,1148,192,3640,3960,6263,666,2492,D
665,L,1322,294,3934,3960,6742,666,2612,L
665,M,25,25,3959,311,7402,666,3934,M
665,N,499,499,4458,240,7642,666,3959,N
665,O,748,748,5206,1025,8667,666,4458,O
665,P,165,165,5371,3960,12627,666,5206,P
666,AEI,309,309,309,967,967,667,0,I
666,AEJ,433,124,433,1141,1141,667,0,E
666,AFJ,689,565,998,90,1057,667,309,J
666,AFK,741,176,1174,90,1231,667,433,F
666,AGK,471,295,1469,850,1907,667,998,K
666,AGL,1635,166,1635,2538,2538,667,0,A
666,BGL,478,17,1652,845,2076,667,1174,G
666,BHL,429,246,1898,3780,5687,667,1469,L
666,BH,933,670,2568,90,2628,667,1635,B
666,CH,490,490,3058,845,3473,667,2568,C
666,DH,1746,340,3398,3780,5856,667,1652,H
666,D,25940,25600,28998,3780,7253,667,3058,D
666,M,50,50,29048,566,7819,667,28998,M
666,N,795,795,29843,300,8119,667,29048,N
666,O,706,706,30549,920,9039,667,29843,O
666,N,303,303,30852,5,9044,667,30549,N
666,O,1431,1431,32283,1260,10304,667,30852,O
666,P,1188,1188,33471,3960,14264,667,32283,P
667,A,1380,1380,1380,1579,1579,668,0,A
667,B,577,577,1957,420,1999,668,1380,B
667,C,865,865,2822,1079,3078,668,1957,C
667,D,4977,4977,7799,356,3434,668,2822,D
667,M,116,116,7915,456,3890,668,7799,M
667,N,524,524,8439,240,4130,668,7915,N
667,O,1161,1161,9600,1135,5265,668,8439,O
667,P,1785,1785,11385,550,5815,668,9600,P
668,AE,474,474,474,1438,1438,669,0,E
668,AF,1001,1001,1475,90,1528,669,474,F
668,AG,1009,1009,2484,1220,2748,669,1475,G
668,AH,3,3,2487,3780,6528,669,2484,H
668,A,19465,16978,19465,19656,19656,669,0,A
668,B,215,215,19680,90,19746,669,19465,B
668,C,714,714,20394,1105,20851,669,19680,C
668,D,174,174,20568,3780,24631,669,20394,D
668,M,164,164,20732,636,25267,669,20568,M
668,N,1413,1413,22145,785,26052,669,20732,N
668,O,1195,1195,23340,1200,27252,669,22145,O
668,P,768,768,24108,550,27802,669,23340,P
669,AE,672,672,672,529,529,670,0,E
669,AF,103,103,775,300,829,670,672,F
669,AG,149,149,924,400,1229,670,775,G
669,AH,76,76,1000,5450,6679,670,924,H
669,A,1131,131,1131,1132,1132,670,0,A
669,B,96,96,1227,150,1282,670,1131,B
669,C,152,152,1379,455,1737,670,1227,C
669,D,914,914,2293,5005,6742,670,1379,D
669,M,97,97,2390,1029,7771,670,2293,M
669,N,1166,1166,3556,240,8011,670,2390,N
669,O,237,237,3793,215,8226,670,3556,O
669,P,4008,4008,7801,5370,13596,670,3793,P
670,AE,44,44,44,984,984,671,0,E
670,AF,619,575,619,1238,1238,671,0,A
670,BF,1128,553,1172,240,1224,671,44,F
670,BG,651,98,1270,90,1328,671,619,B
670,CG,392,392,1662,795,2123,671,1270,C
670,DG,904,414,2076,1020,2244,671,1172,G
670,DH,431,431,2507,4680,6924,671,2076,H
670,D,1791,946,3453,3780,5903,671,1662,D
670,M,8857,8857,12310,9061,15985,671,3453,M
670,N,248,248,12558,90,16075,671,12310,N
670,O,419,419,12977,800,16875,671,12558,O
670,N,480,480,13457,80,16955,671,12977,N
670,O,619,619,14076,940,17895,671,13457,O
670,P,2272,2272,16348,3780,21675,671,14076,P
671,AEI,150,150,150,1128,1128,672,0,I
671,AEJ,179,29,179,1343,1343,672,0,E
671,AFJ,832,653,832,1054,1054,672,0,A
671,BFJ,250,250,1082,90,1144,672,832,B
671,CFJ,1161,229,1311,240,1368,672,150,J
671,CFK,365,136,1447,795,1939,672,1082,C
671,DFK,1357,89,1536,240,1583,672,179,F
671,DGK,895,670,2206,1020,2388,672,1311,K
671,DGL,948,278,2484,995,2578,672,1536,G
671,DHL,1070,33,2517,3780,5719,672,1447,D
671,HL,143,110,2627,4680,7258,672,2484,H
671,L,1519,1098,3725,4680,7068,672,2206,L
671,M,2061,2061,5786,2278,9536,672,3725,M
671,N,266,266,6052,90,9626,672,5786,N
671,O,468,468,6520,795,10421,672,6052,O
671,N,1491,1491,8011,460,10881,672,6520,N
671,O,1344,1344,9355,1885,12766,672,8011,O
671,P,1074,1074,10429,3780,16546,672,9355,P
672,AEI,405,405,405,315,315,673,0,A
672,BEI,165,165,570,300,615,673,405,B
672,CEI,679,679,1249,750,1365,673,570,C
672,DEI,1715,466,1715,1835,1835,673,0,I
672,DEJ,375,375,2090,300,2135,673,1715,J
672,DEK,637,637,2727,810,2945,673,2090,K
672,DEL,1481,3,2730,1560,2925,673,1249,D
672,EL,2796,66,2796,2895,2895,673,0,E
672,FL,352,352,3148,300,3195,673,2796,F
672,GL,637,637,3785,810,4005,673,3148,G
672,HL,3260,3260,7045,1560,5565,673,3785,H
672,L,4813,495,7540,1560,4505,673,2727,L
672,M,14780,14780,22320,14854,20419,673,7540,M
672,N,336,336,22656,300,20719,673,22320,N
672,O,621,621,23277,735,21454,673,22656,O
672,P,147,147,23424,1560,23014,673,23277,P
673,AE,27,27,27,27,27,674,0,A
673,BE,61,34,61,261,261,674,0,E
673,BF,46,12,73,90,117,674,27,B
673,CF,243,231,304,90,351,674,61,F
673,CG,693,462,766,1010,1127,674,73,C
673,DG,774,312,1078,1005,1356,674,304,G
673,DH,29,29,1107,3780,5136,674,1078,H
673,D,705,364,1471,3780,4907,674,766,D
673,M,6,6,1477,394,5530,674,1471,M
673,N,584,584,2061,240,5770,674,1477,N
673,O,474,474,2535,815,6585,674,2061,O
673,P,243,243,2778,3840,10425,674,2535,P
674,AEI,56,56,56,78,78,675,0,A
674,BEI,62,6,62,87,87,675,0,E
674,BFI,96,90,152,135,213,675,56,B
674,CFI,144,54,206,135,222,675,62,F
674,CGI,141,141,347,295,517,675,206,G
674,CHI,266,71,418,285,498,675,152,C
674,DHI,97,97,515,5160,5658,675,418,D
674,HI,189,21,536,5160,5677,675,347,H
674,I,1735,1199,1735,2231,2231,675,0,I
674,J,577,577,2312,90,2321,675,1735,J
674,K,937,937,3249,1285,3606,675,2312,K
674,L,643,643,3892,3780,7386,675,3249,L
674,M,159,159,4051,212,7598,675,3892,M
674,N,152,152,4203,150,7748,675,4051,N
674,O,45,45,4248,100,7848,675,4203,O
674,N,469,469,4717,385,8233,675,4248,N
674,O,209,209,4926,225,8458,675,4717,O
674,P,48,48,4974,4740,13198,675,4926,P
675,AE,396,396,396,1064,1064,676,0,E
675,AF,969,573,969,1364,1364,676,0,A
675,BF,719,146,1115,90,1154,676,396,F
675,BG,488,342,1457,150,1514,676,969,B
675,CG,323,323,1780,280,1794,676,1457,C
675,DG,1022,357,2137,1285,2439,676,1115,G
675,DH,1174,817,2954,5160,6954,676,1780,D
675,H,2614,1797,4751,3780,6219,676,2137,H
675,M,8145,8145,12896,11097,18051,676,4751,M
675,N,3025,3025,15921,90,18141,676,12896,N
675,O,995,995,16916,1250,19391,676,15921,O
675,N,720,720,17636,510,19901,676,16916,N
675,O,713,713,18349,890,20791,676,17636,O
675,P,18942,18942,37291,3780,24571,676,18349,P
676,AEI,117,117,117,204,204,677,0,A
676,BEI,124,7,124,339,339,677,0,E
676,BFI,268,144,268,319,319,677,0,I
676,BFJ,184,33,301,120,324,677,117,B
676,CFJ,107,74,375,120,439,677,268,J
676,CFK,274,23,398,120,459,677,124,F
676,CGK,120,23,421,125,449,677,301,C
676,DGK,125,79,500,125,564,677,375,K
676,DGL,208,106,606,125,584,677,398,G
676,DHL,949,764,1370,2880,3329,677,421,D
676,HL,845,81,1451,2880,3464,677,606,H
676,L,1076,125,1576,2880,3444,677,500,L
676,M,246,246,1822,1109,4573,677,1576,M
676,N,953,953,2775,150,4723,677,1822,N
676,O,122,122,2897,135,4858,677,2775,O
676,P,8644,8644,11541,2880,7738,677,2897,P
677,AE,87,87,87,1057,1057,678,0,E
677,AF,1162,1162,1249,240,1297,678,87,F
677,AG,1805,556,1805,1785,1785,678,0,A
677,BG,712,156,1961,685,1982,678,1249,G
677,BH,249,93,2054,300,2085,678,1805,B
677,CH,659,659,2713,810,2895,678,2054,C
677,DH,1157,405,3118,5760,7742,678,1961,H
677,D,6248,5843,8961,1560,4455,678,2713,D
677,M,13392,13392,22353,13459,21201,678,8961,M
677,N,327,327,22680,300,21501,678,22353,N
677,O,604,604,23284,770,22271,678,22680,O
677,P,241,241,23525,1620,23891,678,23284,P
678,AEI,664,664,664,1102,1102,679,0,A
678,BEI,537,537,1201,150,1252,679,664,B
678,CEI,178,178,1379,140,1392,679,1201,C
678,BEI,2194,815,2194,2621,2621,679,0,I
678,BEJ,524,524,2718,150,2771,679,2194,J
678,BEK,165,165,2883,130,2901,679,2718,K
678,BEJ,1541,37,2920,1555,2947,679,1379,B
678,CEJ,323,323,3243,645,3592,679,2920,C
678,DEJ,515,515,3758,4230,7822,679,3243,D
678,EJ,1534,659,4417,1565,4466,679,2883,J
678,EK,4737,320,4737,5570,5570,679,0,E
678,FK,367,47,4784,650,5116,679,4417,K
678,FL,861,814,5598,90,5660,679,4737,F
678,GL,689,689,6287,905,6565,679,5598,G
678,FL,347,347,6634,90,6655,679,6287,F
678,GL,3196,1346,7980,4230,9346,679,4784,L
678,G,1528,182,8162,2320,8975,679,6634,G
678,H,2779,2779,10941,3420,12395,679,8162,H
678,M,846,846,11787,1759,14154,679,10941,M
678,N,967,967,12754,90,14244,679,11787,N
678,O,1638,1638,14392,1940,16184,679,12754,O
678,N,620,620,15012,335,16519,679,14392,N
678,O,425,425,15437,790,17309,679,15012,O
678,P,323,323,15760,3780,21089,679,15437,P
679,A,521,521,521,4267,4267,680,0,A
679,B,3762,3762,4283,90,4357,680,521,B
679,C,514,514,4797,1035,5392,680,4283,C
679,D,1515,1515,6312,3780,9172,680,4797,D
679,M,1220,1220,7532,1497,10669,680,6312,M
679,N,491,491,8023,240,10909,680,7532,N
679,O,869,869,8892,765,11674,680,8023,O
679,N,224,224,9116,295,11969,680,8892,N
679,O,963,963,10079,1260,13229,680,9116,O
679,P,455,455,10534,3960,17189,680,10079,P
680,A,334,334,334,495,495,681,0,A
680,B,263,263,597,150,645,681,334,B
680,C,472,472,1069,470,1115,681,597,C
680,B,291,291,1360,295,1410,681,1069,B
680,C,107,107,1467,135,1545,681,1360,C
680,D,14655,14655,16122,4230,5775,681,1467,D
680,M,164,164,16286,201,5976,681,16122,M
680,N,138,138,16424,150,6126,681,16286,N
680,O,148,148,16572,130,6256,681,16424,O
680,N,913,913,17485,930,7186,681,16572,N
680,O,397,397,17882,645,7831,681,17485,O
680,P,4782,4782,22664,4230,12061,681,17882,P
681,AEI,12,12,12,334,334,682,0,E
681,AFI,67,55,67,143,143,682,0,I
681,AFJ,155,88,155,183,183,682,0,A
681,BFJ,165,77,232,150,293,682,67,J
681,BFK,121,44,276,150,333,682,155,B
681,CFK,172,128,404,455,748,682,232,K
681,CFL,175,47,451,455,788,682,276,C
681,DFL,554,115,566,300,634,682,12,F
681,DGL,874,712,1278,3565,4313,682,404,L
681,DG,873,46,1324,3565,4353,682,451,D
681,G,768,10,1334,820,1454,682,566,G
681,H,59,59,1393,5315,6769,682,1334,H
681,M,37929,37929,39322,38832,45601,682,1393,M
681,N,942,942,40264,90,45691,682,39322,N
681,O,1086,1086,41350,1210,46901,682,40264,O
681,P,549,549,41899,3780,50681,682,41350,P
682,AE,47,47,47,53,53,683,0,A
682,BE,134,134,181,180,233,683,47,B
682,CE,150,150,331,230,463,683,181,C
682,BE,1311,1311,1642,1205,1668,683,331,B
682,CE,717,717,2359,750,2418,683,1642,C
682,DE,2996,637,2996,3279,3279,683,0,E
682,DF,315,315,3311,90,3369,683,2996,F
682,DG,375,375,3686,795,4164,683,3311,G
682,DH,2562,1235,4921,4140,6558,683,2359,D
682,H,1423,188,5109,3780,7944,683,3686,H
682,M,621,621,5730,1906,9850,683,5109,M
682,N,1405,1405,7135,180,10030,683,5730,N
682,O,850,850,7985,915,10945,683,7135,O
682,P,1444,1444,9429,360,11305,683,7985,P
683,AE,317,317,317,903,903,684,0,E
683,AF,952,952,1269,330,1233,684,317,F
683,AG,1779,510,1779,2260,2260,684,0,A
683,BG,1100,590,2369,1283,2516,684,1269,G
683,BH,621,31,2400,180,2440,684,1779,B
683,CH,374,374,2774,555,2995,684,2400,C
683,BH,494,494,3268,310,3305,684,2774,B
683,CH,1180,281,3549,517,3033,684,2369,H
683,C,572,291,3840,770,4075,684,3268,C
683,D,95,95,3935,1620,5695,684,3840,D
683,M,1510,1510,5445,1905,7600,684,3935,M
683,N,776,776,6221,420,8020,684,5445,N
683,O,1161,1161,7382,1390,9410,684,6221,O
683,N,799,799,8181,690,10100,684,7382,N
683,O,640,640,8821,595,10695,684,8181,O
683,P,228,228,9049,370,11065,684,8821,P
684,AEI,210,210,210,532,532,685,0,A
684,BEI,352,352,562,90,622,685,210,B
684,CEI,617,617,1179,625,1247,685,562,C
684,DEI,1378,199,1378,1383,1383,685,0,E
684,DFI,1506,128,1506,2106,2106,685,0,I
684,DFJ,150,22,1528,205,1588,685,1378,F
684,DGJ,780,758,2286,240,2346,685,1506,J
684,DGK,802,44,2330,695,2283,685,1528,G
684,DHK,381,381,2711,385,2668,685,2330,H
684,DK,812,387,3098,825,3171,685,2286,K
684,DL,2929,1010,4108,550,1797,685,1179,D
684,L,1908,898,5006,385,3556,685,3098,L
684,M,14063,14063,19069,14553,18109,685,5006,M
684,N,610,610,19679,180,18289,685,19069,N
684,O,410,410,20089,840,19129,685,19679,O
684,N,1177,1177,21266,725,19854,685,20089,N
684,O,574,574,21840,710,20564,685,21266,O
684,P,22988,22988,44828,6960,27524,685,21840,P
685,AE,117,117,117,117,117,686,0,A
685,BE,259,142,259,638,638,686,0,E
685,BF,372,230,489,410,527,686,117,B
685,CF,417,187,676,90,728,686,259,F
685,CG,332,332,1008,725,1453,686,676,G
685,CF,800,281,1289,815,1342,686,489,C
685,DF,483,202,1491,95,1548,686,1008,F
685,DG,847,847,2338,1300,2848,686,1491,G
685,DH,1395,1395,3733,3780,6628,686,2338,H
685,D,3119,675,4408,550,1892,686,1289,D
685,M,175,175,4583,453,7081,686,4408,M
685,N,398,398,4981,180,7261,686,4583,N
685,O,838,838,5819,840,8101,686,4981,O
685,P,352,352,6171,6680,14781,686,5819,P
686,A,427,427,427,987,987,687,0,A
686,B,666,666,1093,150,1137,687,427,B
686,C,186,186,1279,140,1277,687,1093,C
686,D,448,448,1727,4290,5567,687,1279,D
686,M,3264,3264,4991,4737,10304,687,1727,M
686,N,1534,1534,6525,90,10394,687,4991,N
686,O,1408,1408,7933,1595,11989,687,6525,O
686,P,255,255,8188,3780,15769,687,7933,P
687,AE,41,41,41,1267,1267,688,0,A
687,BE,1356,1356,1397,165,1432,688,41,B
687,CE,842,842,2239,1035,2467,688,1397,C
687,DE,2445,206,2445,4456,4456,688,0,E
687,DF,2733,2527,4972,3960,6427,688,2239,D
687,F,2736,209,5181,780,5236,688,2445,F
687,G,1027,1027,6208,1155,6391,688,5181,G
687,H,439,439,6647,360,6751,688,6208,H
687,M,1587,1587,8234,1900,8651,688,6647,M
687,N,397,397,8631,90,8741,688,8234,N
687,O,523,523,9154,860,9601,688,8631,O
687,N,323,323,9477,35,9636,688,9154,N
687,O,550,550,10027,790,10426,688,9477,O
687,P,2197,2197,12224,3780,14206,688,10027,P
688,AE,44,44,44,69,69,689,0,A
688,BE,135,91,135,209,209,689,0,E
688,BF,122,31,166,150,219,689,44,B
688,CF,168,137,303,150,359,689,135,F
688,CG,772,635,938,895,1114,689,166,C
688,DG,739,104,1042,830,1189,689,303,G
688,DH,817,817,1859,3490,4679,689,1042,H
688,D,1454,533,2392,3490,4604,689,938,D
688,M,94,94,2486,109,4788,689,2392,M
688,N,206,206,2692,240,5028,689,2486,N
688,O,44,44,2736,295,5323,689,2692,O
688,P,4252,4252,6988,9760,15083,689,2736,P
689,A,112,112,112,721,721,690,0,A
689,B,721,721,833,150,871,690,112,B
689,C,199,199,1032,125,996,690,833,C
689,D,1277,1277,2309,4230,5226,690,1032,D
689,M,4188,4188,6497,4366,9592,690,2309,M
689,N,386,386,6883,240,9832,690,6497,N
689,O,774,774,7657,860,10692,690,6883,O
689,P,4854,4854,12511,3960,14652,690,7657,P
690,A,4,4,4,109,109,691,0,A
690,B,225,225,229,165,274,691,4,B
690,C,702,702,931,965,1239,691,229,C
690,D,192,192,1123,3960,5199,691,931,D
690,M,262,262,1385,581,5780,691,1123,M
690,N,398,398,1783,90,5870,691,1385,N
690,O,472,472,2255,870,6740,691,1783,O
690,P,7241,7241,9496,4505,11245,691,2255,P
691,A,74,74,74,551,551,692,0,A
691,B,678,678,752,240,791,692,74,B
691,C,664,664,1416,960,1751,692,752,C
691,D,117,117,1533,3960,5711,692,1416,D
691,M,100,100,1633,223,5934,692,1533,M
691,N,543,543,2176,480,6414,692,1633,N
691,O,705,705,2881,720,7134,692,2176,O
691,P,1990,1990,4871,550,7684,692,2881,P
692,A,250,250,250,338,338,693,0,A
692,B,275,275,525,240,578,693,250,B
692,C,398,398,923,290,868,693,525,C
692,D,2453,2453,3376,5160,6028,693,923,D
692,M,95,95,3471,209,6237,693,3376,M
692,N,250,250,3721,150,6387,693,3471,N
692,O,93,93,3814,135,6522,693,3721,O
692,P,194,194,4008,4200,10722,693,3814,P
693,A,175,175,175,219,219,694,0,A
693,B,153,153,328,180,399,694,175,B
693,C,148,148,476,545,944,694,328,C
693,D,466,466,942,2790,3734,694,476,D
693,M,202,202,1144,1164,4898,694,942,M
693,N,990,990,2134,90,4988,694,1144,N
693,O,893,893,3027,1200,6188,694,2134,O
693,P,164,164,3191,3780,9968,694,3027,P
694,AE,47,47,47,601,601,695,0,E
694,AF,201,154,201,219,219,695,0,A
694,BF,104,104,305,150,369,695,201,B
694,CF,148,148,453,140,509,695,305,C
694,BF,769,363,816,240,841,695,47,F
694,BG,886,523,1339,855,1364,695,453,B
694,CG,643,120,1459,960,1801,695,816,G
694,CH,324,324,1783,3960,5761,695,1459,H
694,C,626,182,1965,690,2054,695,1339,C
694,D,6316,6316,8281,4230,6284,695,1965,D
694,M,133,133,8414,439,6723,695,8281,M
694,N,478,478,8892,240,6963,695,8414,N
694,O,970,970,9862,975,7938,695,8892,O
694,N,618,618,10480,605,8543,695,9862,N
694,O,220,220,10700,260,8803,695,10480,O
694,P,237,237,10937,5160,13963,695,10700,P
695,AE,34,34,34,1059,1059,696,0,E
695,AF,140,106,140,1341,1341,696,0,A
695,BF,1235,1129,1269,240,1299,696,34,F
695,BG,1381,252,1521,240,1581,696,140,B
695,CG,807,555,2076,995,2294,696,1269,G
695,CH,338,338,2414,4680,6974,696,2076,H
695,C,998,105,2519,995,2576,696,1521,C
695,D,189,189,2708,4680,7256,696,2519,D
695,M,672,672,3380,1416,8672,696,2708,M
695,N,804,804,4184,120,8792,696,3380,N
695,O,737,737,4921,795,9587,696,4184,O
695,P,1025,1025,5946,385,9972,696,4921,P
696,A,37310,37310,37310,38353,38353,697,0,A
696,B,1060,1060,38370,90,38443,697,37310,B
696,C,1387,1387,39757,1450,39893,697,38370,C
696,D,107,107,39864,3840,43733,697,39757,D
696,M,912,912,40776,1350,45083,697,39864,M
696,N,466,466,41242,90,45173,697,40776,N
696,O,207,207,41449,690,45863,697,41242,O
696,P,11612,11612,53061,3780,49643,697,41449,P
697,AE,50,50,50,86,86,698,0,E
697,AF,74,24,74,127,127,698,0,A
697,BF,150,150,224,135,262,698,74,B
697,CF,236,62,286,240,326,698,50,F
697,CG,157,157,443,195,521,698,286,G
697,CH,536,536,979,5220,5741,698,443,H
697,C,8058,7303,8282,190,452,698,224,C
697,D,1182,1182,9464,5220,5672,698,8282,D
697,M,37372,37372,46836,37917,43658,698,9464,M
697,N,1819,1819,48655,90,43748,698,46836,N
697,O,1220,1220,49875,1400,45148,698,48655,O
697,P,60,60,49935,3780,48928,698,49875,P
698,AE,53,53,53,985,985,699,0,A
698,BE,62,9,62,1000,1000,699,0,E
698,BF,1121,1112,1174,240,1225,699,53,B
698,CF,1136,24,1198,240,1240,699,62,F
698,CG,832,808,2006,1020,2245,699,1174,C
698,DG,901,93,2099,1020,2260,699,1198,G
698,DH,229,136,2235,4680,6925,699,2006,D
698,H,161,25,2260,4740,7000,699,2099,H
698,M,305,305,2565,1010,8010,699,2260,M
698,N,956,956,3521,300,8310,699,2565,N
698,O,828,828,4349,1220,9530,699,3521,O
698,P,2298,2298,6647,1140,10670,699,4349,P
699,A,3002,3002,3002,4017,4017,700,0,A
699,B,1047,1047,4049,90,4107,700,3002,B
699,C,538,538,4587,905,5012,700,4049,C
699,B,1133,1133,5720,770,5782,700,4587,B
699,C,853,853,6573,1300,7082,700,5720,C
699,D,4593,4593,11166,3780,10862,700,6573,D
699,M,974,974,12140,9964,20826,700,11166,M
699,N,9377,9377,21517,420,21246,700,12140,N
699,O,659,659,22176,592,21838,700,21517,O
699,P,3393,3393,25569,3723,25561,700,22176,P
700,AE,2170,2170,2170,2600,2600,701,0,A
700,BE,790,790,2960,420,3020,701,2170,B
700,CE,1077,1077,4037,975,3995,701,2960,C
700,DE,1649,1649,5686,550,4545,701,4037,D
700,E,6942,1256,6942,9230,9230,701,0,E
700,F,3235,3235,10177,1020,10250,701,6942,F
700,G,761,761,10938,725,10975,701,10177,G
700,H,2660,2660,13598,550,11525,701,10938,H
700,M,155,155,13753,343,11868,701,13598,M
700,N,308,308,14061,180,12048,701,13753,N
700,O,894,894,14955,830,12878,701,14061,O
700,P,4741,4741,19696,6680,19558,701,14955,P
701,AE,1167,1167,1167,1252,1252,702,0,A
701,BE,225,225,1392,180,1432,702,1167,B
701,CE,126,126,1518,130,1562,702,1392,C
701,BE,1743,225,1743,2234,2234,702,0,E
701,BF,370,145,1888,370,1932,702,1518,B
701,CF,802,802,2690,2049,3981,702,1888,C
701,DF,1224,277,2967,780,3014,702,1743,F
701,DG,1021,744,3711,1846,5827,702,2690,D
701,G,927,183,3894,2049,5063,702,2967,G
701,H,1254,1254,5148,846,5909,702,3894,H
701,M,4769,4769,9917,4600,10509,702,5148,M
701,N,1212,1212,11129,1500,12009,702,9917,N
701,O,202,202,11331,170,12179,702,11129,O
701,N,2352,2352,13683,2325,14504,702,11331,N
701,O,2666,2666,16349,2568,17072,702,13683,O
701,P,2,2,16351,762,17834,702,16349,P
702,AE,1489,1489,1489,1520,1520,703,0,A
702,BE,321,321,1810,300,1820,703,1489,B
702,CE,1860,50,1860,1770,1770,703,0,E
702,CF,194,194,2054,300,2070,703,1860,F
702,CG,700,456,2510,795,2615,703,1810,C
702,DG,656,200,2710,810,2880,703,2054,G
702,DH,2135,2135,4845,1560,4440,703,2710,H
702,D,4477,2142,6987,1560,4175,703,2510,D
702,M,447,447,7434,675,5115,703,6987,M
702,N,348,348,7782,180,5295,703,7434,N
702,O,661,661,8443,855,6150,703,7782,O
702,N,1446,1446,9889,1245,7395,703,8443,N
702,O,471,471,10360,760,8155,703,9889,O
702,P,964,964,11324,3540,11695,703,10360,P
703,AE,1165,1165,1165,1330,1330,704,0,A
703,BE,196,196,1361,90,1420,704,1165,B
703,CE,389,389,1750,695,2115,704,1361,C
703,DE,149,149,1899,3780,5895,704,1750,D
703,E,2892,993,2892,4192,4192,704,0,E
703,F,1346,1346,4238,90,4282,704,2892,F
703,G,956,956,5194,1230,5512,704,4238,G
703,H,28,28,5222,3840,9352,704,5194,H
703,M,655,655,5877,1235,10587,704,5222,M
703,N,617,617,6494,90,10677,704,5877,N
703,O,125,125,6619,585,11262,704,6494,O
703,P,7520,7520,14139,3780,15042,704,6619,P
704,AEI,89,89,89,1433,1433,705,0,A
704,BEI,230,141,230,1249,1249,705,0,I
704,BEJ,1016,786,1016,1338,1338,705,0,E
704,BFJ,1051,265,1281,90,1339,705,230,J
704,BFK,350,85,1366,90,1428,705,1016,F
704,BGK,1375,98,1464,90,1523,705,89,B
704,CGK,893,795,2259,1240,2668,705,1366,G
704,CHK,73,73,2332,3780,6448,705,2259,H
704,CK,1060,9,2341,1200,2539,705,1281,K
704,CL,1141,264,2605,1355,2878,705,1464,C
704,DL,451,187,2792,3780,6319,705,2341,L
704,D,70139,69952,72744,4505,7383,705,2605,D
704,M,924,924,73668,1453,8836,705,72744,M
704,N,590,590,74258,90,8926,705,73668,N
704,O,342,342,74600,800,9726,705,74258,O
704,P,911,911,75511,3780,13506,705,74600,P
705,AEI,1,1,1,156,156,706,0,I
705,AEJ,179,178,179,520,520,706,0,E
705,AFJ,306,127,306,480,480,706,0,A
705,BFJ,341,36,342,240,396,706,1,J
705,BFK,350,314,656,240,720,706,306,B
705,CFK,515,38,694,240,760,706,179,F
705,CGK,778,426,1120,1035,1431,706,342,K
705,CGJ,771,345,1465,985,1745,706,694,G
705,CFJ,834,25,1490,975,1695,706,656,C
705,BFJ,772,772,2262,625,2320,706,1490,B
705,CFJ,847,50,2312,625,2370,706,1465,F
705,CGJ,140,90,2402,285,2605,706,2262,C
705,DGJ,141,51,2453,290,2660,706,2312,G
705,DHJ,116,116,2569,5100,7760,706,2453,H
705,DJ,1464,15,2584,1220,2651,706,1120,J
705,DK,877,877,3461,1210,3861,706,2584,K
705,DL,1599,540,4001,5100,7705,706,2402,D
705,L,743,203,4204,3960,7821,706,3461,L
705,M,1673,1673,5877,2569,10390,706,4204,M
705,N,942,942,6819,90,10480,706,5877,N
705,O,890,890,7709,1200,11680,706,6819,O
705,N,297,297,8006,5,11685,706,7709,N
705,O,229,229,8235,695,12380,706,8006,O
705,P,8300,8300,16535,3780,16160,706,8235,P
706,AEI,925,925,925,951,951,707,0,I
706,AEJ,1004,79,1004,1684,1684,707,0,A
706,BEJ,242,163,1167,240,1191,707,925,J
706,BEK,1444,277,1444,1684,1684,707,0,E
706,BFK,625,348,1792,805,1996,707,1167,K
706,BFL,871,83,1875,240,1924,707,1004,B
706,CFL,467,36,1911,240,1924,707,1444,F
706,CGL,650,650,2561,805,2729,707,1911,G
706,CFL,1101,1101,3662,975,3704,707,2561,F
706,CGL,2179,309,3971,3960,5956,707,1792,L
706,CG,562,253,4224,805,4509,707,3662,G
706,CH,2349,2349,6573,3960,8469,707,4224,H
706,C,5251,553,7126,1005,2929,707,1875,C
706,B,1178,1178,8304,5395,8324,707,7126,B
706,C,590,590,8894,805,9129,707,8304,C
706,D,1058,1058,9952,3960,13089,707,8894,D
706,M,186,186,10138,254,13343,707,9952,M
706,N,252,252,10390,240,13583,707,10138,N
706,O,733,733,11123,970,14553,707,10390,O
706,P,606,606,11729,3960,18513,707,11123,P
707,A,24260,24260,24260,24424,24424,708,0,A
707,B,204,204,24464,90,24514,708,24260,B
707,C,1035,1035,25499,1240,25754,708,24464,C
707,D,1,1,25500,3780,29534,708,25499,D
707,M,3787,3787,29287,4343,33877,708,25500,M
707,N,585,585,29872,90,33967,708,29287,N
707,O,584,584,30456,850,34817,708,29872,O
707,P,450,450,30906,3780,38597,708,30456,P
708,AE,114,114,114,1135,1135,709,0,E
708,AF,1051,1051,1165,90,1225,709,114,F
708,AG,912,912,2077,1210,2435,709,1165,G
708,AH,7,7,2084,3780,6215,709,2077,H
708,A,15502,13418,15502,16207,16207,709,0,A
708,B,755,755,16257,90,16297,709,15502,B
708,C,1009,1009,17266,1340,17637,709,16257,C
708,D,729,729,17995,3780,21417,709,17266,D
708,M,589,589,18584,1374,22791,709,17995,M
708,N,815,815,19399,90,22881,709,18584,N
708,O,187,187,19586,535,23416,709,19399,O
708,P,1358,1358,20944,3780,27196,709,19586,P
709,AE,101,101,101,646,646,710,0,E
709,AF,651,651,752,150,796,710,101,F
709,AG,886,134,886,1122,1122,710,0,A
709,BG,352,352,1238,150,1272,710,886,B
709,CG,820,334,1572,840,1636,710,752,G
709,CH,629,295,1867,590,1862,710,1238,C
709,DH,522,227,2094,4200,5836,710,1572,H
709,D,545,318,2412,4230,6092,710,1867,D
709,M,59,59,2471,77,6169,710,2412,M
709,N,219,219,2690,240,6409,710,2471,N
709,O,708,708,3398,960,7369,710,2690,O
709,P,132,132,3530,3960,11329,710,3398,P
710,A,32,32,32,780,780,711,0,A
710,B,879,879,911,180,960,711,32,B
710,C,900,900,1811,885,1845,711,911,C
710,D,20414,20414,22225,6680,8525,711,1811,D
710,M,388,388,22613,1198,9723,711,22225,M
710,N,930,930,23543,180,9903,711,22613,N
710,O,1347,1347,24890,1080,10983,711,23543,O
710,P,522,522,25412,6960,17943,711,24890,P
711,AEI,2485,2485,2485,2688,2688,712,0,A
711,BEI,328,328,2813,180,2868,712,2485,B
711,CEI,718,718,3531,960,3828,712,2813,C
711,DEI,3826,295,3826,4626,4626,712,0,I
711,DEJ,920,920,4746,180,4806,712,3826,J
711,DEK,1169,1169,5915,900,5706,712,4746,K
711,DEL,6272,3888,9803,6680,10508,712,3531,D
711,EL,17183,7380,17183,17467,17467,712,0,E
711,FL,389,389,17572,180,17647,712,17183,F
711,GL,1079,1079,18651,1235,18882,712,17572,G
711,HL,691,691,19342,6680,25562,712,18651,H
711,L,15685,2258,21600,6680,12386,712,5915,L
711,M,177,177,21777,495,26057,712,21600,M
711,N,406,406,22183,150,26207,712,21777,N
711,O,537,537,22720,461,26668,712,22183,O
711,N,414,414,23134,465,27133,712,22720,N
711,O,676,676,23810,515,27648,712,23134,O
711,P,1169,1169,24979,4230,31878,712,23810,P
712,AEI,1564,1564,1564,1662,1662,713,0,E
712,AFI,458,458,2022,420,2082,713,1564,F
712,AGI,346,346,2368,517,2599,713,2022,G
712,AHI,1664,1664,4032,318,2917,713,2368,H
712,AI,12336,8304,12336,12490,12490,713,0,A
712,BI,486,486,12822,360,12850,713,12336,B
712,CI,693,693,13515,845,13695,713,12822,C
712,DI,130,130,13645,1590,15285,713,13515,D
712,I,22109,8464,22109,22979,22979,713,0,I
712,J,883,883,22992,90,23069,713,22109,J
712,K,611,611,23603,1105,24174,713,22992,K
712,L,4298,4298,27901,3780,27954,713,23603,L
712,M,284,284,28185,240,28194,713,27901,M
712,N,665,665,28850,730,28924,713,28185,N
712,O,1055,1055,29905,925,29849,713,28850,O
712,P,985,985,30890,2760,32609,713,29905,P
713,A,3239,3239,3239,3617,3617,714,0,A
713,B,575,575,3814,240,3857,714,3239,B
713,C,830,830,4644,920,4777,714,3814,C
713,D,88,88,4732,3960,8737,714,4644,D
713,M,464,464,5196,1197,9934,714,4732,M
713,N,771,771,5967,90,10024,714,5196,N
713,O,978,978,6945,1230,11254,714,5967,O
713,N,690,690,7635,415,11669,714,6945,N
713,O,764,764,8399,1060,12729,714,7635,O
713,P,801,801,9200,3780,16509,714,8399,P
714,AEI,288,288,288,766,766,715,0,I
714,AEJ,302,14,302,925,925,715,0,E
714,AFJ,484,182,484,1072,1072,715,0,A
714,BFJ,571,375,859,150,916,715,288,J
714,BFK,137,137,996,130,1046,715,859,K
714,BFJ,724,30,1026,150,1075,715,302,F
714,BGJ,148,148,1174,135,1210,715,1026,G
714,BFJ,817,127,1301,240,1312,715,484,B
714,CFJ,247,120,1421,245,1455,715,1174,F
714,CGJ,682,562,1983,940,2252,715,1301,C
714,DGJ,19,19,2002,3960,6212,715,1983,D
714,GJ,693,112,2114,625,2080,715,1421,G
714,HJ,1734,616,2730,1730,2776,715,996,J
714,HK,675,675,3405,625,3401,715,2730,K
714,HL,2778,1487,4892,4230,6310,715,2114,H
714,L,4102,2615,7507,4230,7631,715,3405,L
714,M,67,67,7574,225,7856,715,7507,M
714,N,346,346,7920,240,8096,715,7574,N
714,O,749,749,8669,875,8971,715,7920,O
714,N,1121,1121,9790,310,9281,715,8669,N
714,O,1088,1088,10878,900,10181,715,9790,O
714,P,639,639,11517,3960,14141,715,10878,P
715,AE,42,42,42,59,59,716,0,A
715,BE,216,216,258,240,299,716,42,B
715,CE,277,19,277,331,331,716,0,E
715,CF,169,169,446,180,511,716,277,F
715,CG,774,586,1032,970,1269,716,258,C
715,DG,796,210,1242,840,1351,716,446,G
715,DF,542,332,1574,3960,5229,716,1032,D
715,F,869,537,2111,810,2161,716,1242,F
715,G,995,995,3106,1079,3240,716,2111,G
715,H,628,628,3734,356,3596,716,3106,H
715,M,214,214,3948,996,6225,716,3734,M
715,N,965,965,4913,240,6465,716,3948,N
715,O,849,849,5762,1015,7480,716,4913,O
715,N,639,639,6401,545,8025,716,5762,N
715,O,245,245,6646,390,8415,716,6401,O
715,P,6158,6158,12804,3960,12375,716,6646,P
716,AE,145,145,145,125,125,717,0,E
716,AF,485,485,630,570,695,717,145,F
716,AG,68,68,698,80,775,717,630,G
716,AH,82,82,780,2880,3655,717,698,H
716,A,1660,880,1660,1858,1858,717,0,A
716,B,238,238,1898,90,1948,717,1660,B
716,C,983,983,2881,1270,3218,717,1898,C
716,D,4733,4733,7614,3780,6998,717,2881,D
716,M,308,308,7922,1359,8357,717,7614,M
716,N,1264,1264,9186,270,8627,717,7922,N
716,O,752,752,9938,810,9437,717,9186,O
716,P,1649,1649,11587,4110,13547,717,9938,P
717,AE,113,113,113,935,935,718,0,A
717,BE,638,525,638,862,862,718,0,E
717,BF,277,277,915,90,952,718,638,F
717,BG,914,112,1027,150,1085,718,113,B
717,CG,78,78,1105,80,1165,718,1027,C
717,DG,63,63,1168,2880,4045,718,1105,D
717,G,820,567,1735,1270,2222,718,915,G
717,H,271,271,2006,3780,6002,718,1735,H
717,M,14791,14791,16797,16522,22524,718,2006,M
717,N,4026,4026,20823,90,22614,718,16797,N
717,O,1060,1060,21883,1360,23974,718,20823,O
717,P,448,448,22331,3780,27754,718,21883,P
718,AEI,3,3,3,72,72,719,0,I
718,AEJ,38,35,38,1468,1468,719,0,A
718,BEJ,242,207,245,240,312,719,3,J
718,BEK,318,73,318,579,579,719,0,E
718,BFK,341,341,659,150,729,719,318,F
718,BGK,182,182,841,400,1129,719,659,G
718,BHK,184,184,1025,5360,6489,719,841,H
718,BK,880,100,1125,975,1287,719,245,K
718,BL,1537,450,1575,150,1618,719,38,B
718,CL,500,500,2075,795,2413,719,1575,C
718,DL,194,194,2269,3955,6368,719,2075,D
718,L,2178,1034,3303,5040,6327,719,1125,L
718,M,68,68,3371,812,7301,719,3303,M
718,N,926,926,4297,240,7541,719,3371,N
718,O,514,514,4811,740,8281,719,4297,O
718,P,28418,28418,33229,5100,13381,719,4811,P
719,AEI,71,71,71,820,820,720,0,A
719,BEI,374,303,374,834,834,720,0,I
719,BEJ,843,540,914,150,970,720,71,B
719,CEJ,558,18,932,150,984,720,374,J
719,CEK,165,147,1079,120,1090,720,914,C
719,BEK,151,4,1083,120,1104,720,932,K
719,BEJ,1537,1533,2616,1570,2660,720,1079,B
719,CEJ,1583,50,2666,1585,2689,720,1083,J
719,CEK,339,289,2955,645,3305,720,2616,C
719,DEK,341,52,3007,645,3334,720,2666,K
719,DEL,1511,1511,4518,4230,7564,720,3007,L
719,DE,5769,1251,5769,6709,6709,720,0,E
719,DF,962,962,6731,90,6799,720,5769,F
719,DG,534,534,7265,880,7679,720,6731,G
719,DF,460,460,7725,110,7789,720,7265,F
719,DG,4849,79,7804,4230,7535,720,2955,D
719,G,1634,1555,9359,2315,10104,720,7725,G
719,H,17230,17230,26589,3420,13524,720,9359,H
719,M,2662,2662,29251,3020,16544,720,26589,M
719,N,488,488,29739,180,16724,720,29251,N
719,O,1190,1190,30929,935,17659,720,29739,O
719,P,1677,1677,32606,660,18319,720,30929,P
720,AE,1585,1585,1585,5120,5120,721,0,E
720,AF,2546,961,2546,4245,4245,721,0,A
720,BF,1958,1958,4504,300,4545,721,2546,B
720,CF,513,513,5017,725,5270,721,4504,C
720,DF,117,117,5134,3960,9230,721,5017,D
720,F,3553,4,5138,90,5210,721,1585,F
720,G,820,820,5958,1040,6250,721,5138,G
720,H,659,659,6617,3780,10030,721,5958,H
720,M,967,967,7584,1973,12003,721,6617,M
720,N,1181,1181,8765,180,12183,721,7584,N
720,O,668,668,9433,855,13038,721,8765,O
720,P,4324,4324,13757,6680,19718,721,9433,P
721,AE,67,67,67,1004,1004,722,0,E
721,AF,263,196,263,1073,1073,722,0,A
721,BF,1115,919,1182,240,1244,722,67,F
721,BG,930,11,1193,180,1253,722,263,B
721,CG,852,841,2034,1075,2319,722,1182,G
721,CH,929,88,2122,1050,2303,722,1193,C
721,DH,2243,2243,4365,5040,7343,722,2122,D
721,H,4366,2035,6400,5400,7719,722,2034,H
721,M,60,60,6460,107,7826,722,6400,M
721,N,132,132,6592,135,7961,722,6460,N
721,O,213,213,6805,380,8341,722,6592,O
721,P,961,961,7766,5460,13801,722,6805,P
722,AEI,345,345,345,410,410,723,0,I
722,AEJ,415,70,415,335,335,723,0,E
722,AFJ,184,184,599,300,635,723,415,F
722,AGJ,334,80,679,300,710,723,345,J
722,AGK,896,217,896,875,875,723,0,A
722,BGK,216,216,1112,300,1175,723,896,B
722,CGK,651,138,1250,835,1470,723,599,G
722,CHK,635,64,1314,835,1545,723,679,K
722,CHL,607,405,1719,695,1870,723,1112,C
722,DHL,2837,2837,4556,4080,5950,723,1719,D
722,HL,8029,4723,9279,1140,2610,723,1250,H
722,L,10764,2799,12078,1140,2685,723,1314,L
722,M,205,205,12283,1863,7813,723,12078,M
722,N,1851,1851,14134,240,8053,723,12283,N
722,O,649,649,14783,735,8788,723,14134,O
722,P,333,333,15116,3960,12748,723,14783,P
723,A,4549,4549,4549,4832,4832,724,0,A
723,B,302,302,4851,90,4922,724,4549,B
723,C,558,558,5409,905,5827,724,4851,C
723,B,374,374,5783,20,5847,724,5409,B
723,C,848,848,6631,1300,7147,724,5783,C
723,D,134,134,6765,3780,10927,724,6631,D
723,M,118,118,6883,987,11914,724,6765,M
723,N,1106,1106,7989,270,12184,724,6883,N
723,O,691,691,8680,1305,13489,724,7989,O
723,P,1856,1856,10536,1240,14729,724,8680,P
724,AEI,246,246,246,707,707,725,0,E
724,AFI,291,45,291,328,328,725,0,I
724,AFJ,160,160,451,150,478,725,291,J
724,AFK,605,154,605,1282,1282,725,0,A
724,BFK,169,15,620,140,618,725,451,K
724,BFJ,560,186,806,150,857,725,246,F
724,BGJ,164,164,970,115,972,725,806,G
724,BFJ,299,299,1269,330,1302,725,970,F
724,BGJ,860,196,1465,240,1522,725,605,B
724,CGJ,944,99,1564,975,1593,725,620,J
724,CGK,625,330,1894,690,1992,725,1269,G
724,CHK,673,343,2237,705,2298,725,1564,K
724,CHL,1183,411,2648,1030,2552,725,1465,C
724,BHL,795,795,3443,925,3477,725,2648,B
724,CHL,664,664,4107,975,4452,725,3443,C
724,DHL,2771,558,4665,4230,6222,725,1894,H
724,DL,2541,1983,6648,3960,8412,725,4107,D
724,L,4414,3,6651,4230,6528,725,2237,L
724,M,730,730,7381,700,9112,725,6651,M
724,N,212,212,7593,300,9412,725,7381,N
724,O,220,220,7813,840,10252,725,7593,O
724,N,1308,1308,9121,630,10882,725,7813,N
724,O,134,134,9255,1255,12137,725,9121,O
724,P,1056,1056,10311,3090,15227,725,9255,P
725,AEI,24,24,24,1119,1119,726,0,I
725,AEJ,159,135,159,195,195,726,0,A
725,BEJ,209,209,368,240,435,726,159,B
725,CEJ,802,434,802,995,995,726,0,E
725,CFJ,441,7,809,700,1135,726,368,C
725,BFJ,235,228,1037,90,1085,726,802,F
725,BGJ,422,422,1459,815,1900,726,1037,G
725,BFJ,1452,17,1476,420,1539,726,24,J
725,BFK,937,937,2413,920,2459,726,1476,K
725,BFL,2596,992,3405,2330,3465,726,809,B
725,CFL,1092,100,3505,775,3234,726,2413,L
725,CF,2763,717,4222,1010,2910,726,1459,F
725,CG,542,542,4764,745,3655,726,4222,G
725,CH,52,52,4816,3780,7435,726,4764,H
725,C,1845,434,5250,848,4313,726,3405,C
725,D,4833,4833,10083,1087,5400,726,5250,D
725,M,374,374,10457,774,8209,726,10083,M
725,N,405,405,10862,180,8389,726,10457,N
725,O,1371,1371,12233,715,9104,726,10862,O
725,P,4919,4919,17152,6680,15784,726,12233,P
726,AEI,40,40,40,1216,1216,727,0,A
726,BEI,51,11,51,1775,1775,727,0,I
726,BEJ,76,25,76,180,180,727,0,E
726,BFJ,212,212,288,150,330,727,76,F
726,BGJ,160,160,448,130,460,727,288,G
726,BFJ,1296,888,1336,165,1381,727,40,B
726,CFJ,1407,519,1855,1350,1810,727,448,F
726,CGJ,1844,40,1895,165,1940,727,51,J
726,CGK,907,348,2243,1035,2416,727,1336,C
726,DGK,118,118,2361,3960,6376,727,2243,D
726,GK,533,27,2388,635,2445,727,1855,G
726,HK,818,325,2713,1075,3015,727,1895,K
726,HL,346,21,2734,4230,6675,727,2388,H
726,L,1078,1057,3791,3960,6975,727,2713,L
726,M,2387,2387,6178,2618,9593,727,3791,M
726,N,343,343,6521,150,9743,727,6178,N
726,O,696,696,7217,700,10443,727,6521,O
726,N,1094,1094,8311,1095,11538,727,7217,N
726,O,623,623,8934,690,12228,727,8311,O
726,P,2702,2702,11636,4230,16458,727,8934,P
727,AEI,182,182,182,1549,1549,728,0,E
727,AFI,1487,1487,1669,180,1729,728,182,F
727,AGI,677,677,2346,980,2709,728,1669,G
727,AFI,2365,19,2365,2735,2735,728,0,I
727,AFJ,2893,528,2893,2865,2865,728,0,A
727,BFJ,632,104,2997,300,3035,728,2365,J
727,BFK,228,124,3121,300,3165,728,2893,B
727,CFK,591,591,3712,750,3915,728,3121,C
727,DFK,1005,290,4002,1045,4080,728,2997,K
727,DFJ,573,573,4575,545,4625,728,4002,J
727,DFK,261,261,4836,410,5035,728,4575,K
727,DFL,262,262,5098,1560,6595,728,4836,L
727,DF,3272,520,5618,2925,5634,728,2346,F
727,DG,604,604,6222,685,6319,728,5618,G
727,DH,3503,993,7215,1560,5475,728,3712,D
727,H,1517,524,7739,5760,12079,728,6222,H
727,M,1141,1141,8880,1407,13486,728,7739,M
727,N,386,386,9266,180,13666,728,8880,N
727,O,741,741,10007,855,14521,728,9266,O
727,N,976,976,10983,1120,15641,728,10007,N
727,O,670,670,11653,580,16221,728,10983,O
727,N,358,358,12011,190,16411,728,11653,N
727,O,861,861,12872,570,16981,728,12011,O
727,P,1461,1461,14333,7140,24121,728,12872,P
728,AE,2057,2057,2057,2229,2229,729,0,A
728,BE,205,205,2262,90,2319,729,2057,B
728,CE,578,578,2840,820,3139,729,2262,C
728,DE,51,51,2891,3780,6919,729,2840,D
728,E,37148,34257,37148,37994,37994,729,0,E
728,F,876,876,38024,90,38084,729,37148,F
728,G,980,980,39004,1220,39304,729,38024,G
728,H,562,562,39566,3780,43084,729,39004,H
728,M,574,574,40140,963,44047,729,39566,M
728,N,417,417,40557,90,44137,729,40140,N
728,O,358,358,40915,795,44932,729,40557,O
728,P,1432,1432,42347,3780,48712,729,40915,P
729,AEI,1550,1550,1550,1960,1960,730,0,I
729,AEJ,1632,82,1632,3188,3188,730,0,E
729,AFJ,1710,78,1710,2101,2101,730,0,A
729,BFJ,691,691,2401,360,2461,730,1710,B
729,CFJ,1660,809,3210,750,2710,730,1550,J
729,CFK,998,189,3399,990,3451,730,2401,C
729,DFK,1916,149,3548,420,3608,730,1632,F
729,DGK,904,566,4114,855,3565,730,3210,K
729,DGL,1039,324,4438,610,4061,730,3399,D
729,GL,1013,123,4561,985,4593,730,3548,G
729,HL,932,485,5046,550,4115,730,4114,L
729,H,1949,1464,6510,550,5143,730,4561,H
729,M,5677,5677,12187,6947,12090,730,6510,M
729,N,1660,1660,13847,420,12510,730,12187,N
729,O,1127,1127,14974,1190,13700,730,13847,O
729,N,583,583,15557,550,14250,730,14974,N
729,O,2382,2382,17939,2268,16518,730,15557,O
729,P,1,1,17940,762,17280,730,17939,P
730,A,3255,3255,3255,3165,3165,731,0,A
730,B,166,166,3421,300,3465,731,3255,B
730,C,718,718,4139,855,4320,731,3421,C
730,D,471,471,4610,1590,5910,731,4139,D
730,M,254,254,4864,380,6290,731,4610,M
730,N,395,395,5259,300,6590,731,4864,N
730,O,734,734,5993,825,7415,731,5259,O
730,P,106,106,6099,2940,10355,731,5993,P
731,AE,48,48,48,168,168,732,0,E
731,AF,210,210,258,150,318,732,48,F
731,AG,220,220,478,455,773,732,258,G
731,AH,840,840,1318,3565,4338,732,478,H
731,A,1776,458,1776,3094,3094,732,0,A
731,B,1555,1555,3331,300,3394,732,1776,B
731,C,658,658,3989,820,4214,732,3331,C
731,D,34,34,4023,5315,9529,732,3989,D
731,M,100,100,4123,1021,10550,732,4023,M
731,N,1112,1112,5235,240,10790,732,4123,N
731,O,823,823,6058,890,11680,732,5235,O
731,P,119,119,6177,5160,16840,732,6058,P
732,A,34,34,34,5,5,733,0,A
732,B,96,96,130,180,185,733,34,B
732,C,152,152,282,455,640,733,130,C
732,D,914,914,1196,5320,5960,733,282,D
732,M,21,21,1217,84,6044,733,1196,M
732,N,140,140,1357,135,6179,733,1217,N
732,O,253,253,1610,295,6474,733,1357,O
732,P,145,145,1755,5160,11634,733,1610,P
733,AE,263,263,263,1322,1322,734,0,A
733,BE,1180,1180,1443,180,1502,734,263,B
733,CE,646,646,2089,670,2172,734,1443,C
733,DE,2829,2829,4918,4140,6312,734,2089,D
733,E,8545,3627,8545,8953,8953,734,0,E
733,F,603,603,9148,240,9193,734,8545,F
733,G,830,830,9978,920,10113,734,9148,G
733,H,149,149,10127,3960,14073,734,9978,H
733,M,116,116,10243,152,14225,734,10127,M
733,N,150,150,10393,150,14375,734,10243,N
733,O,145,145,10538,110,14485,734,10393,O
733,P,397,397,10935,4230,18715,734,10538,P
734,AEI,52,52,52,68,68,735,0,I
734,AEJ,121,69,121,123,123,735,0,E
734,AFJ,122,53,174,150,218,735,52,J
734,AFK,175,1,175,292,292,735,0,A
734,BFK,89,35,210,150,273,735,121,F
734,BGK,128,92,302,400,618,735,174,K
734,BGL,141,49,351,405,678,735,210,G
734,BHL,229,53,404,180,472,735,175,B
734,CHL,495,442,846,3140,3818,735,351,H
734,CL,674,232,1078,865,1337,735,404,C
734,DL,218,218,1296,2880,4217,735,1078,D
734,L,3358,2364,3660,3080,3698,735,302,L
734,M,21878,21878,25538,22802,27019,735,3660,M
734,N,959,959,26497,90,27109,735,25538,N
734,O,998,998,27495,1220,28329,735,26497,O
734,N,419,419,27914,195,28524,735,27495,N
734,O,125,125,28039,585,29109,735,27914,O
734,P,3859,3859,31898,3780,32889,735,28039,P
735,AEI,72,72,72,1048,1048,736,0,I
735,AEJ,125,53,125,159,159,736,0,E
735,AFJ,119,119,244,135,294,736,125,F
735,AGJ,262,18,262,1212,1212,736,0,A
735,BGJ,665,647,909,685,979,736,244,G
735,BHJ,1159,322,1231,240,1288,736,72,J
735,BHK,1138,169,1400,240,1452,736,262,B
735,CHK,665,496,1896,705,1993,736,1231,K
735,CHL,1066,79,1975,5760,6739,736,909,H
735,CL,654,79,2054,705,2157,736,1400,C
735,DL,1259,1101,3155,5820,7813,736,1896,L
735,D,4143,3042,6197,5820,7977,736,2054,D
735,M,14591,14591,20788,14724,22701,736,6197,M
735,N,426,426,21214,300,23001,736,20788,N
735,O,658,658,21872,810,23811,736,21214,O
735,P,214,214,22086,1620,25431,736,21872,P
736,AE,314,314,314,1063,1063,737,0,A
736,BE,869,869,1183,180,1243,737,314,B
736,CE,980,980,2163,1050,2293,737,1183,C
736,DE,722,722,2885,6460,8753,737,2163,D
736,E,3054,169,3054,4561,4561,737,0,E
736,F,1750,1750,4804,300,4861,737,3054,F
736,G,633,633,5437,795,5656,737,4804,G
736,H,51,51,5488,6925,12581,737,5437,H
736,M,35,35,5523,111,12692,737,5488,M
736,N,196,196,5719,135,12827,737,5523,N
736,O,221,221,5940,285,13112,737,5719,O
736,P,541,541,6481,5160,18272,737,5940,P
737,AE,836,836,836,1346,1346,738,0,E
737,AF,551,551,1387,90,1436,738,836,F
737,AG,871,871,2258,1200,2636,738,1387,G
737,AF,705,705,2963,385,3021,738,2258,F
737,AG,815,815,3778,1080,4101,738,2963,G
737,AH,832,832,4610,3780,7881,738,3778,H
737,A,35953,31343,35953,37069,37069,738,0,A
737,B,1272,1272,37225,90,37159,738,35953,B
737,C,978,978,38203,1395,38554,738,37225,C
737,B,755,755,38958,430,38984,738,38203,B
737,C,730,730,39688,1060,40044,738,38958,C
737,D,171,171,39859,3780,43824,738,39688,D
737,M,2555,2555,42414,2693,46517,738,39859,M
737,N,163,163,42577,90,46607,738,42414,N
737,O,721,721,43298,1105,47712,738,42577,O
737,N,1651,1651,44949,1240,48952,738,43298,N
737,O,1170,1170,46119,1340,50292,738,44949,O
737,P,5432,5432,51551,3780,54072,738,46119,P
738,A,73,73,73,1036,1036,739,0,A
738,B,1149,1149,1222,240,1276,739,73,B
738,C,872,872,2094,995,2271,739,1222,C
738,D,1418,1418,3512,4680,6951,739,2094,D
738,M,1225,1225,4737,1705,8656,739,3512,M
738,N,750,750,5487,300,8956,739,4737,N
738,O,882,882,6369,1050,10006,739,5487,O
738,P,3828,3828,10197,1140,11146,739,6369,P
739,AEI,165,165,165,859,859,740,0,A
739,BEI,593,428,593,602,602,740,0,I
739,BEJ,797,369,962,150,1009,740,165,B
739,CEJ,397,28,990,210,812,740,593,J
739,CEK,150,122,1112,95,1104,740,962,C
739,BEK,355,233,1345,530,1342,740,990,K
739,BEL,219,219,1564,1350,2692,740,1345,L
739,BE,545,93,1657,585,1689,740,1112,B
739,CE,1922,265,1922,2160,2160,740,0,E
739,CF,263,263,2185,90,2250,740,1922,F
739,CG,682,154,2339,665,2354,740,1657,C
739,DG,327,173,2512,715,2965,740,2185,G
739,DH,1505,1332,3844,4230,6584,740,2339,D
739,H,1642,310,4154,3780,6745,740,2512,H
739,M,4979,4979,9133,5373,12118,740,4154,M
739,N,417,417,9550,90,12208,740,9133,N
739,O,656,656,10206,795,13003,740,9550,O
739,N,651,651,10857,490,13493,740,10206,N
739,O,621,621,11478,1130,14623,740,10857,O
739,P,1814,1814,13292,3840,18463,740,11478,P
740,AEI,69,69,69,655,655,741,0,I
740,AEJ,676,676,745,150,805,741,69,J
740,AEK,509,509,1254,500,1305,741,745,K
740,AEL,334,334,1588,385,1690,741,1254,L
740,AE,3046,1458,3046,3105,3105,741,0,A
740,BE,3218,172,3218,4338,4338,741,0,E
740,BF,394,222,3440,480,3585,741,3046,B
740,CF,1028,1028,4468,1015,4600,741,3440,C
740,DF,1527,277,4745,410,4748,741,3218,F
740,DG,809,809,5554,815,5563,741,4745,G
740,DH,359,359,5913,550,6113,741,5554,H
740,D,1901,456,6369,460,5060,741,4468,D
740,M,1104,1104,7473,1750,7863,741,6369,M
740,N,766,766,8239,180,8043,741,7473,N
740,O,106,106,8345,235,8278,741,8239,O
740,N,668,668,9013,515,8793,741,8345,N
740,O,271,271,9284,355,9148,741,9013,O
740,P,7016,7016,16300,6060,15208,741,9284,P
741,AE,134,134,134,299,299,742,0,A
741,BE,215,81,215,404,404,742,0,E
741,BF,212,131,346,90,389,742,134,B
741,CF,246,115,461,90,494,742,215,F
741,CG,406,291,752,695,1084,742,346,C
741,DG,1442,1151,1903,1745,2239,742,461,G
741,DH,19,19,1922,3780,6019,742,1903,H
741,D,1275,105,2027,3780,4864,742,752,D
741,M,987,987,3014,2237,8256,742,2027,M
741,N,1295,1295,4309,90,8346,742,3014,N
741,O,561,561,4870,880,9226,742,4309,O
741,P,4394,4394,9264,3780,13006,742,4870,P
742,A,37,37,37,113,113,743,0,A
742,B,841,841,878,120,233,743,37,B
742,C,209,209,1087,110,343,743,878,C
742,D,520,520,1607,2880,3223,743,1087,D
742,M,42,42,1649,99,3322,743,1607,M
742,N,144,144,1793,150,3472,743,1649,N
742,O,141,141,1934,205,3677,743,1793,O
742,P,746,746,2680,2880,6557,743,1934,P
743,AEI,105,105,105,203,203,744,0,E
743,AFI,181,76,181,1100,1100,744,0,I
743,AFJ,268,192,373,240,443,744,105,F
743,AGJ,753,753,1126,975,1418,744,373,G
743,AHJ,19,19,1145,6465,7883,744,1126,H
743,AJ,1039,75,1220,180,1280,744,181,J
743,AK,1299,79,1299,2077,2077,744,0,A
743,BK,824,824,2123,90,2167,744,1299,B
743,CK,979,76,2199,1050,2330,744,1220,K
743,CL,735,735,2934,6460,8790,744,2199,L
743,C,840,29,2963,1240,3407,744,2123,C
743,D,11,11,2974,3780,7187,744,2963,D
743,M,116,116,3090,918,9708,744,2974,M
743,N,982,982,4072,240,9948,744,3090,N
743,O,797,797,4869,995,10943,744,4072,O
743,P,1545,1545,6414,4680,15623,744,4869,P
744,AE,121,121,121,138,138,745,0,A
744,BE,113,113,234,150,288,745,121,B
744,CE,126,126,360,140,428,745,234,C
744,BE,955,955,1315,900,1328,745,360,B
744,CE,339,339,1654,650,1978,745,1315,C
744,DE,1726,72,1726,2246,2246,745,0,E
744,DF,549,549,2275,90,2336,745,1726,F
744,DG,625,625,2900,815,3151,745,2275,G
744,DF,626,626,3526,435,3586,745,2900,F
744,DG,1875,3,3529,4230,6208,745,1654,D
744,G,1560,1557,5086,2380,5966,745,3526,G
744,H,28642,28642,33728,3420,9386,745,5086,H
744,M,2672,2672,36400,2793,12179,745,33728,M
744,N,344,344,36744,240,12419,745,36400,N
744,O,700,700,37444,850,13269,745,36744,O
744,N,207,207,37651,85,13354,745,37444,N
744,O,139,139,37790,405,13759,745,37651,O
744,P,2518,2518,40308,3960,17719,745,37790,P
745,A,1554,1554,1554,1680,1680,746,0,A
745,B,325,325,1879,240,1920,746,1554,B
745,C,700,700,2579,725,2645,746,1879,C
745,B,504,504,3083,680,3325,746,2579,B
745,C,421,421,3504,510,3835,746,3083,C
745,D,74,74,3578,3960,7795,746,3504,D
745,M,8022,8022,11600,8808,16603,746,3578,M
745,N,803,803,12403,90,16693,746,11600,N
745,O,1421,1421,13824,1450,18143,746,12403,O
745,N,1543,1543,15367,1490,19633,746,13824,N
745,O,692,692,16059,995,20628,746,15367,O
745,P,909,909,16968,3780,24408,746,16059,P
746,AEI,277,277,277,1008,1008,747,0,A
746,BEI,774,774,1051,90,1098,747,277,B
746,CEI,92,92,1143,585,1683,747,1051,C
746,DEI,3305,2162,3305,3804,3804,747,0,I
746,DEJ,529,529,3834,90,3894,747,3305,J
746,DEK,615,615,4449,815,4709,747,3834,K
746,DEJ,945,945,5394,730,5439,747,4449,J
746,DEK,145,145,5539,585,6024,747,5394,K
746,DEL,11749,11749,17288,3780,9804,747,5539,L
746,DE,20450,4305,21593,3780,5463,747,1143,D
746,E,37058,15465,37058,37990,37990,747,0,E
746,F,961,961,38019,90,38080,747,37058,F
746,G,1045,1045,39064,1220,39300,747,38019,G
746,F,457,457,39521,275,39575,747,39064,F
746,G,259,259,39780,585,40160,747,39521,G
746,H,13865,13865,53645,3780,43940,747,39780,H
746,M,96,96,53741,25,43965,747,53645,M
746,N,344,344,54085,390,44355,747,53741,N
746,O,976,976,55061,1175,45530,747,54085,O
746,N,2272,2272,57333,2120,47650,747,55061,N
746,O,1057,1057,58390,2205,49855,747,57333,O
746,P,1387,1387,59777,810,50665,747,58390,P
747,AEI,285,285,285,469,469,748,0,I
747,AEJ,375,375,660,240,709,748,285,J
747,AEK,994,334,994,1129,1129,748,0,A
747,BEK,1065,71,1065,1259,1259,748,0,E
747,BFK,343,343,1408,180,1439,748,1065,F
747,BGK,525,111,1519,420,1549,748,994,B
747,CGK,610,499,2018,680,2119,748,1408,G
747,CHK,783,284,2302,940,2489,748,1519,C
747,BHK,1915,273,2575,970,1679,748,660,K
747,BHJ,319,319,2894,1260,2939,748,2575,J
747,BHK,910,34,2928,4140,6259,748,2018,H
747,BK,568,534,3462,845,3784,748,2894,K
747,BL,1497,337,3799,1445,3934,748,2302,B
747,CL,1176,839,4638,3960,7744,748,3462,L
747,C,1782,943,5581,1320,5254,748,3799,C
747,D,6264,6264,11845,3960,9214,748,5581,D
747,M,1443,1443,13288,1603,10817,748,11845,M
747,N,297,297,13585,180,10997,748,13288,N
747,O,630,630,14215,600,11597,748,13585,O
747,N,161,161,14376,185,11782,748,14215,N
747,O,74,74,14450,225,12007,748,14376,O
747,P,34,34,14484,355,12362,748,14450,P
748,AEI,268,268,268,1484,1484,749,0,I
748,AEJ,708,440,708,1010,1010,749,0,E
748,AFJ,712,4,712,769,769,749,0,A
748,BFJ,233,233,945,180,949,749,712,B
748,CFJ,199,199,1144,880,1829,749,945,C
748,DFJ,472,36,1180,180,1190,749,708,F
748,DGJ,1715,803,1983,555,2039,749,268,J
748,DGK,935,132,2115,880,2070,749,1180,G
748,DHK,522,390,2505,1350,3389,749,1983,K
748,DHL,1730,1730,4235,1035,4424,749,2505,L
748,DH,3140,49,4284,6660,8489,749,1144,D
748,H,4107,1938,6222,6660,8730,749,2115,H
748,M,1793,1793,8015,2342,11072,749,6222,M
748,N,579,579,8594,90,11162,749,8015,N
748,O,528,528,9122,820,11982,749,8594,O
748,P,222,222,9344,3780,15762,749,9122,P
749,AEI,87,87,87,199,199,750,0,I
749,AEJ,223,136,223,214,214,750,0,E
749,AFJ,281,58,281,986,986,750,0,A
749,BFJ,212,18,299,150,349,750,87,J
749,BFK,101,101,400,620,969,750,299,K
749,BFL,196,19,419,150,364,750,223,F
749,BGL,113,113,532,540,904,750,419,G
749,BHL,825,574,1106,180,1166,750,281,B
749,CHL,650,76,1182,2850,3754,750,532,H
749,CL,210,134,1316,220,1386,750,1106,C
749,BL,622,622,1938,595,1981,750,1316,B
749,CL,130,130,2068,655,2636,750,1938,C
749,DL,704,704,2772,3710,6346,750,2068,D
749,L,2448,76,2848,3740,4709,750,400,L
749,M,124,124,2972,146,6492,750,2848,M
749,N,118,118,3090,150,6642,750,2972,N
749,O,126,126,3216,140,6782,750,3090,O
749,N,1558,1558,4774,1535,8317,750,3216,N
749,O,889,889,5663,765,9082,750,4774,O
749,P,1013,1013,6676,4230,13312,750,5663,P
750,AEI,1,1,1,991,991,751,0,A
750,BEI,1239,1239,1240,300,1291,751,1,B
750,CEI,1555,315,1555,2551,2551,751,0,I
750,CEJ,533,218,1773,590,1881,751,1240,C
750,DEJ,40,40,1813,4080,5961,751,1773,D
750,EJ,1823,10,1823,3408,3408,751,0,E
750,FJ,337,337,2160,240,3648,751,1823,F
750,GJ,1246,641,2801,300,2851,751,1555,J
750,GK,882,241,3042,895,4543,751,2160,G
750,FK,618,377,3419,1095,3946,751,2801,K
750,FL,3,3,3422,6120,10066,751,3419,L
750,F,2911,2531,5953,1395,5938,751,3042,F
750,G,747,747,6700,1125,7063,751,5953,G
750,H,1253,1253,7953,3960,11023,751,6700,H
750,M,2,2,7955,427,11450,751,7953,M
750,N,633,633,8588,240,11690,751,7955,N
750,O,808,808,9396,1035,12725,751,8588,O
750,N,1680,1680,11076,1490,14215,751,9396,N
750,O,1039,1039,12115,1260,15475,751,11076,O
750,P,2455,2455,14570,3960,19435,751,12115,P
751,AEI,46,46,46,828,828,752,0,E
751,AFI,1003,957,1003,1137,1137,752,0,A
751,BFI,980,23,1026,240,1068,752,46,F
751,BGI,690,690,1716,1005,2073,752,1026,G
751,BHI,153,153,1869,3960,6033,752,1716,H
751,BI,881,15,1884,780,1917,752,1003,B
751,CI,2706,822,2706,4497,4497,752,0,I
751,CJ,1050,228,2934,1381,3298,752,1884,C
751,DJ,2156,1928,4862,420,4917,752,2706,J
751,DK,1402,1402,6264,1376,6293,752,4862,K
751,DL,4900,1570,7834,504,3802,752,2934,D
751,L,1692,122,7956,504,6797,752,6264,L
751,M,336,336,8292,751,7548,752,7956,M
751,N,791,791,9083,420,7968,752,8292,N
751,O,889,889,9972,865,8833,752,9083,O
751,P,1295,1295,11267,550,9383,752,9972,P
752,AE,197,197,197,258,258,753,0,E
752,AF,256,59,256,1025,1025,753,0,A
752,BF,184,125,381,150,408,753,197,F
752,BG,109,109,490,110,518,753,381,G
752,BH,853,619,1109,150,1175,753,256,B
752,CH,234,234,1343,170,1345,753,1109,C
752,DH,264,264,1607,2850,4195,753,1343,D
752,H,1234,117,1724,4230,4748,753,490,H
752,M,2779,2779,4503,4119,8867,753,1724,M
752,N,1376,1376,5879,90,8957,753,4503,N
752,O,884,884,6763,1225,10182,753,5879,O
752,P,68,68,6831,3780,13962,753,6763,P
753,AE,187,187,187,748,748,754,0,A
753,BE,325,138,325,709,709,754,0,E
753,BF,689,551,876,150,898,754,187,B
753,CF,158,158,1034,410,1308,754,876,C
753,BF,1126,417,1451,780,1489,754,325,F
753,BG,435,18,1469,200,1508,754,1034,B
753,CG,728,728,2197,720,2228,754,1469,C
753,DG,1142,396,2593,1717,3206,754,1451,G
753,DH,1035,639,3232,4170,6398,754,2197,D
753,H,5934,5295,8527,338,3544,754,2593,H
753,M,3730,3730,12257,4019,10417,754,8527,M
753,N,662,662,12919,90,10507,754,12257,N
753,O,554,554,13473,815,11322,754,12919,O
753,N,1149,1149,14622,1045,12367,754,13473,N
753,O,677,677,15299,935,13302,754,14622,O
753,P,703,703,16002,3780,17082,754,15299,P
754,AE,210,210,210,1225,1225,755,0,E
754,AF,384,174,384,1279,1279,755,0,A
754,BF,1044,870,1254,90,1315,755,210,F
754,BG,941,71,1325,90,1369,755,384,B
754,CG,944,873,2198,1210,2525,755,1254,G
754,CH,30,30,2228,3780,6305,755,2198,H
754,C,1054,151,2379,1200,2569,755,1325,C
754,D,326,326,2705,3780,6349,755,2379,D
754,M,1694,1694,4399,2117,8466,755,2705,M
754,N,450,450,4849,90,8556,755,4399,N
754,O,1019,1019,5868,1240,9796,755,4849,O
754,P,15,15,5883,3780,13576,755,5868,P
755,AEI,84,84,84,220,220,756,0,A
755,BEI,146,62,146,170,170,756,0,I
755,BEJ,125,125,271,150,320,756,146,J
755,BEK,223,36,307,150,370,756,84,B
755,CEK,98,62,369,140,460,756,271,K
755,CEL,420,51,420,2916,2916,756,0,E
755,CFL,117,4,424,135,505,756,307,C
755,DFL,877,877,1301,2900,3405,756,424,D
755,FL,2946,2065,3366,180,3096,756,420,F
755,GL,3550,553,3919,2900,3360,756,369,L
755,G,1597,1044,4963,915,4011,756,3366,G
755,F,431,431,5394,1425,5436,756,4963,F
755,G,480,480,5874,595,6031,756,5394,G
755,H,4230,4230,10104,7020,13051,756,5874,H
755,M,189,189,10293,255,13306,756,10104,M
755,N,169,169,10462,150,13456,756,10293,N
755,O,186,186,10648,280,13736,756,10462,O
755,P,1126,1126,11774,5160,18896,756,10648,P
756,AE,284,284,284,579,579,757,0,A
756,BE,589,305,589,976,976,757,0,E
756,BF,490,185,774,240,819,757,284,B
756,CF,579,394,1168,240,1216,757,589,F
756,CG,883,489,1657,970,1789,757,774,C
756,BG,504,15,1672,785,2001,757,1168,G
756,BH,224,209,1881,120,1909,757,1657,B
756,CH,518,518,2399,780,2689,757,1881,C
756,DH,1033,306,2705,3960,5961,757,1672,H
756,D,6544,6238,8943,4020,6709,757,2399,D
756,M,1834,1834,10777,1850,8559,757,8943,M
756,N,614,614,11391,645,9204,757,10777,N
756,O,497,497,11888,445,9649,757,11391,O
756,N,153,153,12041,205,9854,757,11888,N
756,O,464,464,12505,480,10334,757,12041,O
756,P,1908,1908,14413,1140,11474,757,12505,P
757,AEI,647,647,647,1461,1461,758,0,I
757,AEJ,1362,715,1362,1508,1508,758,0,A
757,BEJ,839,124,1486,90,1551,758,647,J
757,BEK,234,110,1596,150,1658,758,1362,B
757,CEK,1668,72,1668,2611,2611,758,0,E
757,CFK,173,101,1769,120,1778,758,1596,C
757,BFK,567,284,2053,905,2456,758,1486,K
757,BFJ,429,429,2482,90,2546,758,2053,J
757,BFK,970,156,2638,90,2701,758,1668,F
757,BGK,1222,353,2991,1245,3023,758,1769,B
757,CGK,518,165,3156,880,3581,758,2638,G
757,CFK,387,222,3378,645,3668,758,2991,C
757,DFK,473,251,3629,110,3691,758,3156,F
757,DGK,1505,358,3987,2320,4866,758,2482,K
757,DGL,1655,1297,5284,2315,6006,758,3629,G
757,DHL,1910,4,5288,4290,7958,758,3378,D
757,HL,1431,1427,6715,3480,9486,758,5284,H
757,L,4146,1418,8133,3420,8286,758,3987,L
757,M,2873,2873,11006,2941,12427,758,8133,M
757,N,274,274,11280,240,12667,758,11006,N
757,O,816,816,12096,855,13522,758,11280,O
757,N,105,105,12201,70,13592,758,12096,N
757,O,115,115,12316,400,13992,758,12201,O
757,P,1421,1421,13737,3960,17952,758,12316,P
758,AE,119,119,119,80,80,759,0,E
758,AF,131,131,250,240,320,759,119,F
758,AG,123,123,373,215,535,759,250,G
758,AH,406,406,779,4890,5425,759,373,H
758,A,1499,720,1499,1663,1663,759,0,A
758,B,279,279,1778,150,1813,759,1499,B
758,C,700,700,2478,730,2543,759,1778,C
758,D,58,58,2536,4200,6743,759,2478,D
758,M,55,55,2591,977,7720,759,2536,M
758,N,1121,1121,3712,240,7960,759,2591,N
758,O,584,584,4296,785,8745,759,3712,O
758,P,990,990,5286,3960,12705,759,4296,P
759,AEI,31,31,31,867,867,760,0,E
759,AFI,603,572,603,1139,1139,760,0,A
759,BFI,635,32,635,290,290,760,0,I
759,BFJ,1041,437,1072,240,1107,760,31,F
759,BGJ,565,128,1200,960,1250,760,635,J
759,BGK,731,134,1334,240,1379,760,603,B
759,CGK,396,262,1596,595,1845,760,1200,K
759,CGJ,633,109,1705,785,1892,760,1072,G
759,CHJ,34,34,1739,3960,5852,760,1705,H
759,CJ,467,62,1801,785,2164,760,1334,C
759,DJ,1182,977,2778,980,2825,760,1596,J
759,DK,1051,74,2852,3960,6124,760,1801,D
759,K,269,195,3047,425,3250,760,2778,K
759,L,1026,1026,4073,1590,4840,760,3047,L
759,M,233,233,4306,403,6527,760,4073,M
759,N,281,281,4587,150,6677,760,4306,N
759,O,452,452,5039,470,7147,760,4587,O
759,P,616,616,5655,4230,11377,760,5039,P
760,AE,92,92,92,665,665,761,0,E
760,AF,922,922,1014,300,965,761,92,F
760,AG,1830,816,1830,2446,2446,761,0,A
760,BG,893,77,1907,925,1890,761,1014,G
760,BH,655,578,2485,90,2536,761,1830,B
760,CH,1023,445,2930,2760,4650,761,1907,H
760,C,863,418,3348,1100,3636,761,2485,C
760,D,3461,3461,6809,3780,7416,761,3348,D
760,M,13152,13152,19961,13330,20746,761,6809,M
760,N,988,988,20949,90,20836,761,19961,N
760,O,835,835,21784,1105,21941,761,20949,O
760,N,865,865,22649,1380,23321,761,21784,N
760,O,1164,1164,23813,940,24261,761,22649,O
760,P,3356,3356,27169,3780,28041,761,23813,P
761,AE,269,269,269,487,487,762,0,A
761,BE,256,256,525,90,577,762,269,B
761,CE,379,379,904,795,1372,762,525,C
761,DE,2292,2292,3196,3780,5152,762,904,D
761,E,4124,928,4124,4819,4819,762,0,E
761,F,727,727,4851,90,4909,762,4124,F
761,G,348,348,5199,795,5704,762,4851,G
761,H,947,947,6146,3780,9484,762,5199,H
761,M,1988,1988,8134,2390,11874,762,6146,M
761,N,428,428,8562,90,11964,762,8134,N
761,O,569,569,9131,815,12779,762,8562,O
761,N,294,294,9425,45,12824,762,9131,N
761,O,369,369,9794,740,13564,762,9425,O
761,P,1129,1129,10923,3780,17344,762,9794,P
762,A,1481,1481,1481,1797,1797,763,0,A
762,B,412,412,1893,160,1957,763,1481,B
762,C,104,104,1997,375,2332,763,1893,C
762,D,842,842,2839,3290,5622,763,1997,D
762,M,47,47,2886,1028,6650,763,2839,M
762,N,1164,1164,4050,240,6890,763,2886,N
762,O,820,820,4870,940,7830,763,4050,O
762,P,1212,1212,6082,6990,14820,763,4870,P
763,A,1017,1017,1017,1797,1797,764,0,A
763,B,817,817,1834,90,1887,764,1017,B
763,C,897,897,2731,1250,3137,764,1834,C
763,D,42,42,2773,3780,6917,764,2731,D
763,M,2693,2693,5466,3330,10247,764,2773,M
763,N,679,679,6145,90,10337,764,5466,N
763,O,514,514,6659,880,11217,764,6145,O
763,P,2821,2821,9480,3780,14997,764,6659,P
764,A,1104,1104,1104,1288,1288,765,0,A
764,B,275,275,1379,150,1438,765,1104,B
764,C,155,155,1534,165,1603,765,1379,C
764,D,1396,1396,2930,4200,5803,765,1534,D
764,M,37,37,2967,882,6685,765,2930,M
764,N,1046,1046,4013,240,6925,765,2967,N
764,O,703,703,4716,880,7805,765,4013,O
764,P,1214,1214,5930,3960,11765,765,4716,P
765,AEI,42,42,42,135,135,766,0,E
765,AFI,153,153,195,120,255,766,42,F
765,AGI,277,82,277,1113,1113,766,0,I
765,AGJ,190,108,385,390,645,766,195,G
765,AFJ,492,492,877,285,930,766,385,F
765,AGJ,225,225,1102,290,1220,766,877,G
765,AHJ,1038,213,1315,240,1353,766,277,J
765,AHK,823,610,1925,5160,6380,766,1102,H
765,AK,736,126,2051,905,2258,766,1315,K
765,AJ,465,465,2516,410,2668,766,2051,J
765,AK,2927,411,2927,2951,2951,766,0,A
765,BK,200,200,3127,240,3191,766,2927,B
765,CK,287,287,3414,295,3486,766,3127,C
765,BK,536,536,3950,515,4001,766,3414,B
765,CK,1569,135,4085,1260,3928,766,2516,K
765,CL,212,77,4162,295,4296,766,3950,C
765,DL,727,727,4889,5160,9456,766,4162,D
765,L,901,97,4986,3960,7888,766,4085,L
765,M,17611,17611,22597,18591,28047,766,4986,M
765,N,1106,1106,23703,180,28227,766,22597,N
765,O,889,889,24592,885,29112,766,23703,O
765,P,1480,1480,26072,6680,35792,766,24592,P
766,A,654,654,654,1253,1253,767,0,A
766,B,647,647,1301,90,1343,767,654,B
766,C,400,400,1701,795,2138,767,1301,C
766,D,1646,1646,3347,3780,5918,767,1701,D
766,M,857,857,4204,1408,7326,767,3347,M
766,N,579,579,4783,90,7416,767,4204,N
766,O,595,595,5378,820,8236,767,4783,O
766,N,1227,1227,6605,995,9231,767,5378,N
766,O,395,395,7000,740,9971,767,6605,O
766,P,1128,1128,8128,3780,13751,767,7000,P
767,A,166,166,166,758,758,768,0,A
767,B,718,718,884,180,938,768,166,B
767,C,266,266,1150,225,1163,768,884,C
767,B,992,992,2142,1100,2263,768,1150,B
767,C,519,519,2661,510,2773,768,2142,C
767,D,37,37,2698,3960,6733,768,2661,D
767,M,167,167,2865,526,7259,768,2698,M
767,N,629,629,3494,330,7589,768,2865,N
767,O,94,94,3588,255,7844,768,3494,O
767,N,867,867,4455,680,8524,768,3588,N
767,O,728,728,5183,845,9369,768,4455,O
767,P,1920,1920,7103,5220,14589,768,5183,P
768,A,7493,7493,7493,7649,7649,769,0,A
768,B,191,191,7684,120,7769,769,7493,B
768,C,159,159,7843,390,8159,769,7684,C
768,B,917,917,8760,640,8799,769,7843,B
768,C,1070,1070,9830,890,9689,769,8760,C
768,D,1659,1659,11489,5160,14849,769,9830,D
768,M,222,222,11711,1036,15885,769,11489,M
768,N,934,934,12645,180,16065,769,11711,N
768,O,818,818,13463,1050,17115,769,12645,O
768,P,3785,3785,17248,5040,22155,769,13463,P
769,AE,35,35,35,164,164,770,0,A
769,BE,254,219,254,414,414,770,0,E
769,BF,301,82,336,240,404,770,35,B
769,CF,333,251,587,240,654,770,254,F
769,CG,844,593,1180,985,1389,770,336,C
769,DG,845,252,1432,975,1629,770,587,G
769,DH,812,560,1992,5040,6429,770,1180,D
769,H,743,183,2175,5040,6669,770,1432,H
769,M,1382,1382,3557,2467,9136,770,2175,M
769,N,1115,1115,4672,90,9226,770,3557,N
769,O,1006,1006,5678,1220,10446,770,4672,O
769,P,46,46,5724,3780,14226,770,5678,P
770,AEI,45,45,45,120,120,771,0,A
770,BEI,118,73,118,141,141,771,0,I
770,BEJ,130,130,248,150,291,771,118,J
770,BEK,255,52,300,240,360,771,45,B
770,CEK,541,489,789,795,1086,771,248,K
770,CEL,26,26,815,3955,5041,771,789,L
770,CE,735,220,1035,975,1335,771,300,C
770,DE,1127,92,1127,1160,1160,771,0,E
770,DF,122,122,1249,150,1310,771,1127,F
770,DG,182,182,1431,455,1765,771,1249,G
770,DH,854,458,1889,5040,6375,771,1035,D
770,H,889,431,2320,3565,5330,771,1431,H
770,M,87,87,2407,657,7032,771,2320,M
770,N,758,758,3165,240,7272,771,2407,N
770,O,154,154,3319,215,7487,771,3165,O
770,P,1524,1524,4843,4890,12377,771,3319,P
771,AEI,33,33,33,520,520,772,0,I
771,AEJ,59,26,59,293,293,772,0,A
771,BEJ,294,294,353,120,413,772,59,B
771,CEJ,581,581,934,390,803,772,353,C
771,BEJ,1008,74,1008,1517,1517,772,0,E
771,BFJ,430,356,1364,615,1418,772,934,B
771,CFJ,164,164,1528,200,1618,772,1364,C
771,DFJ,1927,432,1960,1500,2020,772,33,J
771,DFK,798,798,2758,1000,3020,772,1960,K
771,DFJ,1949,199,2957,1500,3017,772,1008,F
771,DGJ,1057,858,3815,1110,4130,772,2758,J
771,DGK,1039,181,3996,1000,4017,772,2957,G
771,DFK,688,507,4503,580,4710,772,3815,K
771,DFJ,337,337,4840,190,4900,772,4503,J
771,DFK,887,43,4883,1110,5127,772,3996,F
771,DGK,685,685,5568,580,5707,772,4883,G
771,DFK,731,3,5571,570,5470,772,4840,K
771,DFL,269,266,5837,190,5897,772,5568,F
771,DGL,900,900,6737,570,6467,772,5837,G
771,DHL,240,240,6977,8580,15047,772,6737,H
771,DL,5675,226,7203,6845,8463,772,1528,D
771,L,7657,6025,13228,5700,11170,772,5571,L
771,M,1643,1643,14871,3574,18621,772,13228,M
771,N,2786,2786,17657,900,19521,772,14871,N
771,O,491,491,18148,480,20001,772,17657,O
771,N,1351,1351,19499,1355,21356,772,18148,N
771,O,1287,1287,20786,2207,23563,772,19499,O
771,P,833,833,21619,353,23916,772,20786,P
772,AE,163,163,163,1227,1227,773,0,E
772,AF,295,132,295,469,469,773,0,A
772,BF,371,371,666,240,709,773,295,B
772,CF,1287,784,1450,240,1467,773,163,F
772,CG,919,135,1585,970,1679,773,666,C
772,BG,729,594,2179,780,2247,773,1450,G
772,BH,1324,730,2909,1270,2949,773,1585,B
772,CH,638,638,3547,810,3759,773,2909,C
772,DH,1755,1755,5302,3960,7719,773,3547,D
772,H,3676,553,5855,7680,9927,773,2179,H
772,M,508,508,6363,1430,11357,773,5855,M
772,N,1185,1185,7548,300,11657,773,6363,N
772,O,575,575,8123,695,12352,773,7548,O
772,P,57,57,8180,1140,13492,773,8123,P
773,A,2680,2680,2680,2830,2830,774,0,A
773,B,399,399,3079,300,3130,774,2680,B
773,C,642,642,3721,810,3940,774,3079,C
773,D,369,369,4090,1560,5500,774,3721,D
773,M,13457,13457,17547,13479,18979,774,4090,M
773,N,279,279,17826,300,19279,774,17547,N
773,O,612,612,18438,740,20019,774,17826,O
773,P,36,36,18474,1560,21579,774,18438,P
774,AEI,140,140,140,901,901,775,0,I
774,AEJ,510,370,510,883,883,775,0,A
774,BEJ,406,406,916,90,973,775,510,B
774,CEJ,944,168,1084,240,1141,775,140,J
774,CEK,1255,171,1255,1290,1290,775,0,E
774,CFK,286,286,1541,300,1590,775,1255,F
774,CGK,637,180,1721,640,1781,775,1084,K
774,CGL,703,523,2244,840,2430,775,1541,G
774,CHL,1460,132,2376,1935,2908,775,916,C
774,DHL,1093,438,2814,5370,7151,775,1721,L
774,DH,3422,2984,5798,3780,6688,775,2376,D
774,H,4461,907,6705,1140,3570,775,2244,H
774,M,141,141,6846,371,7522,775,6705,M
774,N,288,288,7134,90,7612,775,6846,N
774,O,1506,1506,8640,1780,9392,775,7134,O
774,P,184,184,8824,3780,13172,775,8640,P
775,AE,32,32,32,145,145,776,0,A
775,BE,134,102,134,183,183,776,0,E
775,BF,136,136,270,150,333,776,134,F
775,BG,284,46,316,240,385,776,32,B
775,CG,167,121,437,455,788,776,270,G
775,CH,829,708,1145,985,1370,776,316,C
775,DH,892,184,1329,3565,4353,776,437,H
775,D,3626,3442,4771,5040,6410,776,1145,D
775,M,82,82,4853,989,7399,776,4771,M
775,N,1090,1090,5943,240,7639,776,4853,N
775,O,243,243,6186,380,8019,776,5943,O
775,P,19,19,6205,5460,13479,776,6186,P
776,A,485,485,485,444,444,777,0,A
776,B,630,630,1115,155,599,777,485,B
776,C,114,114,1229,520,1119,777,1115,C
776,D,141,141,1370,2865,3984,777,1229,D
776,M,42,42,1412,1349,5333,777,1370,M
776,N,1427,1427,2839,165,5498,777,1412,N
776,O,541,541,3380,825,6323,777,2839,O
776,P,301,301,3681,4020,10343,777,3380,P
777,AE,278,278,278,820,820,778,0,A
777,BE,756,756,1034,240,1060,778,278,B
777,CE,148,148,1182,385,1445,778,1034,C
777,BE,297,297,1479,65,1510,778,1182,B
777,CE,512,512,1991,785,2295,778,1479,C
777,DE,2265,274,2265,1440,1440,778,0,E
777,DF,145,145,2410,1015,2455,778,2265,F
777,DG,222,222,2632,365,2820,778,2410,G
777,DF,976,335,2967,3960,6255,778,1991,D
777,F,482,147,3114,345,3165,778,2632,F
777,G,274,274,3388,925,4090,778,3114,G
777,H,557,557,3945,2640,6730,778,3388,H
777,M,301,301,4246,1363,8093,778,3945,M
777,N,1362,1362,5608,360,8453,778,4246,N
777,O,605,605,6213,678,9131,778,5608,O
777,P,1662,1662,7875,402,9533,778,6213,P
778,AEI,635,635,635,1039,1039,779,0,A
778,BEI,431,431,1066,90,1129,779,635,B
778,CEI,1707,641,1707,2645,2645,779,0,I
778,CEJ,1596,955,2662,2315,3444,779,1066,C
778,DEJ,963,8,2670,90,2735,779,1707,J
778,DEK,3157,487,3157,4013,4013,779,0,E
778,DFK,515,28,3185,880,3615,779,2670,K
778,DFJ,490,490,3675,110,3725,779,3185,J
778,DFK,885,367,4042,90,4103,779,3157,F
778,DGK,608,608,4650,905,5008,779,4042,G
778,DFK,386,386,5036,90,5098,779,4650,F
778,DGK,1562,201,5237,2315,6040,779,3675,K
778,DGL,1525,1324,6561,2320,7418,779,5036,G
778,DHL,4251,352,6913,3420,6864,779,2662,D
778,HL,3019,1343,8256,3420,9460,779,5237,L
778,H,4016,2321,10577,3420,10838,779,6561,H
778,M,514,514,11091,1702,12540,779,10577,M
778,N,1366,1366,12457,240,12780,779,11091,N
778,O,653,653,13110,855,13635,779,12457,O
778,P,1448,1448,14558,3960,17595,779,13110,P
779,AEI,104,104,104,239,239,780,0,E
779,AFI,123,19,123,156,156,780,0,A
779,BFI,226,207,330,150,389,780,104,F
779,BGI,338,8,338,383,383,780,0,I
779,BGJ,246,31,369,270,426,780,123,B
779,CGJ,161,130,499,150,533,780,338,J
779,CGK,295,126,625,410,799,780,330,G
779,CHK,138,12,637,395,928,780,499,K
779,CHL,92,92,729,2880,3808,780,637,L
779,CH,650,290,1019,735,1161,780,369,C
779,DH,16,16,1035,5315,6476,780,1019,D
779,H,3688,3278,4313,3135,3934,780,625,H
779,M,58,58,4371,161,6637,780,4313,M
779,N,299,299,4670,240,6877,780,4371,N
779,O,146,146,4816,215,7092,780,4670,O
779,P,4,4,4820,4890,11982,780,4816,P
780,AE,117,117,117,202,202,781,0,E
780,AF,164,164,281,150,352,781,117,F
780,AG,408,127,408,532,532,781,0,A
780,BG,205,205,613,150,682,781,408,B
780,CG,134,134,747,375,1057,781,613,C
780,DG,531,65,812,795,1147,781,281,G
780,DH,88,88,900,2880,4027,781,812,H
780,D,589,436,1336,5160,6217,781,747,D
780,M,91,91,1427,152,6369,781,1336,M
780,N,253,253,1680,240,6609,781,1427,N
780,O,160,160,1840,190,6799,781,1680,O
780,P,1049,1049,2889,5220,12019,781,1840,P
781,AEI,955,955,955,1135,1135,782,0,E
781,AFI,370,370,1325,180,1315,782,955,F
781,AGI,852,852,2177,930,2245,782,1325,G
781,AHI,516,516,2693,550,2795,782,2177,H
781,AI,4572,1879,4572,4740,4740,782,0,A
781,BI,385,385,4957,240,4980,782,4572,B
781,CI,957,957,5914,995,5975,782,4957,C
781,BI,463,463,6377,410,6385,782,5914,B
781,CI,652,652,7029,810,7195,782,6377,C
781,DI,4101,4101,11130,3960,11155,782,7029,D
781,I,12875,1745,12875,15512,15512,782,0,I
781,J,3566,3566,16441,1020,16532,782,12875,J
781,K,739,739,17180,720,17252,782,16441,K
781,L,2124,2124,19304,550,17802,782,17180,L
781,M,123,123,19427,265,18067,782,19304,M
781,N,227,227,19654,150,18217,782,19427,N
781,O,101,101,19755,55,18272,782,19654,O
781,N,531,531,20286,570,18842,782,19755,N
781,O,248,248,20534,260,19102,782,20286,O
781,P,101,101,20635,5100,24202,782,20534,P
782,A,1235,1235,1235,1437,1437,783,0,A
782,B,388,388,1623,240,1677,783,1235,B
782,C,648,648,2271,740,2417,783,1623,C
782,D,28,28,2299,7150,9567,783,2271,D
782,M,251,251,2550,844,10411,783,2299,M
782,N,774,774,3324,240,10651,783,2550,N
782,O,348,348,3672,260,10911,783,3324,O
782,P,2764,2764,6436,5160,16071,783,3672,P
783,A,2812,2812,2812,3161,3161,784,0,A
783,B,543,543,3355,240,3401,784,2812,B
783,C,861,861,4216,970,4371,784,3355,C
783,D,1747,1747,5963,3960,8331,784,4216,D
783,M,94,94,6057,679,9010,784,5963,M
783,N,781,781,6838,240,9250,784,6057,N
783,O,503,503,7341,765,10015,784,6838,O
783,P,582,582,7923,3960,13975,784,7341,P
784,AEI,123,123,123,222,222,785,0,E
784,AEI,123,0,123,216,216,785,0,I
784,AFJ,197,197,320,150,366,785,123,J
784,AFK,291,94,414,240,462,785,123,F
784,AGK,154,154,568,395,857,785,414,G
784,AHK,610,362,930,620,986,785,320,K
784,AHL,961,31,961,975,975,785,0,A
784,BHL,108,108,1069,150,1125,785,961,B
784,CHL,143,143,1212,170,1295,785,1069,C
784,DHL,453,171,1383,4200,5186,785,930,L
784,DH,1099,284,1667,3960,4817,785,568,H
784,D,1285,830,2497,4200,5495,785,1212,D
784,M,1058,1058,3555,1294,6789,785,2497,M
784,N,502,502,4057,240,7029,785,3555,N
784,O,718,718,4775,965,7994,785,4057,O
784,P,78,78,4853,4020,12014,785,4775,P
785,AE,4231,4231,4231,4873,4873,786,0,A
785,BE,707,707,4938,90,4963,786,4231,B
785,CE,333,333,5271,800,5763,786,4938,C
785,DE,913,913,6184,3780,9543,786,5271,D
785,E,8267,2083,8267,8210,8210,786,0,E
785,F,197,197,8464,300,8510,786,8267,F
785,G,853,853,9317,1005,9515,786,8464,G
785,H,650,650,9967,1200,10715,786,9317,H
785,M,477,477,10444,646,11361,786,9967,M
785,N,199,199,10643,90,11451,786,10444,N
785,O,591,591,11234,820,12271,786,10643,O
785,N,437,437,11671,210,12481,786,11234,N
785,O,163,163,11834,585,13066,786,11671,O
785,P,16846,16846,28680,3780,16846,786,11834,P
786,AEI,87,87,87,169,169,787,0,I
786,AEJ,260,260,347,240,409,787,87,J
786,AEK,357,10,357,431,431,787,0,A
786,BEK,428,71,428,525,525,787,0,E
786,BFK,130,49,477,215,624,787,347,K
786,BFL,57,57,534,4890,5514,787,477,L
786,BF,193,16,550,150,581,787,357,B
786,CF,300,178,728,240,765,787,428,F
786,CG,161,161,889,450,1215,787,728,G
786,CH,127,127,1016,3900,5115,787,889,H
786,C,552,86,1102,500,1081,787,550,C
786,D,221,221,1323,4260,5341,787,1102,D
786,M,146,146,1469,1020,6534,787,1323,M
786,N,1074,1074,2543,240,6774,787,1469,N
786,O,430,430,2973,740,7514,787,2543,O
786,P,11660,11660,14633,3870,11384,787,2973,P
787,A,901,901,901,869,869,788,0,A
787,B,148,148,1049,240,1109,788,901,B
787,C,119,119,1168,380,1489,788,1049,C
787,D,1802,1802,2970,9700,11189,788,1168,D
787,M,216,216,3186,890,12079,788,2970,M
787,N,792,792,3978,180,12259,788,3186,N
787,O,203,203,4181,345,12604,788,3978,O
787,N,1600,1600,5781,1455,14059,788,4181,N
787,O,628,628,6409,715,14774,788,5781,O
787,P,8834,8834,15243,4080,18854,788,6409,P
788,A,490,490,490,1034,1034,789,0,A
788,B,1332,1332,1822,660,1694,789,490,B
788,C,1136,1136,2958,1170,2864,789,1822,C
788,B,2777,2777,5735,1400,4264,789,2958,B
788,C,623,623,6358,975,5239,789,5735,C
788,D,4059,4059,10417,3960,9199,789,6358,D
788,M,885,885,11302,525,9724,789,10417,M
788,N,192,192,11494,600,10324,789,11302,N
788,O,237,237,11731,420,10744,789,11494,O
788,N,429,429,12160,200,10944,789,11731,N
788,O,894,894,13054,1060,12004,789,12160,O
788,P,1703,1703,14757,3360,15364,789,13054,P
789,A,171,171,171,218,218,790,0,A
789,B,136,136,307,150,368,790,171,B
789,C,168,168,475,385,753,790,307,C
789,D,658,658,1133,3160,3913,790,475,D
789,M,62,62,1195,967,4880,790,1133,M
789,N,1097,1097,2292,240,5120,790,1195,N
789,O,216,216,2508,380,5500,790,2292,O
789,P,962,962,3470,5460,10960,790,2508,P
790,AEI,93,93,93,111,111,791,0,E
790,AFI,95,95,188,135,246,791,93,F
790,AGI,197,9,197,470,470,791,0,I
790,AGJ,204,195,392,295,541,791,188,G
790,AHJ,398,6,398,1130,1130,791,0,A
790,BHJ,132,126,524,5100,5641,791,392,H
790,BJ,980,854,1378,300,1430,791,398,B
790,CJ,190,190,1568,375,1805,791,1378,C
790,BJ,1733,362,1930,1500,1970,791,197,J
790,BK,447,85,2015,235,2040,791,1568,B
790,CK,575,575,2590,695,2735,791,2015,C
790,DK,499,499,3089,1140,3875,791,2590,D
790,K,1177,18,3107,995,2965,791,1930,K
790,J,710,710,3817,910,3875,791,3107,J
790,K,203,203,4020,300,4175,791,3817,K
790,L,769,769,4789,5100,9275,791,4020,L
790,M,680,680,5469,1120,10395,791,4789,M
790,N,562,562,6031,180,10575,791,5469,N
790,O,786,786,6817,895,11470,791,6031,O
790,N,422,422,7239,315,11785,791,6817,N
790,O,400,400,7639,360,12145,791,7239,O
790,P,11629,11629,19268,7020,19165,791,7639,P
791,AEI,245,245,245,226,226,792,0,E
791,AFI,66,66,311,150,376,792,245,F
791,AGI,334,23,334,444,444,792,0,A
791,BGI,209,209,543,150,594,792,334,B
791,CGI,96,96,639,375,969,792,543,C
791,DGI,535,207,846,795,1171,792,311,G
791,DHI,1075,229,1075,1432,1432,792,0,I
791,DHJ,466,237,1312,2880,4051,792,846,H
791,DJ,618,381,1693,300,1732,792,1075,J
791,DK,928,928,2621,820,2552,792,1693,K
791,DL,813,813,3434,5315,7867,792,2621,L
791,D,5340,2545,5979,4700,5669,792,639,D
791,M,1672,1672,7651,5792,13659,792,5979,M
791,N,4150,4150,11801,90,13749,792,7651,N
791,O,862,862,12663,1210,14959,792,11801,O
791,P,377,377,13040,3780,18739,792,12663,P
792,A,144,144,144,210,210,793,0,A
792,B,154,154,298,150,360,793,144,B
792,C,122,122,420,540,900,793,298,C
792,D,963,963,1383,2850,3750,793,420,D
792,M,84,84,1467,279,4029,793,1383,M
792,N,295,295,1762,150,4179,793,1467,N
792,O,202,202,1964,130,4309,793,1762,O
792,N,1296,1296,3260,1350,5659,793,1964,N
792,O,579,579,3839,695,6354,793,3260,O
792,P,337,337,4176,4230,10584,793,3839,P
793,AE,20,20,20,37,37,794,0,E
793,AF,27,7,27,784,784,794,0,A
793,BF,159,152,179,180,217,794,20,F
793,BG,166,166,345,335,552,794,179,G
793,BF,949,631,976,240,1024,794,27,B
793,CF,549,549,1525,785,1809,794,976,C
793,DF,1231,51,1576,1065,1617,794,345,F
793,DG,529,529,2105,540,2157,794,1576,G
793,DF,122,122,2227,130,2287,794,2105,F
793,DG,1038,1038,3265,1200,3487,794,2227,G
793,DH,2647,907,4172,3960,5769,794,1525,D
793,H,1419,512,4684,5100,8587,794,3265,H
793,M,2486,2486,7170,2883,11470,794,4684,M
793,N,484,484,7654,150,11620,794,7170,N
793,O,482,482,8136,470,12090,794,7654,O
793,N,429,429,8565,425,12515,794,8136,N
793,O,147,147,8712,870,13385,794,8565,O
793,P,1423,1423,10135,3450,16835,794,8712,P
794,AEI,591,591,591,867,867,795,0,I
794,AEJ,780,189,780,1725,1725,795,0,A
794,BEJ,388,199,979,180,1047,795,591,J
794,BEK,1198,999,1978,300,2025,795,780,B
794,CEK,1249,250,2228,1650,2697,795,979,K
794,CEL,136,136,2364,300,2997,795,2228,L
794,CE,673,287,2651,2065,4090,795,1978,C
794,DE,2825,2825,5476,2760,6850,795,2651,D
794,E,8579,3103,8579,9034,9034,795,0,E
794,F,635,635,9214,240,9274,795,8579,F
794,G,1458,1458,10672,1860,11134,795,9214,G
794,H,2311,2311,12983,300,11434,795,10672,H
794,M,351,351,13334,1770,13204,795,12983,M
794,N,1598,1598,14932,240,13444,795,13334,N
794,O,1108,1108,16040,1485,14929,795,14932,O
794,P,1371,1371,17411,3780,18709,795,16040,P
795,A,52,52,52,240,240,796,0,A
795,B,362,362,414,165,405,796,52,B
795,C,622,622,1036,910,1315,796,414,C
795,D,42,42,1078,3960,5275,796,1036,D
795,M,2638,2638,3716,2721,7996,796,1078,M
795,N,173,173,3889,150,8146,796,3716,N
795,O,763,763,4652,730,8876,796,3889,O
795,N,884,884,5536,900,9776,796,4652,N
795,O,662,662,6198,530,10306,796,5536,O
795,P,2436,2436,8634,1070,11376,796,6198,P
796,A,238,238,238,923,923,797,0,A
796,B,865,865,1103,240,1163,797,238,B
796,C,161,161,1264,415,1578,797,1103,C
796,D,77,77,1341,5160,6738,797,1264,D
796,M,120,120,1461,1186,7924,797,1341,M
796,N,1263,1263,2724,240,8164,797,1461,N
796,O,745,745,3469,760,8924,797,2724,O
796,P,749,749,4218,7680,16604,797,3469,P
797,AE,110,110,110,129,129,798,0,A
797,BE,158,158,268,150,279,798,110,B
797,CE,484,484,752,130,409,798,268,C
797,DE,20,20,772,4200,4609,798,752,D
797,E,5700,4928,5700,6014,6014,798,0,E
797,F,347,347,6047,90,6104,798,5700,F
797,G,739,739,6786,1130,7234,798,6047,G
797,H,1121,1121,7907,3780,11014,798,6786,H
797,M,390,390,8297,1441,12455,798,7907,M
797,N,1134,1134,9431,90,12545,798,8297,N
797,O,925,925,10356,1225,13770,798,9431,O
797,P,30,30,10386,3780,17550,798,10356,P
798,A,269,269,269,701,701,799,0,A
798,B,689,689,958,270,971,799,269,B
798,C,1128,1128,2086,1042,2013,799,958,C
798,D,9,9,2095,333,2346,799,2086,D
798,M,3224,3224,5319,3708,6054,799,2095,M
798,N,514,514,5833,90,6144,799,5319,N
798,O,616,616,6449,815,6959,799,5833,O
798,N,1055,1055,7504,850,7809,799,6449,N
798,O,241,241,7745,695,8504,799,7504,O
798,P,12000,12000,19745,3780,12284,799,7745,P
799,A,1710,1710,1710,1958,1958,800,0,A
799,B,504,504,2214,300,2258,800,1710,B
799,C,861,861,3075,1070,3328,800,2214,C
799,D,2166,2166,5241,3960,7288,800,3075,D
799,M,96,96,5337,195,7483,800,5241,M
799,N,229,229,5566,180,7663,800,5337,N
799,O,122,122,5688,260,7923,800,5566,O
799,N,1026,1026,6714,895,8818,800,5688,N
799,O,187,187,6901,225,9043,800,6714,O
799,P,965,965,7866,4740,13783,800,6901,P
800,A,1545,1545,1545,2128,2128,801,0,A
800,B,772,772,2317,240,2368,801,1545,B
800,C,389,389,2706,460,2828,801,2317,C
800,B,1616,1616,4322,1535,4363,801,2706,B
800,C,656,656,4978,1005,5368,801,4322,C
800,D,1626,1626,6604,3960,9328,801,4978,D
800,M,67,67,6671,852,10180,801,6604,M
800,N,1137,1137,7808,420,10600,801,6671,N
800,O,921,921,8729,865,11465,801,7808,O
800,P,2874,2874,11603,550,12015,801,8729,P
801,AEI,51,51,51,346,346,802,0,E
801,AFI,144,93,144,261,261,802,0,A
801,BFI,462,369,513,240,586,802,51,F
801,BGI,771,771,1284,975,1561,802,513,G
801,BFI,1557,417,1701,1500,1761,802,144,B
801,CFI,1710,9,1710,1613,1613,802,0,I
801,CFJ,973,964,2674,1000,2761,802,1701,C
801,BFJ,1343,379,3053,1500,3113,802,1710,J
801,BFK,414,35,3088,385,3146,802,2674,B
801,CFK,44,44,3132,215,3361,802,3088,C
801,DFK,2192,344,3476,1975,3536,802,1284,F
801,DGK,409,65,3541,5100,8461,802,3132,D
801,GK,131,66,3607,290,3826,802,3476,G
801,HK,13,13,3620,5100,8926,802,3607,H
801,K,779,212,3832,1000,4113,802,3053,K
801,J,2471,2471,6303,2250,6363,802,3832,J
801,K,114,114,6417,290,6653,802,6303,K
801,L,30,30,6447,5100,11753,802,6417,L
801,M,53,53,6500,170,11923,802,6447,M
801,N,177,177,6677,120,12043,802,6500,N
801,O,208,208,6885,390,12433,802,6677,O
801,N,1417,1417,8302,1225,13658,802,6885,N
801,O,673,673,8975,820,14478,802,8302,O
801,P,275,275,9250,5040,19518,802,8975,P
802,AE,144,144,144,1041,1041,803,0,A
802,BE,1053,1053,1197,210,1251,803,144,B
802,CE,153,153,1350,265,1516,803,1197,C
802,BE,1891,541,1891,7219,7219,803,0,E
802,BF,610,69,1960,490,2006,803,1350,B
802,CF,713,713,2673,810,2816,803,1960,C
802,DF,1395,1395,4068,5040,7856,803,2673,D
802,F,5753,3576,7644,90,7309,803,1891,F
802,G,851,851,8495,1127,8436,803,7644,G
802,H,11480,11480,19975,3780,12216,803,8495,H
802,M,260,260,20235,286,12502,803,19975,M
802,N,161,161,20396,195,12697,803,20235,N
802,O,692,692,21088,695,13392,803,20396,O
802,P,257,257,21345,385,13777,803,21088,P
803,AE,122,122,122,327,327,804,0,A
803,BE,383,261,383,2970,2970,804,0,E
803,BF,431,170,553,90,417,804,122,B
803,CF,565,565,1118,1005,1422,804,553,C
803,DF,228,228,1346,3780,5202,804,1118,D
803,F,2682,1719,3065,150,3120,804,383,F
803,G,246,246,3311,185,3305,804,3065,G
803,H,1081,1081,4392,2850,6155,804,3311,H
803,M,11,11,4403,142,6297,804,4392,M
803,N,378,378,4781,240,6537,804,4403,N
803,O,777,777,5558,1035,7572,804,4781,O
803,P,2,2,5560,3960,11532,804,5558,P
804,A,69,69,69,720,720,805,0,A
804,B,860,860,929,240,960,805,69,B
804,C,683,683,1612,810,1770,805,929,C
804,D,311,311,1923,3960,5730,805,1612,D
804,M,1665,1665,3588,1719,7449,805,1923,M
804,N,275,275,3863,240,7689,805,3588,N
804,O,626,626,4489,770,8459,805,3863,O
804,N,264,264,4753,285,8744,805,4489,N
804,O,6227,6227,10980,1260,10004,805,4753,O
804,P,1113,1113,12093,3960,13964,805,10980,P
805,AEI,77,77,77,71,71,806,0,A
805,BEI,193,193,270,240,311,806,77,B
805,CEI,773,773,1043,1035,1346,806,270,C
805,DEI,1463,420,1463,1581,1581,806,0,E
805,DFI,182,182,1645,90,1671,806,1463,F
805,DGI,627,25,1670,3960,5306,806,1043,D
805,GI,466,441,2111,820,2491,806,1645,G
805,HI,2799,688,2799,4092,4092,806,0,I
805,HJ,922,234,3033,3780,6271,806,2111,H
805,J,1323,1089,4122,90,4182,806,2799,J
805,K,882,882,5004,1225,5407,806,4122,K
805,L,77,77,5081,3780,9187,806,5004,L
805,M,1837,1837,6918,2701,11888,806,5081,M
805,N,895,895,7813,90,11978,806,6918,N
805,O,290,290,8103,705,12683,806,7813,O
805,P,746,746,8849,3780,16463,806,8103,P
806,A,2848,2848,2848,3243,3243,807,0,A
806,B,747,747,3595,420,3663,807,2848,B
806,C,864,864,4459,850,4513,807,3595,C
806,D,1096,1096,5555,550,5063,807,4459,D
806,M,17174,17174,22729,19240,24303,807,5555,M
806,N,2196,2196,24925,180,24483,807,22729,N
806,O,736,736,25661,840,25323,807,24925,O
806,P,5661,5661,31322,6680,32003,807,25661,P
807,A,114,114,114,356,356,808,0,A
807,B,434,434,548,240,596,808,114,B
807,C,176,176,724,215,811,808,548,C
807,D,83,83,807,4890,5701,808,724,D
807,M,884,884,1691,1363,7064,808,807,M
807,N,673,673,2364,240,7304,808,1691,N
807,O,566,566,2930,765,8069,808,2364,O
807,P,246,246,3176,3960,12029,808,2930,P
808,AEI,26,26,26,129,129,809,0,I
808,AEJ,139,113,139,1184,1184,809,0,E
808,AFJ,307,194,333,240,369,809,26,J
808,AFK,792,792,1125,1035,1404,809,333,K
808,AFL,28,28,1153,3960,5364,809,1125,L
808,AF,1093,79,1232,90,1274,809,139,F
808,AG,842,842,2074,1230,2504,809,1232,G
808,AH,129,129,2203,3780,6284,809,2074,H
808,A,36983,34780,36983,37994,37994,809,0,A
808,B,1058,1058,38041,90,38084,809,36983,B
808,C,1109,1109,39150,1210,39294,809,38041,C
808,D,372,372,39522,3780,43074,809,39150,D
808,M,658,658,40180,957,44031,809,39522,M
808,N,325,325,40505,90,44121,809,40180,N
808,O,525,525,41030,845,44966,809,40505,O
808,P,446,446,41476,3780,48746,809,41030,P
809,AEI,350,350,350,347,347,810,0,E
809,AFI,147,147,497,210,557,810,350,F
809,AGI,122,122,619,255,812,810,497,G
809,AFI,706,87,706,1422,1422,810,0,A
809,BFI,846,846,1552,180,1602,810,706,B
809,CFI,87,87,1639,130,1732,810,1552,C
809,BFI,1526,506,2145,1390,2202,810,619,F
809,BGI,545,39,2184,495,2227,810,1639,B
809,CGI,713,674,2858,850,3052,810,2145,G
809,CHI,703,29,2887,845,3072,810,2184,C
809,DHI,1810,1810,4697,5220,8292,810,2887,D
809,HI,1936,97,4794,5220,8272,810,2858,H
809,I,14852,10058,14852,14854,14854,810,0,I
809,J,276,276,15128,300,15154,810,14852,J
809,K,558,558,15686,735,15889,810,15128,K
809,L,1468,1468,17154,1560,17449,810,15686,L
809,M,3281,3281,20435,3333,20782,810,17154,M
809,N,241,241,20676,240,21022,810,20435,N
809,O,748,748,21424,995,22017,810,20676,O
809,P,44,44,21468,3960,25977,810,21424,P
810,A,18761,18761,18761,18950,18950,811,0,A
810,B,207,207,18968,90,19040,811,18761,B
810,C,1768,1768,20736,1850,20890,811,18968,C
810,D,268,268,21004,3840,24730,811,20736,D
810,M,5413,5413,26417,5657,30387,811,21004,M
810,N,285,285,26702,90,30477,811,26417,N
810,O,1464,1464,28166,1935,32412,811,26702,O
810,P,1268,1268,29434,3780,36192,811,28166,P
811,A,484,484,484,2500,2500,812,0,A
811,B,2047,2047,2531,90,2590,812,484,B
811,C,867,867,3398,1225,3815,812,2531,C
811,D,113,113,3511,3780,7595,812,3398,D
811,M,708,708,4219,1127,8722,812,3511,M
811,N,467,467,4686,90,8812,812,4219,N
811,O,274,274,4960,625,9437,812,4686,O
811,P,12208,12208,17168,3780,13217,812,4960,P
812,AEI,256,256,256,321,321,813,0,E
812,AFI,161,161,417,150,471,813,256,F
812,AGI,155,155,572,125,596,813,417,G
812,AFI,1481,1481,2053,1505,2101,813,572,F
812,AGI,852,852,2905,775,2876,813,2053,G
812,AHI,230,230,3135,4230,7106,813,2905,H
812,AI,33779,30644,33779,34724,34724,813,0,I
812,AJ,975,975,34754,90,34814,813,33779,J
812,AK,1111,1111,35865,1210,36024,813,34754,K
812,AL,442,442,36307,3780,39804,813,35865,L
812,A,37332,1025,37332,38354,38354,813,0,A
812,B,1096,1096,38428,90,38444,813,37332,B
812,C,1342,1342,39770,1450,39894,813,38428,C
812,D,146,146,39916,3780,43674,813,39770,D
812,M,63,63,39979,199,43873,813,39916,M
812,N,168,168,40147,90,43963,813,39979,N
812,O,920,920,41067,1330,45293,813,40147,O
812,P,1696,1696,42763,3780,49073,813,41067,P
813,A,151,151,151,1157,1157,814,0,A
813,B,1126,1126,1277,180,1337,814,151,B
813,C,840,840,2117,1055,2392,814,1277,C
813,D,869,869,2986,6460,8852,814,2117,D
813,M,220,220,3206,1418,10270,814,2986,M
813,N,1391,1391,4597,240,10510,814,3206,N
813,O,194,194,4791,260,10770,814,4597,O
813,P,7246,7246,12037,5220,15990,814,4791,P
814,AEI,136,136,136,500,500,815,0,A
814,BEI,322,186,322,940,940,815,0,I
814,BEJ,1204,1018,1340,900,1400,815,136,B
814,CEJ,1458,440,1780,900,1840,815,322,J
814,CEK,450,10,1790,630,2030,815,1340,C
814,BEK,493,483,2273,510,2350,815,1780,K
814,BEJ,1233,750,3023,1055,3085,815,1790,B
814,CEJ,888,138,3161,815,3165,815,2273,J
814,CEK,872,872,4033,1162,4327,815,3161,K
814,CEL,1073,63,4096,1206,4291,815,3023,C
814,DEL,202,202,4298,414,4705,815,4096,D
814,EL,5945,1647,5945,6997,6997,815,0,E
814,FL,2140,228,6173,513,4840,815,4033,L
814,F,1303,1075,7248,300,7297,815,5945,F
814,G,800,800,8048,945,8242,815,7248,G
814,H,6069,6069,14117,4080,12322,815,8048,H
814,M,494,494,14611,1234,13556,815,14117,M
814,N,920,920,15531,240,13796,815,14611,N
814,O,538,538,16069,575,14371,815,15531,O
814,P,1203,1203,17272,385,14756,815,16069,P
815,AEI,14,14,14,67,67,816,0,E
815,AFI,44,30,44,189,189,816,0,I
815,AFJ,184,184,228,90,279,816,44,J
815,AFK,226,12,240,240,307,816,14,F
815,AGK,188,188,428,255,562,816,240,G
815,AFK,564,364,792,1005,1284,816,228,K
815,AFL,546,182,974,460,1022,816,428,F
815,AGL,126,126,1100,215,1237,816,974,G
815,AHL,366,58,1158,3780,5064,816,792,L
815,AH,1740,1682,2840,4890,6127,816,1100,H
815,A,7311,4471,7311,7646,7646,816,0,A
815,B,577,577,7888,240,7886,816,7311,B
815,C,796,796,8684,920,8806,816,7888,C
815,D,752,752,9436,3960,12766,816,8684,D
815,M,25018,25018,34454,26000,38766,816,9436,M
815,N,1036,1036,35490,90,38856,816,34454,N
815,O,511,511,36001,865,39721,816,35490,O
815,P,74,74,36075,3780,43501,816,36001,P
816,A,266,266,266,265,265,817,0,A
816,B,256,256,522,300,565,817,266,B
816,C,587,587,1109,775,1340,817,522,C
816,D,249,249,1358,4020,5360,817,1109,D
816,M,78,78,1436,677,6037,817,1358,M
816,N,765,765,2201,180,6217,817,1436,N
816,O,128,128,2329,380,6597,817,2201,O
816,P,80,80,2409,3960,10557,817,2329,P
817,AEI,890,890,890,1319,1319,818,0,E
817,AFI,475,475,1365,90,1409,818,890,F
817,AGI,1617,252,1617,1818,1818,818,0,A
817,BGI,226,226,1843,90,1908,818,1617,B
817,CGI,824,346,2189,1230,2639,818,1365,G
817,CHI,140,140,2329,3780,6419,818,2189,H
817,CI,507,21,2350,905,2813,818,1843,C
817,DI,271,271,2621,3780,6593,818,2350,D
817,I,10710,8089,10710,11621,11621,818,0,I
817,J,1009,1009,11719,90,11711,818,10710,J
817,K,1253,1253,12972,1340,13051,818,11719,K
817,L,161,161,13133,3780,16831,818,12972,L
817,M,1720,1720,14853,2494,19325,818,13133,M
817,N,836,836,15689,90,19415,818,14853,N
817,O,151,151,15840,605,20020,818,15689,O
817,P,10253,10253,26093,3780,23800,818,15840,P
818,A,59,59,59,117,117,819,0,A
818,B,152,152,211,135,252,819,59,B
818,C,227,227,438,285,537,819,211,C
818,D,2703,2703,3141,5160,5697,819,438,D
818,M,18102,18102,21243,18985,24682,819,3141,M
818,N,1012,1012,22255,180,24862,819,21243,N
818,O,772,772,23027,885,25747,819,22255,O
818,P,1669,1669,24696,6680,32427,819,23027,P
819,A,321,321,321,437,437,820,0,A
819,B,241,241,562,150,587,820,321,B
819,C,141,141,703,395,982,820,562,C
819,D,177,177,880,2880,3862,820,703,D
819,M,59,59,939,170,4032,820,880,M
819,N,197,197,1136,135,4167,820,939,N
819,O,656,656,1792,655,4822,820,1136,O
819,P,905,905,2697,5400,10222,820,1792,P
820,AE,2960,2960,2960,3360,3360,821,0,A
820,BE,669,669,3629,300,3660,821,2960,B
820,CE,539,539,4168,1940,5600,821,3629,C
820,DE,1277,1277,5445,2760,8360,821,4168,D
820,E,11708,6263,11708,12646,12646,821,0,E
820,F,1173,1173,12881,240,12886,821,11708,F
820,G,935,935,13816,1545,14431,821,12881,G
820,H,743,743,14559,300,14731,821,13816,H
820,M,34918,34918,49477,35714,50445,821,14559,M
820,N,836,836,50313,90,50535,821,49477,N
820,O,1132,1132,51445,1240,51775,821,50313,O
820,N,495,495,51940,395,52170,821,51445,N
820,O,577,577,52517,935,53105,821,51940,O
820,P,118,118,52635,3780,56885,821,52517,P
821,AEI,2,2,2,258,258,822,0,I
821,AEJ,86,84,86,719,719,822,0,E
821,AFJ,320,234,320,335,335,822,0,A
821,BFJ,30,30,350,75,410,822,320,B
821,CFJ,457,109,459,240,498,822,2,J
821,CFK,825,452,911,240,959,822,86,F
821,CGK,136,136,1047,205,1164,822,911,G
821,CHK,804,216,1263,1045,1543,822,459,K
821,CHJ,307,91,1354,5220,6384,822,1047,H
821,CJ,1177,173,1527,765,1175,822,350,C
821,BJ,544,280,1807,480,2023,822,1263,J
821,BK,289,9,1816,620,1795,822,1527,B
821,CK,501,492,2308,510,2533,822,1807,K
821,CL,40,40,2348,3960,6493,822,2308,L
821,C,616,84,2432,645,2440,822,1816,C
821,B,435,435,2867,520,2960,822,2432,B
821,C,401,401,3268,500,3460,822,2867,C
821,D,385,385,3653,355,3815,822,3268,D
821,M,23452,23452,27105,24691,31184,822,3653,M
821,N,1264,1264,28369,90,31274,822,27105,N
821,O,1396,1396,29765,1365,32639,822,28369,O
821,N,2823,2823,32588,1365,34004,822,29765,N
821,O,610,610,33198,950,34954,822,32588,O
821,P,1247,1247,34445,3780,38734,822,33198,P
822,A,807,807,807,1224,1224,823,0,A
822,B,459,459,1266,90,1314,823,807,B
822,C,986,986,2252,1225,2539,823,1266,C
822,D,34732,34732,36984,4505,7044,823,2252,D
822,M,391,391,37375,583,7627,823,36984,M
822,N,243,243,37618,90,7717,823,37375,N
822,O,902,902,38520,1210,8927,823,37618,O
822,P,3095,3095,41615,3780,12707,823,38520,P
823,A,812,812,812,883,883,824,0,A
823,B,170,170,982,150,1033,824,812,B
823,C,122,122,1104,410,1443,824,982,C
823,D,65,65,1169,3445,4888,824,1104,D
823,M,98,98,1267,1145,6033,824,1169,M
823,N,1077,1077,2344,90,6123,824,1267,N
823,O,960,960,3304,1210,7333,824,2344,O
823,P,28,28,3332,3780,11113,824,3304,P
824,A,604,604,604,1460,1460,825,0,A
824,B,1113,1113,1717,300,1760,825,604,B
824,C,939,939,2656,805,2565,825,1717,C
824,D,78520,78520,81176,3960,6525,825,2656,D
824,M,6031,6031,87207,6040,12565,825,81176,M
824,N,199,199,87406,240,12805,825,87207,N
824,O,527,527,87933,740,13545,825,87406,O
824,N,286,286,88219,50,13595,825,87933,N
824,O,599,599,88818,935,14530,825,88219,O
824,P,419,419,89237,3780,18310,825,88818,P
825,A,151,151,151,777,777,826,0,A
825,B,732,732,883,150,927,826,151,B
825,C,182,182,1065,140,1067,826,883,C
825,B,421,421,1486,470,1537,826,1065,B
825,C,722,722,2208,720,2257,826,1486,C
825,D,213,213,2421,4170,6427,826,2208,D
825,M,3633,3633,6054,3731,10158,826,2421,M
825,N,139,139,6193,90,10248,826,6054,N
825,O,1147,1147,7340,815,11063,826,6193,O
825,N,891,891,8231,1105,12168,826,7340,N
825,O,1313,1313,9544,1850,14018,826,8231,O
825,P,2659,2659,12203,3780,17798,826,9544,P
826,A,215,215,215,199,199,827,0,A
826,B,72,72,287,150,349,827,215,B
826,C,146,146,433,720,1069,827,287,C
826,D,1023,1023,1456,2760,3829,827,433,D
826,M,199,199,1655,207,4036,827,1456,M
826,N,103,103,1758,150,4186,827,1655,N
826,O,125,125,1883,140,4326,827,1758,O
826,N,944,944,2827,900,5226,827,1883,N
826,O,327,327,3154,650,5876,827,2827,O
826,P,10582,10582,13736,4230,10106,827,3154,P
827,AEI,32,32,32,61,61,828,0,E
827,AFI,39,7,39,64,64,828,0,A
827,BFI,69,30,69,685,685,828,0,I
827,BFJ,106,69,138,135,196,828,32,F
827,BGJ,106,7,145,135,199,828,39,B
827,CGJ,147,147,292,285,484,828,145,C
827,DGJ,196,42,334,280,476,828,138,G
827,DHJ,163,163,497,5160,5636,828,334,H
827,DJ,799,371,868,240,925,828,69,J
827,DK,245,245,1113,290,1215,828,868,K
827,DL,689,689,1802,5160,6375,828,1113,L
827,D,10333,8823,10625,5160,5644,828,292,D
827,M,374,374,10999,750,7125,828,10625,M
827,N,489,489,11488,180,7305,828,10999,N
827,O,222,222,11710,205,7510,828,11488,O
827,P,139,139,11849,2850,10360,828,11710,P
828,A,190,190,190,370,370,829,0,A
828,B,381,381,571,270,640,829,190,B
828,C,744,744,1315,735,1375,829,571,C
828,B,1201,1201,2516,1090,2465,829,1315,B
828,C,613,613,3129,690,3155,829,2516,C
828,B,11,11,3140,90,3245,829,3129,B
828,C,870,870,4010,660,3905,829,3140,C
828,D,1235,1235,5245,3780,7685,829,4010,D
828,M,1050,1050,6295,1102,8787,829,5245,M
828,N,207,207,6502,210,8997,829,6295,N
828,O,251,251,6753,260,9257,829,6502,O
828,N,1089,1089,7842,1075,10332,829,6753,N
828,O,633,633,8475,685,11017,829,7842,O
828,P,1305,1305,9780,5760,16777,829,8475,P
829,AEI,41,41,41,200,200,830,0,E
829,AFI,105,64,105,265,265,830,0,A
829,BFI,194,89,194,254,254,830,0,I
829,BFJ,334,181,375,240,440,830,41,F
829,BGJ,278,8,383,90,355,830,105,B
829,CGJ,240,51,434,240,494,830,194,J
829,CGK,205,146,580,215,655,830,375,G
829,CHK,168,22,602,215,709,830,434,K
829,CHL,723,504,1106,1010,1365,830,383,C
829,DHL,887,361,1467,4890,5545,830,580,H
829,DL,2778,2417,3884,3780,5145,830,1106,D
829,L,3703,421,4305,4890,5599,830,602,L
829,M,443,443,4748,1314,6913,830,4305,M
829,N,1067,1067,5815,240,7153,830,4748,N
829,O,491,491,6306,809,7962,830,5815,O
829,P,199,199,6505,3840,11802,830,6306,P
830,AEI,2,2,2,272,272,831,0,E
830,AFI,334,334,336,120,392,831,2,F
830,AGI,396,60,396,984,984,831,0,A
830,BGI,721,661,1057,950,1342,831,336,G
830,BFI,678,17,1074,150,1134,831,396,B
830,CFI,77,77,1151,50,1184,831,1074,C
830,BFI,751,751,1902,775,1959,831,1151,B
830,CFI,739,739,2641,820,2779,831,1902,C
830,DFI,1712,128,2769,1550,2892,831,1057,F
830,DGI,4344,4216,6985,5040,7819,831,2641,D
830,GI,10808,3823,10808,14508,14508,831,0,I
830,GJ,10952,2913,13721,885,3777,831,2769,G
830,HJ,187,187,13908,420,4197,831,13721,H
830,J,3737,637,14545,90,14598,831,10808,J
830,K,683,683,15228,1140,15738,831,14545,K
830,L,19384,19384,34612,3780,19518,831,15228,L
830,M,1816,1816,36428,2174,21692,831,34612,M
830,N,552,552,36980,240,21932,831,36428,N
830,O,872,872,37852,976,22908,831,36980,O
830,N,421,421,38273,375,23283,831,37852,N
830,O,755,755,39028,1080,24363,831,38273,O
830,P,6064,6064,45092,3960,28323,831,39028,P
831,A,103,103,103,1126,1126,832,0,A
831,B,1200,1200,1303,240,1366,832,103,B
831,C,807,807,2110,930,2296,832,1303,C
831,D,1026,1026,3136,6990,9286,832,2110,D
831,M,11858,11858,14994,11757,21043,832,3136,M
831,N,366,366,15360,90,21133,832,14994,N
831,O,1638,1638,16998,1885,23018,832,15360,O
831,P,124,124,17122,3780,26798,832,16998,P
832,AE,105,105,105,130,130,833,0,E
832,AF,223,118,223,220,220,833,0,A
832,BF,73,73,296,135,355,833,223,B
832,CF,346,155,451,300,430,833,105,F
832,CG,216,61,512,285,640,833,296,C
832,DG,268,268,780,5160,5800,833,512,D
832,G,646,317,1097,780,1210,833,451,G
832,H,883,883,1980,1140,2350,833,1097,H
832,M,643,643,2623,1754,7554,833,1980,M
832,N,1933,1933,4556,90,7644,833,2623,N
832,O,1126,1126,5682,1240,8884,833,4556,O
832,P,49,49,5731,3780,12664,833,5682,P
833,AEI,45,45,45,92,92,834,0,A
833,BEI,216,171,216,701,701,834,0,I
833,BEJ,224,53,269,240,332,834,45,B
833,CEJ,357,88,357,1815,1815,834,0,E
833,CFJ,587,446,803,150,851,834,216,J
833,CFK,129,129,932,135,986,834,803,K
833,CFL,811,148,1080,985,1317,834,269,C
833,CFL,148,0,1080,4230,5216,834,932,L
833,BF,798,798,1878,615,1932,834,1080,B
833,CF,223,223,2101,255,2187,834,1878,C
833,DF,1866,122,2223,300,2115,834,357,F
833,DG,132,10,2233,5160,7347,834,2101,D
833,G,542,532,2765,735,2850,834,2223,G
833,F,235,235,3000,225,3075,834,2765,F
833,G,666,666,3666,835,3910,834,3000,G
833,H,2969,2969,6635,4020,7930,834,3666,H
833,M,1076,1076,7711,1015,8945,834,6635,M
833,N,35,35,7746,150,9095,834,7711,N
833,O,3369,3369,11115,405,9500,834,7746,O
833,P,5608,5608,16723,2880,12380,834,11115,P
834,AEI,342,342,342,1421,1421,835,0,I
834,AEJ,1154,812,1154,1419,1419,835,0,A
834,BEJ,1439,285,1439,1865,1865,835,0,E
834,BFJ,458,173,1612,240,1659,835,1154,B
834,BFJ,1270,0,1612,240,1661,835,342,J
834,CFK,497,324,1936,90,1955,835,1439,F
834,CGK,658,334,2270,820,2479,835,1612,C
834,DGK,521,187,2457,825,2780,835,1936,G
834,DFK,847,2,2459,890,2551,835,1612,K
834,DFL,271,82,2541,9700,12179,835,2270,D
834,FL,281,199,2740,5160,7711,835,2459,L
834,F,761,478,3218,495,3275,835,2457,F
834,G,521,521,3739,880,4155,835,3218,G
834,H,4576,4576,8315,3780,7935,835,3739,H
834,M,213,213,8528,1094,13273,835,8315,M
834,N,1001,1001,9529,180,13453,835,8528,N
834,O,810,810,10339,1050,14503,835,9529,O
834,N,938,938,11277,700,15203,835,10339,N
834,O,139,139,11416,240,15443,835,11277,O
834,P,7,7,11423,5040,20483,835,11416,P
835,AE,81,81,81,313,313,836,0,E
835,AF,192,111,192,687,687,836,0,A
835,BF,422,311,503,240,553,836,81,F
835,BG,155,155,658,215,768,836,503,G
835,BH,596,130,788,150,837,836,192,B
835,CH,151,151,939,145,982,836,788,C
835,DH,424,143,1082,4890,5658,836,658,H
835,D,581,438,1520,4200,5182,836,939,D
835,M,376,376,1896,1157,6815,836,1520,M
835,N,982,982,2878,240,7055,836,1896,N
835,O,652,652,3530,895,7950,836,2878,O
835,P,79,79,3609,3960,11910,836,3530,P
836,AE,23,23,23,105,105,837,0,E
836,AF,205,205,228,180,285,837,23,F
836,AG,262,34,262,527,527,837,0,A
836,BG,116,82,344,115,400,837,228,G
836,BH,15,15,359,3320,3720,837,344,H
836,B,300,203,562,90,617,837,262,B
836,C,1003,1003,1565,1270,1887,837,562,C
836,D,157,157,1722,3780,5667,837,1565,D
836,M,95,95,1817,135,5802,837,1722,M
836,N,129,129,1946,150,5952,837,1817,N
836,O,124,124,2070,100,6052,837,1946,O
836,P,13,13,2083,2880,8932,837,2070,P
837,AE,600,600,600,525,525,838,0,E
837,AF,201,201,801,300,825,838,600,F
837,AG,679,679,1480,855,1680,838,801,G
837,AH,445,445,1925,1770,3450,838,1480,H
837,A,2065,140,2065,2215,2215,838,0,A
837,B,191,191,2256,90,2305,838,2065,B
837,C,527,527,2783,790,3095,838,2256,C
837,B,951,951,3734,325,3420,838,2783,B
837,C,1407,1407,5141,1885,5305,838,3734,C
837,D,1032,1032,6173,3780,9085,838,5141,D
837,M,80,80,6253,80,9165,838,6173,M
837,N,311,311,6564,300,9465,838,6253,N
837,O,597,597,7161,2185,11650,838,6564,O
837,P,175,175,7336,2760,14410,838,7161,P
838,A,166,166,166,190,190,839,0,A
838,B,114,114,280,150,340,839,166,B
838,C,81,81,361,80,420,839,280,C
838,D,75,75,436,2880,3300,839,361,D
838,M,167,167,603,788,4088,839,436,M
838,N,736,736,1339,150,4238,839,603,N
838,O,237,237,1576,125,4363,839,1339,O
838,N,1750,1750,3326,1870,6233,839,1576,N
838,O,164,164,3490,125,6358,839,3326,O
838,P,1140,1140,4630,4230,10588,839,3490,P
839,A,79,79,79,139,139,840,0,A
839,B,536,536,615,90,229,840,79,B
839,C,618,618,1233,1010,1239,840,615,C
839,D,95,95,1328,3780,5019,840,1233,D
839,M,40,40,1368,109,5128,840,1328,M
839,N,184,184,1552,150,5278,840,1368,N
839,O,224,224,1776,475,5753,840,1552,O
839,P,18,18,1794,3960,9713,840,1776,P
840,AEI,1539,1539,1539,1744,1744,841,0,I
840,AEJ,489,489,2028,300,2044,841,1539,J
840,AEK,2086,58,2086,3165,3165,841,0,E
840,AFK,708,650,2736,910,2954,841,2028,K
840,AFL,1345,695,3431,300,3465,841,2086,F
840,AGL,1253,558,3989,3960,6914,841,2736,L
840,AG,1041,483,4472,840,4305,841,3431,G
840,AH,8,8,4480,1560,5865,841,4472,H
840,A,14878,10398,14878,14919,14919,841,0,A
840,B,298,298,15176,300,15219,841,14878,B
840,C,613,613,15789,740,15959,841,15176,C
840,D,35,35,15824,1560,17519,841,15789,D
840,M,1365,1365,17189,1350,18869,841,15824,M
840,N,252,252,17441,300,19169,841,17189,N
840,O,723,723,18164,835,20004,841,17441,O
840,P,3241,3241,21405,1140,21144,841,18164,P
841,AEI,49,49,49,66,66,842,0,E
841,AFI,75,26,75,78,78,842,0,A
841,BFI,83,83,158,135,213,842,75,B
841,CFI,131,22,180,135,201,842,49,F
841,CGI,126,104,284,385,598,842,158,C
841,DGI,44,44,328,9245,9843,842,284,D
841,GI,239,91,419,385,586,842,180,G
841,HI,34,34,453,5400,5986,842,419,H
841,I,1025,572,1025,1323,1323,842,0,I
841,J,410,410,1435,150,1473,842,1025,J
841,K,147,147,1582,125,1598,842,1435,K
841,J,861,861,2443,875,2473,842,1582,J
841,K,93,93,2536,105,2578,842,2443,K
841,L,112,112,2648,4230,6808,842,2536,L
841,M,423,423,3071,357,10200,842,2648,M
841,N,129,129,3200,240,10440,842,3071,N
841,O,134,134,3334,380,10820,842,3200,O
841,N,713,713,4047,460,11280,842,3334,N
841,O,534,534,4581,790,12070,842,4047,O
841,P,4324,4324,8905,4020,16090,842,4581,P
842,AE,252,252,252,973,973,843,0,A
842,BE,258,6,258,911,911,843,0,E
842,BF,758,758,1016,150,1061,843,258,F
842,BG,813,49,1065,150,1123,843,252,B
842,CG,205,156,1221,140,1201,843,1016,G
842,CF,158,2,1223,395,1518,843,1065,C
842,BF,476,474,1697,535,1736,843,1221,F
842,BG,525,51,1748,280,1798,843,1223,B
842,CG,587,536,2284,635,2371,843,1697,G
842,CH,580,44,2328,655,2453,843,1748,C
842,DH,287,243,2571,4230,6601,843,2284,H
842,D,425,182,2753,4230,6683,843,2328,D
842,M,1467,1467,4220,1535,8218,843,2753,M
842,N,152,152,4372,90,8308,843,4220,N
842,O,530,530,4902,860,9168,843,4372,O
842,P,75,75,4977,3780,12948,843,4902,P
843,A,202,202,202,270,270,844,0,A
843,B,283,283,485,240,510,844,202,B
843,C,876,876,1361,725,1235,844,485,C
843,D,2530,2530,3891,3960,5195,844,1361,D
843,M,2105,2105,5996,3112,8307,844,3891,M
843,N,1204,1204,7200,240,8547,844,5996,N
843,O,1037,1037,8237,1220,9767,844,7200,O
843,P,15452,15452,23689,3960,13727,844,8237,P
844,AEI,65,65,65,145,145,845,0,E
844,AFI,177,112,177,362,362,845,0,A
844,BFI,331,219,396,300,445,845,65,F
844,BGI,340,121,517,210,572,845,177,B
844,CGI,128,128,645,255,827,845,517,C
844,BGI,594,345,990,735,1180,845,396,G
844,BHI,150,150,1140,1560,2740,845,990,H
844,BI,1736,596,1736,1950,1950,845,0,I
844,BJ,1520,429,2165,1390,2217,845,645,B
844,CJ,553,124,2289,300,2250,845,1736,J
844,CK,543,543,2832,740,2990,845,2289,K
844,CL,717,50,2882,850,3067,845,2165,C
844,DL,93,43,2925,1560,4550,845,2832,L
844,D,506,463,3388,5220,8287,845,2882,D
844,M,6991,6991,10379,7197,15484,845,3388,M
844,N,428,428,10807,240,15724,845,10379,N
844,O,713,713,11520,995,16719,845,10807,O
844,N,355,355,11875,130,16849,845,11520,N
844,O,1197,1197,13072,1620,18469,845,11875,O
844,P,1520,1520,14592,3960,22429,845,13072,P
845,AEI,127,127,127,276,276,846,0,E
845,AFI,241,114,241,296,296,846,0,I
845,AFJ,245,131,372,150,426,846,127,F
845,AGJ,235,104,476,240,536,846,241,J
845,AGK,178,74,550,140,566,846,372,G
845,AFK,872,872,1422,900,1466,846,550,F
845,AGK,1497,75,1497,2412,2412,846,0,A
845,BGK,319,244,1741,650,2116,846,1422,G
845,BHK,1361,96,1837,1560,2096,846,476,K
845,BHJ,940,600,2437,90,2502,846,1497,B
845,CHJ,1055,455,2892,835,2931,846,1837,J
845,CHK,684,229,3121,880,3382,846,2437,C
845,BHK,308,308,3429,110,3492,846,3121,B
845,CHK,1085,548,3977,1121,4052,846,2892,K
845,CHL,966,966,4943,564,4616,846,3977,L
845,CH,1596,82,5025,2315,5807,846,3429,C
845,DH,3393,109,5134,4230,6346,846,1741,H
845,D,4060,3951,9085,3420,9227,846,5025,D
845,M,337,337,9422,587,9814,846,9085,M
845,N,375,375,9797,180,9994,846,9422,N
845,O,610,610,10407,670,10664,846,9797,O
845,N,540,540,10947,525,11189,846,10407,N
845,O,2486,2486,13433,2820,14009,846,10947,O
845,P,1694,1694,15127,3960,17969,846,13433,P
846,A,20,20,20,120,120,847,0,A
846,B,340,340,360,300,420,847,20,B
846,C,939,939,1299,900,1320,847,360,C
846,B,531,531,1830,580,1900,847,1299,B
846,C,554,554,2384,735,2635,847,1830,C
846,D,26,26,2410,5315,7950,847,2384,D
846,M,17,17,2427,353,8303,847,2410,M
846,N,414,414,2841,135,8438,847,2427,N
846,O,186,186,3027,295,8733,847,2841,O
846,P,21,21,3048,5100,13833,847,3027,P
847,AEI,116,116,116,1427,1427,848,0,E
847,AFI,1212,1096,1212,1613,1613,848,0,I
847,AFJ,1342,246,1458,90,1517,848,116,F
847,AGJ,450,204,1662,90,1703,848,1212,J
847,AGK,2409,747,2409,2557,2557,848,0,A
847,BGK,1048,97,2506,1225,2742,848,1458,G
847,BHK,6,6,2512,3780,6522,848,2506,H
847,BK,892,42,2554,1250,2953,848,1662,K
847,BL,178,33,2587,90,2647,848,2409,B
847,CL,523,523,3110,820,3467,848,2587,C
847,DL,355,355,3465,3780,7247,848,3110,D
847,L,1410,499,3964,3780,6733,848,2554,L
847,M,565,565,4529,1252,8499,848,3964,M
847,N,734,734,5263,90,8589,848,4529,N
847,O,1005,1005,6268,1285,9874,848,5263,O
847,P,2301,2301,8569,3780,13654,848,6268,P
848,AE,22,22,22,35,35,849,0,A
848,BE,126,126,148,135,170,849,22,B
848,CE,293,145,293,395,395,849,0,E
848,CF,286,141,434,290,460,849,148,C
848,DF,189,48,482,135,530,849,293,F
848,DG,153,153,635,290,820,849,482,G
848,DH,211,10,645,5160,5620,849,434,D
848,H,225,215,860,5160,5980,849,635,H
848,M,1297,1297,2157,1717,7697,849,860,M
848,N,546,546,2703,180,7877,849,2157,N
848,O,888,888,3591,885,8762,849,2703,O
848,N,702,702,4293,695,9457,849,3591,N
848,O,620,620,4913,710,10167,849,4293,O
848,P,2462,2462,7375,6960,17127,849,4913,P
849,A,65,65,65,637,637,850,0,A
849,B,752,752,817,240,877,850,65,B
849,C,278,278,1095,255,1132,850,817,C
849,D,173,173,1268,5160,6292,850,1095,D
849,M,297,297,1565,932,7224,850,1268,M
849,N,735,735,2300,150,7374,850,1565,N
849,O,179,179,2479,155,7529,850,2300,O
849,N,346,346,2825,325,7854,850,2479,N
849,O,562,562,3387,809,8663,850,2825,O
849,P,3966,3966,7353,3840,12503,850,3387,P
850,A,1700,1700,1700,2704,2704,851,0,A
850,B,1034,1034,2734,90,2794,851,1700,B
850,C,661,661,3395,905,3699,851,2734,C
850,B,259,259,3654,20,3719,851,3395,B
850,C,895,895,4549,1275,4994,851,3654,C
850,D,27,27,4576,3780,8774,851,4549,D
850,M,153,153,4729,1385,10159,851,4576,M
850,N,1455,1455,6184,240,10399,851,4729,N
850,O,674,674,6858,760,11159,851,6184,O
850,P,2546,2546,9404,7740,18899,851,6858,P
851,AE,115,115,115,1368,1368,852,0,A
851,BE,1206,1206,1321,90,1458,852,115,B
851,CE,278,278,1599,535,1993,852,1321,C
851,DE,65,65,1664,3780,5773,852,1599,D
851,E,1912,248,1912,2090,2090,852,0,E
851,F,222,222,2134,90,2180,852,1912,F
851,G,637,637,2771,820,3000,852,2134,G
851,H,507,507,3278,3780,6780,852,2771,H
851,M,287,287,3565,926,7706,852,3278,M
851,N,670,670,4235,90,7796,852,3565,N
851,O,581,581,4816,845,8641,852,4235,O
851,P,1156,1156,5972,3780,12421,852,4816,P
852,AE,69,69,69,139,139,853,0,E
852,AF,190,190,259,180,319,853,69,F
852,AG,173,173,432,335,654,853,259,G
852,AF,1447,1447,1879,1285,1939,853,432,F
852,AG,2562,2562,4441,385,2324,853,1879,G
852,AH,130,130,4571,6365,8689,853,4441,H
852,A,5854,1283,5854,6691,6691,853,0,A
852,B,1105,1105,6959,240,6931,853,5854,B
852,C,793,793,7752,1030,7961,853,6959,C
852,B,970,970,8722,810,8771,853,7752,B
852,C,86,86,8808,380,9151,853,8722,C
852,D,160,160,8968,3960,13111,853,8808,D
852,M,140,140,9108,206,13317,853,8968,M
852,N,156,156,9264,150,13467,853,9108,N
852,O,84,84,9348,90,13557,853,9264,O
852,N,288,288,9636,255,13812,853,9348,N
852,O,112,112,9748,90,13902,853,9636,O
852,P,781,781,10529,2900,16802,853,9748,P
853,AEI,34,34,34,121,121,854,0,A
853,BEI,51,17,51,84,84,854,0,E
853,BFI,226,175,226,1105,1105,854,0,I
853,BFJ,205,30,256,240,324,854,51,F
853,BGJ,259,37,293,240,361,854,34,B
853,CGJ,713,713,1006,975,1336,854,293,C
853,DGJ,23,23,1029,5160,6496,854,1006,D
853,GJ,795,22,1051,975,1299,854,256,G
853,HJ,999,174,1225,180,1285,854,226,J
853,HK,852,852,2077,1050,2335,854,1225,K
853,HL,3639,2613,4690,5040,6339,854,1051,H
853,L,3779,1166,5856,5040,7375,854,2077,L
853,M,62,62,5918,224,7599,854,5856,M
853,N,358,358,6276,240,7839,854,5918,N
853,O,176,176,6452,225,8064,854,6276,O
853,P,1023,1023,7475,4890,12954,854,6452,P
854,AE,121,121,121,123,123,855,0,A
854,BE,180,180,301,240,363,855,121,B
854,CE,324,23,324,361,361,855,0,E
854,CF,161,161,485,180,541,855,324,F
854,CG,189,5,490,240,603,855,301,C
854,DG,528,528,1018,5250,5853,855,490,D
854,G,969,436,1454,935,1476,855,485,G
854,H,825,825,2279,385,1861,855,1454,H
854,M,154,154,2433,968,6821,855,2279,M
854,N,1050,1050,3483,270,7091,855,2433,N
854,O,1077,1077,4560,1120,8211,855,3483,O
854,P,15447,15447,20007,335,8546,855,4560,P
855,AEI,61,61,61,874,874,856,0,I
855,AEJ,98,37,98,1312,1312,856,0,E
855,AFJ,1006,969,1067,240,1114,856,61,J
855,AFK,184,184,1251,265,1379,856,1067,K
855,AFL,1402,249,1500,240,1552,856,98,F
855,AGL,238,238,1738,265,1817,856,1500,G
855,AHL,2899,1161,2899,2899,2899,856,0,A
855,BHL,590,590,3489,650,3549,856,2899,B
855,CHL,839,839,4328,1095,4644,856,3489,C
855,CHL,2590,0,4328,5460,7277,856,1738,H
855,BL,544,544,4872,1795,6439,856,4328,B
855,CL,5773,2152,7024,5460,6839,856,1251,L
855,C,2876,724,7748,2826,9265,856,4872,C
855,D,4,4,7752,384,9649,856,7748,D
855,M,258,258,8010,767,10416,856,7752,M
855,N,600,600,8610,150,10566,856,8010,N
855,O,256,256,8866,485,11051,856,8610,O
855,P,355,355,9221,3960,15011,856,8866,P
856,AE,108,108,108,406,406,857,0,E
856,AF,418,418,526,180,586,857,108,F
856,AG,701,701,1227,975,1561,857,526,G
856,AH,1249,22,1249,1417,1417,857,0,A
856,BH,288,288,1537,180,1597,857,1249,B
856,CH,918,608,2145,4935,6496,857,1227,H
856,C,736,128,2273,855,2452,857,1537,C
856,D,994,994,3267,5310,7762,857,2273,D
856,M,1397,1397,4664,2588,10350,857,3267,M
856,N,1221,1221,5885,90,10440,857,4664,N
856,O,1026,1026,6911,1210,11650,857,5885,O
856,P,1976,1976,8887,3780,15430,857,6911,P
857,AE,73,73,73,39,39,858,0,A
857,BE,83,83,156,180,219,858,73,B
857,CE,165,165,321,220,439,858,156,C
857,BE,877,556,877,959,959,858,0,E
857,BF,169,169,1046,150,1109,858,877,F
857,BG,160,160,1206,100,1209,858,1046,G
857,BF,368,368,1574,485,1694,858,1206,F
857,BG,1266,13,1587,1190,1629,858,321,B
857,CG,97,97,1684,185,1814,858,1587,C
857,DG,734,624,2308,615,2309,858,1574,G
857,DH,838,214,2522,4140,5954,858,1684,D
857,H,1876,1662,4184,2925,5234,858,2308,H
857,M,668,668,4852,783,6737,858,4184,M
857,N,686,686,5538,631,7368,858,4852,N
857,O,305,305,5843,450,7818,858,5538,O
857,N,1826,1826,7669,1680,9498,858,5843,N
857,O,569,569,8238,715,10213,858,7669,O
857,P,1396,1396,9634,4080,14293,858,8238,P
858,AEI,222,222,222,388,388,859,0,I
858,AEJ,495,273,495,605,605,859,0,E
858,AFJ,540,267,762,420,808,859,222,J
858,AFK,578,311,1073,420,1025,859,495,F
858,AGK,856,545,1618,1079,1887,859,762,K
858,AGL,1795,177,1795,2420,2420,859,0,A
858,BGL,855,133,1928,1079,2104,859,1073,G
858,BHL,722,589,2517,150,2570,859,1795,B
858,CHL,205,205,2722,155,2725,859,2517,C
858,BHL,277,277,2999,325,3050,859,2722,B
858,CHL,733,733,3732,700,3750,859,2999,C
858,DHL,5116,3312,7044,356,2460,859,1928,H
858,DL,4667,1355,8399,4230,7980,859,3732,D
858,L,6835,54,8453,356,2243,859,1618,L
858,M,145,145,8598,1763,9743,859,8453,M
858,N,1791,1791,10389,240,9983,859,8598,N
858,O,1168,1168,11557,1140,11123,859,10389,O
858,P,754,754,12311,550,11673,859,11557,P
859,A,2606,2606,2606,2934,2934,860,0,A
859,B,564,564,3170,300,3234,860,2606,B
859,C,722,722,3892,820,4054,860,3170,C
859,B,920,920,4812,825,4879,860,3892,B
859,C,110,110,4922,290,5169,860,4812,C
859,D,3,3,4925,5100,10269,860,4922,D
859,M,9,9,4934,188,10457,860,4925,M
859,N,239,239,5173,120,10577,860,4934,N
859,O,189,189,5362,390,10967,860,5173,O
859,N,493,493,5855,285,11252,860,5362,N
859,O,224,224,6079,290,11542,860,5855,O
859,P,824,824,6903,5160,16702,860,6079,P
860,AE,134,134,134,294,294,861,0,E
860,AF,224,90,224,384,384,861,0,A
860,BF,278,278,502,90,474,861,224,B
860,CF,620,620,1122,1010,1484,861,502,C
860,DF,235,235,1357,3780,5264,861,1122,D
860,F,1353,130,1487,90,384,861,134,F
860,G,681,681,2168,1010,1394,861,1487,G
860,H,125,125,2293,3780,5174,861,2168,H
860,M,632,632,2925,1047,6311,861,2293,M
860,N,457,457,3382,90,6401,861,2925,N
860,O,983,983,4365,1225,7626,861,3382,O
860,N,2007,2007,6372,1780,9406,861,4365,N
860,O,607,607,6979,790,10196,861,6372,O
860,P,404,404,7383,3780,13976,861,6979,P
861,AE,441,441,441,1171,1171,862,0,E
861,AF,595,154,595,1965,1965,862,0,A
861,BF,829,675,1270,150,1321,862,441,F
861,BG,767,767,2037,1030,2351,862,1270,G
861,BF,1548,106,2143,180,2145,862,595,B
861,CF,663,663,2806,670,2815,862,2143,C
861,BF,228,228,3034,265,3080,862,2806,B
861,CF,1104,107,3141,845,3196,862,2037,F
861,CG,138,31,3172,225,3305,862,3034,C
861,DG,107,76,3248,135,3331,862,3141,G
861,DH,1300,1300,4548,4230,7561,862,3248,H
861,D,2542,1166,5714,4140,7445,862,3172,D
861,M,153,153,5867,171,7732,862,5714,M
861,N,113,113,5980,150,7882,862,5867,N
861,O,146,146,6126,140,8022,862,5980,O
861,N,923,923,7049,845,8867,862,6126,N
861,O,883,883,7932,800,9667,862,7049,O
861,P,22284,22284,30216,4230,13897,862,7932,P
862,AEI,242,242,242,1305,1305,863,0,A
862,BEI,324,82,324,560,560,863,0,E
862,BFI,1038,714,1038,3982,3982,863,0,I
862,BFJ,797,83,1121,620,1180,863,324,F
862,BGJ,223,223,1344,240,1420,863,1121,G
862,BHJ,1328,226,1570,300,1605,863,242,B
862,CHJ,685,685,2255,805,2410,863,1570,C
862,DHJ,1917,1006,3261,4140,5560,863,1344,H
862,DJ,3064,841,4102,180,4162,863,1038,J
862,DK,1330,1330,5432,830,4992,863,4102,K
862,DJ,859,859,6291,1350,6342,863,5432,J
862,DK,4200,164,6455,4020,6430,863,2255,D
862,K,743,579,7034,625,6967,863,6291,K
862,L,3017,3017,10051,6960,13927,863,7034,L
862,M,10119,10119,20170,10910,24837,863,10051,M
862,N,1012,1012,21182,240,25077,863,20170,N
862,O,401,401,21583,2020,27097,863,21182,O
862,P,38,38,21621,2700,29797,863,21583,P
863,AE,238,238,238,1348,1348,864,0,A
863,BE,1112,874,1112,1119,1119,864,0,E
863,BF,106,106,1218,150,1269,864,1112,F
863,BG,1327,347,1565,240,1588,864,238,B
863,CG,370,23,1588,140,1409,864,1218,G
863,CF,288,265,1853,915,2503,864,1565,C
863,DF,1165,900,2753,1375,2784,864,1588,F
863,DG,290,290,3043,645,3429,864,2753,G
863,DH,1605,415,3458,3960,6463,864,1853,D
863,H,3016,2601,6059,4230,7659,864,3043,H
863,M,3105,3105,9164,4863,12522,864,6059,M
863,N,1889,1889,11053,180,12702,864,9164,N
863,O,1178,1178,12231,885,13587,864,11053,O
863,N,396,396,12627,820,14407,864,12231,N
863,O,1491,1491,14118,485,14892,864,12627,O
863,P,5080,5080,19198,840,15732,864,14118,P
864,AEI,233,233,233,415,415,865,0,I
864,AEJ,235,2,235,1087,1087,865,0,A
864,BEJ,378,143,378,1185,1185,865,0,E
864,BFJ,242,97,475,120,535,865,233,J
864,BFK,915,675,1150,90,1177,865,235,B
864,CFK,859,184,1334,890,1425,865,475,K
864,CFL,1092,136,1470,300,1485,865,378,F
864,CGL,464,144,1614,905,2082,865,1150,C
864,DGL,981,837,2451,905,2390,865,1470,G
864,DHL,1753,636,3087,5160,6585,865,1334,L
864,DH,2481,1845,4932,2820,5210,865,2451,H
864,D,9663,6345,11277,3780,5862,865,1614,D
864,M,185,185,11462,1119,7704,865,11277,M
864,N,1054,1054,12516,180,7884,865,11462,N
864,O,943,943,13459,1050,8934,865,12516,O
864,P,3006,3006,16465,5400,14334,865,13459,P
865,A,1602,1602,1602,1555,1555,866,0,A
865,B,227,227,1829,300,1855,866,1602,B
865,C,625,625,2454,810,2665,866,1829,C
865,D,3610,3610,6064,1620,4285,866,2454,D
865,M,14861,14861,20925,14855,19140,866,6064,M
865,N,251,251,21176,300,19440,866,20925,N
865,O,555,555,21731,735,20175,866,21176,O
865,P,363,363,22094,1560,21735,866,21731,P
866,AE,44,44,44,199,199,867,0,A
866,BE,243,243,287,150,349,867,44,B
866,CE,332,45,332,446,446,867,0,E
866,CF,210,165,497,405,754,867,287,C
866,DF,219,54,551,150,596,867,332,F
866,DG,130,130,681,400,996,867,551,G
866,DH,17,17,698,2880,3876,867,681,H
866,D,452,251,949,3140,3894,867,497,D
866,M,283,283,1232,820,4714,867,949,M
866,N,751,751,1983,240,4954,867,1232,N
866,O,250,250,2233,250,5204,867,1983,O
866,P,696,696,2929,5250,10454,867,2233,P
867,AE,820,820,820,40,40,868,0,A
867,BE,302,302,1122,1110,1150,868,820,B
867,CE,674,674,1796,845,1995,868,1122,C
867,BE,990,990,2786,840,2835,868,1796,B
867,CE,430,430,3216,615,3450,868,2786,C
867,DE,3456,240,3456,3489,3489,868,0,E
867,DF,93,93,3549,240,3729,868,3456,F
867,DG,1664,1331,4880,1140,4590,868,3216,D
867,G,2527,1196,6076,1500,5229,868,3549,G
867,F,3798,3798,9874,1750,6979,868,6076,F
867,G,744,744,10618,1005,7984,868,9874,G
867,H,358,358,10976,840,8824,868,10618,H
867,M,475,475,11451,860,9684,868,10976,M
867,N,518,518,11969,180,9864,868,11451,N
867,O,386,386,12355,450,10314,868,11969,O
867,N,309,309,12664,240,10554,868,12355,N
867,O,664,664,13328,880,11434,868,12664,O
867,P,88,88,13416,1620,13054,868,13328,P
868,AEI,193,193,193,825,825,869,0,A
868,BEI,732,732,925,150,975,869,193,B
868,CEI,124,124,1049,115,1090,869,925,C
868,BEI,535,535,1584,540,1630,869,1049,B
868,CEI,547,547,2131,665,2295,869,1584,C
868,DEI,3943,1812,3943,3771,3771,869,0,E
868,DFI,87,87,4030,300,4071,869,3943,F
868,DGI,724,724,4754,820,4891,869,4030,G
868,DHI,1682,1682,6436,4080,8971,869,4754,H
868,DI,18778,14473,20909,4170,6465,869,2131,D
868,I,41390,20481,41390,42077,42077,869,0,I
868,J,2352,2352,43742,300,42377,869,41390,J
868,K,390,390,44132,750,43127,869,43742,K
868,L,1390,1390,45522,4080,47207,869,44132,L
868,M,553,553,46075,975,48182,869,45522,M
868,N,10650,10650,56725,180,48362,869,46075,N
868,O,1014,1014,57739,1160,49522,869,56725,O
868,P,962,962,58701,960,50482,869,57739,P
869,AEI,79,79,79,281,281,870,0,A
869,BEI,89,10,89,100,100,870,0,I
869,BEJ,243,154,243,351,351,870,0,E
869,BFJ,188,34,277,240,340,870,89,J
869,BFK,378,180,457,240,521,870,79,B
869,CFK,286,72,529,240,591,870,243,F
869,CGK,102,102,631,385,976,870,529,G
869,CHK,764,410,1041,975,1315,870,277,K
869,CHL,912,328,1369,975,1496,870,457,C
869,DHL,1239,501,1870,3960,4936,870,631,H
869,DL,2095,1594,3464,5040,6536,870,1369,D
869,L,3973,1550,5014,5040,6355,870,1041,L
869,M,45,45,5059,750,7286,870,5014,M
869,N,886,886,5945,240,7526,870,5059,N
869,O,207,207,6152,300,7826,870,5945,O
869,P,135,135,6287,5100,12926,870,6152,P
870,AE,152,152,152,428,428,871,0,A
870,BE,301,301,453,90,518,871,152,B
870,CE,600,147,600,903,903,871,0,E
870,CF,342,195,795,795,1313,871,453,C
870,DF,412,217,1012,150,1053,871,600,F
870,DG,228,228,1240,140,1193,871,1012,G
870,DF,382,382,1622,470,1663,871,1240,F
870,DG,1476,649,2271,3780,5093,871,795,D
870,G,822,173,2444,660,2323,871,1622,G
870,H,1132,1132,3576,4230,6553,871,2444,H
870,M,2381,2381,5957,2466,9019,871,3576,M
870,N,157,157,6114,90,9109,871,5957,N
870,O,696,696,6810,815,9924,871,6114,O
870,N,326,326,7136,145,10069,871,6810,N
870,O,461,461,7597,740,10809,871,7136,O
870,P,3639,3639,11236,3780,14589,871,7597,P
871,AE,97,97,97,217,217,872,0,A
871,BE,253,156,253,1633,1633,872,0,E
871,BF,210,54,307,150,367,872,97,B
871,CF,602,602,909,620,987,872,307,C
871,DF,1577,921,1830,240,1873,872,253,F
871,DG,117,117,1947,380,2253,872,1830,G
871,DH,667,667,2614,3960,6213,872,1947,H
871,D,7976,6271,8885,4200,5187,872,909,D
871,M,33,33,8918,40,6253,872,8885,M
871,N,211,211,9129,240,6493,872,8918,N
871,O,766,766,9895,895,7388,872,9129,O
871,P,1031,1031,10926,3960,11348,872,9895,P
872,AEI,325,325,325,370,370,873,0,I
872,AEJ,431,106,431,1251,1251,873,0,E
872,AFJ,546,115,546,822,822,873,0,A
872,BFJ,301,80,626,300,670,873,325,J
872,BFK,330,250,876,90,912,873,546,B
872,CFK,650,400,1276,840,1510,873,626,K
872,CFL,1006,161,1437,240,1491,873,431,F
872,CGL,667,667,2104,640,2131,873,1437,G
872,CHL,1346,118,2222,1865,2777,873,876,C
872,DHL,2872,2872,5094,3780,6557,873,2222,D
872,HL,4001,183,5277,1140,2650,873,1276,L
872,H,16082,12909,18186,5430,7561,873,2104,H
872,M,140,140,18326,440,8001,873,18186,M
872,N,365,365,18691,90,8091,873,18326,N
872,O,1398,1398,20089,1745,9836,873,18691,O
872,N,676,676,20765,340,10176,873,20089,N
872,O,563,563,21328,945,11121,873,20765,O
872,P,3616,3616,24944,3780,14901,873,21328,P
873,A,719,719,719,971,971,874,0,A
873,B,418,418,1137,180,1151,874,719,B
873,C,912,912,2049,930,2081,874,1137,C
873,D,247,247,2296,550,2631,874,2049,D
873,M,584,584,2880,1119,3750,874,2296,M
873,N,655,655,3535,180,3930,874,2880,N
873,O,921,921,4456,740,4670,874,3535,O
873,N,518,518,4974,690,5360,874,4456,N
873,O,658,658,5632,610,5970,874,4974,O
873,P,5302,5302,10934,5100,11070,874,5632,P
874,AEI,8,8,8,29,29,875,0,E
874,AFI,60,52,60,45,45,875,0,I
874,AFJ,96,44,104,135,164,875,8,F
874,AGJ,120,16,120,699,699,875,0,A
874,BGJ,82,22,142,135,180,875,60,J
874,BGK,149,149,291,285,465,875,142,K
874,BGL,208,21,312,285,449,875,104,G
874,BHL,192,171,483,5160,5625,875,291,L
874,BH,235,64,547,5160,5609,875,312,H
874,B,759,332,879,240,939,875,120,B
874,C,272,272,1151,295,1234,875,879,C
874,D,744,744,1895,5160,6394,875,1151,D
874,M,96,96,1991,90,6484,875,1895,M
874,N,111,111,2102,180,6664,875,1991,N
874,O,184,184,2286,570,7234,875,2102,O
874,P,893,893,3179,2845,10079,875,2286,P
875,A,304,304,304,1338,1338,876,0,A
875,B,1219,1219,1523,240,1578,876,304,B
875,C,723,723,2246,760,2338,876,1523,C
875,D,80,80,2326,7680,10018,876,2246,D
875,M,3221,3221,5547,4215,14233,876,2326,M
875,N,1262,1262,6809,300,14533,876,5547,N
875,O,540,540,7349,785,15318,876,6809,O
875,P,3127,3127,10476,1140,16458,876,7349,P
876,AEI,1186,1186,1186,1356,1356,877,0,E
876,AFI,363,363,1549,240,1596,877,1186,F
876,AGI,747,747,2296,740,2336,877,1549,G
876,AHI,445,445,2741,3960,6296,877,2296,H
876,AI,3040,299,3040,3751,3751,877,0,A
876,BI,3210,170,3210,3386,3386,877,0,I
876,BJ,381,381,3591,240,3626,877,3210,J
876,BK,970,419,4010,300,4051,877,3040,B
876,CK,1018,599,4609,995,4621,877,3591,K
876,CL,218,218,4827,3960,8581,877,4609,L
876,C,1132,315,5142,1050,5101,877,4010,C
876,D,671,671,5813,3960,9061,877,5142,D
876,M,371,371,6184,1307,10368,877,5813,M
876,N,969,969,7153,90,10458,877,6184,N
876,O,856,856,8009,1230,11688,877,7153,O
876,P,121,121,8130,3780,15468,877,8009,P
877,A,295,295,295,488,488,878,0,A
877,B,211,211,506,90,578,878,295,B
877,C,489,489,995,880,1458,878,506,C
877,D,217,217,1212,3780,5238,878,995,D
877,M,3977,3977,5189,5011,10249,878,1212,M
877,N,1065,1065,6254,90,10339,878,5189,N
877,O,764,764,7018,1195,11534,878,6254,O
877,P,70,70,7088,3780,15314,878,7018,P
878,AE,5645,5645,5645,5864,5864,879,0,A
878,BE,594,594,6239,420,6284,879,5645,B
878,CE,6564,325,6564,9154,9154,879,0,E
878,CF,820,495,7059,920,7204,879,6239,C
878,DF,2608,2113,9172,90,9244,879,6564,F
878,DG,2493,380,9552,1175,8379,879,7059,D
878,G,677,297,9849,1130,10374,879,9172,G
878,H,1372,1372,11221,3780,14154,879,9849,H
878,M,416,416,11637,2053,16207,879,11221,M
878,N,1826,1826,13463,240,16447,879,11637,N
878,O,956,956,14419,970,17417,879,13463,O
878,N,401,401,14820,360,17777,879,14419,N
878,O,910,910,15730,1080,18857,879,14820,O
878,P,2845,2845,18575,3960,22817,879,15730,P
879,AEI,673,673,673,1031,1031,880,0,A
879,BEI,396,396,1069,90,1121,880,673,B
879,CEI,1206,137,1206,1575,1575,880,0,I
879,CEJ,449,449,1655,90,1665,880,1206,J
879,CEK,955,369,2024,1240,2361,880,1069,C
879,DEK,117,117,2141,3780,6141,880,2024,D
879,EK,1372,886,3027,1780,3445,880,1655,K
879,EL,891,891,3918,3780,7225,880,3027,L
879,E,37866,33948,37866,37993,37993,880,0,E
879,F,154,154,38020,90,38083,880,37866,F
879,G,890,890,38910,1210,39293,880,38020,G
879,H,119,119,39029,3780,43073,880,38910,H
879,M,86,86,39115,613,43686,880,39029,M
879,N,555,555,39670,90,43776,880,39115,N
879,O,435,435,40105,880,44656,880,39670,O
879,P,54,54,40159,3780,48436,880,40105,P
880,AE,4403,4403,4403,4670,4670,881,0,E
880,AF,282,282,4685,90,4760,881,4403,F
880,AG,583,583,5268,905,5665,881,4685,G
880,AH,119,119,5387,3780,9445,881,5268,H
880,A,37060,31673,37060,37993,37993,881,0,A
880,B,965,965,38025,90,38083,881,37060,B
880,C,1004,1004,39029,1220,39303,881,38025,C
880,D,13,13,39042,3780,43083,881,39029,D
880,M,148,148,39190,437,43520,881,39042,M
880,N,588,588,39778,360,43880,881,39190,N
880,O,350,350,40128,947,44827,881,39778,O
880,P,1496,1496,41624,948,45775,881,40128,P
881,AE,43,43,43,405,405,882,0,E
881,AF,50,7,50,1866,1866,882,0,A
881,BF,482,475,525,165,570,882,43,F
881,BG,1058,1058,1583,1275,1845,882,525,G
881,BH,136,136,1719,3960,5805,882,1583,H
881,B,1866,197,1916,165,2031,882,50,B
881,C,752,752,2668,825,2856,882,1916,C
881,D,181,181,2849,3960,6816,882,2668,D
881,M,3650,3650,6499,3730,10546,882,2849,M
881,N,353,353,6852,330,10876,882,6499,N
881,O,940,940,7792,730,11606,882,6852,O
881,P,3617,3617,11409,550,12156,882,7792,P
882,AE,248,248,248,1013,1013,883,0,E
882,AF,574,326,574,694,694,883,0,A
882,BF,255,255,829,180,874,883,574,B
882,CF,141,141,970,265,1139,883,829,C
882,DF,945,223,1193,240,1253,883,248,F
882,DG,202,202,1395,415,1668,883,1193,G
882,DH,73,73,1468,5160,6828,883,1395,H
882,D,1141,643,2111,6445,7584,883,970,D
882,M,48,48,2159,872,8456,883,2111,M
882,N,1011,1011,3170,240,8696,883,2159,N
882,O,706,706,3876,665,9361,883,3170,O
882,P,1685,1685,5561,5370,14731,883,3876,P
883,AEI,55,55,55,1069,1069,884,0,E
883,AFI,199,144,199,479,479,884,0,I
883,AFJ,308,308,507,90,569,884,199,J
883,AFK,403,403,910,800,1369,884,507,K
883,AFL,1197,342,1252,240,1309,884,55,F
883,AGL,902,902,2154,1020,2329,884,1252,G
883,AHL,214,214,2368,4680,7009,884,2154,H
883,AL,1880,422,2790,3780,5149,884,910,L
883,A,4733,1943,4733,6875,6875,884,0,A
883,B,2205,2205,6938,90,6965,884,4733,B
883,C,1106,1106,8044,1385,8350,884,6938,C
883,B,381,381,8425,130,8480,884,8044,B
883,C,383,383,8808,800,9280,884,8425,C
883,D,475,475,9283,3780,13060,884,8808,D
883,M,1707,1707,10990,1912,14972,884,9283,M
883,N,249,249,11239,90,15062,884,10990,N
883,O,420,420,11659,800,15862,884,11239,O
883,N,1081,1081,12740,695,16557,884,11659,N
883,O,407,407,13147,735,17292,884,12740,O
883,P,980,980,14127,3780,21072,884,13147,P
884,AEI,102,102,102,1109,1109,885,0,A
884,BEI,348,246,348,1545,1545,885,0,I
884,BEJ,1038,792,1140,90,1199,885,102,B
884,CEJ,1260,468,1608,90,1635,885,348,J
884,CEK,1767,159,1767,2151,2151,885,0,E
884,CFK,953,326,2093,1210,2409,885,1140,C
884,DFK,21,21,2114,3780,6189,885,2093,D
884,FK,414,67,2181,90,2241,885,1767,F
884,GK,949,376,2557,1230,2865,885,1608,K
884,GL,67,67,2624,3780,6645,885,2557,L
884,G,550,107,2731,820,3061,885,2181,G
884,H,128,128,2859,3780,6841,885,2731,H
884,M,4508,4508,7367,4696,11537,885,2859,M
884,N,213,213,7580,90,11627,885,7367,N
884,O,421,421,8001,765,12392,885,7580,O
884,P,1029,1029,9030,3780,16172,885,8001,P
885,AE,346,346,346,705,705,886,0,E
885,AF,514,168,514,692,692,886,0,A
885,BF,270,270,784,150,842,886,514,B
885,CF,19,19,803,100,942,886,784,C
885,BF,605,148,951,300,1005,886,346,F
885,BG,162,14,965,120,1062,886,803,B
885,CG,83,83,1048,260,1322,886,965,C
885,DG,6,6,1054,5220,6542,886,1048,D
885,G,145,42,1096,280,1285,886,951,G
885,F,1208,1208,2304,1080,2365,886,1096,F
885,G,107,107,2411,290,2655,886,2304,G
885,H,7,7,2418,5100,7755,886,2411,H
885,M,6877,6877,9295,8115,15870,886,2418,M
885,N,1298,1298,10593,120,15990,886,9295,N
885,O,150,150,10743,420,16410,886,10593,O
885,N,732,732,11475,460,16870,886,10743,N
885,O,801,801,12276,945,17815,886,11475,O
885,P,845,845,13121,5160,22975,886,12276,P
886,AE,1496,1496,1496,1746,1746,887,0,A
886,BE,266,266,1762,90,1836,887,1496,B
886,CE,505,505,2267,905,2741,887,1762,C
886,DE,623,623,2890,3780,6521,887,2267,D
886,E,33485,30595,33485,33718,33718,887,0,E
886,F,265,265,33750,90,33808,887,33485,F
886,G,716,716,34466,1130,34938,887,33750,G
886,H,367,367,34833,3780,38718,887,34466,H
886,M,2326,2326,37159,2820,41538,887,34833,M
886,N,527,527,37686,90,41628,887,37159,N
886,O,514,514,38200,880,42508,887,37686,O
886,P,5645,5645,43845,3780,46288,887,38200,P
887,AEI,37,37,37,557,557,888,0,E
887,AFI,365,328,365,538,538,888,0,A
887,BFI,711,383,748,240,797,888,37,F
887,BGI,390,7,755,240,778,888,365,B
887,CGI,168,161,916,215,1012,888,748,G
887,CHI,173,12,928,390,1168,888,755,C
887,DHI,17,5,933,4890,5902,888,916,H
887,DI,149,144,1077,3960,5128,888,928,D
887,I,2742,1665,2742,2809,2809,888,0,I
887,J,273,273,3015,240,3049,888,2742,J
887,K,849,849,3864,855,3904,888,3015,K
887,L,210,210,4074,3960,7864,888,3864,L
887,M,92,92,4166,662,8526,888,4074,M
887,N,772,772,4938,240,8766,888,4166,N
887,O,634,634,5572,810,9576,888,4938,O
887,P,174,174,5746,3960,13536,888,5572,P
888,AE,190,190,190,1230,1230,889,0,E
888,AF,373,183,373,1907,1907,889,0,A
888,BF,1070,887,1260,90,1320,889,190,F
888,BG,1599,712,1972,90,1997,889,373,B
888,CG,1024,312,2284,1220,2540,889,1260,G
888,CH,33,33,2317,3780,6320,889,2284,H
888,C,1402,1057,3374,1745,3742,889,1972,C
888,D,73,73,3447,3780,7522,889,3374,D
888,M,1471,1471,4918,2618,10140,889,3447,M
888,N,1195,1195,6113,90,10230,889,4918,N
888,O,289,289,6402,720,10950,889,6113,O
888,P,4523,4523,10925,3780,14730,889,6402,P
889,A,1684,1684,1684,1976,1976,890,0,A
889,B,347,347,2031,90,2066,890,1684,B
889,C,596,596,2627,860,2926,890,2031,C
889,D,2200,2200,4827,3780,6706,890,2627,D
889,M,1610,1610,6437,2294,9000,890,4827,M
889,N,726,726,7163,90,9090,890,6437,N
889,O,198,198,7361,605,9695,890,7163,O
889,P,6069,6069,13430,3780,13475,890,7361,P
890,AEI,101,101,101,1049,1049,891,0,I
890,AEJ,118,17,118,186,186,891,0,A
890,BEJ,140,140,258,135,321,891,118,B
890,CEJ,747,747,1005,930,1251,891,258,C
890,DEJ,1139,235,1240,240,1289,891,101,J
890,DEK,369,134,1374,7050,8301,891,1005,D
890,EK,804,670,2044,940,2229,891,1240,K
890,EL,4064,4064,6108,6990,9219,891,2044,L
890,E,15456,9348,15456,15931,15931,891,0,E
890,F,676,676,16132,240,16171,891,15456,F
890,G,643,643,16775,960,17131,891,16132,G
890,H,1450,1450,18225,3960,21091,891,16775,H
890,M,1384,1384,19609,3066,24157,891,18225,M
890,N,269,269,19878,90,24247,891,19609,N
890,O,1200,1200,21078,1525,25772,891,19878,O
890,N,2160,2160,23238,390,26162,891,21078,N
890,O,666,666,23904,945,27107,891,23238,O
890,P,1429,1429,25333,3780,30887,891,23904,P
891,AE,76,76,76,4508,4508,892,0,A
891,AE,76,0,76,148,148,892,0,E
891,BF,202,202,278,150,298,892,76,F
891,BG,530,530,808,115,413,892,278,G
891,BH,224,224,1032,4230,4643,892,808,H
891,B,4779,3823,4855,420,4928,892,76,B
891,C,2550,2550,7405,2628,7556,892,4855,C
891,D,3016,3016,10421,402,7958,892,7405,D
891,M,56,56,10477,704,8662,892,10421,M
891,N,742,742,11219,150,8812,892,10477,N
891,O,165,165,11384,150,8962,892,11219,O
891,P,342,342,11726,4200,13162,892,11384,P
892,A,1151,1151,1151,1512,1512,893,0,A
892,B,595,595,1746,300,1812,893,1151,B
892,C,729,729,2475,820,2632,893,1746,C
892,D,5,5,2480,5315,7947,893,2475,D
892,M,49,49,2529,903,8850,893,2480,M
892,N,1030,1030,3559,240,9090,893,2529,N
892,O,136,136,3695,215,9305,893,3559,O
892,P,84,84,3779,6810,16115,893,3695,P
893,A,136,136,136,257,257,894,0,A
893,B,350,350,486,270,527,894,136,B
893,C,1015,1015,1501,1100,1627,894,486,C
893,D,3574,3574,5075,335,1962,894,1501,D
893,M,192,192,5267,263,2225,894,5075,M
893,N,276,276,5543,250,2475,894,5267,N
893,O,953,953,6496,915,3390,894,5543,O
893,P,1457,1457,7953,550,3940,894,6496,P
894,AEI,40,40,40,158,158,895,0,A
894,BEI,203,203,243,150,308,895,40,B
894,CEI,340,97,340,1001,1001,895,0,I
894,CEJ,485,388,728,795,1103,895,243,C
894,DEJ,81,81,809,2880,3983,895,728,D
894,EJ,1119,310,1119,1141,1141,895,0,E
894,FJ,841,62,1181,240,1241,895,340,J
894,FK,111,49,1230,150,1291,895,1119,F
894,GK,182,182,1412,455,1746,895,1230,G
894,HK,251,20,1432,415,1656,895,1181,K
894,HL,22,22,1454,5160,6816,895,1432,L
894,H,847,805,2259,3565,5311,895,1412,H
894,M,175,175,2434,180,6996,895,2259,M
894,N,79,79,2513,135,7131,895,2434,N
894,O,126,126,2639,280,7411,895,2513,O
894,P,283,283,2922,5160,12571,895,2639,P
895,AEI,98,98,98,333,333,896,0,A
895,BEI,227,129,227,690,690,896,0,E
895,BFI,815,686,913,640,973,896,98,B
895,CFI,800,114,1027,360,1050,896,227,F
895,CGI,1491,464,1491,1951,1951,896,0,I
895,CGJ,820,242,1733,830,1803,896,913,C
895,DGJ,976,270,2003,1130,2180,896,1027,G
895,DFJ,179,179,2182,75,2255,896,2003,F
895,DGJ,124,124,2306,120,2375,896,2182,G
895,DHJ,835,20,2326,420,2371,896,1491,J
895,DHK,1085,1085,3411,980,3351,896,2326,K
895,DHL,1458,353,3764,550,2925,896,2306,H
895,DL,2044,13,3777,550,2353,896,1733,D
895,L,376,10,3787,550,3901,896,3411,L
895,M,1002,1002,4789,2854,6755,896,3787,M
895,N,2228,2228,7017,420,7175,896,4789,N
895,O,659,659,7676,691,7866,896,7017,O
895,P,4896,4896,12572,609,8475,896,7676,P
896,AE,27,27,27,17,17,897,0,A
896,BE,80,80,107,150,167,897,27,B
896,CE,188,188,295,410,577,897,107,C
896,DE,747,747,1042,3450,4027,897,295,D
896,E,2063,1021,2063,2132,2132,897,0,E
896,F,195,195,2258,180,2312,897,2063,F
896,G,602,602,2860,835,3147,897,2258,G
896,H,553,553,3413,4065,7212,897,2860,H
896,M,101,101,3514,852,8064,897,3413,M
896,N,934,934,4448,240,8304,897,3514,N
896,O,264,264,4712,535,8839,897,4448,O
896,P,11510,11510,16222,2880,11719,897,4712,P
897,AEI,410,410,410,434,434,898,0,I
897,AEJ,431,21,431,1499,1499,898,0,A
897,BEJ,121,100,531,150,584,898,410,J
897,BEK,142,142,673,390,974,898,531,K
897,BEJ,1406,733,1406,1528,1528,898,0,E
897,BFJ,870,137,1543,600,1574,898,673,J
897,BFK,1191,79,1622,150,1649,898,431,B
897,CFK,237,21,1643,150,1678,898,1406,F
897,CGK,665,565,2208,765,2339,898,1543,K
897,CGL,691,105,2313,700,2349,898,1622,C
897,BGL,717,47,2360,730,2408,898,1643,G
897,BFL,1039,1039,3399,1005,3413,898,2360,F
897,BGL,1117,31,3430,1095,3444,898,2313,B
897,CGL,618,587,4017,705,4118,898,3399,G
897,CHL,599,12,4029,690,4134,898,3430,C
897,DHL,3105,1284,5313,4170,6509,898,2208,L
897,DH,2925,1629,6942,4230,8348,898,4017,H
897,D,5660,2747,9689,4230,8364,898,4029,D
897,M,56,56,9745,146,8510,898,9689,M
897,N,337,337,10082,300,8810,898,9745,N
897,O,333,333,10415,835,9645,898,10082,O
897,N,1391,1391,11806,890,10535,898,10415,N
897,O,888,888,12694,2905,13440,898,11806,O
897,P,4336,4336,17030,1440,14880,898,12694,P
898,AEI,210,210,210,820,820,899,0,A
898,BEI,229,19,229,1416,1416,899,0,E
898,BFI,283,54,283,913,913,899,0,I
898,BFJ,705,632,915,150,970,899,210,B
898,CFJ,726,94,1009,150,1063,899,283,J
898,CFK,147,53,1062,100,1070,899,915,C
898,BFK,164,111,1173,95,1158,899,1009,K
898,BFJ,530,419,1592,570,1640,899,1062,B
898,CFJ,1377,14,1606,240,1656,899,229,F
898,CGJ,522,89,1695,585,1743,899,1173,J
898,CGK,737,634,2329,660,2300,899,1592,C
898,DGK,666,32,2361,665,2408,899,1695,K
898,DGL,873,118,2479,1020,2676,899,1606,G
898,DHL,354,354,2833,4680,7356,899,2479,H
898,DL,1219,715,3548,4230,6530,899,2329,D
898,L,1233,46,3594,4230,6638,899,2361,L
898,M,768,768,4362,2052,9408,899,3594,M
898,N,1404,1404,5766,180,9588,899,4362,N
898,O,827,827,6593,915,10503,899,5766,O
898,P,539,539,7132,360,10863,899,6593,P
899,AE,125,125,125,460,460,900,0,E
899,AF,967,967,1092,270,730,900,125,F
899,AG,1630,538,1630,1574,1574,900,0,A
899,BG,334,334,1964,420,1994,900,1630,B
899,CG,1130,258,2222,1170,1900,900,1092,G
899,CH,840,582,2804,1069,3063,900,1964,C
899,DH,4768,4186,6990,435,2335,900,2222,H
899,D,4855,669,7659,356,3419,900,2804,D
899,M,127,127,7786,3357,6776,900,7659,M
899,N,3722,3722,11508,240,7016,900,7786,N
899,O,889,889,12397,1195,8211,900,11508,O
899,N,2924,2924,15321,2785,10996,900,12397,N
899,O,810,810,16131,2337,13333,900,15321,O
899,P,754,754,16885,918,14251,900,16131,P
900,AE,274,274,274,210,210,901,0,A
900,BE,106,106,380,240,450,901,274,B
900,CE,543,543,923,840,1290,901,380,C
900,DE,1517,594,1517,1758,1758,901,0,E
900,DF,865,271,1788,4020,5310,901,923,D
900,F,363,92,1880,150,1908,901,1517,F
900,G,485,485,2365,725,2633,901,1880,G
900,F,359,359,2724,135,2768,901,2365,F
900,G,455,455,3179,110,2878,901,2724,G
900,H,746,746,3925,4230,7108,901,3179,H
900,M,333,333,4258,674,7782,901,3925,M
900,N,421,421,4679,90,7872,901,4258,N
900,O,1077,1077,5756,1365,9237,901,4679,O
900,P,100,100,5856,3780,13017,901,5756,P
901,AE,7,7,7,130,130,902,0,A
901,BE,379,379,386,300,430,902,7,B
901,CE,743,743,1129,830,1260,902,386,C
901,DE,169,169,1298,2940,4200,902,1129,D
901,E,11565,10267,11565,12705,12705,902,0,E
901,F,1270,1270,12835,180,12885,902,11565,F
901,G,174,174,13009,360,13245,902,12835,G
901,F,533,533,13542,330,13575,902,13009,F
901,G,864,864,14406,885,14460,902,13542,G
901,H,139,139,14545,2940,17400,902,14406,H
901,M,1696,1696,16241,1765,19165,902,14545,M
901,N,326,326,16567,300,19465,902,16241,N
901,O,683,683,17250,975,20440,902,16567,O
901,N,692,692,17942,385,20825,902,17250,N
901,O,368,368,18310,896,21721,902,17942,O
901,P,2411,2411,20721,3720,25441,902,18310,P
902,A,149,149,149,149,149,903,0,A
902,B,193,193,342,240,389,903,149,B
902,C,639,639,981,740,1129,903,342,C
902,D,48,48,1029,7030,8159,903,981,D
902,M,36,36,1065,1292,9451,903,1029,M
902,N,1437,1437,2502,240,9691,903,1065,N
902,O,181,181,2683,195,9886,903,2502,O
902,P,922,922,3605,5220,15106,903,2683,P
903,AEI,170,170,170,1208,1208,904,0,E
903,AFI,1072,1072,1242,90,1298,904,170,F
903,AGI,1005,1005,2247,1210,2508,904,1242,G
903,AHI,16,16,2263,3780,6288,904,2247,H
903,AI,13271,11008,13271,13664,13664,904,0,I
903,AJ,411,411,13682,90,13754,904,13271,J
903,AK,822,822,14504,1215,14969,904,13682,K
903,AL,256,256,14760,3780,18749,904,14504,L
903,A,19272,4512,19272,20219,20219,904,0,A
903,B,974,974,20246,90,20309,904,19272,B
903,C,1026,1026,21272,1220,21529,904,20246,C
903,D,75,75,21347,3780,25309,904,21272,D
903,M,644,644,21991,1365,26674,904,21347,M
903,N,776,776,22767,90,26764,904,21991,N
903,O,396,396,23163,800,27564,904,22767,O
903,P,1668,1668,24831,3780,31344,904,23163,P
904,A,162,162,162,472,472,905,0,A
904,B,337,337,499,90,562,905,162,B
904,C,875,875,1374,1240,1802,905,499,C
904,D,134,134,1508,3780,5582,905,1374,D
904,M,1832,1832,3340,2249,7831,905,1508,M
904,N,451,451,3791,90,7921,905,3340,N
904,O,954,954,4745,1285,9206,905,3791,O
904,P,1667,1667,6412,3780,12986,905,4745,P
905,AEI,199,199,199,561,561,906,0,I
905,AEJ,299,100,299,1049,1049,906,0,E
905,AFJ,570,271,570,1205,1205,906,0,A
905,BFJ,741,370,940,420,981,906,199,J
905,BFK,781,140,1080,90,1139,906,299,F
905,BGK,135,135,1215,535,1674,906,1080,G
905,BHK,663,18,1233,90,1295,906,570,B
905,CHK,152,152,1385,535,1830,906,1233,C
905,DHK,43,43,1428,3780,5610,906,1385,D
905,HK,995,507,1935,1114,2095,906,940,K
905,HL,1022,1022,2957,341,2436,906,1935,L
905,H,2851,1109,4066,3780,5454,906,1215,H
905,M,334,334,4400,263,5873,906,4066,M
905,N,54,54,4454,180,6053,906,4400,N
905,O,1140,1140,5594,965,7018,906,4454,O
905,P,820,820,6414,385,7403,906,5594,P
906,AE,80,80,80,692,692,907,0,E
906,AF,726,726,806,150,842,907,80,F
906,AG,269,269,1075,140,982,907,806,G
906,AF,1898,823,1898,1947,1947,907,0,A
906,BF,1785,962,2860,1910,2892,907,1075,F
906,BG,1420,458,3318,240,2187,907,1898,B
906,CG,699,241,3559,660,3552,907,2860,G
906,CH,1158,1158,4717,4230,7782,907,3559,H
906,C,1473,74,4791,1140,3327,907,3318,C
906,B,321,321,5112,1830,5157,907,4791,B
906,C,824,824,5936,1080,6237,907,5112,C
906,D,1421,1421,7357,3840,10077,907,5936,D
906,M,584,584,7941,938,11015,907,7357,M
906,N,474,474,8415,180,11195,907,7941,N
906,O,949,949,9364,930,12125,907,8415,O
906,P,5145,5145,14509,550,12675,907,9364,P
907,AE,149,149,149,1104,1104,908,0,A
907,BE,738,589,738,872,872,908,0,E
907,BF,323,323,1061,240,1112,908,738,F
907,BG,1075,163,1224,180,1284,908,149,B
907,CG,192,29,1253,375,1487,908,1061,G
907,CH,812,812,2065,5315,6802,908,1253,H
907,C,996,155,2220,1050,2334,908,1224,C
907,D,3038,3038,5258,5520,7854,908,2220,D
907,M,24,24,5282,179,8033,908,5258,M
907,N,243,243,5525,135,8168,908,5282,N
907,O,139,139,5664,280,8448,908,5525,O
907,P,831,831,6495,5160,13608,908,5664,P
908,AE,164,164,164,435,435,909,0,A
908,BE,183,19,183,340,340,909,0,E
908,BF,147,147,330,150,490,909,183,F
908,BG,128,128,458,690,1180,909,330,G
908,BH,396,102,560,185,620,909,164,B
908,CH,546,546,1106,525,1145,909,560,C
908,DH,728,80,1186,3600,4780,909,458,H
908,D,227,147,1333,2880,4025,909,1106,D
908,M,163,163,1496,951,5731,909,1333,M
908,N,964,964,2460,240,5971,909,1496,N
908,O,154,154,2614,295,6266,909,2460,O
908,N,1147,1147,3761,1000,7266,909,2614,N
908,O,253,253,4014,380,7646,909,3761,O
908,P,9141,9141,13155,5460,13106,909,4014,P
909,A,612,612,612,1030,1030,910,0,A
909,B,595,595,1207,180,1210,910,612,B
909,C,914,914,2121,910,2120,910,1207,C
909,D,4259,4259,6380,550,2670,910,2121,D
909,M,61,61,6441,733,3403,910,6380,M
909,N,1057,1057,7498,270,3673,910,6441,N
909,O,1005,1005,8503,1042,4715,910,7498,O
909,P,70,70,8573,333,5048,910,8503,P
910,AE,81,81,81,123,123,911,0,E
910,AF,94,13,94,561,561,911,0,A
910,BF,129,116,210,150,273,911,81,F
910,BG,167,167,377,455,728,911,210,G
910,BH,590,307,684,180,741,911,94,B
910,CH,460,460,1144,735,1476,911,684,C
910,DH,857,90,1234,3565,4293,911,377,H
910,D,108,18,1252,2880,4356,911,1144,D
910,M,89,89,1341,833,5189,911,1252,M
910,N,924,924,2265,240,5429,911,1341,N
910,O,493,493,2758,540,5969,911,2265,O
910,P,27012,27012,29770,2880,8849,911,2758,P
911,AE,2428,2428,2428,4590,4590,912,0,A
911,BE,2442,14,2442,4590,4590,912,0,E
911,BF,2247,2233,4675,90,4680,912,2428,B
911,BF,2233,0,4675,90,4680,912,2442,F
911,CG,705,705,5380,725,5405,912,4675,C
911,CG,705,0,5380,725,5405,912,4675,G
911,DH,4579,4579,9959,3780,9185,912,5380,D
911,H,4581,2,9961,3780,9185,912,5380,H
911,M,66,66,10027,271,9456,912,9961,M
911,N,431,431,10458,90,9546,912,10027,N
911,O,566,566,11024,1005,10551,912,10458,O
911,P,227,227,11251,3780,14331,912,11024,P
912,AEI,614,614,614,1041,1041,913,0,E
912,AFI,989,375,989,1229,1229,913,0,I
912,AFJ,470,95,1084,90,1131,913,614,F
912,AGJ,702,607,1691,90,1319,913,989,J
912,AGK,962,355,2046,1225,2356,913,1084,G
912,AHK,909,554,2600,1250,2569,913,1691,K
912,AHL,158,158,2758,3780,6349,913,2600,L
912,AH,3221,463,3221,4499,4499,913,0,A
912,BH,1310,1310,4531,90,4589,913,3221,B
912,CH,1246,1246,5777,1430,6019,913,4531,C
912,DH,382,382,6159,3780,9799,913,5777,D
912,H,58544,54431,60590,4505,6861,913,2046,H
912,M,4128,4128,64718,4875,14674,913,60590,M
912,N,807,807,65525,90,14764,913,64718,N
912,O,555,555,66080,920,15684,913,65525,O
912,P,573,573,66653,3780,19464,913,66080,P
913,A,34381,34381,34381,38053,38053,914,0,A
913,B,3702,3702,38083,90,38143,914,34381,B
913,C,916,916,38999,1220,39363,914,38083,C
913,D,4,4,39003,3780,43143,914,38999,D
913,M,1551,1551,40554,1788,44931,914,39003,M
913,N,265,265,40819,90,45021,914,40554,N
913,O,562,562,41381,805,45826,914,40819,O
913,P,4860,4860,46241,3780,49606,914,41381,P
914,AEI,86,86,86,169,169,915,0,I
914,AEJ,162,76,162,180,180,915,0,E
914,AFJ,248,86,248,955,955,915,0,A
914,BFJ,275,189,437,300,480,915,162,F
914,BGJ,361,10,447,300,469,915,86,J
914,BGK,642,632,1079,780,1260,915,437,G
914,BHK,647,15,1094,800,1269,915,447,K
914,BHL,973,127,1221,300,1255,915,248,B
914,CHL,166,24,1245,1140,2400,915,1079,H
914,CL,781,630,1875,1140,2409,915,1094,L
914,C,655,1,1876,910,2165,915,1221,C
914,B,276,276,2152,15,2180,915,1876,B
914,C,146,146,2298,380,2560,915,2152,C
914,D,1348,1348,3646,3960,6520,915,2298,D
914,M,4413,4413,8059,4665,11185,915,3646,M
914,N,247,247,8306,90,11275,915,8059,N
914,O,1403,1403,9709,1655,12930,915,8306,O
914,P,1139,1139,10848,3780,16710,915,9709,P
915,AEI,185,185,185,1820,1820,916,0,E
915,AFI,1222,1037,1222,1878,1878,916,0,I
915,AFJ,1549,327,1549,1900,1900,916,0,A
915,BFJ,690,363,1912,90,1968,916,1222,J
915,BFK,378,15,1927,90,1990,916,1549,B
915,CFK,1775,33,1960,90,1910,916,185,F
915,CGK,978,945,2905,1240,3230,916,1927,C
915,DGK,1431,486,3391,1780,3690,916,1960,G
915,DHK,1487,8,3399,1745,3713,916,1912,K
915,DHL,131,123,3522,3780,7470,916,3391,H
915,DL,409,286,3808,3780,7493,916,3399,L
915,D,1370,467,4275,3780,7010,916,2905,D
915,M,309,309,4584,1154,8647,916,4275,M
915,N,918,918,5502,90,8737,916,4584,N
915,O,1545,1545,7047,1750,10487,916,5502,O
915,P,334,334,7381,3780,14267,916,7047,P
916,A,74,74,74,164,164,917,0,A
916,B,202,202,276,135,299,917,74,B
916,C,584,584,860,390,689,917,276,C
916,D,1,1,861,6110,6799,917,860,D
916,M,53,53,914,85,6884,917,861,M
916,N,134,134,1048,150,7034,917,914,N
916,O,114,114,1162,110,7144,917,1048,O
916,N,1450,1450,2612,1425,8569,917,1162,N
916,O,1090,1090,3702,955,9524,917,2612,O
916,P,2291,2291,5993,4230,13754,917,3702,P
917,A,1640,1640,1640,1577,1577,918,0,A
917,B,177,177,1817,300,1877,918,1640,B
917,C,607,607,2424,775,2652,918,1817,C
917,D,9,9,2433,5320,7972,918,2424,D
917,M,4045,4045,6478,5397,13369,918,2433,M
917,N,1382,1382,7860,90,13459,918,6478,N
917,O,931,931,8791,1220,14679,918,7860,O
917,P,7,7,8798,3780,18459,918,8791,P
918,AE,1399,1399,1399,2567,2567,919,0,E
918,AF,1529,130,1529,2383,2383,919,0,A
918,BF,1041,1041,2570,240,2623,919,1529,B
918,CF,1323,152,2722,180,2747,919,1399,F
918,CG,678,678,3400,810,3557,919,2722,G
918,CH,935,105,3505,1040,3663,919,2570,C
918,BH,2910,2910,6415,2750,6413,919,3505,B
918,CH,1203,1203,7618,1260,7673,919,6415,C
918,DH,5028,810,8428,465,4022,919,3400,H
918,D,2422,1612,10040,3960,11633,919,7618,D
918,M,263,263,10303,791,12424,919,10040,M
918,N,632,632,10935,150,12574,919,10303,N
918,O,179,179,11114,140,12714,919,10935,O
918,N,287,287,11401,330,13044,919,11114,N
918,O,99,99,11500,245,13289,919,11401,O
918,P,1094,1094,12594,4110,17399,919,11500,P
919,AE,174,174,174,189,189,920,0,E
919,AF,153,153,327,180,369,920,174,F
919,AG,421,94,421,2999,2999,920,0,A
919,BG,120,26,447,200,569,920,327,G
919,BF,864,864,1311,780,1349,920,447,F
919,BG,173,173,1484,265,1614,920,1311,G
919,BH,1259,1259,2743,4140,5754,920,1484,H
919,B,2758,436,3179,240,3239,920,421,B
919,C,150,150,3329,385,3624,920,3179,C
919,D,1140,1140,4469,9760,13384,920,3329,D
919,M,3077,3077,7546,3812,17196,920,4469,M
919,N,833,833,8379,150,17346,920,7546,N
919,O,198,198,8577,180,17526,920,8379,O
919,N,354,354,8931,355,17881,920,8577,N
919,O,644,644,9575,775,18656,920,8931,O
919,P,481,481,10056,4230,22886,920,9575,P
920,AE,107,107,107,1482,1482,921,0,E
920,AF,157,50,157,590,590,921,0,A
920,BF,553,553,710,180,770,921,157,B
920,CF,737,737,1447,700,1470,921,710,C
920,BF,1679,339,1786,240,1722,921,107,F
920,BG,914,575,2361,940,2410,921,1447,B
920,CG,586,11,2372,695,2417,921,1786,G
920,CF,160,149,2521,205,2615,921,2361,C
920,DF,370,370,2891,5220,7835,921,2521,D
920,F,889,370,3261,940,3357,921,2372,F
920,G,464,464,3725,510,3867,921,3261,G
920,H,391,391,4116,3960,7827,921,3725,H
920,M,935,935,5051,878,8713,921,4116,M
920,N,123,123,5174,240,8953,921,5051,N
920,O,144,144,5318,380,9333,921,5174,O
920,P,3374,3374,8692,9700,19033,921,5318,P
921,AEI,43,43,43,113,113,922,0,I
921,AEJ,144,101,144,438,438,922,0,E
921,AFJ,299,155,299,535,535,922,0,A
921,BFJ,269,13,312,240,353,922,43,J
921,BFK,654,486,798,420,858,922,144,F
921,BGK,613,114,912,420,955,922,299,B
921,CGK,721,121,1033,970,1323,922,312,K
921,CGL,1035,800,1833,1070,1928,922,798,G
921,CHL,1052,131,1964,1069,2024,922,912,C
921,DHL,1559,628,2592,3960,5283,922,1033,L
921,DH,5156,4528,7120,356,2380,922,1964,D
921,H,5371,84,7204,355,2283,922,1833,H
921,M,5823,5823,13027,6665,11948,922,7204,M
921,N,1040,1040,14067,240,12188,922,13027,N
921,O,793,793,14860,1030,13218,922,14067,O
921,N,1570,1570,16430,1355,14573,922,14860,N
921,O,803,803,17233,1620,16193,922,16430,O
921,P,143,143,17376,3960,20153,922,17233,P
922,AE,682,682,682,1040,1040,923,0,E
922,AF,727,727,1409,420,1460,923,682,F
922,AG,1915,506,1915,2329,2329,923,0,A
922,BG,443,443,2358,90,2419,923,1915,B
922,CG,1139,190,2548,1240,2700,923,1409,G
922,CH,3,3,2551,335,3035,923,2548,H
922,C,542,349,2900,820,3239,923,2358,C
922,B,342,342,3242,60,3299,923,2900,B
922,C,345,345,3587,795,4094,923,3242,C
922,D,1465,1465,5052,3780,7874,923,3587,D
922,M,1240,1240,6292,1610,9484,923,5052,M
922,N,691,691,6983,300,9784,923,6292,N
922,O,1148,1148,8131,1045,10829,923,6983,O
922,P,999,999,9130,1140,11969,923,8131,P
923,A,1344,1344,1344,3043,3043,924,0,A
923,B,1749,1749,3093,90,3133,924,1344,B
923,C,1038,1038,4131,1340,4473,924,3093,C
923,B,1923,1923,6054,1635,6108,924,4131,B
923,C,980,980,7034,1280,7388,924,6054,C
923,D,495,495,7529,3780,11168,924,7034,D
923,M,4528,4528,12057,4901,16069,924,7529,M
923,N,398,398,12455,90,16159,924,12057,N
923,O,780,780,13235,1105,17264,924,12455,O
923,P,170,170,13405,3780,21044,924,13235,P
924,AEI,31,31,31,103,103,925,0,E
924,AFI,69,38,69,80,80,925,0,I
924,AFJ,111,111,180,135,215,925,69,J
924,AFK,166,17,197,135,238,925,31,F
924,AGK,206,9,206,195,195,925,0,A
924,BGK,192,166,372,295,510,925,180,K
924,BGL,176,10,382,240,435,925,206,B
924,CGL,215,30,412,295,533,925,197,G
924,CHL,134,94,506,5160,5670,925,372,L
924,CH,118,24,530,5160,5693,925,412,H
924,C,202,54,584,285,720,925,382,C
924,D,1668,1668,2252,5160,5880,925,584,D
924,M,9821,9821,12073,10734,16614,925,2252,M
924,N,940,940,13013,90,16704,925,12073,N
924,O,965,965,13978,1250,17954,925,13013,O
924,N,1612,1612,15590,1315,19269,925,13978,N
924,O,642,642,16232,890,20159,925,15590,O
924,P,1266,1266,17498,3780,23939,925,16232,P
925,AEI,136,136,136,940,940,926,0,A
925,BEI,154,18,154,299,299,926,0,I
925,BEJ,354,200,354,794,794,926,0,E
925,BFJ,265,65,419,90,389,926,154,J
925,BFK,541,476,895,150,944,926,354,F
925,BGK,888,129,1024,150,1090,926,136,B
925,CGK,630,25,1049,1005,1394,926,419,K
925,CGL,162,8,1057,170,1114,926,895,G
925,CHL,131,123,1180,3780,5174,926,1049,L
925,CH,456,300,1480,170,1260,926,1024,C
925,DH,1771,1348,2828,4200,5314,926,1057,H
925,D,1373,25,2853,2850,4110,926,1480,D
925,M,8697,8697,11550,10119,15433,926,2853,M
925,N,1452,1452,13002,90,15523,926,11550,N
925,O,878,878,13880,1255,16778,926,13002,O
925,P,19152,19152,33032,3780,20558,926,13880,P
926,AE,84,84,84,644,644,927,0,A
926,BE,155,71,155,255,255,927,0,E
926,BF,190,190,345,150,405,927,155,F
926,BG,671,410,755,150,794,927,84,B
926,CG,563,153,908,795,1200,927,345,G
926,CH,186,33,941,400,1194,927,755,C
926,DH,21,21,962,3920,5114,927,941,D
926,H,2795,2741,3703,2880,4080,927,908,H
926,M,59,59,3762,1217,6331,927,3703,M
926,N,1360,1360,5122,240,6571,927,3762,N
926,O,254,254,5376,345,6916,927,5122,O
926,P,9736,9736,15112,5220,12136,927,5376,P
927,AE,83,83,83,621,621,928,0,E
927,AF,105,22,105,377,377,928,0,A
927,BF,392,392,497,180,557,928,105,B
927,CF,631,217,714,150,771,928,83,F
927,CG,749,532,1246,855,1412,928,497,C
927,DG,817,285,1531,1015,1786,928,714,G
927,DH,2418,2133,3664,5310,6722,928,1246,D
927,H,2867,734,4398,5600,7386,928,1531,H
927,M,99,99,4497,673,8059,928,4398,M
927,N,759,759,5256,240,8299,928,4497,N
927,O,255,255,5511,300,8599,928,5256,O
927,P,521,521,6032,5100,13699,928,5511,P
928,AE,95,95,95,207,207,929,0,E
928,AF,264,264,359,180,387,929,95,F
928,AG,399,40,399,647,647,929,0,A
928,BG,135,95,494,150,537,929,359,G
928,BH,68,68,562,385,922,929,494,H
928,B,368,205,767,180,827,929,399,B
928,C,794,794,1561,765,1592,929,767,C
928,D,4432,4432,5993,550,2142,929,1561,D
928,M,424,424,6417,1310,3452,929,5993,M
928,N,1336,1336,7753,510,3962,929,6417,N
928,O,331,331,8084,925,4887,929,7753,O
928,P,8838,8838,16922,350,5237,929,8084,P
929,AE,441,441,441,861,861,930,0,E
929,AF,443,2,443,683,683,930,0,A
929,BF,522,520,963,150,1011,930,441,F
929,BG,660,140,1103,330,1013,930,443,B
929,CG,206,66,1169,410,1421,930,963,G
929,CF,407,407,1576,200,1621,930,1169,F
929,CG,775,302,1878,947,1960,930,1103,C
929,DG,214,214,2092,348,2308,930,1878,D
929,G,747,231,2323,720,2341,930,1576,G
929,H,1256,1256,3579,4170,6511,930,2323,H
929,M,1803,1803,5382,2332,8843,930,3579,M
929,N,666,666,6048,180,9023,930,5382,N
929,O,889,889,6937,900,9923,930,6048,O
929,P,3465,3465,10402,550,10473,930,6937,P
930,AE,810,810,810,1452,1452,931,0,E
930,AF,688,688,1498,90,1542,931,810,F
930,AG,340,340,1838,800,2342,931,1498,G
930,AH,878,878,2716,3780,6122,931,1838,H
930,A,4947,2231,4947,5763,5763,931,0,A
930,B,841,841,5788,90,5853,931,4947,B
930,C,1259,1259,7047,1480,7333,931,5788,C
930,B,1738,1738,8785,1510,8843,931,7047,B
930,C,351,351,9136,800,9643,931,8785,C
930,D,1708,1708,10844,3780,13423,931,9136,D
930,M,1190,1190,12034,1560,14983,931,10844,M
930,N,632,632,12666,300,15283,931,12034,N
930,O,939,939,13605,1045,16328,931,12666,O
930,P,175,175,13780,1140,17468,931,13605,P
931,A,531,531,531,1695,1695,932,0,A
931,B,1422,1422,1953,300,1995,932,531,B
931,C,738,738,2691,825,2820,932,1953,C
931,D,167,167,2858,2940,5760,932,2691,D
931,M,2750,2750,5608,2855,8615,932,2858,M
931,N,444,444,6052,395,9010,932,5608,N
931,O,644,644,6696,745,9755,932,6052,O
931,P,3327,3327,10023,1560,11315,932,6696,P
932,AE,46,46,46,107,107,933,0,A
932,BE,420,374,420,1652,1652,933,0,E
932,BF,418,44,464,240,347,933,46,B
932,CF,711,711,1175,970,1317,933,464,C
932,DF,1437,682,1857,240,1892,933,420,F
932,DG,1363,681,2538,3960,5277,933,1175,D
932,G,698,17,2555,970,2862,933,1857,G
932,H,137,137,2692,3960,6822,933,2555,H
932,M,2941,2941,5633,3725,10547,933,2692,M
932,N,974,974,6607,240,10787,933,5633,N
932,O,1642,1642,8249,1015,11802,933,6607,O
932,N,196,196,8445,820,12622,933,8249,N
932,O,287,287,8732,375,12997,933,8445,O
932,P,154,154,8886,4020,17017,933,8732,P
933,AE,173,173,173,878,878,934,0,A
933,BE,854,854,1027,180,1058,934,173,B
933,CE,1851,824,1851,2280,2280,934,0,E
933,CF,1217,393,2244,1050,2108,934,1027,C
933,DF,681,288,2532,300,2580,934,1851,F
933,DG,732,444,2976,6960,9068,934,2244,D
933,G,542,98,3074,710,3290,934,2532,G
933,H,1078,1078,4152,4080,7370,934,3074,H
933,M,2988,2988,7140,3134,12202,934,4152,M
933,N,425,425,7565,300,12502,934,7140,N
933,O,497,497,8062,2071,14573,934,7565,O
933,P,1596,1596,9658,2625,17198,934,8062,P
934,A,317,317,317,917,917,935,0,A
934,B,712,712,1029,150,1067,935,317,B
934,C,214,214,1243,410,1477,935,1029,C
934,B,394,394,1637,200,1677,935,1243,B
934,C,725,725,2362,720,2397,935,1637,C
934,D,1093,1093,3455,4170,6567,935,2362,D
934,M,3327,3327,6782,3480,10047,935,3455,M
934,N,193,193,6975,90,10137,935,6782,N
934,O,444,444,7419,800,10937,935,6975,O
934,N,659,659,8078,310,11247,935,7419,N
934,O,207,207,8285,585,11832,935,8078,O
934,P,2435,2435,10720,3780,15612,935,8285,P
935,AEI,4,4,4,112,112,936,0,A
935,BEI,185,181,185,2489,2489,936,0,I
935,BEJ,193,8,193,1094,1094,936,0,E
935,BFJ,344,155,348,300,412,936,4,B
935,CFJ,578,578,926,820,1232,936,348,C
935,BFJ,1021,288,1214,180,1274,936,193,F
935,BGJ,894,894,2108,1050,2324,936,1214,G
935,BFJ,1219,37,2145,995,2227,936,926,B
935,CFJ,130,130,2275,240,2467,936,2145,C
935,DFJ,19,19,2294,5040,7507,936,2275,D
935,FJ,2424,315,2609,180,2669,936,185,J
935,FK,840,339,2948,700,3024,936,2108,F
935,GK,205,205,3153,240,3264,936,2948,G
935,HK,16,16,3169,5160,8424,936,3153,H
935,K,1104,544,3713,1050,3719,936,2609,K
935,J,518,518,4231,550,4269,936,3713,J
935,K,154,154,4385,240,4509,936,4231,K
935,L,49,49,4434,5040,9549,936,4385,L
935,M,108,108,4542,225,9774,936,4434,M
935,N,177,177,4719,120,9894,936,4542,N
935,O,141,141,4860,120,10014,936,4719,O
935,N,3555,3555,8415,3550,13564,936,4860,N
935,O,184,184,8599,265,13829,936,8415,O
935,P,159,159,8758,5100,18929,936,8599,P
936,AE,281,281,281,1398,1398,937,0,A
936,BE,1147,1147,1428,90,1488,937,281,B
936,CE,979,979,2407,1210,2698,937,1428,C
936,DE,30,30,2437,3780,6478,937,2407,D
936,E,5982,3545,5982,7407,7407,937,0,E
936,F,1496,1496,7478,90,7497,937,5982,F
936,G,1233,1233,8711,1365,8862,937,7478,G
936,H,7741,7741,16452,3780,12642,937,8711,H
936,M,2288,2288,18740,2816,15458,937,16452,M
936,N,560,560,19300,90,15548,937,18740,N
936,O,422,422,19722,765,16313,937,19300,O
936,P,1234,1234,20956,3780,20093,937,19722,P
937,AEI,38,38,38,116,116,938,0,E
937,AFI,160,122,160,182,182,938,0,A
937,BFI,168,46,206,150,266,938,38,F
937,BGI,247,41,247,1114,1114,938,0,I
937,BGJ,117,30,277,150,332,938,160,B
937,CGJ,202,131,408,455,721,938,206,G
937,CHJ,190,59,467,455,787,938,277,C
937,DHJ,987,767,1234,180,1294,938,247,J
937,DHK,862,36,1270,3565,4286,938,408,H
937,DK,850,47,1317,3565,4352,938,467,D
937,K,999,916,2233,1050,2344,938,1234,K
937,L,4496,4496,6729,5400,7744,938,2233,L
937,M,150,150,6879,187,7931,938,6729,M
937,N,149,149,7028,135,8066,938,6879,N
937,O,365,365,7393,290,8356,938,7028,O
937,P,17,17,7410,5160,13516,938,7393,P
938,AEI,167,167,167,354,354,939,0,I
938,AEJ,381,214,381,1441,1441,939,0,E
938,AFJ,327,113,494,90,444,939,167,J
938,AFK,1123,1010,1504,90,1531,939,381,F
938,AGK,1416,406,1910,1780,2224,939,494,K
938,AGL,14,14,1924,3780,6004,939,1910,L
938,AG,945,525,2449,1200,2731,939,1504,G
938,AH,2533,84,2533,2734,2734,939,0,A
938,BH,245,245,2778,90,2824,939,2533,B
938,CH,626,297,3075,3780,6511,939,2449,H
938,C,730,433,3508,1130,3954,939,2778,C
938,D,592,592,4100,3780,7734,939,3508,D
938,M,1685,1685,5785,2202,9936,939,4100,M
938,N,562,562,6347,90,10026,939,5785,N
938,O,1023,1023,7370,1240,11266,939,6347,O
938,P,2748,2748,10118,3780,15046,939,7370,P
939,AE,716,716,716,959,959,940,0,A
939,BE,457,457,1173,240,1199,940,716,B
939,CE,1166,1166,2339,1245,2444,940,1173,C
939,DE,5708,3369,5708,5945,5945,940,0,E
939,DF,327,327,6035,120,6065,940,5708,F
939,DG,9,9,6044,120,6185,940,6035,G
939,DF,245,245,6289,165,6350,940,6044,F
939,DG,4495,545,6834,3670,6114,940,2339,D
939,G,715,170,7004,820,7170,940,6289,G
939,H,54,54,7058,5040,12210,940,7004,H
939,M,322,322,7380,662,12872,940,7058,M
939,N,550,550,7930,240,13112,940,7380,N
939,O,884,884,8814,970,14082,940,7930,O
939,N,1219,1219,10033,1130,15212,940,8814,N
939,O,748,748,10781,925,16137,940,10033,O
939,P,78786,78786,89567,3960,20097,940,10781,P
940,AEI,648,648,648,1274,1274,941,0,I
940,AEJ,836,836,1484,240,1514,941,648,J
940,AEK,1208,1208,2692,1245,2759,941,1484,K
940,AEL,3160,468,3160,4132,4132,941,0,E
940,AFL,2068,2068,5228,1140,5272,941,3160,F
940,AGL,1000,1000,6228,985,6257,941,5228,G
940,AFL,4534,998,7226,3670,6429,941,2692,L
940,AF,4659,3661,10887,4445,10702,941,6228,F
940,AG,733,733,11620,1382,12084,941,10887,G
940,AH,846,846,12466,713,12797,941,11620,H
940,A,42374,29908,42374,42824,42824,941,0,A
940,B,691,691,43065,270,43094,941,42374,B
940,C,773,773,43838,878,43972,941,43065,C
940,D,1162,1162,45000,1217,45189,941,43838,D
940,M,1633,1633,46633,1848,47037,941,45000,M
940,N,410,410,47043,240,47277,941,46633,N
940,O,761,761,47804,970,48247,941,47043,O
940,N,885,885,48689,750,48997,941,47804,N
940,O,343,343,49032,660,49657,941,48689,O
940,P,4325,4325,53357,4020,53677,941,49032,P
941,AEI,287,287,287,434,434,942,0,I
941,AEJ,502,502,789,420,854,942,287,J
941,AEK,1127,1127,1916,1309,2163,942,789,K
941,AEL,2842,926,2842,3041,3041,942,0,A
941,BEL,2931,89,2931,3416,3416,942,0,E
941,BFL,577,488,3419,420,3461,942,2842,B
941,CFL,853,365,3784,420,3836,942,2931,F
941,CGL,839,474,4258,1079,4540,942,3419,C
941,DGL,902,428,4686,1069,4905,942,3784,G
941,DHL,5003,4575,9261,356,4896,942,4258,D
941,HL,7919,574,9835,356,2519,942,1916,L
941,H,6323,1174,11009,356,5261,942,4686,H
941,M,4561,4561,15570,5468,10729,942,11009,M
941,N,1001,1001,16571,150,10879,942,15570,N
941,O,800,800,17371,1030,11909,942,16571,O
941,N,267,267,17638,30,11939,942,17371,N
941,O,539,539,18177,120,12059,942,17638,O
941,P,317,317,18494,4230,16289,942,18177,P
942,AE,40,40,40,2425,2425,943,0,E
942,AF,279,239,279,1529,1529,943,0,A
942,BF,1440,1440,1719,240,1769,943,279,B
942,CF,524,524,2243,765,2534,943,1719,C
942,DF,2505,302,2545,165,2590,943,40,F
942,DG,324,22,2567,9700,12234,943,2243,D
942,G,743,721,3288,1035,3625,943,2545,G
942,H,151,151,3439,3960,7585,943,3288,H
942,M,655,655,4094,1667,13901,943,3439,M
942,N,1127,1127,5221,150,14051,943,4094,N
942,O,739,739,5960,700,14751,943,5221,O
942,N,856,856,6816,895,15646,943,5960,N
942,O,405,405,7221,230,15876,943,6816,O
942,P,4039,4039,11260,4230,20106,943,7221,P
943,AEI,521,521,521,1806,1806,944,0,E
943,AFI,1083,562,1083,1423,1423,944,0,A
943,BFI,378,378,1461,90,1513,944,1083,B
943,CFI,1690,229,1690,5866,5866,944,0,I
943,CFJ,1310,141,1831,90,1896,944,521,F
943,CGJ,472,102,1933,805,2318,944,1461,C
943,BGJ,1685,1583,3516,1940,3836,944,1831,G
943,BFJ,2076,493,4009,1740,4058,944,1933,B
943,CFJ,722,229,4238,435,4271,944,3516,F
943,CGJ,818,589,4827,1060,5118,944,4009,C
943,DGJ,176,176,5003,3780,8898,944,4827,D
943,GJ,850,85,5088,1080,5351,944,4238,G
943,HJ,4210,812,5900,90,5956,944,1690,J
943,HK,904,904,6804,1240,7196,944,5900,K
943,HJ,2465,749,7553,3780,9131,944,5088,H
943,J,2380,1631,9184,2035,9231,944,6804,J
943,K,745,745,9929,1080,10311,944,9184,K
943,L,135,135,10064,3780,14091,944,9929,L
943,M,976,976,11040,1076,15167,944,10064,M
943,N,124,124,11164,90,15257,944,11040,N
943,O,732,732,11896,1130,16387,944,11164,O
943,P,618,618,12514,3780,20167,944,11896,P
944,AE,31,31,31,83,83,945,0,E
944,AF,151,120,151,238,238,945,0,A
944,BF,142,22,173,150,233,945,31,F
944,BG,146,146,319,400,633,945,173,G
944,BH,169,1,320,150,388,945,151,B
944,CH,141,141,461,410,798,945,320,C
944,DH,459,317,778,3080,3713,945,319,H
944,D,3435,3118,3896,3135,3933,945,461,D
944,M,62,62,3958,659,4592,945,3896,M
944,N,779,779,4737,240,4832,945,3958,N
944,O,275,275,5012,385,5217,945,4737,O
944,P,217,217,5229,5460,10677,945,5012,P
945,A,116,116,116,180,180,946,0,A
945,B,151,151,267,150,330,946,116,B
945,C,198,198,465,455,785,946,267,C
945,D,849,849,1314,3565,4350,946,465,D
945,M,35,35,1349,43,4393,946,1314,M
945,N,93,93,1442,135,4528,946,1349,N
945,O,195,195,1637,295,4823,946,1442,O
945,P,100,100,1737,5160,9983,946,1637,P
946,A,385,385,385,410,410,947,0,A
946,B,145,145,530,180,590,947,385,B
946,C,1150,1150,1680,1590,2180,947,530,C
946,B,2484,2484,4164,2015,4195,947,1680,B
946,C,921,921,5085,1240,5435,947,4164,C
946,D,1381,1381,6466,335,5770,947,5085,D
946,M,2061,2061,8527,2279,8049,947,6466,M
946,N,267,267,8794,90,8139,947,8527,N
946,O,468,468,9262,795,8934,947,8794,O
946,N,1491,1491,10753,460,9394,947,9262,N
946,O,1344,1344,12097,1885,11279,947,10753,O
946,P,814,814,12911,3780,15059,947,12097,P
947,AE,1795,1795,1795,2138,2138,948,0,A
947,BE,1886,91,1886,2064,2064,948,0,E
947,BF,438,438,2324,300,2364,948,1886,F
947,BG,537,8,2332,240,2378,948,1795,B
947,CG,824,824,3156,970,3348,948,2332,C
947,BG,951,119,3275,1070,3434,948,2324,G
947,BF,321,202,3477,210,3558,948,3156,B
947,CF,651,449,3926,505,3939,948,3275,F
947,CG,824,375,4301,1620,5178,948,3477,C
947,DG,318,318,4619,3960,9138,948,4301,D
947,G,2051,1358,5977,2025,5964,948,3926,G
947,H,322,322,6299,2310,8274,948,5977,H
947,M,175,175,6474,747,9885,948,6299,M
947,N,763,763,7237,240,10125,948,6474,N
947,O,133,133,7370,385,10510,948,7237,O
947,N,520,520,7890,270,10780,948,7370,N
947,O,671,671,8561,875,11655,948,7890,O
947,P,3933,3933,12494,3960,15615,948,8561,P
948,A,486,486,486,1197,1197,949,0,A
948,B,904,904,1390,240,1437,949,486,B
948,C,811,811,2201,1045,2482,949,1390,C
948,D,688,688,2889,3960,6442,949,2201,D
948,M,1483,1483,4372,2181,8623,949,2889,M
948,N,767,767,5139,90,8713,949,4372,N
948,O,1227,1227,6366,1440,10153,949,5139,O
948,P,1085,1085,7451,3780,13933,949,6366,P
949,AEI,60,60,60,45,45,950,0,E
949,AFI,87,27,87,187,187,950,0,A
949,BFI,208,121,208,1770,1770,950,0,I
949,BFJ,160,12,220,180,225,950,60,F
949,BGJ,248,248,468,545,770,950,220,G
949,BHJ,422,41,509,240,427,950,87,B
949,CHJ,789,789,1298,985,1412,950,509,C
949,DHJ,1441,611,1909,5400,6170,950,468,H
949,DJ,1739,38,1947,240,2010,950,208,J
949,DK,733,733,2680,975,2985,950,1947,K
949,DL,2075,693,3373,5040,6452,950,1298,D
949,L,884,191,3564,5040,8025,950,2680,L
949,M,33546,33546,37110,35758,43783,950,3564,M
949,N,2242,2242,39352,90,43873,950,37110,N
949,O,997,997,40349,1210,45083,950,39352,O
949,N,879,879,41228,640,45723,950,40349,N
949,O,829,829,42057,945,46668,950,41228,O
949,P,1277,1277,43334,3780,50448,950,42057,P
950,AEI,22,22,22,862,862,951,0,A
950,BEI,268,246,268,328,328,951,0,E
950,BFI,143,143,411,270,598,951,268,F
950,BGI,1037,648,1059,240,1102,951,22,B
950,CGI,1773,714,1773,1798,1798,951,0,I
950,CGJ,737,23,1796,970,2072,951,1059,C
950,DGJ,109,109,1905,3960,6032,951,1796,D
950,GJ,429,297,2202,420,2218,951,1773,J
950,GK,771,771,2973,1069,3287,951,2202,K
950,GL,2919,357,3330,2910,3508,951,411,G
950,FL,1758,1758,5088,1645,5153,951,3330,F
950,GL,1072,1072,6160,1309,6462,951,5088,G
950,HL,5291,2104,8264,356,3643,951,2973,L
950,H,2660,556,8820,356,6818,951,6160,H
950,M,361,361,9181,1094,7912,951,8820,M
950,N,940,940,10121,240,8152,951,9181,N
950,O,1436,1436,11557,1030,9182,951,10121,O
950,P,855,855,12412,3960,13142,951,11557,P
951,A,298,298,298,507,507,952,0,A
951,B,1217,1217,1515,1105,1612,952,298,B
951,C,926,926,2441,880,2492,952,1515,C
951,D,474,474,2915,5160,7652,952,2441,D
951,M,84,84,2999,191,7843,952,2915,M
951,N,289,289,3288,240,8083,952,2999,N
951,O,170,170,3458,285,8368,952,3288,O
951,P,1630,1630,5088,5160,13528,952,3458,P
952,A,1154,1154,1154,1642,1642,953,0,A
952,B,693,693,1847,240,1882,953,1154,B
952,C,1415,1415,3262,740,2622,953,1847,C
952,D,400,400,3662,3960,6582,953,3262,D
952,M,127,127,3789,162,6744,953,3662,M
952,N,142,142,3931,150,6894,953,3789,N
952,O,633,633,4564,765,7659,953,3931,O
952,P,1,1,4565,3600,11259,953,4564,P
953,AE,201,201,201,196,196,954,0,A
953,BE,90,90,291,150,346,954,201,B
953,CE,146,146,437,140,486,954,291,C
953,BE,910,910,1347,900,1386,954,437,B
953,CE,1628,281,1628,2130,2130,954,0,E
953,CF,348,67,1695,650,2036,954,1347,C
953,DF,542,475,2170,90,2220,954,1628,F
953,DG,1434,1434,3604,2315,4535,954,2170,G
953,DH,1202,1202,4806,3420,7955,954,3604,H
953,D,4702,1591,6397,4230,6266,954,1695,D
953,M,142,142,6539,479,8434,954,6397,M
953,N,465,465,7004,180,8614,954,6539,N
953,O,1114,1114,8118,885,9499,954,7004,O
953,P,537,537,8655,660,10159,954,8118,P
954,AE,39,39,39,20,20,955,0,E
954,AF,71,71,110,150,170,955,39,F
954,AG,223,113,223,854,854,955,0,A
954,BG,149,36,259,135,305,955,110,G
954,BH,677,677,936,2880,3185,955,259,H
954,B,781,68,1004,210,1064,955,223,B
954,C,941,941,1945,1000,2064,955,1004,C
954,D,2006,2006,3951,5165,7229,955,1945,D
954,M,216,216,4167,1391,8620,955,3951,M
954,N,1358,1358,5525,240,8860,955,4167,N
954,O,199,199,5724,260,9120,955,5525,O
954,P,1472,1472,7196,5340,14460,955,5724,P
955,AE,7,7,7,355,355,956,0,E
955,AF,579,579,586,300,655,956,7,F
955,AG,1037,451,1037,1453,1453,956,0,A
955,BG,678,227,1264,820,1475,956,586,G
955,BH,53,53,1317,5315,6790,956,1264,H
955,B,648,368,1685,300,1753,956,1037,B
955,C,760,760,2445,825,2578,956,1685,C
955,D,17,17,2462,5430,8008,956,2445,D
955,M,48,48,2510,244,8252,956,2462,M
955,N,348,348,2858,165,8417,956,2510,N
955,O,626,626,3484,910,9327,956,2858,O
955,P,246,246,3730,3960,13287,956,3484,P
956,AE,2213,2213,2213,2360,2360,957,0,E
956,AF,221,221,2434,90,2450,957,2213,F
956,AG,616,616,3050,790,3240,957,2434,G
956,AF,3693,643,3693,3822,3822,957,0,A
956,BF,159,159,3852,90,3912,957,3693,B
956,CF,1058,256,4108,325,3565,957,3050,F
956,CG,445,189,4297,795,4707,957,3852,C
956,BG,1381,1192,5489,1885,5450,957,4108,G
956,BH,1229,37,5526,425,5132,957,4297,B
956,CH,1341,1341,6867,1885,7017,957,5526,C
956,DH,2348,2348,9215,3780,10797,957,6867,D
956,H,7095,3369,12584,3780,9230,957,5489,H
956,M,360,360,12944,1335,12132,957,12584,M
956,N,1234,1234,14178,300,12432,957,12944,N
956,O,640,640,14818,805,13237,957,14178,O
956,P,1514,1514,16332,2940,16177,957,14818,P
957,AE,82,82,82,718,718,958,0,E
957,AF,188,106,188,788,788,958,0,A
957,BF,730,624,812,150,868,958,82,F
957,BG,712,88,900,150,938,958,188,B
957,CG,142,54,954,130,998,958,812,G
957,CF,210,156,1110,130,1068,958,900,C
957,BF,257,101,1211,250,1248,958,954,F
957,BG,649,649,1860,610,1858,958,1211,G
957,BH,1616,866,2726,1690,2758,958,1110,B
957,CH,698,698,3424,610,3368,958,2726,C
957,DH,1020,1020,4444,4230,7598,958,3424,D
957,H,4193,1609,6053,4230,6088,958,1860,H
957,M,125,125,6178,227,7825,958,6053,M
957,N,292,292,6470,240,8065,958,6178,N
957,O,748,748,7218,860,8925,958,6470,O
957,N,1925,1925,9143,1775,10700,958,7218,N
957,O,529,529,9672,900,11600,958,9143,O
957,P,336,336,10008,3960,15560,958,9672,P
958,A,83,83,83,95,95,959,0,A
958,B,104,104,187,150,245,959,83,B
958,C,129,129,316,400,645,959,187,C
958,B,1552,1552,1868,1265,1910,959,316,B
958,C,808,808,2676,765,2675,959,1868,C
958,D,98,98,2774,4230,6905,959,2676,D
958,M,519,519,3293,1005,7910,959,2774,M
958,N,521,521,3814,90,8000,959,3293,N
958,O,642,642,4456,970,8970,959,3814,O
958,P,529,529,4985,3780,12750,959,4456,P
959,AEI,63,63,63,172,172,960,0,E
959,AFI,117,54,117,85,85,960,0,A
959,BFI,89,89,206,180,265,960,117,B
959,CFI,154,11,217,90,262,960,63,F
959,CGI,190,179,396,140,405,960,206,C
959,DGI,398,2,398,438,438,960,0,I
959,DGJ,9,7,405,2880,3285,960,396,D
959,GJ,303,115,520,575,837,960,217,G
959,FJ,163,41,561,180,618,960,398,J
959,FK,654,654,1215,865,1483,960,561,K
959,FJ,580,580,1795,370,1853,960,1215,J
959,FK,141,141,1936,290,2143,960,1795,K
959,FL,1451,35,1971,1170,2007,960,520,F
959,GL,853,853,2824,1240,3247,960,1971,G
959,HL,636,636,3460,3780,7027,960,2824,H
959,L,2151,627,4087,5100,7243,960,1936,L
959,M,296,296,4383,740,7983,960,4087,M
959,N,635,635,5018,240,8223,960,4383,N
959,O,122,122,5140,385,8608,960,5018,O
959,N,801,801,5941,510,9118,960,5140,N
959,O,1024,1024,6965,1225,10343,960,5941,O
959,P,3721,3721,10686,3960,14303,960,6965,P
960,A,331,331,331,506,506,961,0,A
960,B,275,275,606,150,656,961,331,B
960,C,591,591,1197,620,1276,961,606,C
960,D,666,666,1863,4200,5476,961,1197,D
960,M,913,913,2776,1901,7377,961,1863,M
960,N,1018,1018,3794,90,7467,961,2776,N
960,O,645,645,4439,1130,8597,961,3794,O
960,P,10203,10203,14642,3780,12377,961,4439,P
961,A,281,281,281,820,820,962,0,A
961,B,793,793,1074,300,1120,962,281,B
961,C,607,607,1681,760,1880,962,1074,C
961,D,1039,1039,2720,3960,5840,962,1681,D
961,M,1372,1372,4092,1383,7223,962,2720,M
961,N,217,217,4309,240,7463,962,4092,N
961,O,584,584,4893,740,8203,962,4309,O
961,N,1486,1486,6379,1345,9548,962,4893,N
961,O,264,264,6643,535,10083,962,6379,O
961,P,12940,12940,19583,2880,12963,962,6643,P
962,A,2909,2909,2909,3217,3217,963,0,A
962,B,341,341,3250,90,3307,963,2909,B
962,C,508,508,3758,820,4127,963,3250,C
962,B,348,348,4106,45,4172,963,3758,B
962,C,956,956,5062,1470,5642,963,4106,C
962,D,2777,2777,7839,3780,9422,963,5062,D
962,M,3263,3263,11102,3466,12888,963,7839,M
962,N,400,400,11502,90,12978,963,11102,N
962,O,1545,1545,13047,1910,14888,963,11502,O
962,N,1415,1415,14462,1215,16103,963,13047,N
962,O,558,558,15020,805,16908,963,14462,O
962,P,13500,13500,28520,3780,20688,963,15020,P
963,AE,30,30,30,70,70,964,0,A
963,BE,144,144,174,150,220,964,30,B
963,CE,192,18,192,210,210,964,0,E
963,CF,123,105,297,830,1050,964,174,C
963,DF,112,7,304,150,360,964,192,F
963,DG,135,135,439,830,1190,964,304,G
963,DH,154,12,451,3490,4540,964,297,D
963,H,886,874,1325,3490,4680,964,439,H
963,M,33,33,1358,30,4710,964,1325,M
963,N,91,91,1449,155,4865,964,1358,N
963,O,66,66,1515,90,4955,964,1449,O
963,P,8,8,1523,3380,8335,964,1515,P
964,AE,97,97,97,79,79,965,0,A
964,BE,74,74,171,150,229,965,97,B
964,CE,142,142,313,130,359,965,171,C
964,BE,1060,1060,1373,955,1314,965,313,B
964,CE,1388,15,1388,1669,1669,965,0,E
964,CF,480,480,1868,240,1909,965,1388,F
964,CG,655,160,2028,590,1904,965,1373,C
964,DG,582,422,2450,620,2529,965,1868,G
964,DH,1552,1130,3580,4140,6044,965,2028,D
964,H,4191,3061,6641,6300,8829,965,2450,H
964,M,468,468,7109,416,9245,965,6641,M
964,N,158,158,7267,270,9515,965,7109,N
964,O,628,628,7895,445,9960,965,7267,O
964,N,912,912,8807,1095,11055,965,7895,N
964,O,184,184,8991,268,11323,965,8807,O
964,P,5776,5776,14767,347,11670,965,8991,P
965,A,426,426,426,1012,1012,966,0,A
965,B,779,779,1205,240,1252,966,426,B
965,C,229,229,1434,445,1697,966,1205,C
965,D,24,24,1458,5160,6857,966,1434,D
965,M,84,84,1542,1104,7961,966,1458,M
965,N,1202,1202,2744,240,8201,966,1542,N
965,O,779,779,3523,780,8981,966,2744,O
965,P,831,831,4354,7680,16661,966,3523,P
966,AE,140,140,140,193,193,967,0,E
966,AF,164,164,304,180,373,967,140,F
966,AG,380,76,380,733,733,967,0,A
966,BG,373,373,753,90,823,967,380,B
966,CG,729,280,1033,975,1348,967,304,G
966,CH,565,285,1318,950,1773,967,753,C
966,BH,795,510,1828,3495,4843,967,1033,H
966,B,1093,583,2411,685,2458,967,1318,B
966,C,925,925,3336,1240,3698,967,2411,C
966,D,2689,2689,6025,3780,7478,967,3336,D
966,M,55,55,6080,232,7710,967,6025,M
966,N,360,360,6440,240,7950,967,6080,N
966,O,226,226,6666,285,8235,967,6440,O
966,P,1463,1463,8129,5160,13395,967,6666,P
967,AEI,187,187,187,1097,1097,968,0,E
967,AFI,480,293,480,1006,1006,968,0,A
967,BFI,619,619,1099,150,1156,968,480,B
967,CFI,1030,118,1217,180,1277,968,187,F
967,CGI,134,16,1233,400,1556,968,1099,C
967,DGI,1458,225,1458,1495,1495,968,0,I
967,DGJ,277,277,1735,300,1795,968,1458,J
967,DGK,973,455,2190,1055,2332,968,1217,G
967,DHK,648,193,2383,770,2565,968,1735,K
967,DHL,15,15,2398,5325,7890,968,2383,L
967,DH,733,525,2923,6460,8792,968,2190,H
967,D,2765,1075,3998,2880,4436,968,1233,D
967,M,43,43,4041,30,8822,968,3998,M
967,N,169,169,4210,240,9062,968,4041,N
967,O,157,157,4367,285,9347,968,4210,O
967,P,550,550,4917,5160,14507,968,4367,P
968,AE,61,61,61,1033,1033,969,0,A
968,BE,67,6,67,1064,1064,969,0,E
968,BF,1153,1147,1214,240,1273,969,61,B
968,CF,1182,35,1249,240,1304,969,67,F
968,CG,458,423,1672,750,2023,969,1214,C
968,DG,476,53,1725,760,2064,969,1249,G
968,DH,2074,2074,3799,3540,5604,969,1725,H
968,D,3519,1392,5191,3540,5563,969,1672,D
968,M,735,735,5926,1289,6893,969,5191,M
968,N,584,584,6510,90,6983,969,5926,N
968,O,488,488,6998,820,7803,969,6510,O
968,N,844,844,7842,510,8313,969,6998,N
968,O,383,383,8225,765,9078,969,7842,O
968,P,233,233,8458,3780,12858,969,8225,P
969,AE,49,49,49,1134,1134,970,0,E
969,AF,50,1,50,244,244,970,0,A
969,BF,368,368,418,165,409,970,50,B
969,CF,622,622,1040,910,1319,970,418,C
969,DF,1205,214,1254,165,1299,970,49,F
969,DG,1011,1011,2265,1275,2574,970,1254,G
969,DH,1346,121,2386,3960,5279,970,1040,D
969,H,847,726,3112,3960,6534,970,2265,H
969,M,2443,2443,5555,2676,9210,970,3112,M
969,N,345,345,5900,150,9360,970,5555,N
969,O,696,696,6596,700,10060,970,5900,O
969,N,1094,1094,7690,1095,11155,970,6596,N
969,O,623,623,8313,690,11845,970,7690,O
969,P,1333,1333,9646,4230,16075,970,8313,P
970,A,588,588,588,890,890,971,0,A
970,B,482,482,1070,240,1130,971,588,B
970,C,887,887,1957,1020,2150,971,1070,C
970,B,1064,1064,3021,905,3055,971,1957,B
970,C,1128,1128,4149,1240,4295,971,3021,C
970,D,213,213,4362,335,4630,971,4149,D
970,M,2087,2087,6449,2180,6810,971,4362,M
970,N,118,118,6567,90,6900,971,6449,N
970,O,630,630,7197,820,7720,971,6567,O
970,N,426,426,7623,230,7950,971,7197,N
970,O,210,210,7833,605,8555,971,7623,O
970,P,2633,2633,10466,3780,12335,971,7833,P
971,AEI,39,39,39,121,121,972,0,A
971,BEI,87,48,87,154,154,972,0,E
971,BFI,174,126,213,150,271,972,39,B
971,CFI,231,18,231,1080,1080,972,0,I
971,CFJ,162,18,249,150,304,972,87,F
971,CGJ,177,141,390,455,726,972,213,C
971,DGJ,190,49,439,455,759,972,249,G
971,DHJ,969,761,1200,180,1260,972,231,J
971,DHK,851,90,1290,3565,4324,972,439,H
971,DK,902,2,1292,3565,4291,972,390,D
971,K,991,899,2191,1050,2310,972,1200,K
971,L,2305,2305,4496,5160,7470,972,2191,L
971,M,45,45,4541,460,7930,972,4496,M
971,N,597,597,5138,240,8170,972,4541,N
971,O,192,192,5330,255,8425,972,5138,O
971,P,263,263,5593,5160,13585,972,5330,P
972,AEI,149,149,149,179,179,973,0,E
972,AFI,125,125,274,150,329,973,149,F
972,AGI,123,123,397,160,489,973,274,G
972,AHI,827,827,1224,4200,4689,973,397,H
972,AI,1326,102,1326,1942,1942,973,0,I
972,AJ,1588,262,1588,2767,2767,973,0,A
972,BJ,669,407,1995,90,2032,973,1326,J
972,BK,1390,983,2978,240,3007,973,1588,B
972,CK,1112,129,3107,1310,3342,973,1995,K
972,CL,170,170,3277,3780,7122,973,3107,L
972,C,960,661,3938,850,3857,973,2978,C
972,D,240,240,4178,3960,7817,973,3938,D
972,M,266,266,4444,905,8722,973,4178,M
972,N,834,834,5278,240,8962,973,4444,N
972,O,711,711,5989,960,9922,973,5278,O
972,P,1256,1256,7245,4020,13942,973,5989,P
973,A,509,509,509,761,761,974,0,A
973,B,372,372,881,180,941,974,509,B
973,C,147,147,1028,265,1206,974,881,C
973,D,1415,1415,2443,5425,6631,974,1028,D
973,M,85,85,2528,1009,7640,974,2443,M
973,N,998,998,3526,135,7775,974,2528,N
973,O,655,655,4181,665,8440,974,3526,O
973,P,13303,13303,17484,5370,13810,974,4181,P
974,AEI,282,282,282,1747,1747,975,0,A
974,BEI,1193,911,1193,1485,1485,975,0,I
974,BEJ,518,518,1711,90,1575,975,1193,J
974,BEK,1495,66,1777,90,1837,975,282,B
974,CEK,650,584,2361,1060,2635,975,1711,K
974,CEL,5,5,2366,3780,6415,975,2361,L
974,CE,1236,647,3013,1420,3257,975,1777,C
974,DE,241,241,3254,3780,7037,975,3013,D
974,E,15736,12482,15736,16447,16447,975,0,E
974,F,749,749,16485,90,16537,975,15736,F
974,G,375,375,16860,795,17332,975,16485,G
974,H,455,455,17315,3780,21112,975,16860,H
974,M,512,512,17827,631,21743,975,17315,M
974,N,172,172,17999,90,21833,975,17827,N
974,O,529,529,18528,845,22678,975,17999,O
974,P,422,422,18950,3780,26458,975,18528,P
975,AE,15,15,15,48,48,976,0,A
975,BE,49,34,49,83,83,976,0,E
975,BF,112,78,127,135,183,976,15,B
975,CF,113,35,162,135,218,976,49,F
975,CG,161,126,288,385,568,976,127,C
975,DG,7,7,295,6365,6933,976,288,D
975,G,161,28,323,385,603,976,162,G
975,H,6,6,329,6365,6968,976,323,H
975,M,318,318,647,216,7184,976,329,M
975,N,163,163,810,150,7334,976,647,N
975,O,321,321,1131,205,7539,976,810,O
975,P,993,993,2124,1520,9059,976,1131,P
976,A,64,64,64,397,397,977,0,A
976,B,570,570,634,300,697,977,64,B
976,C,637,637,1271,820,1517,977,634,C
976,B,1002,1002,2273,825,2342,977,1271,B
976,C,133,133,2406,290,2632,977,2273,C
976,D,7,7,2413,5100,7732,977,2406,D
976,M,2766,2766,5179,4294,12026,977,2413,M
976,N,1588,1588,6767,120,12146,977,5179,N
976,O,188,188,6955,420,12566,977,6767,O
976,N,1895,1895,8850,1665,14231,977,6955,N
976,O,904,904,9754,970,15201,977,8850,O
976,P,658,658,10412,5160,20361,977,9754,P
977,AEI,39,39,39,229,229,978,0,E
977,AFI,333,333,372,180,409,978,39,F
977,AGI,140,140,512,166,575,978,372,G
977,AHI,74,74,586,379,954,978,512,H
977,AI,1905,1319,1905,2501,2501,978,0,I
977,AJ,716,716,2621,180,2681,978,1905,J
977,AK,792,792,3413,795,3476,978,2621,K
977,AL,4318,905,4318,4659,4659,978,0,A
977,BL,499,499,4817,230,4889,978,4318,B
977,CL,599,599,5416,575,5464,978,4817,C
977,DL,1540,1540,6956,385,5849,978,5416,D
977,L,5110,1567,8523,550,4026,978,3413,L
977,M,1292,1292,9815,1389,7238,978,8523,M
977,N,831,831,10646,780,8018,978,9815,N
977,O,949,949,11595,1160,9178,978,10646,O
977,P,15602,15602,27197,665,9843,978,11595,P
978,A,1165,1165,1165,1645,1645,979,0,A
978,B,748,748,1913,300,1945,979,1165,B
978,C,919,919,2832,1045,2990,979,1913,C
978,D,1145,1145,3977,1140,4130,979,2832,D
978,M,2919,2919,6896,3054,7184,979,3977,M
978,N,321,321,7217,240,7424,979,6896,N
978,O,528,528,7745,765,8189,979,7217,O
978,N,507,507,8252,295,8484,979,7745,N
978,O,818,818,9070,1260,9744,979,8252,O
978,P,349,349,9419,3960,13704,979,9070,P
979,A,56,56,56,1011,1011,980,0,A
979,B,988,988,1044,90,1101,980,56,B
979,C,1014,1014,2058,1220,2321,980,1044,C
979,D,153,153,2211,3780,6101,980,2058,D
979,M,379,379,2590,832,6933,980,2211,M
979,N,484,484,3074,90,7023,980,2590,N
979,O,939,939,4013,1285,8308,980,3074,O
979,P,168,168,4181,3780,12088,980,4013,P
980,AE,110,110,110,359,359,981,0,E
980,AF,414,304,414,1391,1391,981,0,A
980,BF,445,141,555,240,599,981,110,F
980,BG,730,730,1285,845,1444,981,555,G
980,BH,1170,299,1584,240,1631,981,414,B
980,CH,948,948,2532,995,2626,981,1584,C
980,DH,1344,97,2629,9700,11144,981,1285,H
980,D,123,26,2655,4680,7306,981,2532,D
980,M,4564,4564,7219,4721,15865,981,2655,M
980,N,199,199,7418,90,15955,981,7219,N
980,O,620,620,8038,820,16775,981,7418,O
980,N,1047,1047,9085,835,17610,981,8038,N
980,O,491,491,9576,805,18415,981,9085,O
980,P,10560,10560,20136,3780,22195,981,9576,P
981,A,88,88,88,163,163,982,0,A
981,B,274,274,362,240,403,982,88,B
981,C,153,153,515,190,593,982,362,C
981,D,769,769,1284,5220,5813,982,515,D
981,M,35315,35315,36599,36283,42096,982,1284,M
981,N,1010,1010,37609,90,42186,982,36599,N
981,O,1143,1143,38752,1395,43581,982,37609,O
981,N,721,721,39473,430,44011,982,38752,N
981,O,858,858,40331,1060,45071,982,39473,O
981,P,29,29,40360,3780,48851,982,40331,P
982,AE,574,574,574,1268,1268,983,0,E
982,AF,1043,1043,1617,240,1508,983,574,F
982,AG,996,996,2613,1050,2558,983,1617,G
982,AF,339,339,2952,770,3328,983,2613,F
982,AG,415,415,3367,150,3478,983,2952,G
982,AH,58,58,3425,3900,7378,983,3367,H
982,A,4212,787,4212,13205,13205,983,0,A
982,B,498,498,4710,180,13385,983,4212,B
982,C,1679,1679,6389,1330,14715,983,4710,C
982,B,1867,1867,8256,395,15110,983,6389,B
982,C,459,459,8715,1440,16550,983,8256,C
982,D,1214,1214,9929,3090,19640,983,8715,D
982,M,794,794,10723,1970,21610,983,9929,M
982,N,2293,2293,13016,90,21700,983,10723,N
982,O,1154,1154,14170,1375,23075,983,13016,O
982,N,188,188,14358,1055,24130,983,14170,N
982,O,697,697,15055,790,24920,983,14358,O
982,P,315,315,15370,3780,28700,983,15055,P
983,A,1976,1976,1976,2589,2589,984,0,A
983,B,733,733,2709,180,2769,984,1976,B
983,C,937,937,3646,930,3699,984,2709,C
983,D,1807,1807,5453,550,4249,984,3646,D
983,M,781,781,6234,1184,5433,984,5453,M
983,N,1149,1149,7383,780,6213,984,6234,N
983,O,911,911,8294,1162,7375,984,7383,O
983,P,1500,1500,9794,533,7908,984,8294,P
984,AEI,233,233,233,1227,1227,985,0,I
984,AEJ,321,88,321,1190,1190,985,0,A
984,BEJ,899,899,1220,90,1280,985,321,B
984,CEJ,1234,14,1234,1615,1615,985,0,E
984,CFJ,1024,23,1257,90,1317,985,233,J
984,CFK,405,382,1639,90,1705,985,1234,F
984,CGK,1053,634,2273,1240,2520,985,1220,C
984,DGK,1042,26,2299,1220,2537,985,1257,K
984,DGL,843,183,2482,1025,2730,985,1639,G
984,DHL,479,296,2778,3780,6317,985,2299,L
984,DH,395,99,2877,3780,6510,985,2482,H
984,D,2813,2209,5086,3780,6300,985,2273,D
984,M,1299,1299,6385,1869,8379,985,5086,M
984,N,623,623,7008,90,8469,985,6385,N
984,O,914,914,7922,1310,9779,985,7008,O
984,P,460,460,8382,3780,13559,985,7922,P
985,AEI,671,671,671,1287,1287,986,0,I
985,AEJ,674,3,674,902,902,986,0,A
985,BEJ,797,123,797,1414,1414,986,0,E
985,BFJ,260,137,934,90,992,986,674,B
985,CFJ,656,393,1327,90,1377,986,671,J
985,CFK,409,16,1343,800,1792,986,934,C
985,DFK,646,100,1443,90,1504,986,797,F
985,DGK,377,261,1704,795,2172,986,1327,K
985,DGL,394,133,1837,800,2304,986,1443,G
985,DHL,868,868,2705,3780,6084,986,1837,H
985,DL,1033,32,2737,3780,5952,986,1704,L
985,D,1397,3,2740,3780,5572,986,1343,D
985,M,2150,2150,4890,2304,8388,986,2740,M
985,N,310,310,5200,90,8478,986,4890,N
985,O,619,619,5819,795,9273,986,5200,O
985,N,829,829,6648,760,10033,986,5819,N
985,O,401,401,7049,815,10848,986,6648,O
985,P,20280,20280,27329,3780,14628,986,7049,P
986,AEI,54,54,54,156,156,987,0,A
986,BEI,55,1,55,117,117,987,0,I
986,BEJ,138,83,138,237,237,987,0,E
986,BFJ,192,108,246,150,306,987,54,B
986,CFJ,229,38,284,240,357,987,55,J
986,CFK,192,46,330,150,387,987,138,F
986,CGK,207,123,453,455,761,987,246,C
986,DGK,515,392,845,795,1182,987,330,G
986,DHK,161,161,1006,5395,6577,987,845,H
986,DK,811,89,1095,975,1332,987,284,K
986,DL,840,198,1293,3565,4326,987,453,D
986,L,2147,1949,3242,5040,6372,987,1095,L
986,M,185,185,3427,185,6762,987,3242,M
986,N,187,187,3614,240,7002,987,3427,N
986,O,216,216,3830,295,7297,987,3614,O
986,P,199,199,4029,5100,12397,987,3830,P
987,AE,47,47,47,148,148,988,0,E
987,AF,283,283,330,240,388,988,47,F
987,AG,185,185,515,285,673,988,330,G
987,AH,740,740,1255,5160,5833,988,515,H
987,A,1718,463,1718,2041,2041,988,0,A
987,B,353,353,2071,90,2131,988,1718,B
987,C,592,592,2663,825,2956,988,2071,C
987,B,743,743,3406,480,3436,988,2663,B
987,C,1247,1247,4653,1340,4776,988,3406,C
987,D,8242,8242,12895,3780,8556,988,4653,D
987,M,264,264,13159,373,8929,988,12895,M
987,N,409,409,13568,360,9289,988,13159,N
987,O,885,885,14453,1259,10548,988,13568,O
987,N,1751,1751,16204,1355,11903,988,14453,N
987,O,1084,1084,17288,1160,13063,988,16204,O
987,P,726,726,18014,635,13698,988,17288,P
988,AEI,43,43,43,439,439,989,0,E
988,AFI,48,5,48,2579,2579,989,0,I
988,AFJ,180,132,180,1119,1119,989,0,A
988,BFJ,601,464,644,240,679,989,43,F
988,BGJ,1125,661,1305,240,1359,989,180,B
988,CGJ,684,23,1328,960,1639,989,644,G
988,CHJ,288,288,1616,3960,5599,989,1328,H
988,CJ,832,521,2137,930,2289,989,1305,C
988,DJ,2717,628,2765,240,2819,989,48,J
988,DK,809,809,3574,940,3759,989,2765,K
988,DL,1740,303,3877,6990,9279,989,2137,D
988,L,6854,6551,10428,6990,10749,989,3574,L
988,M,252,252,10680,468,11217,989,10428,M
988,N,457,457,11137,360,11577,989,10680,N
988,O,1050,1050,12187,985,12562,989,11137,O
988,N,637,637,12824,635,13197,989,12187,N
988,O,35,35,12859,415,13612,989,12824,O
988,P,3388,3388,16247,6060,19672,989,12859,P
989,AEI,77,77,77,145,145,990,0,I
989,AEJ,195,118,195,360,360,990,0,A
989,BEJ,158,40,235,150,295,990,77,J
989,BEK,66,66,301,80,375,990,235,K
989,BEL,56,56,357,2880,3255,990,301,L
989,BE,186,24,381,90,450,990,195,B
989,CE,1084,703,1084,1239,1239,990,0,E
989,CF,245,245,1329,150,1389,990,1084,F
989,CG,246,246,1575,155,1544,990,1329,G
989,CF,1403,209,1784,1855,2305,990,381,C
989,DF,76,76,1860,3780,6085,990,1784,D
989,F,1136,851,2711,1215,2759,990,1575,F
989,G,149,149,2860,285,3044,990,2711,G
989,H,1091,1091,3951,5100,8144,990,2860,H
989,M,142,142,4093,250,8394,990,3951,M
989,N,193,193,4286,150,8544,990,4093,N
989,O,137,137,4423,540,9084,990,4286,O
989,P,782,782,5205,2850,11934,990,4423,P
990,A,3145,3145,3145,3429,3429,991,0,A
990,B,399,399,3544,180,3609,991,3145,B
990,C,1055,1055,4599,1235,4844,991,3544,C
990,B,556,556,5155,355,5199,991,4599,B
990,C,389,389,5544,540,5739,991,5155,C
990,D,2532,2532,8076,6960,12699,991,5544,D
990,M,3168,3168,11244,3978,16677,991,8076,M
990,N,851,851,12095,90,16767,991,11244,N
990,O,281,281,12376,625,17392,991,12095,O
990,N,1292,1292,13668,940,18332,991,12376,N
990,O,716,716,14384,1155,19487,991,13668,O
990,P,60,60,14444,3780,23267,991,14384,P
991,AEI,17,17,17,326,326,992,0,E
991,AFI,883,883,900,420,746,992,17,F
991,AGI,1600,700,1600,3824,3824,992,0,I
991,AGJ,758,58,1658,831,1577,992,900,G
991,AHJ,1711,53,1711,1801,1801,992,0,A
991,BHJ,870,870,2581,840,2641,992,1711,B
991,CHJ,672,672,3253,1020,3661,992,2581,C
991,BHJ,1887,292,3545,629,2206,992,1658,H
991,BJ,2255,310,3855,90,3914,992,1600,J
991,BK,479,479,4334,805,4719,992,3855,K
991,BJ,1101,20,4354,710,4371,992,3253,B
991,CJ,599,579,4933,250,4969,992,4334,J
991,CK,644,65,4998,836,5207,992,4354,C
991,DK,1269,1269,6267,764,5971,992,4998,D
991,K,1522,188,6455,2035,7004,992,4933,K
991,L,2872,2872,9327,3780,10784,992,6455,L
991,M,1613,1613,10940,1635,12419,992,9327,M
991,N,271,271,11211,300,12719,992,10940,N
991,O,602,602,11813,695,13414,992,11211,O
991,P,1377,1377,13190,1140,14554,992,11813,P
992,A,404,404,404,493,493,993,0,A
992,B,179,179,583,150,643,993,404,B
992,C,146,146,729,375,1018,993,583,C
992,D,1051,1051,1780,3260,4278,993,729,D
992,M,1486,1486,3266,2160,6438,993,1780,M
992,N,885,885,4151,240,6678,993,3266,N
992,O,127,127,4278,240,6918,993,4151,O
992,P,9039,9039,13317,5100,12018,993,4278,P
993,A,1301,1301,1301,1427,1427,994,0,A
993,B,321,321,1622,240,1667,994,1301,B
993,C,625,625,2247,765,2432,994,1622,C
993,D,653,653,2900,4020,6452,994,2247,D
993,M,475,475,3375,1200,7652,994,2900,M
993,N,929,929,4304,240,7892,994,3375,N
993,O,495,495,4799,765,8657,994,4304,O
993,P,109,109,4908,3960,12617,994,4799,P
994,AEI,71,71,71,145,145,995,0,I
994,AEJ,97,26,97,154,154,995,0,E
994,AFJ,178,152,249,150,295,995,71,J
994,AFK,164,12,261,150,304,995,97,F
994,AGK,166,166,427,840,1144,995,261,G
994,AHK,216,38,465,150,445,995,249,K
994,AHL,494,456,921,3540,4684,995,427,H
994,AL,1211,290,1211,2235,2235,995,0,A
994,BL,818,72,1283,4290,4735,995,465,L
994,B,1127,1055,2338,150,2385,995,1211,B
994,C,195,195,2533,175,2560,995,2338,C
994,D,1162,1162,3695,340,2900,995,2533,D
994,M,325,325,4020,939,5674,995,3695,M
994,N,769,769,4789,180,5854,995,4020,N
994,O,201,201,4990,255,6109,995,4789,O
994,N,290,290,5280,260,6369,995,4990,N
994,O,147,147,5427,215,6584,995,5280,O
994,P,4282,4282,9709,4140,10724,995,5427,P
995,AE,476,476,476,1033,1033,996,0,E
995,AF,1008,532,1008,1114,1114,996,0,A
995,BF,673,141,1149,150,1183,996,476,F
995,BG,66,66,1215,50,1233,996,1149,G
995,BF,215,8,1223,150,1264,996,1008,B
995,CF,124,124,1347,50,1314,996,1223,C
995,BF,1241,1109,2456,1280,2513,996,1215,F
995,BG,1202,93,2549,1280,2594,996,1347,B
995,CG,199,106,2655,265,2778,996,2456,G
995,CH,172,172,2827,5100,7878,996,2655,H
995,C,368,90,2917,265,2859,996,2549,C
995,D,76,76,2993,5100,7959,996,2917,D
995,M,57,57,3050,118,8077,996,2993,M
995,N,244,244,3294,240,8317,996,3050,N
995,O,132,132,3426,255,8572,996,3294,O
995,N,615,615,4041,460,9032,996,3426,N
995,O,186,186,4227,215,9247,996,4041,O
995,P,250,250,4477,4890,14137,996,4227,P
996,AEI,179,179,179,1223,1223,997,0,A
996,BEI,313,134,313,687,687,997,0,E
996,BFI,439,439,752,90,777,997,313,F
996,BGI,1074,501,1253,90,1313,997,179,B
996,CGI,1403,902,2155,1745,2522,997,752,G
996,CHI,1038,136,2291,1220,2533,997,1253,C
996,DHI,295,159,2450,3780,6302,997,2155,H
996,DI,2979,529,2979,3247,3247,997,0,I
996,DJ,889,201,3180,3780,6313,997,2291,D
996,J,293,92,3272,90,3337,997,2979,J
996,K,548,548,3820,905,4242,997,3272,K
996,L,245,245,4065,3780,8022,997,3820,L
996,M,399,399,4464,1117,9139,997,4065,M
996,N,745,745,5209,90,9229,997,4464,N
996,O,224,224,5433,625,9854,997,5209,O
996,P,1624,1624,7057,3780,13634,997,5433,P
997,AEI,513,513,513,761,761,998,0,E
997,AFI,546,33,546,1385,1385,998,0,A
997,BFI,281,248,794,90,851,998,513,F
997,BGI,808,14,808,1450,1450,998,0,I
997,BGJ,445,431,1239,880,1731,998,794,G
997,BHJ,866,173,1412,90,1475,998,546,B
997,CHJ,708,104,1516,90,1540,998,808,J
997,CHK,976,976,2492,1250,2790,998,1516,K
997,CHL,2,2,2494,3780,6570,998,2492,L
997,CH,1108,26,2520,1200,2675,998,1412,C
997,DH,1465,184,2704,3780,5511,998,1239,H
997,D,1519,1335,4039,3780,6455,998,2520,D
997,M,1032,1032,5071,1354,7924,998,4039,M
997,N,365,365,5436,90,8014,998,5071,N
997,O,227,227,5663,695,8709,998,5436,O
997,P,11563,11563,17226,3780,12489,998,5663,P
998,AE,233,233,233,364,364,999,0,E
998,AF,418,185,418,941,941,999,0,A
998,BF,335,150,568,240,604,999,233,F
998,BG,555,405,973,90,1031,999,418,B
998,CG,954,549,1522,1045,1649,999,568,G
998,CF,1003,454,1976,1270,2301,999,973,C
998,DF,59,59,2035,3780,6081,999,1976,D
998,F,3475,2962,4997,2660,4309,999,1522,F
998,G,304,304,5301,1210,5519,999,4997,G
998,H,4253,4253,9554,3960,9479,999,5301,H
998,M,142,142,9696,655,10134,999,9554,M
998,N,531,531,10227,90,10224,999,9696,N
998,O,1276,1276,11503,1360,11584,999,10227,O
998,P,129,129,11632,3840,15424,999,11503,P
999,AEI,376,376,376,1175,1175,1000,0,A
999,BEI,994,994,1370,240,1415,1000,376,B
999,CEI,1452,82,1452,1572,1572,1000,0,E
999,CFI,184,184,1636,90,1662,1000,1452,F
999,CGI,1663,27,1663,1899,1899,1000,0,I
999,CGJ,264,264,1927,90,1989,1000,1663,J
999,CGK,483,192,2119,820,2482,1000,1636,G
999,CFK,805,56,2175,740,2155,1000,1370,C
999,DFK,562,314,2489,805,2794,1000,1927,K
999,DFL,1186,816,3305,880,3362,1000,2119,F
999,DGL,557,557,3862,805,4167,1000,3305,G
999,DHL,4860,3487,7349,3780,6574,1000,2489,L
999,DH,6589,1415,8764,5100,7255,1000,2175,D
999,H,25080,20178,28942,3780,7947,1000,3862,H
999,M,2410,2410,31352,2684,10631,1000,28942,M
999,N,389,389,31741,90,10721,1000,31352,N
999,O,462,462,32203,805,11526,1000,31741,O
999,P,8029,8029,40232,3780,15306,1000,32203,P
1000,A,61,61,61,167,167,1001,0,A
1000,B,203,203,264,150,317,1001,61,B
1000,C,131,131,395,155,472,1001,264,C
1000,D,9,9,404,4200,4672,1001,395,D
1000,M,47,47,451,991,5663,1001,404,M
1000,N,1065,1065,1516,165,5828,1001,451,N
1000,O,772,772,2288,1035,6863,1001,1516,O
1000,P,208,208,2496,3960,10823,1001,2288,P
1001,AE,4,4,4,1459,1459,1002,0,A
1001,BE,291,291,295,300,1759,1002,4,B
1001,CE,501,501,796,685,2444,1002,295,C
1001,DE,231,231,1027,3960,6404,1002,796,D
1001,E,1830,803,1830,2103,2103,1002,0,E
1001,F,335,335,2165,90,2193,1002,1830,F
1001,G,936,936,3101,1330,3523,1002,2165,G
1001,H,720,720,3821,3780,7303,1002,3101,H
1001,M,8113,8113,11934,8923,16226,1002,3821,M
1001,N,950,950,12884,180,16406,1002,11934,N
1001,O,993,993,13877,885,17291,1002,12884,O
1001,N,300,300,14177,400,17691,1002,13877,N
1001,O,447,447,14624,540,18231,1002,14177,O
1001,P,3232,3232,17856,6960,25191,1002,14624,P
1002,AEI,31,31,31,1258,1258,1003,0,I
1002,AEJ,45,14,45,193,193,1003,0,E
1002,AFJ,141,96,141,872,872,1003,0,A
1002,BFJ,832,832,973,150,1022,1003,141,B
1002,CFJ,166,166,1139,145,1167,1003,973,C
1002,DFJ,1410,302,1441,240,1498,1003,31,J
1002,DFK,491,189,1630,4200,5367,1003,1139,D
1002,FK,203,14,1644,215,1713,1003,1441,K
1002,FL,1797,198,1842,240,433,1003,45,F
1002,GL,769,571,2413,4890,6603,1003,1644,L
1002,G,777,206,2619,970,1403,1003,1842,G
1002,H,211,211,2830,3960,5363,1003,2619,H
1002,M,1278,1278,4108,1366,7969,1003,2830,M
1002,N,254,254,4362,180,8149,1003,4108,N
1002,O,138,138,4500,260,8409,1003,4362,O
1002,N,980,980,5480,895,9304,1003,4500,N
1002,O,185,185,5665,225,9529,1003,5480,O
1002,P,1158,1158,6823,4860,14389,1003,5665,P
1003,A,325,325,325,1911,1911,1004,0,A
1003,B,1602,1602,1927,90,2001,1004,325,B
1003,C,1369,1369,3296,1635,3636,1004,1927,C
1003,D,598,598,3894,3780,7416,1004,3296,D
1003,M,4416,4416,8310,4824,12240,1004,3894,M
1003,N,479,479,8789,90,12330,1004,8310,N
1003,O,507,507,9296,905,13235,1004,8789,O
1003,P,3729,3729,13025,3780,17015,1004,9296,P
1004,A,518,518,518,1084,1084,1005,0,A
1004,B,1009,1009,1527,420,1504,1005,518,B
1004,C,929,929,2456,1240,2744,1005,1527,C
1004,D,17495,17495,19951,335,3079,1005,2456,D
1004,M,2116,2116,22067,2234,5313,1005,19951,M
1004,N,146,146,22213,90,5403,1005,22067,N
1004,O,414,414,22627,820,6223,1005,22213,O
1004,N,862,862,23489,445,6668,1005,22627,N
1004,O,559,559,24048,935,7603,1005,23489,O
1004,P,1197,1197,25245,3780,11383,1005,24048,P
1005,AEI,197,197,197,598,598,1006,0,E
1005,AFI,226,29,226,1111,1111,1006,0,I
1005,AFJ,658,629,855,240,838,1006,197,F
1005,AGJ,178,178,1033,490,1328,1006,855,G
1005,AHJ,1083,50,1083,1490,1490,1006,0,A
1005,BHJ,1131,274,1357,300,1411,1006,226,J
1005,BHK,599,325,1682,240,1730,1006,1083,B
1005,CHK,809,484,2166,995,2406,1006,1357,K
1005,CHL,1461,977,3143,750,2480,1006,1682,C
1005,DHL,2155,45,3188,3960,5288,1006,1033,H
1005,DL,1354,332,3520,3960,6366,1006,2166,L
1005,D,658,281,3801,3960,6440,1006,3143,D
1005,M,435,435,4236,1327,7767,1006,3801,M
1005,N,948,948,5184,90,7857,1006,4236,N
1005,O,940,940,6124,1230,9087,1006,5184,O
1005,P,652,652,6776,3780,12867,1006,6124,P
1006,AE,195,195,195,225,225,1007,0,A
1006,BE,306,306,501,300,525,1007,195,B
1006,CE,691,691,1192,1845,2370,1007,501,C
1006,DE,1199,7,1199,1645,1645,1007,0,E
1006,DF,33,26,1225,2940,5310,1007,1192,D
1006,F,719,693,1918,300,1945,1007,1199,F
1006,G,829,829,2747,2140,4085,1007,1918,G
1006,H,1008,1008,3755,2645,6730,1007,2747,H
1006,M,1395,1395,5150,1465,8195,1007,3755,M
1006,N,393,393,5543,300,8495,1007,5150,N
1006,O,749,749,6292,830,9325,1007,5543,O
1006,P,516,516,6808,1560,10885,1007,6292,P
1007,AEI,149,149,149,654,654,1008,0,I
1007,AEJ,167,18,167,145,145,1008,0,A
1007,BEJ,203,36,203,1142,1142,1008,0,E
1007,BFJ,91,55,258,180,325,1008,167,B
1007,CFJ,278,278,536,160,485,1008,258,C
1007,DFJ,716,329,865,240,894,1008,149,J
1007,DFK,227,227,1092,255,1149,1008,865,K
1007,DFL,584,28,1120,3350,3835,1008,536,D
1007,FL,1059,142,1262,180,1322,1008,203,F
1007,GL,1112,1112,2374,1055,2377,1008,1262,G
1007,FL,554,554,2928,610,2987,1008,2374,F
1007,GL,222,222,3150,255,3242,1008,2928,G
1007,HL,219,219,3369,5160,8402,1008,3150,H
1007,L,2802,525,3894,5160,6309,1008,1092,L
1007,M,105,105,3999,234,8636,1008,3894,M
1007,N,245,245,4244,150,8786,1008,3999,N
1007,O,163,163,4407,240,9026,1008,4244,O
1007,P,50,50,4457,895,9921,1008,4407,P
1008,AE,2142,2142,2142,2651,2651,1009,0,E
1008,AF,538,538,2680,90,2741,1009,2142,F
1008,AG,1242,1242,3922,1400,4141,1009,2680,G
1008,AH,4231,309,4231,4807,4807,1009,0,A
1008,BH,594,594,4825,90,4897,1009,4231,B
1008,CH,596,596,5421,750,5647,1009,4825,C
1008,DH,226,226,5647,3780,9427,1009,5421,D
1008,H,1772,47,5694,3780,7921,1009,3922,H
1008,M,1175,1175,6869,2176,11603,1009,5694,M
1008,N,1034,1034,7903,90,11693,1009,6869,N
1008,O,1075,1075,8978,1330,13023,1009,7903,O
1008,P,1608,1608,10586,3780,16803,1009,8978,P
1009,AE,515,515,515,550,550,1010,0,E
1009,AF,307,307,822,300,850,1010,515,F
1009,AG,686,686,1508,850,1700,1010,822,G
1009,AH,477,477,1985,1770,3470,1010,1508,H
1009,A,2067,82,2067,2335,2335,1010,0,A
1009,B,308,308,2375,90,2425,1010,2067,B
1009,C,566,566,2941,795,3220,1010,2375,C
1009,B,560,560,3501,295,3515,1010,2941,B
1009,C,1321,1321,4822,1885,5400,1010,3501,C
1009,D,560,560,5382,3840,9240,1010,4822,D
1009,M,10850,10850,16232,13250,22490,1010,5382,M
1009,N,2688,2688,18920,300,22790,1010,16232,N
1009,O,763,763,19683,840,23630,1010,18920,O
1009,P,24,24,19707,1560,25190,1010,19683,P
1010,A,213,213,213,1139,1139,1011,0,A
1010,B,1046,1046,1259,180,1319,1011,213,B
1010,C,853,853,2112,1055,2374,1011,1259,C
1010,D,849,849,2961,6460,8834,1011,2112,D
1010,M,136,136,3097,1325,10159,1011,2961,M
1010,N,1391,1391,4488,240,10399,1011,3097,N
1010,O,829,829,5317,995,11394,1011,4488,O
1010,P,168,168,5485,4680,16074,1011,5317,P
1011,A,698,698,698,499,499,1012,0,A
1011,B,187,187,885,420,919,1012,698,B
1011,C,138,138,1023,395,1314,1012,885,C
1011,D,91,91,1114,5395,6709,1012,1023,D
1011,M,84,84,1198,1349,8058,1012,1114,M
1011,N,1447,1447,2645,240,8298,1012,1198,N
1011,O,586,586,3231,620,8918,1012,2645,O
1011,P,680,680,3911,6360,15278,1012,3231,P
1012,AE,92,92,92,1022,1022,1013,0,A
1012,BE,1116,1116,1208,240,1262,1013,92,B
1012,CE,447,447,1655,750,2012,1013,1208,C
1012,DE,941,941,2596,3540,5552,1013,1655,D
1012,E,4445,1849,4445,5450,5450,1013,0,E
1012,F,1257,1257,5702,300,5750,1013,4445,F
1012,G,1022,1022,6724,1045,6795,1013,5702,G
1012,H,826,826,7550,1200,7995,1013,6724,H
1012,M,581,581,8131,2037,10032,1013,7550,M
1012,N,1701,1701,9832,300,10332,1013,8131,N
1012,O,886,886,10718,815,11147,1013,9832,O
1012,N,1487,1487,12205,1545,12692,1013,10718,N
1012,O,707,707,12912,760,13452,1013,12205,O
1012,P,147,147,13059,7680,21132,1013,12912,P
1013,A,1609,1609,1609,2390,2390,1014,0,A
1013,B,1069,1069,2678,300,2690,1014,1609,B
1013,C,887,887,3565,1050,3740,1014,2678,C
1013,B,1056,1056,4621,980,4720,1014,3565,B
1013,C,1283,1283,5904,1560,6280,1014,4621,C
1013,D,33,33,5937,3960,10240,1014,5904,D
1013,M,928,928,6865,2735,12975,1014,5937,M
1013,N,1974,1974,8839,180,13155,1014,6865,N
1013,O,688,688,9527,895,14050,1014,8839,O
1013,N,380,380,9907,220,14270,1014,9527,N
1013,O,1183,1183,11090,690,14960,1014,9907,O
1013,P,610,610,11700,6660,21620,1014,11090,P
1014,A,5950,5950,5950,6423,6423,1015,0,A
1014,B,847,847,6797,420,6843,1015,5950,B
1014,C,847,847,7644,1079,7922,1015,6797,C
1014,D,3109,3109,10753,356,8278,1015,7644,D
1014,M,142,142,10895,945,9223,1015,10753,M
1014,N,987,987,11882,240,9463,1015,10895,N
1014,O,781,781,12663,1030,10493,1015,11882,O
1014,N,913,913,13576,650,11143,1015,12663,N
1014,O,188,188,13764,385,11528,1015,13576,O
1014,P,779,779,14543,3960,15488,1015,13764,P
1015,AEI,15,15,15,1,1,1016,0,I
1015,AEJ,28,13,28,167,167,1016,0,A
1015,BEJ,153,125,153,1104,1104,1016,0,E
1015,BFJ,221,83,236,300,301,1016,15,J
1015,BFK,229,21,257,150,317,1016,28,B
1015,CFK,505,505,762,795,1112,1016,257,C
1015,DFK,65,65,827,2880,3992,1016,762,D
1015,FK,727,136,963,820,1121,1016,236,K
1015,FL,55,55,1018,5315,6436,1016,963,L
1015,F,1071,206,1224,180,1284,1016,153,F
1015,G,988,988,2212,1050,2334,1016,1224,G
1015,H,702,702,2914,5040,7374,1016,2212,H
1015,M,5741,5741,8655,6282,13656,1016,2914,M
1015,N,731,731,9386,240,13896,1016,8655,N
1015,O,826,826,10212,830,14726,1016,9386,O
1015,P,2717,2717,12929,5400,20126,1016,10212,P
1016,AE,41,41,41,1550,1550,1017,0,E
1016,AF,1629,1629,1670,165,1715,1017,41,F
1016,AG,811,811,2481,1075,2790,1017,1670,G
1016,AH,3011,530,3011,4140,4140,1017,0,A
1016,BH,1108,578,3589,3960,6750,1017,2481,H
1016,B,1153,575,4164,90,4230,1017,3011,B
1016,C,443,443,4607,860,5090,1017,4164,C
1016,D,2631,2631,7238,3780,8870,1017,4607,D
1016,M,3089,3089,10327,3458,12328,1017,7238,M
1016,N,401,401,10728,90,12418,1017,10327,N
1016,O,602,602,11330,855,13273,1017,10728,O
1016,N,455,455,11785,205,13478,1017,11330,N
1016,O,264,264,12049,535,14013,1017,11785,O
1016,P,25,25,12074,3780,17793,1017,12049,P
1017,A,78,78,78,993,993,1018,0,A
1017,B,1101,1101,1179,240,1233,1018,78,B
1017,C,874,874,2053,995,2228,1018,1179,C
1017,D,8,8,2061,4680,6908,1018,2053,D
1017,M,1728,1728,3789,2413,9321,1018,2061,M
1017,N,875,875,4664,180,9501,1018,3789,N
1017,O,861,861,5525,930,10431,1018,4664,O
1017,P,2337,2337,7862,550,10981,1018,5525,P
1018,AE,503,503,503,764,764,1019,0,A
1018,BE,442,442,945,180,944,1019,503,B
1018,CE,1274,329,1274,1816,1816,1019,0,E
1018,CF,898,569,1843,930,1874,1019,945,C
1018,DF,707,138,1981,230,2046,1019,1274,F
1018,DG,792,792,2773,730,2776,1019,1981,G
1018,DH,1508,578,3351,550,2424,1019,1843,D
1018,H,4029,3451,6802,385,3161,1019,2773,H
1018,M,514,514,7316,1574,4735,1019,6802,M
1018,N,1381,1381,8697,420,5155,1019,7316,N
1018,O,738,738,9435,900,6055,1019,8697,O
1018,N,1290,1290,10725,1070,7125,1019,9435,N
1018,O,115,115,10840,386,7511,1019,10725,O
1018,P,1916,1916,12756,1454,8965,1019,10840,P
1019,AE,78,78,78,430,430,1020,0,A
1019,BE,403,325,403,649,649,1020,0,E
1019,BF,452,127,530,180,610,1020,78,B
1019,CF,414,414,944,660,1270,1020,530,C
1019,DF,614,73,1017,426,1075,1020,403,F
1019,DG,92,92,1109,110,1185,1020,1017,G
1019,DH,309,144,1253,3960,5230,1020,944,D
1019,H,152,8,1261,2880,4065,1020,1109,H
1019,M,26,26,1287,1051,6281,1020,1261,M
1019,N,1075,1075,2362,165,6446,1020,1287,N
1019,O,712,712,3074,885,7331,1020,2362,O
1019,P,374,374,3448,3960,11291,1020,3074,P
1020,AEI,46,46,46,126,126,1021,0,E
1020,AFI,69,23,69,237,237,1021,0,I
1020,AFJ,256,233,302,240,366,1021,46,F
1020,AGJ,296,63,365,180,417,1021,69,J
1020,AGK,425,60,425,839,839,1021,0,A
1020,BGK,569,569,994,210,1049,1021,425,B
1020,CGK,732,103,1097,975,1392,1021,365,K
1020,CGL,174,71,1168,375,1424,1021,994,C
1020,DGL,21,21,1189,5475,6899,1021,1168,D
1020,GL,924,37,1226,985,1351,1021,302,G
1020,HL,654,654,1880,5040,6391,1021,1226,H
1020,L,818,35,1915,3495,4887,1021,1097,L
1020,M,160,160,2075,1105,8004,1021,1915,M
1020,N,1143,1143,3218,240,8244,1021,2075,N
1020,O,690,690,3908,760,9004,1021,3218,O
1020,P,1194,1194,5102,7740,16744,1021,3908,P
1021,AEI,173,173,173,1499,1499,1022,0,I
1021,AEJ,520,347,520,722,722,1022,0,A
1021,BEJ,222,222,742,90,812,1022,520,B
1021,CEJ,776,34,776,1146,1146,1022,0,E
1021,CFJ,395,395,1171,90,1236,1022,776,F
1021,CGJ,546,117,1288,880,1692,1022,742,C
1021,DGJ,157,157,1445,3780,5472,1022,1288,D
1021,GJ,1394,122,1567,90,1589,1022,173,J
1021,GK,977,581,2148,1240,2476,1022,1171,G
1021,HK,4,4,2152,3780,6256,1022,2148,H
1021,K,922,337,2489,1225,2814,1022,1567,K
1021,L,24,24,2513,3780,6594,1022,2489,L
1021,M,1680,1680,4193,2254,8848,1022,2513,M
1021,N,629,629,4822,90,8938,1022,4193,N
1021,O,635,635,5457,815,9753,1022,4822,O
1021,P,27120,27120,32577,3780,13533,1022,5457,P
1022,AEI,229,229,229,297,297,1023,0,A
1022,BEI,429,200,429,1015,1015,1023,0,E
1022,BFI,719,290,719,957,957,1023,0,I
1022,BFJ,680,190,909,540,837,1023,229,B
1022,CFJ,826,346,1255,240,1255,1023,429,F
1022,CGJ,548,12,1267,400,1357,1023,719,J
1022,CGK,249,237,1504,250,1505,1023,1255,G
1022,CHK,770,175,1679,795,1632,1023,909,C
1022,DHK,417,242,1921,5250,6755,1023,1504,H
1022,DK,1264,610,2531,1210,2567,1023,1267,K
1022,DL,2023,2023,4554,550,3117,1023,2531,L
1022,D,4917,2042,6596,550,2182,1023,1679,D
1022,M,106,106,6702,258,7013,1023,6596,M
1022,N,395,395,7097,270,7283,1023,6702,N
1022,O,1010,1010,8107,1160,8443,1023,7097,O
1022,P,6854,6854,14961,695,9138,1023,8107,P
1023,AEI,66,66,66,110,110,1024,0,E
1023,AFI,194,194,260,150,260,1024,66,F
1023,AGI,59,59,319,80,340,1024,260,G
1023,AHI,340,21,340,1379,1379,1024,0,I
1023,AHJ,37,16,356,2880,3220,1024,319,H
1023,AJ,866,510,866,1189,1189,1024,0,A
1023,BJ,1088,562,1428,90,1469,1024,340,J
1023,BK,924,362,1790,240,1429,1024,866,B
1023,CK,160,160,1950,355,1784,1024,1790,C
1023,DK,1608,1086,3036,1850,3319,1024,1428,K
1023,DL,109,109,3145,3780,7099,1024,3036,L
1023,D,5320,4125,7270,4020,5804,1024,1950,D
1023,M,44,44,7314,2747,9846,1024,7270,M
1023,N,2753,2753,10067,165,10011,1024,7314,N
1023,O,712,712,10779,885,10896,1024,10067,O
1023,P,301,301,11080,3960,14856,1024,10779,P
1024,AE,78,78,78,175,175,1025,0,A
1024,BE,279,279,357,240,415,1025,78,B
1024,CE,179,179,536,215,630,1025,357,C
1024,DE,715,715,1251,4890,5520,1025,536,D
1024,E,1547,296,1547,1662,1662,1025,0,E
1024,F,335,335,1882,240,1902,1025,1547,F
1024,G,741,741,2623,995,2897,1025,1882,G
1024,H,463,463,3086,3960,6857,1025,2623,H
1024,M,17,17,3103,119,6976,1025,3086,M
1024,N,306,306,3409,240,7216,1025,3103,N
1024,O,695,695,4104,960,8176,1025,3409,O
1024,P,204,204,4308,3960,12136,1025,4104,P
1025,AEI,119,119,119,139,139,1026,0,E
1025,AFI,96,96,215,135,274,1026,119,F
1025,AGI,269,54,269,354,354,1026,0,I
1025,AGJ,146,92,361,280,554,1026,215,G
1025,AHJ,162,70,431,120,474,1026,269,J
1025,AHK,309,239,670,5160,5714,1026,361,H
1025,AK,250,11,681,210,684,1026,431,K
1025,AL,2786,2105,2786,2861,2861,1026,0,A
1025,BL,260,260,3046,240,3101,1026,2786,B
1025,CL,640,640,3686,850,3951,1026,3046,C
1025,BL,513,513,4199,225,4176,1026,3686,B
1025,CL,3966,448,4647,2880,3564,1026,681,L
1025,C,870,422,5069,1260,5436,1026,4199,C
1025,D,3411,3411,8480,3960,9396,1026,5069,D
1025,M,1420,1420,9900,2076,11472,1026,8480,M
1025,N,749,749,10649,150,11622,1026,9900,N
1025,O,76,76,10725,100,11722,1026,10649,O
1025,N,408,408,11133,390,12112,1026,10725,N
1025,O,153,153,11286,225,12337,1026,11133,O
1025,P,1015,1015,12301,4740,17077,1026,11286,P
1026,AE,1178,1178,1178,1280,1280,1027,0,A
1026,BE,304,304,1482,240,1520,1027,1178,B
1026,CE,1984,502,1984,2198,2198,1027,0,E
1026,CF,415,415,2399,240,2438,1027,1984,F
1026,CG,1019,102,2501,1195,2715,1027,1482,C
1026,DG,388,286,2787,435,2873,1027,2399,G
1026,DF,500,214,3001,3960,6675,1027,2501,D
1026,F,1486,1272,4273,1430,4303,1027,2787,F
1026,G,562,562,4835,785,5088,1027,4273,G
1026,H,998,998,5833,3960,9048,1027,4835,H
1026,M,7,7,5840,355,9403,1027,5833,M
1026,N,555,555,6395,240,9643,1027,5840,N
1026,O,760,760,7155,725,10368,1027,6395,O
1026,N,347,347,7502,380,10748,1027,7155,N
1026,O,575,575,8077,810,11558,1027,7502,O
1026,P,2485,2485,10562,3960,15518,1027,8077,P
1027,AEI,83,83,83,182,182,1028,0,E
1027,AFI,184,184,267,150,332,1028,83,F
1027,AGI,300,33,300,797,797,1028,0,I
1027,AGJ,205,172,472,410,742,1028,267,G
1027,AHJ,608,136,608,1109,1109,1028,0,A
1027,BHJ,649,341,949,210,1007,1028,300,J
1027,BHK,122,122,1071,375,1382,1028,949,K
1027,BHL,94,94,1165,5475,6857,1028,1071,L
1027,BH,591,34,1199,150,1259,1028,608,B
1027,CH,90,90,1289,350,1609,1028,1199,C
1027,DH,251,251,1540,2880,4489,1028,1289,D
1027,H,3620,2552,4092,3450,4192,1028,472,H
1027,M,276,276,4368,445,7302,1028,4092,M
1027,N,284,284,4652,240,7542,1028,4368,N
1027,O,578,578,5230,630,8172,1028,4652,O
1027,N,2547,2547,7777,2430,10602,1028,5230,N
1027,O,969,969,8746,570,11172,1028,7777,O
1027,P,5961,5961,14707,5700,16872,1028,8746,P
1028,AE,77,77,77,1029,1029,1029,0,E
1028,AF,515,438,515,615,615,1029,0,A
1028,BF,220,220,735,180,795,1029,515,B
1028,CF,290,290,1025,660,1455,1029,735,C
1028,BF,1152,204,1229,240,1269,1029,77,F
1028,BG,788,788,2017,890,2159,1029,1229,G
1028,BH,293,293,2310,5160,7319,1029,2017,H
1028,B,1894,609,2919,1415,2870,1029,1025,B
1028,C,1003,1003,3922,930,3800,1029,2919,C
1028,D,3868,3868,7790,2760,6560,1029,3922,D
1028,M,176,176,7966,252,7571,1029,7790,M
1028,N,256,256,8222,220,7791,1029,7966,N
1028,O,905,905,9127,880,8671,1029,8222,O
1028,N,1086,1086,10213,830,9501,1029,9127,N
1028,O,2005,2005,12218,2356,11857,1029,10213,O
1028,P,1790,1790,14008,374,12231,1029,12218,P
1029,A,27,27,27,160,160,1030,0,A
1029,B,329,329,356,240,400,1030,27,B
1029,C,208,208,564,285,685,1030,356,C
1029,D,3297,3297,3861,5160,5845,1030,564,D
1029,M,8307,8307,12168,9232,15077,1030,3861,M
1029,N,1060,1060,13228,180,15257,1030,12168,N
1029,O,682,682,13910,885,16142,1030,13228,O
1029,N,613,613,14523,405,16547,1030,13910,N
1029,O,467,467,14990,565,17112,1030,14523,O
1029,P,16020,16020,31010,6960,24072,1030,14990,P
1030,AEI,24,24,24,129,129,1031,0,I
1030,AEJ,43,19,43,144,144,1031,0,E
1030,AFJ,107,64,107,867,867,1031,0,A
1030,BFJ,195,112,219,150,279,1031,24,J
1030,BFK,282,106,325,240,384,1031,43,F
1030,BGK,456,350,675,410,689,1031,219,K
1030,BGL,786,218,893,90,957,1031,107,B
1030,CGL,261,261,1154,575,1532,1031,893,C
1030,BGL,844,15,1169,985,1369,1031,325,G
1030,BHL,534,40,1209,3450,4139,1031,675,L
1030,BH,763,723,1932,6465,7834,1031,1169,H
1030,B,883,105,2037,375,1907,1031,1154,B
1030,C,1065,1065,3102,1240,3147,1031,2037,C
1030,D,1285,1285,4387,3780,6927,1031,3102,D
1030,M,1167,1167,5554,1511,9345,1031,4387,M
1030,N,581,581,6135,240,9585,1031,5554,N
1030,O,260,260,6395,245,9830,1031,6135,O
1030,P,579,579,6974,5250,15080,1031,6395,P
1031,AE,536,536,536,934,934,1032,0,E
1031,AF,660,124,660,1239,1239,1032,0,A
1031,BF,698,574,1234,360,1294,1032,536,F
1031,BG,840,266,1500,180,1419,1032,660,B
1031,CG,1003,737,2237,1125,2419,1032,1234,G
1031,CF,199,199,2436,80,2499,1032,2237,F
1031,CG,964,28,2464,920,2339,1032,1500,C
1031,DG,148,120,2584,120,2619,1032,2436,G
1031,DH,777,657,3241,550,2889,1032,2464,D
1031,H,3321,2664,5905,550,3169,1032,2584,H
1031,M,2172,2172,8077,4547,7716,1032,5905,M
1031,N,2721,2721,10798,420,8136,1032,8077,N
1031,O,433,433,11231,790,8926,1032,10798,O
1031,P,1695,1695,12926,1315,10241,1032,11231,P
1032,AE,228,228,228,980,980,1033,0,E
1032,AF,527,299,527,1089,1089,1033,0,A
1032,BF,947,648,1175,240,1220,1033,228,F
1032,BG,682,34,1209,180,1269,1033,527,B
1032,CG,184,150,1359,415,1635,1033,1175,G
1032,CH,20,20,1379,5160,6795,1033,1359,H
1032,C,561,391,1770,740,2009,1033,1209,C
1032,D,3460,3460,5230,5040,7049,1033,1770,D
1032,M,153,153,5383,1347,8396,1033,5230,M
1032,N,1374,1374,6757,240,8636,1033,5383,N
1032,O,833,833,7590,890,9526,1033,6757,O
1032,P,86473,86473,94063,5160,14686,1033,7590,P
1033,AE,131,131,131,181,181,1034,0,E
1033,AF,164,33,164,1006,1006,1034,0,A
1033,BF,137,104,268,150,331,1034,131,F
1033,BG,168,168,436,455,786,1034,268,G
1033,BH,962,690,1126,180,1186,1034,164,B
1033,CH,891,201,1327,3565,4351,1034,436,H
1033,C,904,703,2030,1055,2241,1034,1126,C
1033,D,2259,2259,4289,5040,7281,1034,2030,D
1033,M,102,102,4391,707,7988,1034,4289,M
1033,N,795,795,5186,240,8228,1034,4391,N
1033,O,162,162,5348,215,8443,1034,5186,O
1033,P,3176,3176,8524,5690,14133,1034,5348,P
1034,AEI,25,25,25,49,49,1035,0,E
1034,AFI,45,20,45,197,197,1035,0,A
1034,BFI,47,2,47,225,225,1035,0,I
1034,BFJ,101,79,126,135,184,1035,25,F
1034,BGJ,252,173,299,135,360,1035,47,J
1034,BGK,355,101,400,240,437,1035,45,B
1034,CGK,275,1,401,295,479,1035,126,G
1034,CHK,126,24,425,280,640,1035,299,K
1034,CHL,146,122,547,5160,5639,1035,401,H
1034,CL,184,62,609,5160,5800,1035,425,L
1034,C,229,20,629,280,717,1035,400,C
1034,D,1377,1377,2006,5160,5877,1035,629,D
1034,M,964,964,2970,1370,7247,1035,2006,M
1034,N,467,467,3437,90,7337,1035,2970,N
1034,O,907,907,4344,1250,8587,1035,3437,O
1034,P,6,6,4350,3780,12367,1035,4344,P
1035,AEI,50,50,50,1017,1017,1036,0,A
1035,BEI,589,539,589,1352,1352,1036,0,I
1035,BEJ,1153,614,1203,240,1257,1036,50,B
1035,CEJ,816,202,1405,90,1442,1036,589,J
1035,CEK,388,388,1793,800,2242,1036,1405,K
1035,CEL,2031,238,2031,2774,2774,1036,0,E
1035,CFL,872,44,2075,995,2252,1036,1203,C
1035,DFL,192,192,2267,4680,6932,1036,2075,D
1035,FL,802,566,2833,90,2864,1036,2031,F
1035,GL,348,348,3181,800,3664,1036,2833,G
1035,HL,2407,1019,4200,3780,6022,1036,1793,L
1035,H,1725,706,4906,3780,7444,1036,3181,H
1035,M,1813,1813,6719,2167,9611,1036,4906,M
1035,N,727,727,7446,90,9701,1036,6719,N
1035,O,682,682,8128,815,10516,1036,7446,O
1035,N,643,643,8771,850,11366,1036,8128,N
1035,O,245,245,9016,695,12061,1036,8771,O
1035,P,1459,1459,10475,3780,15841,1036,9016,P
1036,AE,32,32,32,180,180,1037,0,E
1036,AF,256,256,288,150,330,1037,32,F
1036,AG,75,75,363,110,440,1037,288,G
1036,AH,1,1,364,4230,4670,1037,363,H
1036,A,3036,2672,3036,3758,3758,1037,0,A
1036,B,758,758,3794,90,3848,1037,3036,B
1036,C,815,815,4609,1270,5118,1037,3794,C
1036,D,3491,3491,8100,3780,8898,1037,4609,D
1036,M,147,147,8247,768,9666,1037,8100,M
1036,N,722,722,8969,150,9816,1037,8247,N
1036,O,151,151,9120,115,9931,1037,8969,O
1036,N,755,755,9875,780,10711,1037,9120,N
1036,O,766,766,10641,755,11466,1037,9875,O
1036,P,163,163,10804,4290,15756,1037,10641,P
1037,AEI,111,111,111,873,873,1038,0,I
1037,AEJ,116,5,116,533,533,1038,0,E
1037,AFJ,165,49,165,188,188,1038,0,A
1037,BFJ,113,113,278,150,338,1038,165,B
1037,CFJ,179,179,457,455,793,1038,278,C
1037,DFJ,548,207,664,180,713,1038,116,F
1037,DGJ,936,383,1047,240,1113,1038,111,J
1037,DGK,457,74,1121,735,1448,1038,664,G
1037,DHK,169,95,1216,415,1528,1038,1047,K
1037,DHL,105,10,1226,2880,4328,1038,1121,H
1037,DL,64,54,1280,6715,8243,1038,1216,L
1037,D,878,55,1335,3565,4358,1038,457,D
1037,M,62,62,1397,351,8594,1038,1335,M
1037,N,466,466,1863,240,8834,1038,1397,N
1037,O,233,233,2096,240,9074,1038,1863,O
1037,P,30740,30740,32836,5250,14324,1038,2096,P
1038,A,308,308,308,1080,1080,1039,0,A
1038,B,862,862,1170,150,1230,1039,308,B
1038,C,812,812,1982,1050,2280,1039,1170,C
1038,D,2720,2720,4702,3490,5770,1039,1982,D
1038,M,22,22,4724,140,5910,1039,4702,M
1038,N,304,304,5028,240,6150,1039,4724,N
1038,O,166,166,5194,290,6440,1039,5028,O
1038,P,11641,11641,16835,5160,11600,1039,5194,P
1039,AE,192,192,192,923,923,1040,0,E
1039,AF,961,961,1153,300,1223,1040,192,F
1039,AG,92,92,1245,305,1528,1040,1153,G
1039,AF,558,558,1803,315,1843,1040,1245,F
1039,AG,707,707,2510,820,2663,1040,1803,G
1039,AH,1281,1281,3791,5040,7703,1040,2510,H
1039,A,6997,3206,6997,7391,7391,1040,0,A
1039,B,389,389,7386,120,7511,1040,6997,B
1039,C,205,205,7591,390,7901,1040,7386,C
1039,B,1474,1474,9065,1225,9126,1040,7591,B
1039,C,694,694,9759,820,9946,1040,9065,C
1039,D,313,313,10072,5040,14986,1040,9759,D
1039,M,405,405,10477,190,15176,1040,10072,M
1039,N,154,154,10631,420,15596,1040,10477,N
1039,O,764,764,11395,945,16541,1040,10631,O
1039,N,519,519,11914,345,16886,1040,11395,N
1039,O,95,95,12009,410,17296,1040,11914,O
1039,P,24096,24096,36105,6060,23356,1040,12009,P
1040,AE,21,21,21,716,716,1041,0,A
1040,BE,471,450,471,2831,2831,1041,0,E
1040,BF,799,349,820,150,866,1041,21,B
1040,CF,152,152,972,385,1251,1041,820,C
1040,BF,435,435,1407,195,1446,1041,972,B
1040,CF,871,871,2278,785,2231,1041,1407,C
1040,DF,221,221,2499,4170,6401,1041,2278,D
1040,F,2423,395,2894,90,2921,1041,471,F
1040,G,1098,1098,3992,1375,4296,1041,2894,G
1040,F,2011,2011,6003,1725,6021,1041,3992,F
1040,G,293,293,6296,735,6756,1041,6003,G
1040,H,13719,13719,20015,3780,10536,1041,6296,H
1040,M,1576,1576,21591,2388,12924,1041,20015,M
1040,N,1102,1102,22693,300,13224,1041,21591,N
1040,O,1286,1286,23979,1050,14274,1041,22693,O
1040,N,2576,2576,26555,3140,17414,1041,23979,N
1040,O,927,927,27482,660,18074,1041,26555,O
1040,P,1467,1467,28949,3960,22034,1041,27482,P
1041,AE,165,165,165,551,551,1042,0,A
1041,BE,660,495,660,1074,1074,1042,0,E
1041,BF,888,393,1053,660,1211,1042,165,B
1041,CF,680,680,1733,1291,2502,1042,1053,C
1041,BF,1554,481,2214,180,1254,1042,660,F
1041,BG,1198,717,2931,410,2912,1042,1733,B
1041,CG,1245,528,3459,880,2134,1042,2214,G
1041,CH,692,164,3623,840,3752,1042,2931,C
1041,DH,1947,1947,5570,3960,7712,1042,3623,D
1041,H,2786,675,6245,6660,8794,1042,3459,H
1041,M,1054,1054,7299,2208,11002,1042,6245,M
1041,N,1187,1187,8486,90,11092,1042,7299,N
1041,O,654,654,9140,820,11912,1042,8486,O
1041,N,831,831,9971,495,12407,1042,9140,N
1041,O,1314,1314,11285,1865,14272,1042,9971,O
1041,P,1710,1710,12995,3780,18052,1042,11285,P
1042,AEI,445,445,445,1368,1368,1043,0,E
1042,AFI,967,967,1412,90,1458,1043,445,F
1042,AGI,1511,99,1511,2570,2570,1043,0,A
1042,BGI,2209,698,2209,2516,2516,1043,0,I
1042,BGJ,1048,251,2460,1220,2678,1043,1412,G
1042,BHJ,45,45,2505,3780,6458,1043,2460,H
1042,BJ,347,51,2556,90,2606,1043,2209,J
1042,BK,1088,43,2599,90,2660,1043,1511,B
1042,CK,985,942,3541,1240,3846,1043,2556,K
1042,CL,943,1,3542,1210,3870,1043,2599,C
1042,DL,31,31,3573,3780,7650,1043,3542,D
1042,L,1740,1708,5281,3780,7626,1043,3541,L
1042,M,1871,1871,7152,2265,9915,1043,5281,M
1042,N,426,426,7578,90,10005,1043,7152,N
1042,O,869,869,8447,920,10925,1043,7578,O
1042,P,882,882,9329,3780,14705,1043,8447,P
1043,A,56,56,56,220,220,1044,0,A
1043,B,357,357,413,240,460,1044,56,B
1043,C,290,290,703,285,745,1044,413,C
1043,D,5082,5082,5785,5160,5905,1044,703,D
1043,M,1502,1502,7287,2528,8433,1044,5785,M
1043,N,1076,1076,8363,90,8523,1044,7287,N
1043,O,1192,1192,9555,1375,9898,1044,8363,O
1043,N,406,406,9961,215,10113,1044,9555,N
1043,O,182,182,10143,535,10648,1044,9961,O
1043,P,661,661,10804,3780,14428,1044,10143,P
1044,AE,25,25,25,630,630,1045,0,E
1044,AF,98,73,98,351,351,1045,0,A
1044,BF,433,433,531,240,591,1045,98,B
1044,CF,735,229,760,180,810,1045,25,F
1044,CG,91,91,851,390,1200,1045,760,G
1044,CH,36,36,887,3960,5160,1045,851,H
1044,C,672,316,1203,825,1416,1045,531,C
1044,D,1023,1023,2226,2880,4296,1045,1203,D
1044,M,69,69,2295,1282,6442,1045,2226,M
1044,N,1436,1436,3731,240,6682,1045,2295,N
1044,O,622,622,4353,760,7442,1045,3731,O
1044,P,9845,9845,14198,5160,12602,1045,4353,P
1045,AE,63,63,63,176,176,1046,0,A
1045,BE,202,202,265,150,326,1046,63,B
1045,CE,166,166,431,455,781,1046,265,C
1045,DE,892,892,1323,5005,5786,1046,431,D
1045,E,4174,2851,4174,4309,4309,1046,0,E
1045,F,239,239,4413,150,4459,1046,4174,F
1045,G,92,92,4505,375,4834,1046,4413,G
1045,H,1039,1039,5544,3260,8094,1046,4505,H
1045,M,32,32,5576,137,8231,1046,5544,M
1045,N,187,187,5763,135,8366,1046,5576,N
1045,O,200,200,5963,295,8661,1046,5763,O
1045,P,108,108,6071,5100,13761,1046,5963,P
1046,AEI,74,74,74,3296,3296,1047,0,E
1046,AFI,76,2,76,182,182,1047,0,I
1046,AFJ,173,97,173,1164,1164,1047,0,A
1046,BFJ,197,100,273,150,332,1047,76,J
1046,BFK,175,175,448,455,787,1047,273,K
1046,BFL,1111,836,1284,180,1344,1047,173,B
1046,CFL,836,836,2120,1055,2399,1047,1284,C
1046,DFL,872,872,2992,6460,8859,1047,2120,D
1046,FL,3312,394,3386,150,3446,1047,74,F
1046,GL,570,570,3956,795,4241,1047,3386,G
1046,HL,47,47,4003,2880,7121,1047,3956,H
1046,L,3782,227,4230,3565,4352,1047,448,L
1046,M,81,81,4311,286,9145,1047,4230,M
1046,N,390,390,4701,240,9385,1047,4311,N
1046,O,239,239,4940,285,9670,1047,4701,O
1046,P,5378,5378,10318,5160,14830,1047,4940,P
1047,AEI,266,266,266,733,733,1048,0,E
1047,AFI,446,180,446,684,684,1048,0,A
1047,BFI,157,157,603,135,819,1048,446,B
1047,CFI,577,240,843,150,883,1048,266,F
1047,CGI,224,224,1067,545,1428,1048,843,G
1047,CHI,482,18,1085,535,1354,1048,603,C
1047,DHI,205,205,1290,1520,2874,1048,1085,D
1047,HI,3323,2033,3323,4280,4280,1048,0,I
1047,HJ,1220,1220,4543,300,4580,1048,3323,J
1047,HK,632,632,5175,2065,6645,1048,4543,K
1047,HL,6182,2074,7249,1200,2628,1048,1067,H
1047,L,2761,687,7936,2760,9405,1048,5175,L
1047,M,549,549,8485,603,10008,1048,7936,M
1047,N,205,205,8690,180,10188,1048,8485,N
1047,O,176,176,8866,212,10400,1048,8690,O
1047,P,19,19,8885,393,10793,1048,8866,P
1048,A,3297,3297,3297,3634,3634,1049,0,A
1048,B,378,378,3675,90,3724,1049,3297,B
1048,C,1146,1146,4821,1315,5039,1049,3675,C
1048,D,2992,2992,7813,3780,8819,1049,4821,D
1048,M,294,294,8107,1526,10345,1049,7813,M
1048,N,1428,1428,9535,240,10585,1049,8107,N
1048,O,1374,1374,10909,1790,12375,1049,9535,O
1048,P,454,454,11363,2940,15315,1049,10909,P
1049,A,344,344,344,564,564,1050,0,A
1049,B,273,273,617,90,654,1050,344,B
1049,C,990,990,1607,1240,1894,1050,617,C
1049,D,57,57,1664,3780,5674,1050,1607,D
1049,M,64,64,1728,70,5744,1050,1664,M
1049,N,180,180,1908,240,5984,1050,1728,N
1049,O,201,201,2109,245,6229,1050,1908,O
1049,P,615,615,2724,5250,11479,1050,2109,P
1050,AEI,35,35,35,101,101,1051,0,A
1050,BEI,88,53,88,813,813,1051,0,I
1050,BEJ,176,123,211,240,341,1051,35,B
1050,CEJ,820,697,908,150,963,1051,88,J
1050,CEK,149,149,1057,120,1083,1051,908,K
1050,CEJ,1060,3,1060,1803,1803,1051,0,E
1050,CFJ,738,738,1798,90,1893,1051,1060,F
1050,CGJ,759,18,1816,745,1828,1051,1057,J
1050,CGK,769,769,2585,775,2603,1051,1816,K
1050,CGL,2469,95,2680,2700,3041,1051,211,C
1050,BGL,98,3,2683,4230,6833,1051,2585,L
1050,BG,1542,657,3340,1755,3648,1051,1798,G
1050,BH,728,68,3408,390,3431,1051,2680,B
1050,CH,290,222,3630,3780,7428,1051,3340,H
1050,C,798,576,4206,1045,4476,1051,3408,C
1050,D,1523,1523,5729,3960,8436,1051,4206,D
1050,M,3919,3919,9648,4731,13167,1051,5729,M
1050,N,859,859,10507,90,13257,1051,9648,N
1050,O,143,143,10650,585,13842,1051,10507,O
1050,P,2991,2991,13641,3780,17622,1051,10650,P
1051,AEI,18,18,18,45,45,1052,0,I
1051,AEJ,22,4,22,121,121,1052,0,A
1051,BEJ,88,66,88,42,42,1052,0,E
1051,BFJ,170,100,188,150,195,1052,18,J
1051,BFK,140,40,228,240,282,1052,88,F
1051,BGK,226,20,248,150,271,1052,22,B
1051,CGK,179,159,407,150,432,1052,228,G
1051,CHK,272,113,520,890,1161,1052,248,C
1051,DHK,686,354,874,130,325,1052,188,K
1051,DHL,1,1,875,3400,3725,1052,874,L
1051,DH,710,355,1230,3490,4651,1052,520,D
1051,H,4259,3436,4666,4230,4662,1052,407,H
1051,M,290,290,4956,395,5057,1052,4666,M
1051,N,192,192,5148,150,5207,1052,4956,N
1051,O,96,96,5244,90,5297,1052,5148,O
1051,P,782,782,6026,3415,8712,1052,5244,P
1052,AE,627,627,627,635,635,1053,0,E
1052,AF,118,118,745,170,805,1053,627,F
1052,AG,1090,345,1090,1036,1036,1053,0,A
1052,BG,208,208,1298,300,1336,1053,1090,B
1052,CG,576,23,1321,465,1270,1053,745,G
1052,CF,180,180,1501,270,1540,1053,1321,F
1052,CG,527,324,1825,700,2036,1053,1298,C
1052,DG,537,213,2038,610,2150,1053,1501,G
1052,DH,1102,889,2927,4080,6116,1053,1825,D
1052,H,3438,2549,5476,320,2470,1053,2038,H
1052,M,43,43,5519,729,6845,1053,5476,M
1052,N,751,751,6270,90,6935,1053,5519,N
1052,O,1479,1479,7749,1745,8680,1053,6270,O
1052,P,32,32,7781,3780,12460,1053,7749,P
1053,A,1489,1489,1489,1845,1845,1054,0,A
1053,B,387,387,1876,90,1935,1054,1489,B
1053,C,1459,1459,3335,1745,3680,1054,1876,C
1053,D,22,22,3357,3780,7460,1054,3335,D
1053,M,2396,2396,5753,4843,12303,1054,3357,M
1053,N,2493,2493,8246,90,12393,1054,5753,N
1053,O,194,194,8440,690,13083,1054,8246,O
1053,P,3153,3153,11593,3780,16863,1054,8440,P
1054,AE,388,388,388,1336,1336,1055,0,E
1054,AF,1060,1060,1448,150,1486,1055,388,F
1054,AG,797,797,2245,885,2371,1055,1448,G
1054,AH,427,427,2672,3960,6331,1055,2245,H
1054,A,5248,2576,5248,5994,5994,1055,0,A
1054,B,943,943,6191,240,6234,1055,5248,B
1054,C,674,674,6865,860,7094,1055,6191,C
1054,D,2076,2076,8941,3960,11054,1055,6865,D
1054,M,248,248,9189,1184,12238,1055,8941,M
1054,N,1056,1056,10245,180,12418,1055,9189,N
1054,O,770,770,11015,690,13108,1055,10245,O
1054,P,5152,5152,16167,550,13658,1055,11015,P
1055,AEI,20,20,20,50,50,1056,0,E
1055,AFI,35,15,35,81,81,1056,0,I
1055,AFJ,51,16,51,764,764,1056,0,A
1055,BFJ,115,84,135,135,185,1056,20,F
1055,BGJ,124,24,159,135,216,1056,35,J
1055,BGK,227,203,362,295,480,1056,135,G
1055,BHK,222,19,381,295,511,1056,159,K
1055,BHL,126,126,507,5160,5671,1056,381,L
1055,BH,170,25,532,5160,5640,1056,362,H
1055,B,895,414,946,240,1004,1056,51,B
1055,C,221,221,1167,290,1294,1056,946,C
1055,D,5821,5821,6988,5160,6454,1056,1167,D
1055,M,122,122,7110,325,6779,1056,6988,M
1055,N,355,355,7465,180,6959,1056,7110,N
1055,O,704,704,8169,885,7844,1056,7465,O
1055,P,29,29,8198,6680,14524,1056,8169,P
1056,AEI,32,32,32,25,25,1057,0,A
1056,BEI,123,123,155,180,205,1057,32,B
1056,CEI,291,136,291,1379,1379,1057,0,E
1056,CFI,143,7,298,220,425,1057,155,C
1056,BFI,539,241,539,1148,1148,1057,0,I
1056,BFJ,927,927,1466,180,1328,1057,539,J
1056,BFK,1276,101,1567,240,1619,1057,291,F
1056,BGK,1336,67,1634,1245,1670,1057,298,B
1056,CGK,395,227,1861,895,2223,1057,1466,K
1056,CGJ,813,519,2380,995,2614,1057,1567,G
1056,CHJ,33,33,2413,4680,7294,1057,2380,H
1056,CJ,794,15,2428,755,2425,1057,1634,C
1056,DJ,1,1,2429,4140,6565,1057,2428,D
1056,J,1098,530,2959,750,2973,1057,1861,J
1056,K,177,177,3136,745,3718,1057,2959,K
1056,L,410,410,3546,4020,7738,1057,3136,L
1056,M,1030,1030,4576,1152,8890,1057,3546,M
1056,N,282,282,4858,180,9070,1057,4576,N
1056,O,840,840,5698,930,10000,1057,4858,O
1056,P,1935,1935,7633,550,10550,1057,5698,P
1057,AE,544,544,544,1265,1265,1058,0,E
1057,AF,815,815,1359,90,1355,1058,544,F
1057,AG,1092,1092,2451,1385,2740,1058,1359,G
1057,AH,3642,1191,3642,3807,3807,1058,0,A
1057,BH,191,191,3833,90,3897,1058,3642,B
1057,CH,461,461,4294,735,4632,1058,3833,C
1057,DH,1934,91,4385,3780,6520,1058,2451,H
1057,D,1343,1252,5637,3780,8412,1058,4294,D
1057,M,1568,1568,7205,2116,10528,1058,5637,M
1057,N,660,660,7865,150,10678,1058,7205,N
1057,O,922,922,8787,840,11518,1058,7865,O
1057,N,3029,3029,11816,3125,14643,1058,8787,N
1057,O,577,577,12393,590,15233,1058,11816,O
1057,P,1423,1423,13816,4230,19463,1058,12393,P
1058,AE,42,42,42,4527,4527,1059,0,A
1058,BE,53,11,53,1709,1709,1059,0,E
1058,BF,1806,1806,1859,165,1874,1059,53,F
1058,BG,636,636,2495,910,2784,1059,1859,G
1058,BH,1315,1315,3810,3960,6744,1059,2495,H
1058,B,4605,837,4647,165,4692,1059,42,B
1058,C,858,858,5505,1075,5767,1059,4647,C
1058,D,1056,1056,6561,3960,9727,1059,5505,D
1058,M,1497,1497,8058,2483,12210,1059,6561,M
1058,N,1255,1255,9313,300,12510,1059,8058,N
1058,O,827,827,10140,970,13480,1059,9313,O
1058,N,1819,1819,11959,1790,15270,1059,10140,N
1058,O,339,339,12298,390,15660,1059,11959,O
1058,P,1459,1459,13757,3960,19620,1059,12298,P
1059,AE,232,232,232,1486,1486,1060,0,A
1059,BE,344,112,344,1333,1333,1060,0,E
1059,BF,1022,1022,1366,90,1423,1060,344,F
1059,BG,1282,148,1514,90,1576,1060,232,B
1059,CG,1043,895,2409,1220,2643,1060,1366,G
1059,CH,5,5,2414,3780,6423,1060,2409,H
1059,C,996,96,2510,1210,2786,1060,1514,C
1059,D,55,55,2565,3780,6566,1060,2510,D
1059,M,564,564,3129,1222,7788,1060,2565,M
1059,N,694,694,3823,90,7878,1060,3129,N
1059,O,598,598,4421,940,8818,1060,3823,O
1059,P,554,554,4975,3780,12598,1060,4421,P
1060,A,362,362,362,1099,1099,1061,0,A
1060,B,837,837,1199,150,1249,1061,362,B
1060,C,162,162,1361,135,1384,1061,1199,C
1060,B,285,285,1646,285,1669,1061,1361,B
1060,C,599,599,2245,690,2359,1061,1646,C
1060,D,4160,4160,6405,4230,6589,1061,2245,D
1060,M,355,355,6760,310,6899,1061,6405,M
1060,N,206,206,6966,300,7199,1061,6760,N
1060,O,234,234,7200,840,8039,1061,6966,O
1060,N,971,971,8171,825,8864,1061,7200,N
1060,O,320,320,8491,2460,11324,1061,8171,O
1060,P,9,9,8500,2075,13399,1061,8491,P
1061,A,144,144,144,189,189,1062,0,A
1061,B,218,218,362,240,429,1062,144,B
1061,C,720,720,1082,975,1404,1062,362,C
1061,D,886,886,1968,5040,6444,1062,1082,D
1061,M,82,82,2050,1468,7912,1062,1968,M
1061,N,1569,1569,3619,240,8152,1062,2050,N
1061,O,714,714,4333,780,8932,1062,3619,O
1061,P,6598,6598,10931,7680,16612,1062,4333,P
1062,AEI,568,568,568,1563,1563,1063,0,A
1062,BEI,582,14,582,1182,1182,1063,0,I
1062,BEJ,783,783,1365,240,1422,1063,582,J
1062,BEK,204,204,1569,240,1662,1063,1365,K
1062,BEL,1133,132,1701,180,1743,1063,568,B
1062,CEL,678,678,2379,697,2440,1063,1701,C
1062,DEL,1501,1501,3880,4080,6520,1063,2379,D
1062,EL,6257,2377,6257,8016,8016,1063,0,E
1062,FL,5653,965,7222,5100,6762,1063,1569,L
1062,F,1879,914,8136,180,8196,1063,6257,F
1062,G,1266,1266,9402,695,8891,1063,8136,G
1062,F,2326,2326,11728,2880,11771,1063,9402,F
1062,G,496,496,12224,565,12336,1063,11728,G
1062,H,2097,2097,14321,6960,19296,1063,12224,H
1062,M,240,240,14561,294,19590,1063,14321,M
1062,N,178,178,14739,180,19770,1063,14561,N
1062,O,672,672,15411,820,20590,1063,14739,O
1062,P,1356,1356,16767,6680,27270,1063,15411,P
1063,AEI,83,83,83,721,721,1064,0,I
1063,AEJ,723,723,806,150,871,1064,83,J
1063,AEK,170,170,976,130,1001,1064,806,K
1063,AEJ,688,688,1664,705,1706,1064,976,J
1063,AEK,132,132,1796,115,1821,1064,1664,K
1063,AEL,2268,472,2268,2380,2380,1064,0,A
1063,BEL,211,211,2479,150,2530,1064,2268,B
1063,CEL,103,103,2582,115,2645,1064,2479,C
1063,DEL,802,16,2598,4230,6051,1064,1796,L
1063,DE,5598,3000,5598,5789,5789,1064,0,E
1063,DF,781,781,6379,650,6439,1064,5598,F
1063,DG,4300,503,6882,4230,6875,1064,2582,D
1063,G,775,272,7154,1095,7534,1064,6379,G
1063,F,859,859,8013,595,8129,1064,7154,F
1063,G,2738,2738,10751,2628,10757,1064,8013,G
1063,H,1460,1460,12211,402,11159,1064,10751,H
1063,M,1043,1043,13254,1030,12189,1064,12211,M
1063,N,47,47,13301,120,12309,1064,13254,N
1063,O,175,175,13476,210,12519,1064,13301,O
1063,P,580,580,14056,2880,15399,1064,13476,P
1064,AE,543,543,543,2094,2094,1065,0,E
1064,AF,935,392,935,1297,1297,1065,0,A
1064,BF,556,556,1491,240,1537,1065,935,B
1064,CF,744,744,2235,970,2507,1065,1491,C
1064,DF,1923,231,2466,420,2514,1065,543,F
1064,DG,869,869,3335,895,3409,1065,2466,G
1064,DH,433,433,3768,370,3779,1065,3335,H
1064,D,21847,20314,24082,3960,6467,1065,2235,D
1064,M,441,441,24523,1393,7860,1065,24082,M
1064,N,974,974,25497,90,7950,1065,24523,N
1064,O,505,505,26002,880,8830,1065,25497,O
1064,N,1822,1822,27824,1440,10270,1065,26002,N
1064,O,1110,1110,28934,1300,11570,1065,27824,O
1064,P,3969,3969,32903,3780,15350,1065,28934,P
1065,AEI,84,84,84,84,84,1066,0,I
1065,AEJ,90,90,174,150,234,1066,84,J
1065,AEK,300,126,300,645,645,1066,0,A
1065,BEK,175,49,349,410,644,1066,174,K
1065,BEL,441,392,741,150,795,1066,300,B
1065,CEL,135,135,876,400,1195,1066,741,C
1065,DEL,63,63,939,2880,4075,1066,876,D
1065,EL,1646,707,1646,2083,2083,1066,0,E
1065,FL,588,588,2234,210,2293,1066,1646,F
1065,GL,137,137,2371,375,2668,1066,2234,G
1065,HL,83,83,2454,5470,8138,1066,2371,H
1065,L,3876,1771,4225,3450,4094,1066,349,L
1065,M,179,179,4404,1200,9338,1066,4225,M
1065,N,1213,1213,5617,240,9578,1066,4404,N
1065,O,739,739,6356,760,10338,1066,5617,O
1065,P,119,119,6475,7680,18018,1066,6356,P
1066,AEI,459,459,459,742,742,1067,0,I
1066,AEJ,313,313,772,90,832,1067,459,J
1066,AEK,866,94,866,7756,7756,1067,0,A
1066,BEK,454,360,1226,820,1652,1067,772,K
1066,BEJ,1365,139,1365,2993,2993,1067,0,E
1066,BFJ,699,560,1925,305,1957,1067,1226,J
1066,BFK,722,722,2647,1060,3017,1067,1925,K
1066,BFL,34,34,2681,3780,6797,1067,2647,L
1066,BF,1663,347,3028,90,3083,1067,1365,F
1066,BG,900,900,3928,1220,4303,1067,3028,G
1066,BF,763,763,4691,430,4733,1067,3928,F
1066,BG,800,800,5491,1080,5813,1067,4691,G
1066,BH,744,744,6235,3780,9593,1067,5491,H
1066,B,6926,1557,7792,90,7846,1067,866,B
1066,C,842,842,8634,1215,9061,1067,7792,C
1066,B,1620,1620,10254,1225,10286,1067,8634,B
1066,C,738,738,10992,1060,11346,1067,10254,C
1066,D,835,835,11827,3780,15126,1067,10992,D
1066,M,8582,8582,20409,8660,23786,1067,11827,M
1066,N,112,112,20521,90,23876,1067,20409,N
1066,O,698,698,21219,1130,25006,1067,20521,O
1066,P,534,534,21753,3780,28786,1067,21219,P
1067,AE,48,48,48,198,198,1068,0,E
1067,AF,80,32,80,76,76,1068,0,A
1067,BF,86,86,166,150,226,1068,80,B
1067,CF,240,122,288,150,348,1068,48,F
1067,CG,202,80,368,455,681,1068,166,C
1067,DG,220,140,508,455,803,1068,288,G
1067,DH,861,721,1229,3565,4246,1068,368,D
1067,H,840,119,1348,3565,4368,1068,508,H
1067,M,83,83,1431,137,4505,1068,1348,M
1067,N,132,132,1563,135,4640,1068,1431,N
1067,O,210,210,1773,295,4935,1068,1563,O
1067,P,114,114,1887,5160,10095,1068,1773,P
1068,A,19,19,19,2344,2344,1069,0,A
1068,B,2738,2738,2757,420,2764,1069,19,B
1068,C,1712,1712,4469,1749,4513,1069,2757,C
1068,D,8340,8340,12809,2471,6984,1069,4469,D
1068,M,1131,1131,13940,1246,8230,1069,12809,M
1068,N,220,220,14160,150,8380,1069,13940,N
1068,O,144,144,14304,130,8510,1069,14160,O
1068,P,1869,1869,16173,550,9060,1069,14304,P
1069,AEI,237,237,237,965,965,1070,0,I
1069,AEJ,400,163,400,1460,1460,1070,0,E
1069,AFJ,1071,671,1071,1418,1418,1070,0,A
1069,BFJ,908,74,1145,240,1205,1070,237,J
1069,BFK,164,164,1309,415,1620,1070,1145,K
1069,BFL,15,15,1324,5160,6780,1070,1309,L
1069,BF,594,341,1665,300,1718,1070,1071,B
1069,CF,1300,35,1700,300,1760,1070,400,F
1069,CG,623,623,2323,770,2530,1070,1700,G
1069,CH,685,27,2350,825,2543,1070,1665,C
1069,DH,78,78,2428,5325,7868,1070,2350,D
1069,H,996,891,3319,5325,7855,1070,2323,H
1069,M,240,240,3559,673,8541,1070,3319,M
1069,N,614,614,4173,240,8781,1070,3559,N
1069,O,213,213,4386,380,9161,1070,4173,O
1069,P,73,73,4459,5460,14621,1070,4386,P
1070,A,383,383,383,832,832,1071,0,A
1070,B,569,569,952,180,1012,1071,383,B
1070,C,213,213,1165,265,1277,1071,952,C
1070,D,1335,1335,2500,6445,7722,1071,1165,D
1070,M,50,50,2550,123,7845,1071,2500,M
1070,N,260,260,2810,240,8085,1071,2550,N
1070,O,219,219,3029,290,8375,1071,2810,O
1070,P,772,772,3801,5160,13535,1071,3029,P
1071,AEI,61,61,61,1095,1095,1072,0,A
1071,BEI,729,668,729,1197,1197,1072,0,I
1071,BEJ,503,503,1232,90,1287,1072,729,J
1071,BEK,1277,45,1277,1421,1421,1072,0,E
1071,BFK,1221,5,1282,240,1335,1072,61,B
1071,CFK,232,227,1509,150,1571,1072,1277,F
1071,CGK,393,116,1625,795,2082,1072,1232,K
1071,CGL,572,456,2081,585,2156,1072,1509,G
1071,CFL,890,91,2172,1020,2355,1072,1282,C
1071,DFL,90,90,2262,4680,7035,1072,2172,D
1071,FL,545,364,2626,520,2676,1072,2081,F
1071,GL,1054,53,2679,3780,5862,1072,1625,L
1071,G,689,636,3315,665,3341,1072,2626,G
1071,H,1162,1162,4477,4230,7571,1072,3315,H
1071,M,1994,1994,6471,2166,9737,1072,4477,M
1071,N,202,202,6673,90,9827,1072,6471,N
1071,O,589,589,7262,820,10647,1072,6673,O
1071,P,75,75,7337,3780,14427,1072,7262,P
1072,AEI,28,28,28,138,138,1073,0,A
1072,BEI,133,105,133,1100,1100,1073,0,E
1072,BFI,276,171,304,240,378,1073,28,B
1072,CFI,1108,804,1108,1130,1130,1073,0,I
1072,CFJ,112,112,1220,150,1280,1073,1108,J
1072,CFK,925,9,1229,975,1353,1073,304,C
1072,DFK,1145,49,1278,240,1340,1073,133,F
1072,DGK,180,122,1400,455,1735,1073,1220,K
1072,DGL,865,743,2143,1075,2415,1073,1278,G
1072,DHL,64,64,2207,5720,8135,1073,2143,H
1072,DL,876,69,2276,3565,5300,1073,1400,L
1072,D,3519,2472,4748,5040,6393,1073,1229,D
1072,M,31,31,4779,114,8249,1073,4748,M
1072,N,172,172,4951,135,8384,1073,4779,N
1072,O,234,234,5185,290,8674,1073,4951,O
1072,P,1029,1029,6214,5160,13834,1073,5185,P
1073,A,29,29,29,1198,1198,1074,0,A
1073,B,1358,1358,1387,240,1438,1074,29,B
1073,C,845,845,2232,1020,2458,1074,1387,C
1073,D,1604,1604,3836,4680,7138,1074,2232,D
1073,M,766,766,4602,1443,8581,1074,3836,M
1073,N,797,797,5399,180,8761,1074,4602,N
1073,O,791,791,6190,795,9556,1074,5399,O
1073,P,1184,1184,7374,550,10106,1074,6190,P
1074,A,3689,3689,3689,3819,3819,1075,0,A
1074,B,160,160,3849,90,3909,1075,3689,B
1074,C,445,445,4294,795,4704,1075,3849,C
1074,B,1229,1229,5523,425,5129,1075,4294,B
1074,C,1341,1341,6864,1885,7014,1075,5523,C
1074,D,1403,1403,8267,3780,10794,1075,6864,D
1074,M,191,191,8458,1585,12379,1075,8267,M
1074,N,1647,1647,10105,300,12679,1075,8458,N
1074,O,733,733,10838,2065,14744,1075,10105,O
1074,P,1284,1284,12122,2760,17504,1075,10838,P
1075,AE,108,108,108,155,155,1076,0,A
1075,BE,166,166,274,150,305,1076,108,B
1075,CE,160,160,434,125,430,1076,274,C
1075,BE,462,28,462,991,991,1076,0,E
1075,BF,571,571,1033,90,1081,1076,462,F
1075,BG,858,259,1292,890,1320,1076,434,B
1075,CG,346,346,1638,645,1965,1076,1292,C
1075,DG,2924,2319,3957,2320,3401,1076,1033,G
1075,DH,3368,1049,5006,4230,6195,1076,1638,D
1075,H,2652,1603,6609,3420,6821,1076,3957,H
1075,M,1428,1428,8037,2680,9501,1076,6609,M
1075,N,1639,1639,9676,410,9911,1076,8037,N
1075,O,809,809,10485,815,10726,1076,9676,O
1075,P,4832,4832,15317,550,11276,1076,10485,P
1076,AE,129,129,129,2925,2925,1077,0,A
1076,BE,165,36,165,314,314,1077,0,E
1076,BF,259,259,424,180,494,1077,165,F
1076,BG,724,724,1148,985,1479,1077,424,G
1076,BH,946,946,2094,3495,4974,1077,1148,H
1076,B,2975,1010,3104,240,3165,1077,129,B
1076,C,763,763,3867,985,4150,1077,3104,C
1076,D,812,812,4679,5040,9190,1077,3867,D
1076,M,102,102,4781,151,9341,1077,4679,M
1076,N,127,127,4908,135,9476,1077,4781,N
1076,O,207,207,5115,295,9771,1077,4908,O
1076,P,30,30,5145,5100,14871,1077,5115,P
1077,AE,20,20,20,124,124,1078,0,E
1077,AF,234,234,254,135,259,1078,20,F
1077,AG,1028,1028,1282,385,644,1078,254,G
1077,AH,257,257,1539,5400,6044,1078,1282,H
1077,A,2061,522,2061,4179,4179,1078,0,A
1077,B,2311,2311,4372,240,4419,1078,2061,B
1077,C,792,792,5164,1015,5434,1078,4372,C
1077,B,1070,1070,6234,820,6254,1078,5164,B
1077,C,1445,1445,7679,1215,7469,1078,6234,C
1077,D,1496,1496,9175,3120,10589,1078,7679,D
1077,M,20,20,9195,511,11100,1078,9175,M
1077,N,678,678,9873,240,11340,1078,9195,N
1077,O,200,200,10073,385,11725,1078,9873,O
1077,N,261,261,10334,65,11790,1078,10073,N
1077,O,483,483,10817,785,12575,1078,10334,O
1077,P,1181,1181,11998,3960,16535,1078,10817,P
1078,AEI,238,238,238,1658,1658,1079,0,E
1078,AFI,513,275,513,3718,3718,1079,0,I
1078,AFJ,803,290,803,1171,1171,1079,0,A
1078,BFJ,516,516,1319,180,1351,1079,803,B
1078,CFJ,1625,544,1863,250,1908,1079,238,F
1078,CGJ,875,331,2194,945,2296,1079,1319,C
1078,DGJ,916,585,2779,915,2823,1079,1863,G
1078,DHJ,416,416,3195,550,3373,1079,2779,H
1078,DJ,1862,861,4056,550,2846,1079,2194,D
1078,J,3572,29,4085,420,4138,1079,513,J
1078,K,1169,1169,5254,1095,5233,1079,4085,K
1078,L,2626,2626,7880,550,5783,1079,5254,L
1078,M,11194,11194,19074,11766,17549,1079,7880,M
1078,N,727,727,19801,180,17729,1079,19074,N
1078,O,1283,1283,21084,830,18559,1079,19801,O
1078,N,217,217,21301,705,19264,1079,21084,N
1078,O,578,578,21879,695,19959,1079,21301,O
1078,P,44387,44387,66266,6960,26919,1079,21879,P
1079,A,332,332,332,2867,2867,1080,0,A
1079,B,914,914,1246,90,2957,1080,332,B
1079,C,1235,1235,2481,1430,4387,1080,1246,C
1079,D,1784,1784,4265,3780,8167,1080,2481,D
1079,M,545,545,4810,1264,9431,1080,4265,M
1079,N,745,745,5555,90,9521,1080,4810,N
1079,O,413,413,5968,795,10316,1080,5555,O
1079,P,1938,1938,7906,3780,14096,1080,5968,P
1080,AEI,42,42,42,1115,1115,1081,0,I
1080,AEJ,149,107,149,408,408,1081,0,A
1080,BEJ,446,446,595,240,648,1081,149,B
1080,CEJ,1256,703,1298,240,1355,1081,42,J
1080,CEK,976,273,1571,976,1624,1081,595,C
1080,BEK,1620,49,1620,3144,3144,1081,0,E
1080,BFK,608,559,2179,795,2419,1081,1571,B
1080,CFK,921,40,2219,1091,2446,1081,1298,K
1080,CFJ,420,380,2599,510,2929,1081,2179,C
1080,DFJ,510,130,2729,340,2786,1081,2219,J
1080,DFK,138,8,2737,3960,6889,1081,2599,D
1080,FK,131,123,2860,195,2981,1081,2729,K
1080,FL,1531,291,3151,90,3234,1081,1620,F
1080,GL,685,685,3836,1040,4274,1081,3151,G
1080,HL,1366,390,4226,5220,8201,1081,2860,L
1080,H,903,513,4739,3780,8054,1081,3836,H
1080,M,36026,36026,40765,36373,44574,1081,4739,M
1080,N,652,652,41417,90,44664,1081,40765,N
1080,O,1240,1240,42657,1385,46049,1081,41417,O
1080,N,1009,1009,43666,1135,47184,1081,42657,N
1080,O,725,725,44391,1060,48244,1081,43666,O
1080,P,160,160,44551,3780,52024,1081,44391,P
1081,AEI,93,93,93,1425,1425,1082,0,A
1081,BEI,160,67,160,1357,1357,1082,0,I
1081,BEJ,268,108,268,364,364,1082,0,E
1081,BFJ,200,200,468,150,514,1082,268,F
1081,BGJ,183,183,651,95,609,1082,468,G
1081,BFJ,131,131,782,245,854,1082,651,F
1081,BGJ,594,594,1376,606,1460,1082,782,G
1081,BHJ,1378,162,1538,240,1597,1082,160,J
1081,BHK,168,6,1544,364,1824,1082,1376,H
1081,BK,1514,63,1607,240,1665,1082,93,B
1081,CK,716,647,2254,760,2357,1082,1538,K
1081,CL,683,36,2290,760,2425,1082,1607,C
1081,DL,2320,2320,4610,7680,10105,1082,2290,D
1081,L,4121,1765,6375,7680,10037,1082,2254,L
1081,M,1222,1222,7597,1499,11604,1082,6375,M
1081,N,491,491,8088,240,11844,1082,7597,N
1081,O,869,869,8957,765,12609,1082,8088,O
1081,N,224,224,9181,295,12904,1082,8957,N
1081,O,958,958,10139,1260,14164,1082,9181,O
1081,P,460,460,10599,3960,18124,1082,10139,P
1082,AE,8578,8578,8578,8719,8719,1083,0,E
1082,AF,169,169,8747,90,8809,1083,8578,F
1082,AG,8999,252,8999,9191,9191,1083,0,A
1082,BG,759,507,9506,1105,9914,1083,8747,G
1082,BH,462,462,9968,3780,13694,1083,9506,H
1082,B,1756,787,10755,90,9281,1083,8999,B
1082,C,725,725,11480,1105,10386,1083,10755,C
1082,D,73,73,11553,3780,14166,1083,11480,D
1082,M,439,439,11992,793,14959,1083,11553,M
1082,N,652,652,12644,360,15319,1083,11992,N
1082,O,1176,1176,13820,1130,16449,1083,12644,O
1082,N,436,436,14256,480,16929,1083,13820,N
1082,O,158,158,14414,120,17049,1083,14256,O
1082,P,4412,4412,18826,550,17599,1083,14414,P
1083,A,107,107,107,125,125,1084,0,A
1083,B,90,90,197,120,245,1084,107,B
1083,C,174,174,371,100,345,1084,197,C
1083,D,1128,1128,1499,2880,3225,1084,371,D
1083,M,216,216,1715,269,3494,1084,1499,M
1083,N,141,141,1856,150,3644,1084,1715,N
1083,O,99,99,1955,60,3704,1084,1856,O
1083,P,914,914,2869,2880,6584,1084,1955,P
1084,AE,84,84,84,94,94,1085,0,E
1084,AF,165,81,165,1062,1062,1085,0,A
1084,BF,100,19,184,150,244,1085,84,F
1084,BG,164,164,348,455,699,1085,184,G
1084,BH,1017,834,1182,180,1242,1085,165,B
1084,CH,893,59,1241,3565,4264,1085,348,H
1084,C,930,871,2112,1050,2292,1085,1182,C
1084,D,791,791,2903,6460,8752,1085,2112,D
1084,M,337,337,3240,1334,10086,1085,2903,M
1084,N,1025,1025,4265,90,10176,1085,3240,N
1084,O,1018,1018,5283,1210,11386,1085,4265,O
1084,N,630,630,5913,440,11826,1085,5283,N
1084,O,743,743,6656,940,12766,1085,5913,O
1084,P,1272,1272,7928,3780,16546,1085,6656,P
1085,A,170,170,170,730,730,1086,0,A
1085,B,688,688,858,180,910,1086,170,B
1085,C,141,141,999,265,1175,1086,858,C
1085,D,4256,4256,5255,5425,6600,1086,999,D
1085,M,236,236,5491,868,7468,1086,5255,M
1085,N,841,841,6332,240,7708,1086,5491,N
1085,O,211,211,6543,240,7948,1086,6332,O
1085,P,4621,4621,11164,5100,13048,1086,6543,P
1086,AEI,54,54,54,317,317,1087,0,A
1086,BEI,117,63,117,278,278,1087,0,I
1086,BEJ,337,220,337,1188,1188,1087,0,E
1086,BFJ,332,49,386,135,452,1087,54,B
1086,CFJ,279,10,396,150,428,1087,117,J
1086,CFK,109,99,495,380,832,1087,386,C
1086,DFK,133,34,529,410,838,1087,396,K
1086,DFL,38,4,533,9250,10082,1087,495,D
1086,FL,241,237,770,1080,1918,1087,529,L
1086,F,1090,657,1427,240,1428,1087,337,F
1086,G,1209,1209,2636,1040,2468,1087,1427,G
1086,F,2431,2431,5067,2610,5078,1087,2636,F
1086,G,1546,1546,6613,1620,6698,1087,5067,G
1086,H,1129,1129,7742,3960,10658,1087,6613,H
1086,M,110,110,7852,214,10872,1087,7742,M
1086,N,194,194,8046,150,11022,1087,7852,N
1086,O,106,106,8152,90,11112,1087,8046,O
1086,N,282,282,8434,255,11367,1087,8152,N
1086,O,100,100,8534,90,11457,1087,8434,O
1086,P,7785,7785,16319,2900,14357,1087,8534,P
1087,AEI,160,160,160,187,187,1088,0,A
1087,BEI,175,15,175,1148,1148,1088,0,E
1087,BFI,115,100,275,150,337,1088,160,B
1087,CFI,330,55,330,465,465,1088,0,I
1087,CFJ,146,91,421,540,877,1088,275,C
1087,DFJ,203,112,533,120,585,1088,330,J
1087,DFK,304,304,837,560,1145,1088,533,K
1087,DFJ,766,350,1187,2850,3727,1088,421,D
1087,FJ,1066,54,1241,150,1298,1088,175,F
1087,GJ,406,2,1243,160,1305,1088,837,J
1087,GK,94,94,1337,80,1385,1088,1243,K
1087,GL,223,127,1464,110,1408,1088,1241,G
1087,FL,319,192,1656,2880,4265,1088,1337,L
1087,F,1224,1032,2688,1330,2738,1088,1464,F
1087,G,106,106,2794,135,2873,1088,2688,G
1087,H,113,113,2907,4230,7103,1088,2794,H
1087,M,101,101,3008,91,7194,1088,2907,M
1087,N,114,114,3122,180,7374,1088,3008,N
1087,O,140,140,3262,220,7594,1088,3122,O
1087,N,764,764,4026,675,8269,1088,3262,N
1087,O,626,626,4652,820,9089,1088,4026,O
1087,P,105,105,4757,3960,13049,1088,4652,P
1088,AEI,209,209,209,287,287,1089,0,I
1088,AEJ,258,258,467,240,527,1089,209,J
1088,AEK,727,260,727,1099,1099,1089,0,E
1088,AFK,524,264,991,500,1027,1089,467,K
1088,AFL,524,260,1251,180,1279,1089,727,F
1088,AGL,135,135,1386,150,1429,1089,1251,G
1088,AHL,232,232,1618,385,1814,1089,1386,H
1088,AL,1330,703,2321,550,1577,1089,991,L
1088,A,6063,3742,6063,6188,6188,1089,0,A
1088,B,342,342,6405,240,6428,1089,6063,B
1088,C,332,332,6737,325,6753,1089,6405,C
1088,D,1157,1157,7894,460,7213,1089,6737,D
1088,M,825,825,8719,1216,8429,1089,7894,M
1088,N,756,756,9475,420,8849,1089,8719,N
1088,O,1157,1157,10632,1259,10108,1089,9475,O
1088,P,1311,1311,11943,351,10459,1089,10632,P
1089,AEI,27,27,27,50,50,1090,0,A
1089,BEI,76,49,76,1791,1791,1090,0,I
1089,BEJ,170,121,197,150,200,1090,27,B
1089,CEJ,248,51,248,381,381,1090,0,E
1089,CFJ,135,84,332,455,655,1090,197,C
1089,DFJ,365,281,613,300,681,1090,248,F
1089,DGJ,950,950,1563,975,1656,1090,613,G
1089,DHJ,1835,348,1911,180,1971,1090,76,J
1089,DHK,712,364,2275,5040,6696,1090,1563,H
1089,DK,1101,737,3012,1140,3111,1090,1911,K
1089,DL,7,7,3019,5370,8481,1090,3012,L
1089,D,3746,1059,4078,3565,4220,1090,332,D
1089,M,50,50,4128,40,8521,1090,4078,M
1089,N,169,169,4297,240,8761,1090,4128,N
1089,O,225,225,4522,245,9006,1090,4297,O
1089,P,503,503,5025,5250,14256,1090,4522,P
1090,AEI,136,136,136,190,190,1091,0,A
1090,BEI,191,55,191,210,210,1091,0,I
1090,BEJ,140,85,276,150,340,1091,136,B
1090,CEJ,118,33,309,150,360,1091,191,J
1090,CEK,145,145,454,135,495,1091,309,K
1090,CEL,461,7,461,317,317,1091,0,E
1090,CFL,88,88,549,300,617,1091,461,F
1090,CGL,580,307,856,795,1135,1091,276,C
1090,DGL,641,239,1095,2880,3375,1091,454,L
1090,DG,558,12,1107,775,1392,1091,549,G
1090,DH,60,60,1167,6760,8152,1091,1107,H
1090,D,1636,1325,2492,2880,4015,1091,856,D
1090,M,48,48,2540,241,8393,1091,2492,M
1090,N,270,270,2810,135,8528,1091,2540,N
1090,O,262,262,3072,280,8808,1091,2810,O
1090,P,158,158,3230,5160,13968,1091,3072,P
1091,A,408,408,408,515,515,1092,0,A
1091,B,1547,1547,1955,1500,2015,1092,408,B
1091,C,862,862,2817,1000,3015,1092,1955,C
1091,B,1036,1036,3853,900,3915,1092,2817,B
1091,C,176,176,4029,260,4175,1092,3853,C
1091,D,70,70,4099,5100,9275,1092,4029,D
1091,M,407,407,4506,1247,10522,1092,4099,M
1091,N,215,215,4721,240,10762,1092,4506,N
1091,O,2330,2330,7051,785,11547,1092,4721,O
1091,N,352,352,7403,1045,12592,1092,7051,N
1091,O,978,978,8381,1285,13877,1092,7403,O
1091,P,12980,12980,21361,3960,17837,1092,8381,P
1092,AEI,178,178,178,1286,1286,1093,0,E
1092,AFI,1432,1254,1432,2556,2556,1093,0,I
1092,AFJ,1480,226,1658,300,1586,1093,178,F
1092,AGJ,1779,121,1779,2945,2945,1093,0,A
1092,BGJ,551,430,2209,1085,2671,1093,1658,G
1092,BHJ,3,3,2212,7560,10231,1093,2209,H
1092,BJ,1384,604,2816,300,2856,1093,1432,J
1092,BK,1438,401,3217,300,3245,1093,1779,B
1092,CK,179,179,3396,665,3910,1093,3217,C
1092,BK,683,103,3499,1095,3951,1093,2816,K
1092,BL,3,3,3502,6120,10071,1093,3499,L
1092,B,933,827,4329,460,4370,1093,3396,B
1092,C,493,493,4822,2690,7060,1093,4329,C
1092,D,8,8,4830,1905,8965,1093,4822,D
1092,M,670,670,5500,255,10486,1093,4830,M
1092,N,499,499,5999,960,11446,1093,5500,N
1092,O,445,445,6444,595,12041,1093,5999,O
1092,N,1431,1431,7875,1295,13336,1093,6444,N
1092,O,2566,2566,10441,1440,14776,1093,7875,O
1092,P,92,92,10533,2280,17056,1093,10441,P
1093,AEI,10,10,10,399,399,1094,0,A
1093,BEI,616,616,626,300,699,1094,10,B
1093,CEI,935,309,935,1113,1113,1094,0,E
1093,CFI,1050,115,1050,1449,1449,1094,0,I
1093,CFJ,624,200,1250,820,1519,1094,626,C
1093,DFJ,412,97,1347,300,1413,1094,935,F
1093,DGJ,104,7,1354,5315,6834,1094,1250,D
1093,GJ,641,337,1691,300,1749,1094,1050,J
1093,GK,921,577,2268,985,2398,1094,1347,G
1093,GK,577,0,2268,820,2569,1094,1691,K
1093,HL,82,82,2350,5315,7884,1094,2268,L
1093,H,1007,925,3275,5040,7438,1094,2268,H
1093,M,144,144,3419,167,8051,1094,3275,M
1093,N,106,106,3525,135,8186,1094,3419,N
1093,O,125,125,3650,280,8466,1094,3525,O
1093,P,256,256,3906,5160,13626,1094,3650,P
1094,AE,216,216,216,235,235,1095,0,A
1094,BE,467,251,467,1208,1208,1095,0,E
1094,BF,269,18,485,300,535,1095,216,B
1094,CF,678,678,1163,725,1260,1095,485,C
1094,DF,185,185,1348,1140,2400,1095,1163,D
1094,F,946,65,1413,240,1448,1095,467,F
1094,G,829,829,2242,1015,2463,1095,1413,G
1094,F,582,582,2824,485,2948,1095,2242,F
1094,G,406,406,3230,510,3458,1095,2824,G
1094,H,209,209,3439,3960,7418,1095,3230,H
1094,M,520,520,3959,697,8115,1095,3439,M
1094,N,327,327,4286,210,8325,1095,3959,N
1094,O,806,806,5092,1000,9325,1095,4286,O
1094,N,920,920,6012,725,10050,1095,5092,N
1094,O,560,560,6572,540,10590,1095,6012,O
1094,P,31411,31411,37983,2880,13470,1095,6572,P
1095,AE,5,5,5,170,170,1096,0,E
1095,AF,12,7,12,244,244,1096,0,A
1095,BF,354,354,366,150,394,1096,12,B
1095,CF,373,12,378,240,410,1096,5,F
1095,CG,485,473,851,725,1119,1096,366,C
1095,BG,621,148,999,725,1135,1096,378,G
1095,BF,274,126,1125,60,1179,1096,851,B
1095,CF,209,209,1334,175,1354,1096,1125,C
1095,DF,1148,1148,2482,4230,5584,1096,1334,D
1095,F,2948,1465,3947,2930,4065,1096,999,F
1095,G,3211,3211,7158,3240,7305,1096,3947,G
1095,H,753,753,7911,3960,11265,1096,7158,H
1095,M,337,337,8248,1099,12364,1096,7911,M
1095,N,849,849,9097,150,12514,1096,8248,N
1095,O,244,244,9341,180,12694,1096,9097,O
1095,N,333,333,9674,355,13049,1096,9341,N
1095,O,717,717,10391,775,13824,1096,9674,O
1095,P,665,665,11056,4230,18054,1096,10391,P
1096,AEI,45,45,45,153,153,1097,0,E
1096,AFI,198,198,243,150,303,1097,45,F
1096,AGI,347,104,347,336,336,1097,0,A
1096,BGI,408,61,408,494,494,1097,0,I
1096,BGJ,189,24,432,385,688,1097,243,G
1096,BHJ,109,24,456,180,516,1097,347,B
1096,CHJ,179,131,587,150,644,1097,408,J
1096,CHK,152,152,739,400,1044,1097,587,K
1096,CHL,46,46,785,5360,6404,1097,739,L
1096,CH,464,111,896,4600,5288,1097,432,H
1096,C,895,455,1351,1140,1656,1097,456,C
1096,D,170,170,1521,5370,7026,1097,1351,D
1096,M,199,199,1720,1217,8243,1097,1521,M
1096,N,1048,1048,2768,90,8333,1097,1720,N
1096,O,945,945,3713,1210,9543,1097,2768,O
1096,P,6,6,3719,3780,13323,1097,3713,P
1097,A,152,152,152,1202,1202,1098,0,A
1097,B,1244,1244,1396,240,1442,1098,152,B
1097,C,744,744,2140,760,2202,1098,1396,C
1097,D,1286,1286,3426,7680,9882,1098,2140,D
1097,M,4130,4130,7556,4330,14212,1098,3426,M
1097,N,414,414,7970,240,14452,1098,7556,N
1097,O,707,707,8677,765,15217,1098,7970,O
1097,N,276,276,8953,295,15512,1098,8677,N
1097,O,798,798,9751,1260,16772,1098,8953,O
1097,P,408,408,10159,3960,20732,1098,9751,P
1098,AEI,1030,1030,1030,1127,1127,1099,0,I
1098,AEJ,218,218,1248,180,1307,1099,1030,J
1098,AEK,175,175,1423,240,1547,1099,1248,K
1098,AEL,1696,273,1696,1911,1911,1099,0,A
1098,BEL,241,241,1937,90,2001,1099,1696,B
1098,CEL,919,919,2856,1150,3151,1099,1937,C
1098,BEL,1733,300,3156,4140,5687,1099,1423,L
1098,BE,4492,1336,4492,4674,4674,1099,0,E
1098,BF,208,208,4700,90,4764,1099,4492,F
1098,BG,2225,381,5081,1960,5111,1099,2856,B
1098,CG,895,514,5595,1145,5909,1099,4700,G
1098,CF,927,413,6008,1310,6421,1099,5081,C
1098,DF,437,437,6445,3780,10201,1099,6008,D
1098,F,2653,1803,8248,835,6744,1099,5595,F
1098,G,1456,1456,9704,1605,8349,1099,8248,G
1098,H,975,975,10679,3780,12129,1099,9704,H
1098,M,380,380,11059,624,12753,1099,10679,M
1098,N,448,448,11507,240,12993,1099,11059,N
1098,O,711,711,12218,810,13803,1099,11507,O
1098,P,18259,18259,30477,3960,17763,1099,12218,P
1099,AE,27,27,27,202,202,1100,0,A
1099,BE,35,8,35,197,197,1100,0,E
1099,BF,358,350,385,240,442,1100,27,B
1099,CF,360,10,395,240,437,1100,35,F
1099,CG,190,180,575,280,722,1100,385,C
1099,DG,231,51,626,285,722,1100,395,G
1099,DH,1205,1154,1780,5160,5882,1100,575,D
1099,H,2447,1293,3073,5160,5882,1100,626,H
1099,M,5447,5447,8520,5868,11750,1100,3073,M
1099,N,547,547,9067,180,11930,1100,8520,N
1099,O,888,888,9955,885,12815,1100,9067,O
1099,N,416,416,10371,405,13220,1100,9955,N
1099,O,519,519,10890,565,13785,1100,10371,O
1099,P,3299,3299,14189,6960,20745,1100,10890,P
1100,AEI,2,2,2,405,405,1101,0,I
1100,AEJ,39,37,39,1070,1070,1101,0,E
1100,AFJ,579,540,579,976,976,1101,0,A
1100,BFJ,598,21,600,240,645,1101,2,J
1100,BFK,590,569,1169,240,1216,1101,579,B
1100,CFK,1211,81,1250,240,1310,1101,39,F
1100,CGK,671,21,1271,960,1605,1101,600,K
1100,CGL,137,35,1306,400,1616,1101,1169,C
1100,BGL,331,296,1602,3960,5565,1101,1271,L
1100,BG,806,454,2056,940,2250,1101,1250,G
1100,BH,1516,766,2822,1250,2866,1101,1306,B
1100,CH,1048,282,3104,6990,9240,1101,2056,H
1100,C,623,341,3445,960,3826,1101,2822,C
1100,D,270,270,3715,3960,7786,1101,3445,D
1100,M,3087,3087,6802,3005,12245,1101,3715,M
1100,N,182,182,6984,300,12545,1101,6802,N
1100,O,984,984,7968,1005,13550,1101,6984,O
1100,P,466,466,8434,1200,14750,1101,7968,P
1101,AE,29,29,29,212,212,1102,0,A
1101,BE,60,31,60,90,90,1102,0,E
1101,BF,257,226,286,135,347,1102,29,B
1101,CF,278,52,338,300,390,1102,60,F
1101,CG,162,110,448,285,632,1102,286,C
1101,DG,158,158,606,5160,5792,1102,448,D
1101,G,615,347,953,780,1170,1102,338,G
1101,H,96,96,1049,1140,2310,1102,953,H
1101,M,737,737,1786,3267,9059,1102,1049,M
1101,N,2340,2340,4126,90,9149,1102,1786,N
1101,O,884,884,5010,1250,10399,1102,4126,O
1101,N,1912,1912,6922,1315,11714,1102,5010,N
1101,O,654,654,7576,890,12604,1102,6922,O
1101,P,147,147,7723,3780,16384,1102,7576,P
1102,AE,119,119,119,1163,1163,1103,0,E
1102,AF,267,148,267,388,388,1103,0,A
1102,BF,231,231,498,165,553,1103,267,B
1102,CF,596,596,1094,855,1408,1103,498,C
1102,DF,83,83,1177,3780,5188,1103,1094,D
1102,F,1230,172,1349,240,1403,1103,119,F
1102,G,1048,1048,2397,1091,2494,1103,1349,G
1102,H,42,42,2439,5600,8094,1103,2397,H
1102,M,86,86,2525,114,8208,1103,2439,M
1102,N,106,106,2631,135,8343,1103,2525,N
1102,O,240,240,2871,285,8628,1103,2631,O
1102,P,91,91,2962,5160,13788,1103,2871,P
1103,AE,115,115,115,218,218,1104,0,A
1103,BE,231,116,231,1084,1084,1104,0,E
1103,BF,188,72,303,150,368,1104,115,B
1103,CF,482,482,785,795,1163,1104,303,C
1103,DF,157,157,942,2880,4043,1104,785,D
1103,F,973,262,1204,180,1264,1104,231,F
1103,G,812,812,2016,1050,2314,1104,1204,G
1103,H,892,892,2908,6460,8774,1104,2016,H
1103,M,124,124,3032,198,8972,1104,2908,M
1103,N,154,154,3186,135,9107,1104,3032,N
1103,O,197,197,3383,385,9492,1104,3186,O
1103,P,656,656,4039,9245,18737,1104,3383,P
1104,AEI,121,121,121,1097,1097,1105,0,E
1104,AFI,1162,1162,1283,240,1337,1105,121,F
1104,AGI,870,870,2153,1020,2357,1105,1283,G
1104,AHI,60,60,2213,4680,7037,1105,2153,H
1104,AI,5740,3527,5740,5660,5660,1105,0,A
1104,BI,244,244,5984,300,5960,1105,5740,B
1104,CI,801,801,6785,1005,6965,1105,5984,C
1104,DI,974,974,7759,1200,8165,1105,6785,D
1104,I,14445,6686,14445,14440,14440,1105,0,I
1104,J,248,248,14693,300,14740,1105,14445,J
1104,K,913,913,15606,1005,15745,1105,14693,K
1104,L,563,563,16169,1260,17005,1105,15606,L
1104,M,2107,2107,18276,2293,19298,1105,16169,M
1104,N,204,204,18480,90,19388,1105,18276,N
1104,O,436,436,18916,820,20208,1105,18480,O
1104,N,585,585,19501,160,20368,1105,18916,N
1104,O,952,952,20453,1425,21793,1105,19501,O
1104,P,1010,1010,21463,3780,25573,1105,20453,P
1105,A,636,636,636,1381,1381,1106,0,A
1105,B,791,791,1427,90,1471,1106,636,B
1105,C,957,957,2384,1230,2701,1106,1427,C
1105,B,635,635,3019,375,3076,1106,2384,B
1105,C,507,507,3526,815,3891,1106,3019,C
1105,D,16440,16440,19966,3840,7731,1106,3526,D
1105,M,1061,1061,21027,1450,9181,1106,19966,M
1105,N,411,411,21438,90,9271,1106,21027,N
1105,O,484,484,21922,805,10076,1106,21438,O
1105,N,1147,1147,23069,815,10891,1106,21922,N
1105,O,487,487,23556,850,11741,1106,23069,O
1105,P,711,711,24267,3780,15521,1106,23556,P
1106,AE,50,50,50,119,119,1107,0,E
1106,AF,149,149,199,135,254,1107,50,F
1106,AG,714,714,913,845,1099,1107,199,G
1106,AH,3204,3204,4117,5280,6379,1107,913,H
1106,A,14845,10728,14845,14854,14854,1107,0,A
1106,B,309,309,15154,300,15154,1107,14845,B
1106,C,543,543,15697,735,15889,1107,15154,C
1106,D,167,167,15864,1560,17449,1107,15697,D
1106,M,37,37,15901,294,17743,1107,15864,M
1106,N,462,462,16363,240,17983,1107,15901,N
1106,O,1014,1014,17377,995,18978,1107,16363,O
1106,N,253,253,17630,270,19248,1107,17377,N
1106,O,629,629,18259,935,20183,1107,17630,O
1106,P,446,446,18705,3420,23603,1107,18259,P
1107,AEI,111,111,111,519,519,1108,0,I
1107,AEJ,129,18,129,475,475,1108,0,A
1107,BEJ,436,436,565,150,625,1108,129,B
1107,CEJ,531,77,642,180,699,1108,111,J
1107,CEK,464,464,1106,735,1434,1108,642,K
1107,CEL,1204,98,1204,1224,1224,1108,0,E
1107,CFL,142,44,1248,2880,4314,1108,1106,L
1107,CF,713,30,1278,855,1480,1108,565,C
1107,DF,112,38,1316,150,1374,1108,1204,F
1107,DG,157,157,1473,455,1829,1108,1316,G
1107,DH,887,887,2360,3565,5394,1108,1473,H
1107,D,1138,56,2416,2880,4360,1108,1278,D
1107,M,8,8,2424,1187,6581,1108,2416,M
1107,N,1362,1362,3786,240,6821,1108,2424,N
1107,O,838,838,4624,890,7711,1108,3786,O
1107,P,5974,5974,10598,5160,12871,1108,4624,P
1108,AE,966,966,966,1403,1403,1109,0,E
1108,AF,516,516,1482,120,1523,1109,966,F
1108,AG,960,960,2442,900,2423,1109,1482,G
1108,AH,3875,1433,3875,5825,5825,1109,0,A
1108,BH,1511,78,3953,385,2808,1109,2442,H
1108,B,2002,1924,5877,90,5915,1109,3875,B
1108,C,467,467,6344,735,6650,1109,5877,C
1108,B,319,319,6663,75,6725,1109,6344,B
1108,C,837,837,7500,1300,8025,1109,6663,C
1108,D,2751,2751,10251,3780,11805,1109,7500,D
1108,M,807,807,11058,1686,13491,1109,10251,M
1108,N,1617,1617,12675,780,14271,1109,11058,N
1108,O,4210,4210,16885,2579,16850,1109,12675,O
1108,P,4011,4011,20896,1096,17946,1109,16885,P
1109,AE,1,1,1,354,354,1110,0,A
1109,BE,399,398,399,938,938,1110,0,E
1109,BF,573,175,574,240,594,1110,1,B
1109,CF,645,470,1044,150,1088,1110,399,F
1109,CG,60,60,1104,50,1138,1110,1044,G
1109,CF,111,111,1215,135,1273,1110,1104,F
1109,CG,132,132,1347,235,1508,1110,1215,G
1109,CH,101,101,1448,5280,6788,1110,1347,H
1109,C,938,64,1512,1045,1639,1110,574,C
1109,B,2577,2577,4089,2490,4129,1110,1512,B
1109,C,2881,2881,6970,2880,7009,1110,4089,C
1109,D,1587,1587,8557,3960,10969,1110,6970,D
1109,M,103,103,8660,243,11212,1110,8557,M
1109,N,233,233,8893,150,11362,1110,8660,N
1109,O,185,185,9078,155,11517,1110,8893,O
1109,N,808,808,9886,830,12347,1110,9078,N
1109,O,119,119,10005,125,12472,1110,9886,O
1109,P,335,335,10340,4230,16702,1110,10005,P
1110,AE,380,380,380,250,250,1111,0,E
1110,AF,3,3,383,180,430,1111,380,F
1110,AG,1045,1045,1428,965,1395,1111,383,G
1110,AH,1078,1078,2506,385,1780,1111,1428,H
1110,A,7238,4732,7238,7488,7488,1111,0,A
1110,B,454,454,7692,240,7728,1111,7238,B
1110,C,741,741,8433,995,8723,1111,7692,C
1110,B,724,724,9157,410,9133,1111,8433,B
1110,C,905,905,10062,810,9943,1111,9157,C
1110,D,4874,4874,14936,3960,13903,1111,10062,D
1110,M,2963,2963,17899,7127,21030,1111,14936,M
1110,N,4664,4664,22563,90,21120,1111,17899,N
1110,O,1093,1093,23656,1340,22460,1111,22563,O
1110,P,201,201,23857,3780,26240,1111,23656,P
1111,AE,1524,1524,1524,1762,1762,1112,0,E
1111,AF,1627,103,1627,1697,1697,1112,0,A
1111,BF,119,16,1643,240,2002,1112,1524,F
1111,BG,277,261,1904,240,1937,1112,1627,B
1111,CG,608,608,2512,855,2792,1112,1904,C
1111,DG,1233,364,2876,2220,4222,1112,1643,G
1111,DF,1847,1847,4723,535,4757,1112,2876,F
1111,DG,1117,1117,5840,715,5472,1112,4723,G
1111,DH,824,824,6664,3960,9432,1112,5840,H
1111,D,4295,143,6807,3960,6752,1112,2512,D
1111,M,109,109,6916,219,9651,1112,6807,M
1111,N,320,320,7236,240,9891,1112,6916,N
1111,O,756,756,7992,1035,10926,1112,7236,O
1111,P,685,685,8677,3960,14886,1112,7992,P
1112,AEI,403,403,403,1131,1131,1113,0,I
1112,AEJ,823,823,1226,150,1281,1113,403,J
1112,AEK,204,204,1430,435,1716,1113,1226,K
1112,AEJ,2000,570,2000,2381,2381,1113,0,E
1112,AFJ,587,587,2587,240,2621,1113,2000,F
1112,AGJ,1504,347,2934,1245,2961,1113,1430,J
1112,AGK,643,296,3230,960,3581,1113,2587,G
1112,AFK,124,124,3354,670,4251,1113,3230,F
1112,AGK,667,247,3601,705,3666,1113,2934,K
1112,AGL,1263,1016,4617,600,4851,1113,3354,G
1112,AHL,1385,369,4986,4230,7896,1113,3601,L
1112,AH,7242,2256,7242,8474,8474,1113,0,A
1112,BH,1260,1260,8502,90,8564,1113,7242,B
1112,CH,218,218,8720,600,9164,1113,8502,C
1112,BH,1456,1456,10176,1070,10234,1113,8720,B
1112,CH,5982,423,10599,3960,8811,1113,4617,H
1112,C,1082,659,11258,1510,11744,1113,10176,C
1112,D,11284,11284,22542,3780,15524,1113,11258,D
1112,M,416,416,22958,1449,16973,1113,22542,M
1112,N,1191,1191,24149,180,17153,1113,22958,N
1112,O,776,776,24925,826,17979,1113,24149,O
1112,P,239,239,25164,4080,22059,1113,24925,P
1113,AE,59,59,59,1071,1071,1114,0,E
1113,AF,814,755,814,1386,1386,1114,0,A
1113,BF,1042,287,1101,90,1161,1114,59,F
1113,BG,634,347,1448,90,1476,1114,814,B
1113,CG,167,167,1615,605,2081,1114,1448,C
1113,DG,953,439,2054,1210,2371,1114,1101,G
1113,DF,497,497,2551,220,2591,1114,2054,F
1113,DG,186,186,2737,605,3196,1114,2551,G
1113,DH,1683,561,3298,3780,5861,1114,1615,D
1113,H,12347,11786,15084,3780,6976,1114,2737,H
1113,M,8640,8640,23724,10470,17446,1114,15084,M
1113,N,2079,2079,25803,300,17746,1114,23724,N
1113,O,1008,1008,26811,895,18641,1114,25803,O
1113,P,1860,1860,28671,550,19191,1114,26811,P
1114,A,4117,4117,4117,4379,4379,1115,0,A
1114,B,281,281,4398,90,4469,1115,4117,B
1114,C,547,547,4945,905,5374,1115,4398,C
1114,D,321,321,5266,3780,9154,1115,4945,D
1114,M,276,276,5542,1152,10306,1115,5266,M
1114,N,904,904,6446,90,10396,1115,5542,N
1114,O,381,381,6827,800,11196,1115,6446,O
1114,P,752,752,7579,3780,14976,1115,6827,P
1115,A,592,592,592,1454,1454,1116,0,A
1115,B,1102,1102,1694,300,1754,1116,592,B
1115,C,644,644,2338,665,2419,1116,1694,C
1115,D,4014,4014,6352,550,2969,1116,2338,D
1115,M,246,246,6598,482,3451,1116,6352,M
1115,N,191,191,6789,150,3601,1116,6598,N
1115,O,107,107,6896,420,4021,1116,6789,O
1115,N,608,608,7504,150,4171,1116,6896,N
1115,O,134,134,7638,240,4411,1116,7504,O
1115,P,19,19,7657,5040,9451,1116,7638,P
1116,A,335,335,335,1346,1346,1117,0,A
1116,B,1161,1161,1496,240,1586,1117,335,B
1116,C,5511,5511,7007,4020,5606,1117,1496,C
1116,B,349,349,7356,1725,7331,1117,7007,B
1116,C,580,580,7936,925,8256,1117,7356,C
1116,D,152,152,8088,3960,12216,1117,7936,D
1116,M,1532,1532,9620,1466,13682,1117,8088,M
1116,N,193,193,9813,300,13982,1117,9620,N
1116,O,800,800,10613,970,14952,1117,9813,O
1116,N,468,468,11081,350,15302,1117,10613,N
1116,O,216,216,11297,390,15692,1117,11081,O
1116,P,443,443,11740,3960,19652,1117,11297,P
1117,AE,176,176,176,223,223,1118,0,A
1117,BE,151,151,327,150,373,1118,176,B
1117,CE,156,156,483,110,483,1118,327,C
1117,DE,991,508,991,1010,1010,1118,0,E
1117,DF,596,88,1079,4230,4713,1118,483,D
1117,F,198,110,1189,240,1250,1118,991,F
1117,G,291,291,1480,355,1605,1118,1189,G
1117,H,1105,1105,2585,4020,5625,1118,1480,H
1117,M,198,198,2783,812,6437,1118,2585,M
1117,N,710,710,3493,150,6587,1118,2783,N
1117,O,158,158,3651,115,6702,1118,3493,O
1117,N,501,501,4152,535,7237,1118,3651,N
1117,O,3524,3524,7676,665,7902,1118,4152,O
1117,P,5460,5460,13136,4140,12042,1118,7676,P
1118,AEI,172,172,172,485,485,1119,0,E
1118,AFI,244,72,244,841,841,1119,0,A
1118,BFI,355,111,355,484,484,1119,0,I
1118,BFJ,218,218,573,150,634,1119,355,J
1118,BFK,28,28,601,100,734,1119,573,K
1118,BFJ,494,65,666,300,785,1119,172,F
1118,BGJ,474,409,1075,385,1119,1119,601,J
1118,BGK,965,134,1209,420,1261,1119,244,B
1118,CGK,169,35,1244,225,1344,1119,1075,K
1118,CGL,171,136,1380,280,1541,1119,1209,C
1118,BGL,1022,308,1688,985,1770,1119,666,G
1118,BFL,1418,974,2662,4740,6084,1119,1244,L
1118,BF,1128,154,2816,1105,2875,1119,1688,F
1118,BG,147,147,2963,225,3100,1119,2816,G
1118,BH,1758,175,3138,1645,3186,1119,1380,B
1118,CH,204,204,3342,225,3411,1119,3138,C
1118,DH,1480,1480,4822,4740,8151,1119,3342,D
1118,H,5576,3717,8539,4740,7840,1119,2963,H
1118,M,174,174,8713,314,8465,1119,8539,M
1118,N,315,315,9028,240,8705,1119,8713,N
1118,O,241,241,9269,295,9000,1119,9028,O
1118,N,574,574,9843,515,9515,1119,9269,N
1118,O,265,265,10108,295,9810,1119,9843,O
1118,P,755,755,10863,5160,14970,1119,10108,P
1119,AEI,92,92,92,1058,1058,1120,0,E
1119,AFI,162,70,162,1112,1112,1120,0,A
1119,BFI,1154,1084,1246,240,1298,1120,92,F
1119,BGI,1135,51,1297,240,1352,1120,162,B
1119,CGI,638,638,1935,705,2057,1120,1297,C
1119,DGI,703,14,1949,685,1983,1120,1246,G
1119,DHI,3029,1080,3029,3175,3175,1120,0,I
1119,DHJ,264,264,3293,180,3355,1120,3029,J
1119,DHK,135,135,3428,235,3590,1120,3293,K
1119,DHJ,871,871,4299,745,4335,1120,3428,J
1119,DHK,2529,179,4478,5760,7743,1120,1949,H
1119,DK,2714,171,4649,5820,7877,1120,1935,D
1119,K,693,343,4992,685,5020,1120,4299,K
1119,L,9721,9721,14713,5760,10780,1120,4992,L
1119,M,162,162,14875,315,11095,1120,14713,M
1119,N,425,425,15300,300,11395,1120,14875,N
1119,O,645,645,15945,870,12265,1120,15300,O
1119,P,188,188,16133,1620,13885,1120,15945,P
1120,AEI,32,32,32,1051,1051,1121,0,E
1120,AFI,48,16,48,151,151,1121,0,A
1120,BFI,307,307,355,240,391,1121,48,B
1120,CFI,378,23,378,310,310,1121,0,I
1120,CFJ,158,158,536,270,580,1121,378,J
1120,CFK,689,508,1044,960,1351,1121,355,C
1120,DFK,195,195,1239,3960,5311,1121,1044,D
1120,FK,1212,5,1244,240,1291,1121,32,F
1120,GK,1148,440,1684,1115,1695,1121,536,K
1120,GL,829,389,2073,890,2181,1121,1244,G
1120,HL,618,229,2302,335,2030,1121,1684,L
1120,H,3082,2853,5155,5160,7341,1121,2073,H
1120,M,7316,7316,12471,8957,16298,1121,5155,M
1120,N,1824,1824,14295,90,16388,1121,12471,N
1120,O,865,865,15160,1105,17493,1121,14295,O
1120,N,693,693,15853,580,18073,1121,15160,N
1120,O,997,997,16850,1275,19348,1121,15853,O
1120,P,370,370,17220,3780,23128,1121,16850,P
1121,AE,216,216,216,805,805,1122,0,E
1121,AF,308,92,308,1474,1474,1122,0,A
1121,BF,685,593,901,150,955,1122,216,F
1121,BG,96,96,997,100,1055,1122,901,G
1121,BF,600,600,1597,570,1625,1122,997,F
1121,BG,1351,62,1659,240,1714,1122,308,B
1121,CG,757,695,2354,660,2285,1122,1597,G
1121,CH,931,236,2590,1020,2734,1122,1659,C
1121,DH,242,242,2832,4680,7414,1122,2590,D
1121,H,1126,648,3480,4230,6515,1122,2354,H
1121,M,724,724,4204,808,8222,1122,3480,M
1121,N,244,244,4448,180,8402,1122,4204,N
1121,O,1004,1004,5452,930,9332,1122,4448,O
1121,P,1869,1869,7321,550,9882,1122,5452,P
1122,A,1107,1107,1107,1545,1545,1123,0,A
1122,B,648,648,1755,240,1785,1123,1107,B
1122,C,667,667,2422,925,2710,1123,1755,C
1122,D,1288,1288,3710,3960,6670,1123,2422,D
1122,M,63,63,3773,811,7481,1123,3710,M
1122,N,977,977,4750,240,7721,1123,3773,N
1122,O,670,670,5420,810,8531,1123,4750,O
1122,P,216,216,5636,3960,12491,1123,5420,P
1123,A,138,138,138,147,147,1124,0,A
1123,B,132,132,270,180,327,1124,138,B
1123,C,155,155,425,220,547,1124,270,C
1123,B,921,921,1346,840,1387,1124,425,B
1123,C,370,370,1716,735,2122,1124,1346,C
1123,D,1915,1915,3631,4140,6262,1124,1716,D
1123,M,1512,1512,5143,1648,7910,1124,3631,M
1123,N,232,232,5375,150,8060,1124,5143,N
1123,O,570,570,5945,585,8645,1124,5375,O
1123,N,744,744,6689,725,9370,1124,5945,N
1123,O,571,571,7260,1045,10415,1124,6689,O
1123,P,264,264,7524,3300,13715,1124,7260,P
1124,AEI,367,367,367,385,385,1125,0,A
1124,BEI,406,406,773,420,805,1125,367,B
1124,CEI,913,913,1686,1079,1884,1125,773,C
1124,DEI,4975,4975,6661,356,2240,1125,1686,D
1124,EI,6682,21,6682,7065,7065,1125,0,E
1124,FI,586,586,7268,240,7305,1125,6682,F
1124,GI,711,711,7979,970,8275,1125,7268,G
1124,HI,15593,7614,15593,15593,15593,1125,0,I
1124,HJ,194,194,15787,240,15833,1125,15593,J
1124,HK,726,726,16513,970,16803,1125,15787,K
1124,HL,466,466,16979,3960,20763,1125,16513,L
1124,H,10354,1354,18333,3960,12235,1125,7979,H
1124,M,1700,1700,20033,1834,22597,1125,18333,M
1124,N,160,160,20193,90,22687,1125,20033,N
1124,O,528,528,20721,905,23592,1125,20193,O
1124,P,348,348,21069,3780,27372,1125,20721,P
1125,AEI,393,393,393,452,452,1126,0,E
1125,AFI,206,206,599,180,632,1126,393,F
1125,AGI,122,122,721,205,837,1126,599,G
1125,AHI,847,126,847,1144,1144,1126,0,A
1125,BHI,408,408,1255,150,1294,1126,847,B
1125,CHI,665,131,1386,4140,4977,1126,721,H
1125,CI,178,47,1433,120,1414,1126,1255,C
1125,BI,1489,56,1489,1846,1846,1126,0,I
1125,BJ,312,256,1745,360,1774,1126,1433,B
1125,CJ,110,110,1855,120,1894,1126,1745,C
1125,DJ,544,178,2033,240,2086,1126,1489,J
1125,DK,929,929,2962,970,3056,1126,2033,K
1125,DJ,1318,211,3173,4230,6124,1126,1855,D
1125,J,1280,1069,4242,210,3266,1126,2962,J
1125,K,3043,3043,7285,2820,6086,1126,4242,K
1125,L,1236,1236,8521,3960,10046,1126,7285,L
1125,M,82,82,8603,352,10398,1126,8521,M
1125,N,390,390,8993,180,10578,1126,8603,N
1125,O,1858,1858,10851,1995,12573,1126,8993,O
1125,N,2507,2507,13358,2350,14923,1126,10851,N
1125,O,855,855,14213,1074,15997,1126,13358,O
1125,P,930,930,15143,351,16348,1126,14213,P
1126,AEI,98,98,98,343,343,1127,0,E
1126,AFI,183,85,183,1336,1336,1127,0,A
1126,BFI,250,67,250,760,760,1127,0,I
1126,BFJ,395,243,493,210,553,1127,98,F
1126,BGJ,153,153,646,255,808,1127,493,G
1126,BFJ,900,504,1150,300,1060,1127,250,J
1126,BFK,1344,377,1527,240,1576,1127,183,B
1126,CFK,924,43,1570,810,1618,1127,646,F
1126,CGK,889,469,2039,925,1985,1127,1150,K
1126,CGL,841,329,2368,890,2466,1127,1527,C
1126,DGL,892,94,2462,890,2508,1127,1570,G
1126,DHL,270,176,2638,5160,7626,1127,2368,D
1126,HL,1778,1602,4240,5160,7668,1127,2462,H
1126,L,3899,1698,5938,2760,4745,1127,2039,L
1126,M,7377,7377,13315,8372,16040,1127,5938,M
1126,N,1027,1027,14342,90,16130,1127,13315,N
1126,O,634,634,14976,935,17065,1127,14342,O
1126,P,610,610,15586,3780,20845,1127,14976,P
1127,AEI,262,262,262,120,120,1128,0,A
1127,BEI,98,98,360,300,420,1128,262,B
1127,CEI,499,139,499,842,842,1128,0,E
1127,CFI,389,389,888,90,932,1128,499,F
1127,CGI,940,412,1300,1020,1440,1128,360,C
1127,BGI,850,438,1738,1275,2207,1128,888,G
1127,BHI,445,7,1745,270,1710,1128,1300,B
1127,CHI,2114,369,2114,2192,2192,1128,0,I
1127,CHJ,592,223,2337,750,2460,1128,1745,C
1127,DHJ,246,23,2360,180,2372,1128,2114,J
1127,DHK,827,827,3187,930,3302,1128,2360,K
1127,DHL,3340,1891,5078,3780,5987,1128,1738,H
1127,DL,6572,4681,9759,550,3852,1128,3187,L
1127,D,9166,1744,11503,3960,6420,1128,2337,D
1127,M,384,384,11887,895,7315,1128,11503,M
1127,N,745,745,12632,270,7585,1128,11887,N
1127,O,926,926,13558,1042,8627,1128,12632,O
1127,P,18,18,13576,333,8960,1128,13558,P
1128,AE,1222,1222,1222,1270,1270,1129,0,A
1128,BE,228,228,1450,240,1510,1129,1222,B
1128,CE,746,746,2196,875,2385,1129,1450,C
1128,BE,564,564,2760,310,2695,1129,2196,B
1128,CE,876,876,3636,1065,3760,1129,2760,C
1128,DE,4088,452,4088,4472,4472,1129,0,E
1128,DF,424,424,4512,120,4592,1129,4088,F
1128,DG,215,215,4727,390,4982,1129,4512,G
1128,DF,1423,1423,6150,1225,6207,1129,4727,F
1128,DG,665,665,6815,820,7027,1129,6150,G
1128,DH,350,350,7165,5040,12067,1129,6815,H
1128,D,5384,1855,9020,3960,7720,1129,3636,D
1128,M,1423,1423,10443,1618,13685,1129,9020,M
1128,N,551,551,10994,420,14105,1129,10443,N
1128,O,761,761,11755,945,15050,1129,10994,O
1128,P,2932,2932,14687,5600,20650,1129,11755,P
1129,A,931,931,931,1414,1414,1130,0,A
1129,B,511,511,1442,90,1504,1130,931,B
1129,C,855,855,2297,1230,2734,1130,1442,C
1129,D,221,221,2518,3780,6514,1130,2297,D
1129,M,527,527,3045,897,7411,1130,2518,M
1129,N,406,406,3451,90,7501,1130,3045,N
1129,O,406,406,3857,795,8296,1130,3451,O
1129,P,1358,1358,5215,3780,12076,1130,3857,P
1130,A,1317,1317,1317,1550,1550,1131,0,A
1130,B,263,263,1580,90,1640,1131,1317,B
1130,C,1357,1357,2937,1760,3400,1131,1580,C
1130,B,586,586,3523,175,3575,1131,2937,B
1130,C,649,649,4172,1125,4700,1131,3523,C
1130,D,2314,2314,6486,3780,8480,1131,4172,D
1130,M,1238,1238,7724,2038,10518,1131,6486,M
1130,N,2000,2000,9724,1260,11778,1131,7724,N
1130,O,422,422,10146,400,12178,1131,9724,O
1130,P,8600,8600,18746,425,12603,1131,10146,P
1131,A,1232,1232,1232,1300,1300,1132,0,A
1131,B,107,107,1339,90,1390,1132,1232,B
1131,C,741,741,2080,1105,2495,1132,1339,C
1131,D,476,476,2556,3780,6275,1132,2080,D
1131,M,599,599,3155,1132,7407,1132,2556,M
1131,N,562,562,3717,90,7497,1132,3155,N
1131,O,348,348,4065,705,8202,1132,3717,O
1131,P,9,9,4074,3780,11982,1132,4065,P
1132,A,579,579,579,1350,1350,1133,0,A
1132,B,829,829,1408,120,1470,1133,579,B
1132,C,231,231,1639,145,1615,1133,1408,C
1132,B,356,356,1995,440,2055,1133,1639,B
1132,C,123,123,2118,540,2595,1133,1995,C
1132,D,900,900,3018,2850,5445,1133,2118,D
1132,M,172,172,3190,201,5646,1133,3018,M
1132,N,112,112,3302,150,5796,1133,3190,N
1132,O,143,143,3445,130,5926,1133,3302,O
1132,N,1178,1178,4623,1155,7081,1133,3445,N
1132,O,588,588,5211,815,7896,1133,4623,O
1132,P,3400,3400,8611,3840,11736,1133,5211,P
1133,AE,3066,3066,3066,4561,4561,1134,0,A
1133,BE,1589,1589,4655,90,4651,1134,3066,B
1133,CE,5409,754,5409,6008,6008,1134,0,E
1133,CF,1049,295,5704,1360,6011,1134,4655,C
1133,BF,624,329,6033,120,6128,1134,5409,F
1133,BG,211,211,6244,390,6518,1134,6033,G
1133,BF,1449,1449,7693,1225,7743,1134,6244,F
1133,BG,691,691,8384,810,8553,1134,7693,G
1133,BH,344,344,8728,5040,13593,1134,8384,H
1133,B,5526,2502,11230,5255,11266,1134,5704,B
1133,C,655,655,11885,1130,12396,1134,11230,C
1133,D,19178,19178,31063,3780,16176,1134,11885,D
1133,M,338,338,31401,3209,19385,1134,31063,M
1133,N,3064,3064,34465,240,19625,1134,31401,N
1133,O,947,947,35412,970,20595,1134,34465,O
1133,N,438,438,35850,335,20930,1134,35412,N
1133,O,426,426,36276,570,21500,1134,35850,O
1133,P,7269,7269,43545,3960,25460,1134,36276,P
1134,A,360,360,360,505,505,1135,0,A
1134,B,775,775,1135,720,1225,1135,360,B
1134,C,85,85,1220,270,1495,1135,1135,C
1134,B,402,402,1622,190,1685,1135,1220,B
1134,C,598,598,2220,1350,3035,1135,1622,C
1134,D,805,805,3025,3480,6515,1135,2220,D
1134,M,11325,11325,14350,11470,17985,1135,3025,M
1134,N,403,403,14753,300,18285,1135,14350,N
1134,O,711,711,15464,695,18980,1135,14753,O
1134,P,1229,1229,16693,1140,20120,1135,15464,P
1135,A,40,40,40,3827,3827,1136,0,A
1135,B,3907,3907,3947,180,4007,1136,40,B
1135,C,338,338,4285,750,4757,1136,3947,C
1135,D,1608,1608,5893,5400,10157,1136,4285,D
1135,M,165,165,6058,1357,11514,1136,5893,M
1135,N,1374,1374,7432,240,11754,1136,6058,N
1135,O,674,674,8106,780,12534,1136,7432,O
1135,P,2526,2526,10632,7680,20214,1136,8106,P
1136,AE,165,165,165,258,258,1137,0,E
1136,AF,262,262,427,220,478,1137,165,F
1136,AG,1035,1035,1462,990,1468,1137,427,G
1136,AH,1568,106,1568,2048,2048,1137,0,A
1136,BH,852,852,2420,420,2468,1137,1568,B
1136,CH,1461,503,2923,385,1853,1137,1462,H
1136,C,926,423,3346,880,3348,1137,2420,C
1136,D,398,398,3744,550,3898,1137,3346,D
1136,M,796,796,4540,1343,5241,1137,3744,M
1136,N,932,932,5472,420,5661,1137,4540,N
1136,O,2145,2145,7617,2049,7710,1137,5472,O
1136,P,12,12,7629,846,8556,1137,7617,P
1137,A,777,777,777,795,795,1138,0,A
1137,B,394,394,1171,420,1215,1138,777,B
1137,C,781,781,1952,942,2157,1138,1171,C
1137,D,173,173,2125,318,2475,1138,1952,D
1137,M,450,450,2575,1551,4026,1138,2125,M
1137,N,1120,1120,3695,90,4116,1138,2575,N
1137,O,1888,1888,5583,2095,6211,1138,3695,O
1137,P,2013,2013,7596,3780,9991,1138,5583,P
1138,AEI,121,121,121,388,388,1139,0,A
1138,BEI,320,199,320,1045,1045,1139,0,I
1138,BEJ,437,238,558,240,628,1139,121,B
1138,CEJ,1084,526,1084,1408,1408,1139,0,E
1138,CFJ,885,121,1205,210,1255,1139,320,J
1138,CFK,258,258,1463,285,1540,1139,1205,K
1138,CFJ,921,16,1479,975,1603,1139,558,C
1138,BFJ,556,161,1640,300,1708,1139,1084,F
1138,BGJ,606,445,2085,535,2138,1139,1479,B
1138,CGJ,138,138,2223,290,2428,1139,2085,C
1138,DGJ,20,20,2243,5100,7528,1139,2223,D
1138,GJ,930,150,2393,900,2440,1139,1463,J
1138,GK,774,21,2414,820,2528,1139,1640,G
1138,FK,126,105,2519,300,2740,1139,2393,K
1138,FL,4,4,2523,5100,7840,1139,2519,L
1138,F,870,761,3284,825,3353,1139,2414,F
1138,G,102,102,3386,290,3643,1139,3284,G
1138,H,14,14,3400,5100,8743,1139,3386,H
1138,M,4053,4053,7453,4351,13094,1139,3400,M
1138,N,413,413,7866,120,13214,1139,7453,N
1138,O,9,9,7875,120,13334,1139,7866,O
1138,N,218,218,8093,165,13499,1139,7875,N
1138,O,684,684,8777,810,14309,1139,8093,O
1138,P,249,249,9026,5040,19349,1139,8777,P
1139,AEI,32,32,32,418,418,1140,0,A
1139,BEI,112,80,112,156,156,1140,0,E
1139,BFI,132,132,244,150,306,1140,112,F
1139,BGI,184,184,428,455,761,1140,244,G
1139,BHI,514,118,546,180,598,1140,32,B
1139,CHI,484,484,1030,735,1333,1140,546,C
1139,DHI,1127,97,1127,1386,1386,1140,0,I
1139,DHJ,147,50,1177,2880,4213,1140,1030,D
1139,HJ,439,389,1566,240,1626,1140,1127,J
1139,HK,833,833,2399,985,2611,1140,1566,K
1139,HL,812,812,3211,5040,7651,1140,2399,L
1139,H,3720,937,4148,3565,4326,1140,428,H
1139,M,26,26,4174,909,8560,1140,4148,M
1139,N,961,961,5135,135,8695,1140,4174,N
1139,O,766,766,5901,685,9380,1140,5135,O
1139,P,790,790,6691,5760,15140,1140,5901,P
1140,AE,111,111,111,737,737,1141,0,A
1140,BE,802,802,913,150,887,1141,111,B
1140,CE,149,149,1062,225,1112,1141,913,C
1140,DE,1909,1909,2971,4170,5282,1141,1062,D
1140,E,6302,3331,6302,6506,6506,1141,0,E
1140,F,411,411,6713,240,6746,1141,6302,F
1140,G,711,711,7424,920,7666,1141,6713,G
1140,H,68,68,7492,3960,11626,1141,7424,H
1140,M,17,17,7509,831,12457,1141,7492,M
1140,N,1019,1019,8528,240,12697,1141,7509,N
1140,O,702,702,9230,1045,13742,1141,8528,O
1140,P,3453,3453,12683,3960,17702,1141,9230,P
1141,AE,299,299,299,939,939,1142,0,A
1141,BE,724,425,724,1129,1129,1142,0,E
1141,BF,914,489,1213,300,1239,1142,299,B
1141,CF,680,191,1404,300,1429,1142,724,F
1141,CG,623,432,1836,760,1999,1142,1213,C
1141,DG,1755,1323,3159,760,2189,1142,1404,G
1141,DH,1368,45,3204,3960,5959,1142,1836,D
1141,H,596,551,3755,3960,6149,1142,3159,H
1141,M,56,56,3811,242,6391,1142,3755,M
1141,N,397,397,4208,240,6631,1142,3811,N
1141,O,604,604,4812,695,7326,1142,4208,O
1141,N,3343,3343,8155,3250,10576,1142,4812,N
1141,O,821,821,8976,1620,12196,1142,8155,O
1141,P,333,333,9309,3960,16156,1142,8976,P
1142,A,1261,1261,1261,1420,1420,1143,0,A
1142,B,292,292,1553,150,1570,1143,1261,B
1142,C,628,628,2181,585,2155,1143,1553,C
1142,B,263,263,2444,340,2495,1143,2181,B
1142,C,145,145,2589,130,2625,1143,2444,C
1142,D,4282,4282,6871,4230,6855,1143,2589,D
1142,M,141,141,7012,157,7012,1143,6871,M
1142,N,114,114,7126,150,7162,1143,7012,N
1142,O,192,192,7318,130,7292,1143,7126,O
1142,N,854,854,8172,910,8202,1143,7318,N
1142,O,1686,1686,9858,650,8852,1143,8172,O
1142,P,681,681,10539,4230,13082,1143,9858,P
1143,AE,153,153,153,710,710,1144,0,E
1143,AF,258,105,258,1076,1076,1144,0,A
1143,BF,676,571,829,180,890,1144,153,F
1143,BG,143,143,972,375,1265,1144,829,G
1143,BH,37,37,1009,5470,6735,1144,972,H
1143,B,908,157,1166,150,1226,1144,258,B
1143,C,780,780,1946,1050,2276,1144,1166,C
1143,D,3837,3837,5783,3490,5766,1144,1946,D
1143,M,62,62,5845,808,7543,1144,5783,M
1143,N,925,925,6770,240,7783,1144,5845,N
1143,O,210,210,6980,515,8298,1144,6770,O
1143,P,1452,1452,8432,6150,14448,1144,6980,P
1144,AEI,13,13,13,114,114,1145,0,E
1144,AFI,63,50,63,554,554,1145,0,A
1144,BFI,106,43,106,148,148,1145,0,I
1144,BFJ,277,184,290,240,354,1145,13,F
1144,BGJ,232,48,338,240,388,1145,106,J
1144,BGK,202,154,492,515,869,1145,290,G
1144,BHK,220,66,558,515,903,1145,338,K
1144,BHL,677,182,740,240,794,1145,63,B
1144,CHL,173,173,913,515,1309,1145,740,C
1144,DHL,787,432,1345,6150,7053,1145,558,L
1144,DH,6614,5761,7106,6150,7019,1145,492,H
1144,D,6679,486,7592,6150,7459,1145,913,D
1144,M,3234,3234,10826,4194,11653,1145,7592,M
1144,N,982,982,11808,90,11743,1145,10826,N
1144,O,1045,1045,12853,1255,12998,1145,11808,O
1144,P,98,98,12951,3780,16778,1145,12853,P
1145,AE,177,177,177,190,190,1146,0,A
1145,BE,216,216,393,240,430,1146,177,B
1145,CE,152,152,545,290,720,1146,393,C
1145,DE,768,768,1313,5100,5820,1146,545,D
1145,E,1462,149,1462,1554,1554,1146,0,E
1145,F,215,215,1677,150,1704,1146,1462,F
1145,G,464,464,2141,470,2174,1146,1677,G
1145,F,467,467,2608,475,2649,1146,2141,F
1145,G,257,257,2865,110,2759,1146,2608,G
1145,H,863,863,3728,4230,6989,1146,2865,H
1145,M,161,161,3889,255,7244,1146,3728,M
1145,N,183,183,4072,150,7394,1146,3889,N
1145,O,105,105,4177,540,7934,1146,4072,O
1145,P,763,763,4940,2850,10784,1146,4177,P
1146,AEI,178,178,178,600,600,1147,0,A
1146,BEI,482,304,482,1430,1430,1147,0,I
1146,BEJ,628,324,806,270,870,1147,178,B
1146,CEJ,1042,236,1042,2947,2947,1147,0,E
1146,CFJ,637,401,1443,735,1605,1147,806,C
1146,BFJ,1456,495,1938,540,1970,1147,482,J
1146,BFK,1089,594,2532,985,2590,1147,1443,B
1146,CFK,125,125,2657,200,2790,1147,2532,C
1146,DFK,757,38,2695,975,2945,1147,1938,K
1146,DFJ,2105,452,3147,270,3217,1147,1042,F
1146,DGJ,504,504,3651,735,3952,1147,3147,G
1146,DFJ,1479,485,4136,3780,6570,1147,2657,D
1146,FJ,1666,225,4361,1515,4460,1147,2695,J
1146,FK,1221,511,4872,980,4932,1147,3651,F
1146,GK,134,134,5006,200,5132,1147,4872,G
1146,HK,832,187,5193,708,5168,1147,4361,K
1146,HL,215,28,5221,3780,8912,1147,5006,H
1146,L,218,190,5411,402,5570,1147,5193,L
1146,M,4128,4128,9539,4204,13116,1147,5411,M
1146,N,226,226,9765,210,13326,1147,9539,N
1146,O,434,434,10199,450,13776,1147,9765,O
1146,N,24,24,10223,89,13865,1147,10199,N
1146,O,696,696,10919,901,14766,1147,10223,O
1146,N,1400,1400,12319,1105,15871,1147,10919,N
1146,O,707,707,13026,910,16781,1147,12319,O
1146,P,20949,20949,33975,5160,21941,1147,13026,P
1147,AEI,63,63,63,762,762,1148,0,A
1147,BEI,94,31,94,677,677,1148,0,E
1147,BFI,770,770,864,240,917,1148,94,F
1147,BGI,882,81,945,240,1002,1148,63,B
1147,CGI,144,63,1008,300,1217,1148,864,G
1147,CHI,184,121,1129,295,1297,1148,945,C
1147,DHI,1603,474,1603,2673,2673,1148,0,I
1147,DHJ,771,176,1779,5100,6317,1148,1008,H
1147,DJ,1124,948,2727,90,2763,1148,1603,J
1147,DK,1934,336,3063,5220,6517,1148,1129,D
1147,K,551,215,3278,915,3678,1148,2727,K
1147,J,1645,1645,4923,1280,4958,1148,3278,J
1147,K,1105,1105,6028,1425,6383,1148,4923,K
1147,L,1488,1488,7516,3780,10163,1148,6028,L
1147,M,2031,2031,9547,2671,12834,1148,7516,M
1147,N,789,789,10336,180,13014,1148,9547,N
1147,O,765,765,11101,895,13909,1148,10336,O
1147,N,443,443,11544,320,14229,1148,11101,N
1147,O,425,425,11969,565,14794,1148,11544,O
1147,P,2671,2671,14640,6960,21754,1148,11969,P
1148,AEI,19,19,19,129,129,1149,0,A
1148,BEI,185,185,204,135,264,1149,19,B
1148,CEI,277,73,277,930,930,1149,0,E
1148,CFI,177,104,381,285,549,1149,204,C
1148,DFI,421,40,421,1270,1270,1149,0,I
1148,DFJ,163,123,544,5160,5709,1149,381,D
1148,FJ,851,584,1128,240,1170,1149,277,F
1148,GJ,1096,389,1517,240,1510,1149,421,J
1148,GK,755,366,1883,1015,2185,1149,1128,G
1148,FK,887,521,2404,1040,2550,1149,1517,K
1148,FJ,908,387,2791,650,2835,1149,1883,F
1148,GJ,176,176,2967,385,3220,1149,2791,G
1148,HJ,747,184,3151,690,3240,1149,2404,J
1148,HK,1066,1066,4217,1141,4381,1149,3151,K
1148,HL,449,449,4666,4020,8401,1149,4217,L
1148,H,1887,188,4854,3960,7180,1149,2967,H
1148,M,872,872,5726,1207,9608,1149,4854,M
1148,N,463,463,6189,180,9788,1149,5726,N
1148,O,737,737,6926,885,10673,1149,6189,O
1148,P,859,859,7785,6680,17353,1149,6926,P
1149,AEI,14,14,14,236,236,1150,0,I
1149,AEJ,188,174,188,338,338,1150,0,A
1149,BEJ,227,227,415,135,473,1150,188,B
1149,CEJ,473,72,487,300,536,1150,14,J
1149,CEK,498,11,498,3557,3557,1150,0,E
1149,CFK,89,78,576,375,911,1150,487,K
1149,CFJ,710,549,1125,845,1318,1150,415,C
1149,DFJ,1662,1113,2238,2820,3731,1150,576,J
1149,DFK,1765,652,2890,5220,6538,1150,1125,D
1149,FK,913,261,3151,945,4676,1150,2238,K
1149,FJ,3181,528,3679,180,3737,1150,498,F
1149,GJ,838,838,4517,835,4572,1150,3679,G
1149,FJ,683,683,5200,685,5257,1150,4517,F
1149,GJ,717,717,5917,845,6102,1150,5200,G
1149,HJ,3093,327,6244,4485,9161,1150,3151,J
1149,HK,628,628,6872,820,9981,1150,6244,K
1149,HL,325,325,7197,8355,18336,1150,6872,L
1149,H,4838,3558,10755,5220,11322,1150,5917,H
1149,M,5744,5744,16499,5869,24205,1150,10755,M
1149,N,348,348,16847,240,24445,1150,16499,N
1149,O,707,707,17554,995,25440,1150,16847,O
1149,N,542,542,18096,260,25700,1150,17554,N
1149,O,485,485,18581,900,26600,1150,18096,O
1149,P,482,482,19063,3960,30560,1150,18581,P
1150,AE,47,47,47,1085,1085,1151,0,A
1150,BE,1029,982,1029,1187,1187,1151,0,E
1150,BF,1068,86,1115,90,1175,1151,47,B
1150,CF,189,103,1218,90,1277,1151,1029,F
1150,CG,1006,903,2121,1210,2385,1151,1115,C
1150,DG,919,16,2137,1240,2517,1151,1218,G
1150,DH,35,35,2172,3780,6297,1151,2137,H
1150,D,123,72,2244,3780,6165,1151,2121,D
1150,M,325,325,2569,1061,7358,1151,2244,M
1150,N,773,773,3342,90,7448,1151,2569,N
1150,O,695,695,4037,1080,8528,1151,3342,O
1150,P,165,165,4202,3780,12308,1151,4037,P
1151,AE,2911,2911,2911,5892,5892,1152,0,A
1151,BE,3084,3084,5995,150,6042,1152,2911,B
1151,CE,238,238,6233,275,6317,1152,5995,C
1151,DE,834,834,7067,4200,10517,1152,6233,D
1151,E,20137,13070,20137,21938,21938,1152,0,E
1151,F,2826,2826,22963,90,22028,1152,20137,F
1151,G,714,714,23677,1120,23148,1152,22963,G
1151,H,441,441,24118,3780,26928,1152,23677,H
1151,M,365,365,24483,660,27588,1152,24118,M
1151,N,487,487,24970,240,27828,1152,24483,N
1151,O,523,523,25493,815,28643,1152,24970,O
1151,P,235,235,25728,3960,32603,1152,25493,P
1152,A,2377,2377,2377,4252,4252,1153,0,A
1152,B,1913,1913,4290,90,4342,1153,2377,B
1152,C,404,404,4694,805,5147,1153,4290,C
1152,B,1461,1461,6155,1040,6187,1153,4694,B
1152,C,725,725,6880,1060,7247,1153,6155,C
1152,D,867,867,7747,3780,11027,1153,6880,D
1152,M,1192,1192,8939,1309,12336,1153,7747,M
1152,N,147,147,9086,90,12426,1153,8939,N
1152,O,818,818,9904,1130,13556,1153,9086,O
1152,P,428,428,10332,3780,17336,1153,9904,P
1153,A,6895,6895,6895,6876,6876,1154,0,A
1153,B,221,221,7116,300,7176,1154,6895,B
1153,C,705,705,7821,835,8011,1154,7116,C
1153,D,173,173,7994,4080,12091,1154,7821,D
1153,M,217,217,8211,395,12486,1154,7994,M
1153,N,221,221,8432,90,12576,1154,8211,N
1153,O,1509,1509,9941,1780,14356,1154,8432,O
1153,N,613,613,10554,345,14701,1154,9941,N
1153,O,687,687,11241,965,15666,1154,10554,O
1153,P,6058,6058,17299,3780,19446,1154,11241,P
1154,A,137,137,137,172,172,1155,0,A
1154,B,212,212,349,240,412,1155,137,B
1154,C,693,693,1042,975,1387,1155,349,C
1154,D,3825,3825,4867,5040,6427,1155,1042,D
1154,M,82,82,4949,175,6602,1155,4867,M
1154,N,275,275,5224,240,6842,1155,4949,N
1154,O,163,163,5387,285,7127,1155,5224,O
1154,P,1454,1454,6841,5160,12287,1155,5387,P
1155,AE,109,109,109,626,626,1156,0,A
1155,BE,189,80,189,1383,1383,1156,0,E
1155,BF,700,620,809,240,866,1156,109,B
1155,CF,271,271,1080,435,1301,1156,809,C
1155,BF,288,288,1368,105,1406,1156,1080,B
1155,CF,1390,211,1579,240,1623,1156,189,F
1155,CG,568,357,1936,855,2261,1156,1368,C
1155,DG,752,395,2331,705,2328,1156,1579,G
1155,DH,1400,1005,3336,4020,6281,1156,1936,D
1155,H,18501,17496,20832,5760,8088,1156,2331,H
1155,M,1426,1426,22258,1535,9623,1156,20832,M
1155,N,426,426,22684,300,9923,1156,22258,N
1155,O,811,811,23495,805,10728,1156,22684,O
1155,P,1252,1252,24747,1560,12288,1156,23495,P
1156,AEI,48,48,48,91,91,1157,0,E
1156,AFI,140,140,188,135,226,1157,48,F
1156,AGI,334,146,334,558,558,1157,0,A
1156,BGI,255,255,589,90,648,1157,334,B
1156,CGI,378,378,967,800,1448,1157,589,C
1156,DGI,828,49,1016,995,1221,1157,188,G
1156,DHI,1417,1368,2384,3780,5228,1157,967,D
1156,HI,1535,167,2551,4680,5901,1157,1016,H
1156,I,11751,9200,11751,11983,11983,1157,0,I
1156,J,183,183,11934,90,12073,1157,11751,J
1156,K,584,584,12518,1171,13244,1157,11934,K
1156,J,916,916,13434,235,13479,1157,12518,J
1156,K,764,764,14198,1070,14549,1157,13434,K
1156,L,788,788,14986,3840,18389,1157,14198,L
1156,M,858,858,15844,1023,19412,1157,14986,M
1156,N,234,234,16078,90,19502,1157,15844,N
1156,O,591,591,16669,815,20317,1157,16078,O
1156,P,2844,2844,19513,3780,24097,1157,16669,P
1157,A,1462,1462,1462,2351,2351,1158,0,A
1157,B,1005,1005,2467,150,2501,1158,1462,B
1157,C,757,757,3224,790,3291,1158,2467,C
1157,D,1538,1538,4762,4200,7491,1158,3224,D
1157,M,15200,15200,19962,16237,23728,1158,4762,M
1157,N,1273,1273,21235,240,23968,1158,19962,N
1157,O,451,451,21686,780,24748,1158,21235,O
1157,P,2404,2404,24090,3960,28708,1158,21686,P
1158,A,559,559,559,512,512,1159,0,A
1158,B,193,193,752,300,812,1159,559,B
1158,C,689,689,1441,775,1587,1159,752,C
1158,D,47,47,1488,5320,6907,1159,1441,D
1158,M,88,88,1576,215,7122,1159,1488,M
1158,N,200,200,1776,135,7257,1159,1576,N
1158,O,233,233,2009,285,7542,1159,1776,O
1158,P,156,156,2165,5160,12702,1159,2009,P
1159,A,997,997,997,871,871,1160,0,A
1159,B,435,435,1432,90,961,1160,997,B
1159,C,1221,1221,2653,1385,2346,1160,1432,C
1159,D,1580,1580,4233,3780,6126,1160,2653,D
1159,M,4219,4219,8452,4673,10799,1160,4233,M
1159,N,491,491,8943,90,10889,1160,8452,N
1159,O,345,345,9288,625,11514,1160,8943,O
1159,P,1733,1733,11021,3780,15294,1160,9288,P
1160,A,119,119,119,705,705,1161,0,A
1160,B,769,769,888,240,945,1161,119,B
1160,C,184,184,1072,215,1160,1161,888,C
1160,D,458,458,1530,4890,6050,1161,1072,D
1160,M,30714,30714,32244,31633,37683,1161,1530,M
1160,N,972,972,33216,90,37773,1161,32244,N
1160,O,459,459,33675,865,38638,1161,33216,O
1160,P,200,200,33875,3780,42418,1161,33675,P
1161,AEI,53,53,53,372,372,1162,0,A
1161,BEI,116,63,116,206,206,1162,0,I
1161,BEJ,122,6,122,1135,1135,1162,0,E
1161,BFJ,220,214,336,180,386,1162,116,J
1161,BFK,115,115,451,235,621,1162,336,K
1161,BFJ,533,135,586,240,612,1162,53,B
1161,CFJ,743,608,1194,610,1231,1162,451,J
1161,CFK,677,69,1263,960,1572,1162,586,C
1161,DFK,1171,30,1293,180,1315,1162,122,F
1161,DGK,631,532,1825,780,2011,1162,1194,K
1161,DGL,974,442,2267,1133,2448,1162,1293,G
1161,DHL,1196,192,2459,3960,5532,1162,1263,D
1161,HL,1869,1235,3694,4140,6151,1162,1825,L
1161,H,6384,4957,8651,4080,6528,1162,2267,H
1161,M,197,197,8848,493,7021,1162,8651,M
1161,N,687,687,9535,480,7501,1162,8848,N
1161,O,748,748,10283,720,8221,1162,9535,O
1161,P,3393,3393,13676,550,8771,1162,10283,P
1162,A,3236,3236,3236,3858,3858,1163,0,A
1162,B,649,649,3885,90,3948,1163,3236,B
1162,C,371,371,4256,800,4748,1163,3885,C
1162,D,1053,1053,5309,3780,8528,1163,4256,D
1162,M,1465,1465,6774,1567,10095,1163,5309,M
1162,N,131,131,6905,90,10185,1163,6774,N
1162,O,543,543,7448,820,11005,1163,6905,O
1162,N,1256,1256,8704,975,11980,1163,7448,N
1162,O,679,679,9383,1070,13050,1163,8704,O
1162,P,19,19,9402,3780,16830,1163,9383,P
1163,A,146,146,146,1338,1338,1164,0,A
1163,B,1372,1372,1518,240,1578,1164,146,B
1163,C,572,572,2090,620,2198,1164,1518,C
1163,D,738,738,2828,6300,8498,1164,2090,D
1163,M,271,271,3099,220,8718,1164,2828,M
1163,N,189,189,3288,300,9018,1164,3099,N
1163,O,523,523,3811,690,9708,1164,3288,O
1163,N,585,585,4396,390,10098,1164,3811,N
1163,O,633,633,5029,720,10818,1164,4396,O
1163,P,341,341,5370,3960,14778,1164,5029,P
1164,A,1280,1280,1280,1473,1473,1165,0,A
1164,B,224,224,1504,90,1563,1165,1280,B
1164,C,901,901,2405,1250,2813,1165,1504,C
1164,D,1573,1573,3978,3780,6593,1165,2405,D
1164,M,5034,5034,9012,5308,11901,1165,3978,M
1164,N,330,330,9342,90,11991,1165,9012,N
1164,O,456,456,9798,850,12841,1165,9342,O
1164,P,716,716,10514,3780,16621,1165,9798,P
1165,AE,104,104,104,317,317,1166,0,A
1165,BE,470,470,574,270,587,1166,104,B
1165,CE,1371,797,1371,1721,1721,1166,0,E
1165,CF,819,22,1393,810,1397,1166,574,C
1165,DF,595,573,1966,300,2021,1166,1371,F
1165,DG,768,195,2161,550,1947,1166,1393,D
1165,G,1051,856,3017,1275,3296,1166,1966,G
1165,F,1485,1485,4502,765,4061,1166,3017,F
1165,G,144,144,4646,810,4871,1166,4502,G
1165,H,298,298,4944,3960,8831,1166,4646,H
1165,M,136,136,5080,276,9107,1166,4944,M
1165,N,359,359,5439,270,9377,1166,5080,N
1165,O,1118,1118,6557,1100,10477,1166,5439,O
1165,P,5425,5425,11982,335,10812,1166,6557,P
1166,A,410,410,410,970,970,1167,0,A
1166,B,666,666,1076,150,1120,1167,410,B
1166,C,186,186,1262,140,1260,1167,1076,C
1166,B,1472,1472,2734,1515,2775,1167,1262,B
1166,C,1242,1242,3976,1290,4065,1167,2734,C
1166,D,4839,4839,8815,3720,7785,1167,3976,D
1166,M,1498,1498,10313,3355,11140,1167,8815,M
1166,N,2041,2041,12354,240,11380,1167,10313,N
1166,O,1002,1002,13356,985,12365,1167,12354,O
1166,P,1619,1619,14975,3960,16325,1167,13356,P
1167,AE,560,560,560,1223,1223,1168,0,A
1167,BE,1028,468,1028,1010,1010,1168,0,E
1167,BF,236,236,1264,300,1310,1168,1028,F
1167,BG,856,152,1416,240,1463,1168,560,B
1167,CG,951,799,2215,1000,2310,1168,1264,G
1167,CH,979,180,2395,1015,2478,1168,1416,C
1167,DH,1230,1050,3445,3960,6270,1168,2215,H
1167,D,1398,348,3793,3960,6438,1168,2395,D
1167,M,160,160,3953,854,7292,1168,3793,M
1167,N,1139,1139,5092,240,7532,1168,3953,N
1167,O,1287,1287,6379,1630,9162,1168,5092,O
1167,P,1049,1049,7428,3960,13122,1168,6379,P
1168,AE,83,83,83,1011,1011,1169,0,A
1168,BE,852,769,852,959,959,1169,0,E
1168,BF,305,305,1157,180,1139,1169,852,F
1168,BG,1147,73,1230,240,1251,1169,83,B
1168,CG,465,465,1695,760,2011,1169,1230,C
1168,DG,997,459,2154,880,2019,1169,1157,G
1168,DH,946,487,2641,3540,5551,1169,1695,D
1168,H,2422,1935,4576,6660,8679,1169,2154,H
1168,M,13257,13257,17833,16957,25636,1169,4576,M
1168,N,3725,3725,21558,90,25726,1169,17833,N
1168,O,600,600,22158,820,26546,1169,21558,O
1168,N,963,963,23121,725,27271,1169,22158,N
1168,O,229,229,23350,695,27966,1169,23121,O
1168,P,4388,4388,27738,3780,31746,1169,23350,P
1169,AE,366,366,366,808,808,1170,0,E
1169,AF,791,425,791,1391,1391,1170,0,A
1169,BF,543,118,909,150,958,1170,366,F
1169,BG,142,142,1051,115,1073,1170,909,G
1169,BF,630,370,1421,90,1481,1170,791,B
1169,CF,126,126,1547,535,2016,1170,1421,C
1169,DF,764,268,1815,775,1848,1170,1051,F
1169,DG,699,699,2514,755,2603,1170,1815,G
1169,DH,260,260,2774,4290,6893,1170,2514,H
1169,D,1427,200,2974,3780,5796,1170,1547,D
1169,M,242,242,3216,392,7285,1170,2974,M
1169,N,273,273,3489,180,7465,1170,3216,N
1169,O,992,992,4481,965,8430,1170,3489,O
1169,P,1400,1400,5881,385,8815,1170,4481,P
1170,AE,2164,2164,2164,2324,2324,1171,0,E
1170,AF,219,219,2383,90,2414,1171,2164,F
1170,AG,2404,21,2404,2511,2511,1171,0,A
1170,BG,240,240,2644,90,2601,1171,2404,B
1170,CG,425,164,2808,795,3209,1171,2383,G
1170,CF,557,393,3201,790,3391,1171,2644,C
1170,BF,1009,1009,4210,875,4266,1171,3201,B
1170,CF,1478,76,4286,970,4179,1171,2808,F
1170,CG,1153,1077,5363,1625,5891,1171,4210,C
1170,DG,1254,177,5540,1810,5989,1171,4286,G
1170,DH,1239,1062,6602,3780,9671,1171,5363,D
1170,H,2592,1530,8132,3780,9769,1171,5540,H
1170,M,382,382,8514,1250,11019,1171,8132,M
1170,N,1123,1123,9637,300,11319,1171,8514,N
1170,O,861,861,10498,1005,12324,1171,9637,O
1170,P,681,681,11179,1200,13524,1171,10498,P
1171,AEI,135,135,135,478,478,1172,0,A
1171,BEI,231,96,231,993,993,1172,0,E
1171,BFI,493,262,493,5590,5590,1172,0,I
1171,BFJ,377,19,512,90,568,1172,135,B
1171,CFJ,912,631,1143,210,1203,1172,231,F
1171,CGJ,899,268,1411,1275,1843,1172,512,C
1171,DGJ,13,13,1424,3780,5623,1172,1411,D
1171,GJ,723,442,1866,1000,2203,1172,1143,G
1171,HJ,763,763,2629,6290,8493,1172,1866,H
1171,J,5345,3209,5838,300,5890,1172,493,J
1171,K,637,637,6475,910,6800,1172,5838,K
1171,J,1703,1703,8178,1325,8125,1172,6475,J
1171,K,867,867,9045,1500,9625,1172,8178,K
1171,L,1834,1834,10879,3960,13585,1172,9045,L
1171,M,158,158,11037,398,13983,1172,10879,M
1171,N,317,317,11354,135,14118,1172,11037,N
1171,O,726,726,12080,845,14963,1172,11354,O
1171,P,3487,3487,15567,5220,20183,1172,12080,P
1172,AE,49,49,49,380,380,1173,0,E
1172,AF,501,452,501,1106,1106,1173,0,A
1172,BF,500,48,549,165,545,1173,49,F
1172,BG,660,612,1161,90,1196,1173,501,B
1172,CG,972,360,1521,1275,1820,1173,549,G
1172,CH,447,87,1608,860,2056,1173,1161,C
1172,DH,116,116,1724,3780,5836,1173,1608,D
1172,H,818,615,2339,3960,5780,1173,1521,H
1172,M,1754,1754,4093,1949,7785,1173,2339,M
1172,N,251,251,4344,90,7875,1173,4093,N
1172,O,600,600,4944,860,8735,1173,4344,O
1172,N,1614,1614,6558,1355,10090,1173,4944,N
1172,O,635,635,7193,815,10905,1173,6558,O
1172,P,27120,27120,34313,3780,14685,1173,7193,P
1173,AE,405,405,405,537,537,1174,0,A
1173,BE,180,180,585,90,627,1174,405,B
1173,CE,697,112,697,1169,1169,1174,0,E
1173,CF,779,667,1364,1130,1757,1174,585,C
1173,DF,190,190,1554,3780,5537,1174,1364,D
1173,F,2404,1547,3101,90,1259,1174,697,F
1173,G,852,852,3953,1250,2509,1174,3101,G
1173,H,392,392,4345,3780,6289,1174,3953,H
1173,M,4158,4158,8503,4727,11016,1174,4345,M
1173,N,596,596,9099,90,11106,1174,8503,N
1173,O,222,222,9321,625,11731,1174,9099,O
1173,P,546,546,9867,3780,15511,1174,9321,P
1174,AE,100,100,100,740,740,1175,0,E
1174,AF,826,826,926,240,980,1175,100,F
1174,AG,200,200,1126,390,1370,1175,926,G
1174,AF,1512,1512,2638,1300,2670,1175,1126,F
1174,AG,299,299,2937,915,3585,1175,2638,G
1174,AH,3317,380,3317,4130,4130,1175,0,A
1174,BH,838,838,4155,90,4220,1175,3317,B
1174,CH,567,567,4722,905,5125,1175,4155,C
1174,BH,429,429,5151,90,5215,1175,4722,B
1174,CH,1505,1505,6656,2320,7535,1175,5151,C
1174,DH,2805,2805,9461,3420,10955,1175,6656,D
1174,H,13526,7002,16463,3960,7545,1175,2937,H
1174,M,1485,1485,17948,1750,12705,1175,16463,M
1174,N,295,295,18243,90,12795,1175,17948,N
1174,O,1526,1526,19769,1875,14670,1175,18243,O
1174,N,819,819,20588,450,15120,1175,19769,N
1174,O,668,668,21256,940,16060,1175,20588,O
1174,P,6073,6073,27329,3780,19840,1175,21256,P
1175,AEI,176,176,176,190,190,1176,0,I
1175,AEJ,140,140,316,180,370,1176,176,J
1175,AEK,149,149,465,540,910,1176,316,K
1175,AEL,579,114,579,980,980,1176,0,A
1175,BEL,1031,452,1031,1194,1194,1176,0,E
1175,BFL,652,86,1117,2850,3760,1176,465,L
1175,BF,583,45,1162,240,1220,1176,579,B
1175,CF,337,206,1368,180,1374,1176,1031,F
1175,CG,214,8,1376,370,1590,1176,1162,C
1175,DG,580,572,1948,675,2049,1176,1368,G
1175,DF,293,293,2241,245,2294,1176,1948,F
1175,DG,1020,1020,3261,225,2519,1176,2241,G
1175,DH,3988,2103,5364,4020,5610,1176,1376,D
1175,H,2150,47,5411,4140,6659,1176,3261,H
1175,M,374,374,5785,425,7084,1176,5411,M
1175,N,142,142,5927,150,7234,1176,5785,N
1175,O,264,264,6191,520,7754,1176,5927,O
1175,P,4795,4795,10986,2855,10609,1176,6191,P
1176,A,245,245,245,360,360,1177,0,A
1176,B,409,409,654,300,660,1177,245,B
1176,C,689,689,1343,870,1530,1177,654,C
1176,D,200,200,1543,1620,3150,1177,1343,D
1176,M,3903,3903,5446,5890,9040,1177,1543,M
1176,N,2847,2847,8293,420,9460,1177,5446,N
1176,O,1035,1035,9328,985,10445,1177,8293,O
1176,P,3026,3026,12354,550,10995,1177,9328,P
1177,AEI,339,339,339,667,667,1178,0,A
1177,BEI,349,349,688,90,757,1178,339,B
1177,CEI,1039,351,1039,1188,1188,1178,0,I
1177,CEJ,186,186,1225,90,1278,1178,1039,J
1177,CEK,966,429,1654,1250,2007,1178,688,C
1177,DEK,2,2,1656,3780,5787,1178,1654,D
1177,EK,697,266,1922,1130,2408,1178,1225,K
1177,EL,61,61,1983,3780,6188,1178,1922,L
1177,E,34910,32927,34910,35706,35706,1178,0,E
1177,F,836,836,35746,90,35796,1178,34910,F
1177,G,1034,1034,36780,1240,37036,1178,35746,G
1177,H,191,191,36971,3780,40816,1178,36780,H
1177,M,927,927,37898,1183,41999,1178,36971,M
1177,N,283,283,38181,90,42089,1178,37898,N
1177,O,313,313,38494,625,42714,1178,38181,O
1177,P,278,278,38772,3780,46494,1178,38494,P
1178,AEI,1155,1155,1155,1195,1195,1179,0,A
1178,BEI,323,323,1478,300,1495,1179,1155,B
1178,CEI,1485,7,1485,1729,1729,1179,0,E
1178,CFI,1740,255,1740,2561,2561,1179,0,I
1178,CFJ,494,239,1979,300,2029,1179,1485,F
1178,CGJ,886,385,2364,1050,2545,1179,1478,C
1178,BGJ,384,384,2748,350,2895,1179,2364,B
1178,CGJ,1028,20,2768,240,2801,1179,1740,J
1178,CGK,1061,272,3040,1275,3304,1179,1979,G
1178,CFK,492,200,3240,510,3405,1179,2748,C
1178,DFK,953,481,3721,1030,3831,1179,2768,K
1178,DFJ,401,401,4122,485,4316,1179,3721,J
1178,DFK,1469,387,4509,1065,4369,1179,3040,F
1178,DGK,1329,60,4569,3960,7365,1179,3240,D
1178,GK,513,66,4635,510,4826,1179,4122,K
1178,GL,62,62,4697,3960,8786,1179,4635,L
1178,G,223,35,4732,510,4879,1179,4509,G
1178,H,87,87,4819,4020,8899,1179,4732,H
1178,M,37391,37391,42210,38278,47177,1179,4819,M
1178,N,1854,1854,44064,90,47267,1179,42210,N
1178,O,1352,1352,45416,1430,48697,1179,44064,O
1178,P,1785,1785,47201,3780,52477,1179,45416,P
1179,A,126,126,126,122,122,1180,0,A
1179,B,174,174,300,240,362,1180,126,B
1179,C,404,404,704,240,602,1180,300,C
1179,D,338,338,1042,5250,5852,1180,704,D
1179,M,790,790,1832,2732,8584,1180,1042,M
1179,N,2709,2709,4541,780,9364,1180,1832,N
1179,O,956,956,5497,1114,10478,1180,4541,O
1179,P,916,916,6413,341,10819,1180,5497,P
1180,AEI,146,146,146,291,291,1181,0,E
1180,AFI,265,265,411,90,381,1181,146,F
1180,AGI,412,1,412,1013,1013,1181,0,I
1180,AGJ,693,693,1105,150,1163,1181,412,J
1180,AGK,720,26,1131,1005,1386,1181,411,G
1180,AHK,41,41,1172,3780,5166,1181,1131,H
1180,AK,1226,54,1226,1473,1473,1181,0,A
1180,BK,176,55,1281,185,1348,1181,1105,K
1180,BL,231,231,1512,4200,5548,1181,1281,L
1180,B,394,108,1620,180,1653,1181,1226,B
1180,C,734,734,2354,545,2198,1181,1620,C
1180,D,175,175,2529,4140,6338,1181,2354,D
1180,M,41,41,2570,76,6414,1181,2529,M
1180,N,232,232,2802,240,6654,1181,2570,N
1180,O,143,143,2945,218,6872,1181,2802,O
1180,P,539,539,3484,682,7554,1181,2945,P
1181,AEI,126,126,126,845,845,1182,0,E
1181,AFI,203,77,203,707,707,1182,0,I
1181,AFJ,218,15,218,743,743,1182,0,A
1181,BFJ,664,649,867,210,917,1182,203,J
1181,BFK,675,26,893,210,953,1182,218,B
1181,CFK,927,160,1053,240,1085,1182,126,F
1181,CGK,388,388,1441,535,1620,1182,1053,G
1181,CHK,900,352,1793,1000,1953,1182,893,C
1181,BHK,979,53,1846,1000,1917,1182,867,K
1181,BHJ,619,619,2465,605,2522,1182,1846,J
1181,BHK,721,49,2514,605,2558,1182,1793,B
1181,CHK,241,241,2755,535,3093,1182,2514,C
1181,DHK,512,222,2977,535,3057,1182,2465,K
1181,DHL,5502,5280,8257,2880,5973,1182,2755,D
1181,HL,10027,3211,11468,2880,4500,1182,1441,H
1181,L,81961,73470,84938,2880,5937,1182,2977,L
1181,M,60,60,84998,1388,7361,1182,84938,M
1181,N,728,728,85726,180,7541,1182,84998,N
1181,O,1148,1148,86874,545,8086,1182,85726,O
1181,P,1380,1380,88254,5400,13486,1182,86874,P
1182,AEI,320,320,320,1475,1475,1183,0,I
1182,AEJ,1445,1445,1765,300,1775,1183,320,J
1182,AEK,680,680,2445,840,2615,1183,1765,K
1182,AEL,120,120,2565,1560,4175,1183,2445,L
1182,AE,10236,7671,10236,10255,10255,1183,0,E
1182,AF,299,299,10535,300,10555,1183,10236,F
1182,AG,561,561,11096,735,11290,1183,10535,G
1182,AH,104,104,11200,1560,12850,1183,11096,H
1182,A,14326,3126,14326,14715,14715,1183,0,A
1182,B,720,720,15046,300,15015,1183,14326,B
1182,C,665,665,15711,760,15775,1183,15046,C
1182,D,144,144,15855,1500,17275,1183,15711,D
1182,M,1740,1740,17595,1845,19120,1183,15855,M
1182,N,373,373,17968,300,19420,1183,17595,N
1182,O,694,694,18662,1015,20435,1183,17968,O
1182,N,309,309,18971,10,20445,1183,18662,N
1182,O,2385,2385,21356,2630,23075,1183,18971,O
1182,P,2259,2259,23615,1620,24695,1183,21356,P
1183,A,2627,2627,2627,2969,2969,1184,0,A
1183,B,585,585,3212,300,3269,1184,2627,B
1183,C,756,756,3968,820,4089,1184,3212,C
1183,D,2614,2614,6582,5315,9404,1184,3968,D
1183,M,61,61,6643,134,9538,1184,6582,M
1183,N,253,253,6896,240,9778,1184,6643,N
1183,O,234,234,7130,290,10068,1184,6896,O
1183,P,1221,1221,8351,5160,15228,1184,7130,P
1184,AE,20,20,20,71,71,1185,0,E
1184,AF,257,237,257,442,442,1185,0,A
1184,BF,386,149,406,480,551,1185,20,F
1184,BG,275,126,532,150,592,1185,257,B
1184,CG,155,155,687,195,787,1185,532,C
1184,DG,1028,747,1434,1015,1566,1185,406,G
1184,DH,908,161,1595,385,1172,1185,687,D
1184,H,1901,1740,3335,460,2026,1185,1434,H
1184,M,13079,13079,16414,13721,15747,1185,3335,M
1184,N,668,668,17082,90,15837,1185,16414,N
1184,O,878,878,17960,1215,17052,1185,17082,O
1184,P,196,196,18156,3780,20832,1185,17960,P
1185,AEI,905,905,905,1280,1280,1186,0,I
1185,AEJ,928,23,928,1315,1315,1186,0,E
1185,AFJ,405,382,1310,90,1370,1186,905,J
1185,AFK,591,209,1519,240,1555,1186,928,F
1185,AGK,420,211,1730,815,2185,1186,1310,K
1185,AGL,502,291,2021,845,2400,1186,1519,G
1185,AHL,2211,190,2211,2706,2706,1186,0,A
1185,BHL,637,447,2658,3960,6360,1186,2021,H
1185,BL,521,74,2732,90,2796,1186,2211,B
1185,CL,424,424,3156,815,3611,1186,2732,C
1185,DL,3000,1574,4730,3780,5965,1186,1730,L
1185,D,20340,18766,23496,3780,7391,1186,3156,D
1185,M,1183,1183,24679,2270,9661,1186,23496,M
1185,N,1138,1138,25817,90,9751,1186,24679,N
1185,O,537,537,26354,805,10556,1186,25817,O
1185,N,1275,1275,27629,240,10796,1186,26354,N
1185,O,502,502,28131,925,11721,1186,27629,O
1185,P,861,861,28992,3780,15501,1186,28131,P
1186,AE,290,290,290,580,580,1187,0,A
1186,BE,410,410,700,180,760,1187,290,B
1186,CE,713,13,713,1917,1917,1187,0,E
1186,CF,262,249,962,645,1405,1187,700,C
1186,BF,969,969,1931,575,1980,1187,962,B
1186,CF,1459,241,2172,300,2217,1187,713,F
1186,CG,693,452,2624,880,2860,1187,1931,C
1186,DG,401,401,3025,1620,4480,1187,2624,D
1186,G,2127,1274,4299,790,3007,1187,2172,G
1186,H,2910,2910,7209,4080,7087,1187,4299,H
1186,M,1727,1727,8936,3334,10421,1187,7209,M
1186,N,1989,1989,10925,420,10841,1187,8936,N
1186,O,968,968,11893,1015,11856,1187,10925,O
1186,P,2363,2363,14256,550,12406,1187,11893,P
1187,AE,1692,1692,1692,1795,1795,1188,0,E
1187,AF,193,193,1885,150,1945,1188,1692,F
1187,AG,86,86,1971,55,2000,1188,1885,G
1187,AF,909,909,2880,930,2930,1188,1971,F
1187,AG,796,796,3676,940,3870,1188,2880,G
1187,AH,4246,570,4246,4499,4499,1188,0,A
1187,BH,289,289,4535,90,4589,1188,4246,B
1187,CH,1245,386,4921,6990,10860,1188,3676,H
1187,C,972,586,5507,1470,6059,1188,4535,C
1187,D,1009,1009,6516,3780,9839,1188,5507,D
1187,M,115,115,6631,160,11020,1188,6516,M
1187,N,163,163,6794,180,11200,1188,6631,N
1187,O,838,838,7632,675,11875,1188,6794,O
1187,N,1241,1241,8873,1400,13275,1188,7632,N
1187,O,179,179,9052,225,13500,1188,8873,O
1187,P,4393,4393,13445,4740,18240,1188,9052,P
1188,AE,90,90,90,513,513,1189,0,E
1188,AF,644,644,734,270,783,1189,90,F
1188,AG,1070,336,1070,1525,1525,1189,0,A
1188,BG,564,228,1298,735,1518,1189,734,G
1188,BF,739,511,1809,300,1825,1189,1070,B
1188,CF,532,532,2341,720,2545,1189,1809,C
1188,DF,1741,698,3039,1580,3098,1189,1298,F
1188,DG,722,722,3761,255,3353,1189,3039,G
1188,DH,1709,289,4050,4140,6685,1189,2341,D
1188,H,822,533,4583,5160,8513,1189,3761,H
1188,M,1268,1268,5851,1558,10071,1189,4583,M
1188,N,320,320,6171,90,10161,1189,5851,N
1188,O,913,913,7084,1240,11401,1189,6171,O
1188,P,281,281,7365,3780,15181,1189,7084,P
1189,A,361,361,361,279,279,1190,0,A
1189,B,114,114,475,240,519,1190,361,B
1189,C,163,163,638,420,939,1190,475,C
1189,B,819,819,1457,555,1494,1190,638,B
1189,C,119,119,1576,395,1889,1190,1457,C
1189,D,1333,1333,2909,3960,5849,1190,1576,D
1189,M,390,390,3299,1015,6864,1190,2909,M
1189,N,813,813,4112,240,7104,1190,3299,N
1189,O,250,250,4362,400,7504,1190,4112,O
1189,N,1696,1696,6058,1515,9019,1190,4362,N
1189,O,669,669,6727,960,9979,1190,6058,O
1189,P,5793,5793,12520,3960,13939,1190,6727,P
1190,A,77,77,77,161,161,1191,0,A
1190,B,255,255,332,240,401,1191,77,B
1190,C,750,750,1082,975,1376,1191,332,C
1190,D,2238,2238,3320,5040,6416,1191,1082,D
1190,M,281,281,3601,1301,7717,1191,3320,M
1190,N,1050,1050,4651,90,7807,1191,3601,N
1190,O,1003,1003,5654,1220,9027,1191,4651,O
1190,N,432,432,6086,215,9242,1191,5654,N
1190,O,182,182,6268,605,9847,1191,6086,O
1190,P,1139,1139,7407,3780,13627,1191,6268,P
1191,A,120,120,120,203,203,1192,0,A
1191,B,177,177,297,150,353,1192,120,B
1191,C,79,79,376,110,463,1192,297,C
1191,D,513,513,889,4230,4693,1192,376,D
1191,M,342,342,1231,1434,6127,1192,889,M
1191,N,1123,1123,2354,90,6217,1192,1231,N
1191,O,1008,1008,3362,1210,7427,1192,2354,O
1191,N,416,416,3778,220,7647,1192,3362,N
1191,O,198,198,3976,605,8252,1192,3778,O
1191,P,16918,16918,20894,3780,12032,1192,3976,P
1192,A,1349,1349,1349,2354,2354,1193,0,A
1192,B,1034,1034,2383,90,2444,1193,1349,B
1192,C,234,234,2617,585,3029,1193,2383,C
1192,D,5727,5727,8344,3780,6809,1193,2617,D
1192,M,256,256,8600,1555,8364,1193,8344,M
1192,N,1328,1328,9928,90,8454,1193,8600,N
1192,O,332,332,10260,575,9029,1193,9928,O
1192,N,2871,2871,13131,2610,11639,1193,10260,N
1192,O,866,866,13997,1240,12879,1193,13131,O
1192,P,1218,1218,15215,3780,16659,1193,13997,P
1193,A,60,60,60,199,199,1194,0,A
1193,B,313,313,373,240,439,1194,60,B
1193,C,729,729,1102,975,1414,1194,373,C
1193,D,14,14,1116,5040,6454,1194,1102,D
1193,M,61,61,1177,855,7309,1194,1116,M
1193,N,986,986,2163,240,7549,1194,1177,N
1193,O,515,515,2678,740,8289,1194,2163,O
1193,P,10851,10851,13529,5100,13389,1194,2678,P
1194,AE,591,591,591,1305,1305,1195,0,E
1194,AF,745,745,1336,90,1395,1195,591,F
1194,AG,342,342,1678,795,2190,1195,1336,G
1194,AH,2138,460,2138,3243,3243,1195,0,A
1194,BH,1786,1326,3464,3780,5970,1195,1678,H
1194,B,1855,529,3993,780,4023,1195,2138,B
1194,C,1097,1097,5090,1245,5268,1195,3993,C
1194,D,12,12,5102,335,5603,1195,5090,D
1194,M,1989,1989,7091,2613,8583,1195,5102,M
1194,N,744,744,7835,180,8763,1195,7091,N
1194,O,948,948,8783,945,9708,1195,7835,O
1194,P,857,857,9640,550,10258,1195,8783,P
1195,AEI,80,80,80,231,231,1196,0,E
1195,AFI,127,47,127,1070,1070,1196,0,I
1195,AFJ,196,69,196,1111,1111,1196,0,A
1195,BFJ,244,128,324,150,381,1196,80,F
1195,BGJ,178,178,502,455,836,1196,324,G
1195,BHJ,951,645,1147,90,1201,1196,196,B
1195,CHJ,1063,43,1190,180,1250,1196,127,J
1195,CHK,888,200,1390,3565,4401,1196,502,H
1195,CK,524,281,1671,795,1996,1196,1147,C
1195,BK,969,488,2159,1055,2305,1196,1190,K
1195,BL,1992,1504,3663,1715,3711,1196,1671,B
1195,CL,2204,700,4363,5040,7345,1196,2159,L
1195,C,921,221,4584,1275,4986,1196,3663,C
1195,D,75,75,4659,3780,8766,1196,4584,D
1195,M,123,123,4782,273,9039,1196,4659,M
1195,N,335,335,5117,240,9279,1196,4782,N
1195,O,753,753,5870,830,10109,1196,5117,O
1195,P,416,416,6286,5400,15509,1196,5870,P
1196,A,29,29,29,145,145,1197,0,A
1196,B,206,206,235,135,280,1197,29,B
1196,C,208,208,443,295,575,1197,235,C
1196,D,111,111,554,5100,5675,1197,443,D
1196,M,331,331,885,1701,7376,1197,554,M
1196,N,1546,1546,2431,180,7556,1197,885,N
1196,O,920,920,3351,895,8451,1197,2431,O
1196,N,99,99,3450,180,8631,1197,3351,N
1196,O,492,492,3942,270,8901,1197,3450,O
1196,P,2415,2415,6357,7020,15921,1197,3942,P
1197,AEI,254,254,254,369,369,1198,0,I
1197,AEJ,576,322,576,1088,1088,1198,0,A
1197,BEJ,375,53,629,300,669,1198,254,J
1197,BEK,496,496,1125,545,1214,1198,629,K
1197,BEL,674,125,1250,150,1238,1198,576,B
1197,CEL,1254,4,1254,1387,1387,1198,0,E
1197,CFL,137,8,1262,4080,5294,1198,1125,L
1197,CF,184,172,1434,220,1458,1198,1250,C
1197,BF,253,73,1507,180,1567,1198,1254,F
1197,BG,304,304,1811,335,1902,1198,1507,G
1197,BF,505,128,1939,500,1958,1198,1434,B
1197,CF,514,514,2453,510,2468,1198,1939,C
1197,DF,1105,463,2916,1065,2967,1198,1811,F
1197,DG,559,559,3475,540,3507,1198,2916,G
1197,DF,102,102,3577,130,3637,1198,3475,F
1197,DG,1275,1275,4852,1200,4837,1198,3577,G
1197,DH,1274,1274,6126,5100,9937,1198,4852,H
1197,D,3833,160,6286,4230,6698,1198,2453,D
1197,M,7460,7460,13746,7457,17394,1198,6286,M
1197,N,179,179,13925,240,17634,1198,13746,N
1197,O,483,483,14408,740,18374,1198,13925,O
1197,N,608,608,15016,345,18719,1198,14408,N
1197,O,611,611,15627,860,19579,1198,15016,O
1197,P,79829,79829,95456,3960,23539,1198,15627,P
1198,AEI,64,64,64,922,922,1199,0,E
1198,AFI,313,249,313,354,354,1199,0,I
1198,AFJ,455,142,455,950,950,1199,0,A
1198,BFJ,251,109,564,180,534,1199,313,J
1198,BFK,292,292,856,660,1194,1199,564,K
1198,BFL,615,214,1070,180,1130,1199,455,B
1198,CFL,1077,71,1141,240,1162,1199,64,F
1198,CGL,235,164,1305,335,1465,1199,1070,C
1198,DGL,1303,1303,2608,4020,5485,1199,1305,D
1198,GL,1540,73,2681,1040,2202,1199,1141,G
1198,FL,3136,1311,3992,3960,5154,1199,856,L
1198,F,2119,808,4800,2480,4682,1199,2681,F
1198,G,991,991,5791,1210,5892,1199,4800,G
1198,H,2997,2997,8788,3960,9852,1199,5791,H
1198,M,165,165,8953,1173,11025,1199,8788,M
1198,N,1033,1033,9986,90,11115,1199,8953,N
1198,O,968,968,10954,1200,12315,1199,9986,O
1198,P,29,29,10983,3780,16095,1199,10954,P
1199,AE,100,100,100,206,206,1200,0,E
1199,AF,202,202,302,150,356,1200,100,F
1199,AG,600,600,902,620,976,1200,302,G
1199,AH,323,323,1225,4200,5176,1200,902,H
1199,A,1438,213,1438,1722,1722,1200,0,A
1199,B,317,317,1755,90,1812,1200,1438,B
1199,C,1356,1356,3111,1625,3437,1200,1755,C
1199,D,4240,4240,7351,3780,7217,1200,3111,D
1199,M,466,466,7817,701,7918,1200,7351,M
1199,N,355,355,8172,180,8098,1200,7817,N
1199,O,180,180,8352,265,8363,1200,8172,O
1199,N,319,319,8671,225,8588,1200,8352,N
1199,O,160,160,8831,225,8813,1200,8671,O
1199,P,131,131,8962,4740,13553,1200,8831,P
1200,AE,439,439,439,1143,1143,1201,0,E
1200,AF,892,892,1331,240,1383,1201,439,F
1200,AG,957,957,2288,1030,2413,1201,1331,G
1200,AH,1345,1345,3633,3960,6373,1201,2288,H
1200,A,22969,19336,22969,22664,22664,1201,0,A
1200,B,1174,1174,24143,90,22754,1201,22969,B
1200,C,1233,1233,25376,1130,23884,1201,24143,C
1200,D,222,222,25598,3780,27664,1201,25376,D
1200,M,20,20,25618,489,28153,1201,25598,M
1200,N,665,665,26283,240,28393,1201,25618,N
1200,O,484,484,26767,815,29208,1201,26283,O
1200,P,189,189,26956,3840,33048,1201,26767,P
1201,AE,273,273,273,365,365,1202,0,A
1201,BE,235,235,508,150,515,1202,273,B
1201,CE,495,495,1003,575,1090,1202,508,C
1201,DE,667,667,1670,4230,5320,1202,1003,D
1201,E,2507,837,2507,2621,2621,1202,0,E
1201,F,188,188,2695,90,2711,1202,2507,F
1201,G,620,620,3315,790,3501,1202,2695,G
1201,F,189,189,3504,70,3571,1202,3315,F
1201,G,517,517,4021,815,4386,1202,3504,G
1201,H,18060,18060,22081,3780,8166,1202,4021,H
1201,M,2107,2107,24188,2533,10699,1202,22081,M
1201,N,474,474,24662,90,10789,1202,24188,N
1201,O,577,577,25239,805,11594,1202,24662,O
1201,P,122,122,25361,3840,15434,1202,25239,P
1202,AE,211,211,211,1175,1175,1203,0,A
1202,BE,1211,1211,1422,300,1475,1203,211,B
1202,CE,1527,105,1527,2430,2430,1203,0,E
1202,CF,899,794,2321,905,2380,1203,1422,C
1202,DF,1155,361,2682,300,2730,1203,1527,F
1202,DG,842,842,3524,925,3655,1203,2682,G
1202,DH,2571,2571,6095,2760,6415,1203,3524,H
1202,D,4065,291,6386,2760,5140,1203,2321,D
1202,M,3060,3060,9446,4037,10452,1203,6386,M
1202,N,1027,1027,10473,90,10542,1203,9446,N
1202,O,473,473,10946,915,11457,1203,10473,O
1202,N,1127,1127,12073,670,12127,1203,10946,N
1202,O,545,545,12618,915,13042,1203,12073,O
1202,P,1104,1104,13722,3780,16822,1203,12618,P
1203,A,629,629,629,1914,1914,1204,0,A
1203,B,1315,1315,1944,90,2004,1204,629,B
1203,C,962,962,2906,1240,3244,1204,1944,C
1203,D,1631,1631,4537,3840,7084,1204,2906,D
1203,M,7214,7214,11751,9154,16238,1204,4537,M
1203,N,2100,2100,13851,90,16328,1204,11751,N
1203,O,1186,1186,15037,1345,17673,1204,13851,O
1203,N,2232,2232,17269,2165,19838,1204,15037,N
1203,O,431,431,17700,815,20653,1204,17269,O
1203,P,961,961,18661,3780,24433,1204,17700,P
1204,A,240,240,240,339,339,1205,0,A
1204,B,206,206,446,150,489,1205,240,B
1204,C,784,784,1230,585,1074,1205,446,C
1204,B,1143,1143,2373,1330,2404,1205,1230,B
1204,C,1371,1371,3744,135,2539,1205,2373,C
1204,D,739,739,4483,4230,6769,1205,3744,D
1204,M,69,69,4552,874,7643,1205,4483,M
1204,N,910,910,5462,150,7793,1205,4552,N
1204,O,205,205,5667,140,7933,1205,5462,O
1204,N,687,687,6354,730,8663,1205,5667,N
1204,O,853,853,7207,775,9438,1205,6354,O
1204,P,14,14,7221,4230,13668,1205,7207,P
1205,AEI,182,182,182,342,342,1206,0,I
1205,AEJ,529,347,529,611,611,1206,0,A
1205,BEJ,541,12,541,2012,2012,1206,0,E
1205,BFJ,239,227,768,150,761,1206,529,B
1205,CFJ,1353,767,1535,90,432,1206,182,J
1205,CFK,865,98,1633,180,941,1206,768,C
1205,DFK,351,351,1984,4200,5141,1206,1633,D
1205,FK,1528,85,2069,90,2102,1206,541,F
1205,GK,680,146,2215,1010,1442,1206,1535,K
1205,GL,143,143,2358,3780,5222,1206,2215,L
1205,G,984,695,3053,1275,3377,1206,2069,G
1205,H,214,214,3267,3780,7157,1206,3053,H
1205,M,84,84,3351,738,7895,1206,3267,M
1205,N,856,856,4207,240,8135,1206,3351,N
1205,O,511,511,4718,815,8950,1206,4207,O
1205,P,391,391,5109,3840,12790,1206,4718,P
1206,A,6205,6205,6205,6165,6165,1207,0,A
1206,B,222,222,6427,300,6465,1207,6205,B
1206,C,733,733,7160,840,7305,1207,6427,C
1206,B,730,730,7890,645,7950,1207,7160,B
1206,C,799,799,8689,900,8850,1207,7890,C
1206,D,576,576,9265,1650,10500,1207,8689,D
1206,M,225,225,9490,245,10745,1207,9265,M
1206,N,265,265,9755,240,10985,1207,9490,N
1206,O,629,629,10384,630,11615,1207,9755,O
1206,P,1611,1611,11995,4080,15695,1207,10384,P
1207,A,2903,2903,2903,3388,3388,1208,0,A
1207,B,528,528,3431,90,3478,1208,2903,B
1207,C,524,524,3955,825,4303,1208,3431,C
1207,B,3682,3682,7637,3350,7653,1208,3955,B
1207,C,1210,1210,8847,1440,9093,1208,7637,C
1207,D,1789,1789,10636,3780,12873,1208,8847,D
1207,M,425,425,11061,3259,16132,1208,10636,M
1207,N,2889,2889,13950,90,16222,1208,11061,N
1207,O,848,848,14798,1240,17462,1208,13950,O
1207,N,532,532,15330,165,17627,1208,14798,N
1207,O,523,523,15853,880,18507,1208,15330,O
1207,P,360,360,16213,3780,22287,1208,15853,P
1208,A,2238,2238,2238,5943,5943,1209,0,A
1208,B,3735,3735,5973,90,6033,1209,2238,B
1208,C,706,706,6679,1106,7139,1209,5973,C
1208,D,2241,2241,8920,3780,10919,1209,6679,D
1208,M,1125,1125,10045,1338,12257,1209,8920,M
1208,N,513,513,10558,360,12617,1209,10045,N
1208,O,682,682,11240,875,13492,1209,10558,O
1208,N,1224,1224,12464,1030,14522,1209,11240,N
1208,O,252,252,12716,388,14910,1209,12464,O
1208,P,585,585,13301,512,15422,1209,12716,P
1209,AEI,329,329,329,507,507,1210,0,I
1209,AEJ,271,271,600,150,657,1210,329,J
1209,AEK,242,242,842,175,832,1210,600,K
1209,AEL,236,236,1078,1520,2352,1210,842,L
1209,AE,1896,818,1896,2681,2681,1210,0,E
1209,AF,2860,964,2860,3115,3115,1210,0,A
1209,BF,1066,102,2962,300,2981,1210,1896,F
1209,BG,518,416,3378,300,3415,1210,2860,B
1209,CG,360,360,3738,820,4235,1210,3378,C
1209,DG,1056,280,4018,1050,4031,1210,2962,G
1209,DF,498,218,4236,3870,8105,1210,3738,D
1209,F,1409,1191,5427,1460,5491,1210,4018,F
1209,G,768,768,6195,900,6391,1210,5427,G
1209,H,1936,1936,8131,3960,10351,1210,6195,H
1209,M,4206,4206,12337,5508,15859,1210,8131,M
1209,N,1342,1342,13679,90,15949,1210,12337,N
1209,O,973,973,14652,1240,17189,1210,13679,O
1209,N,2883,2883,17535,2590,19779,1210,14652,N
1209,O,204,204,17739,675,20454,1210,17535,O
1209,P,5784,5784,23523,3780,24234,1210,17739,P
1210,AEI,92,92,92,1069,1069,1211,0,I
1210,AEJ,195,103,195,213,213,1211,0,E
1210,AFJ,129,129,324,150,363,1211,195,F
1210,AGJ,418,94,418,976,976,1211,0,A
1210,BGJ,174,80,498,130,493,1211,324,G
1210,BFJ,588,508,1006,90,1066,1211,418,B
1210,CFJ,1160,246,1252,240,1309,1211,92,J
1210,CFK,409,163,1415,800,1866,1211,1006,C
1210,DFK,1284,367,1782,1335,1828,1211,498,F
1210,DGK,856,326,2108,1020,2329,1211,1252,K
1210,DGL,965,272,2380,3780,5646,1211,1415,D
1210,GL,688,90,2470,665,2493,1211,1782,G
1210,HL,385,23,2493,4680,7009,1211,2108,L
1210,H,1226,1203,3696,4230,6723,1211,2470,H
1210,M,2023,2023,5719,2192,9201,1211,3696,M
1210,N,210,210,5929,90,9291,1211,5719,N
1210,O,408,408,6337,820,10111,1211,5929,O
1210,P,147,147,6484,3780,13891,1211,6337,P
1211,AE,296,296,296,1285,1285,1212,0,E
1211,AF,1019,1019,1315,90,1375,1212,296,F
1211,AG,953,953,2268,1240,2615,1212,1315,G
1211,AH,2925,2925,5193,3780,6395,1212,2268,H
1211,A,22193,17000,22193,21505,21505,1212,0,A
1211,B,359,359,22552,90,21595,1212,22193,B
1211,C,1217,1217,23769,1430,23025,1212,22552,C
1211,D,1352,1352,25121,3780,26805,1212,23769,D
1211,M,1729,1729,26850,1839,28644,1212,25121,M
1211,N,152,152,27002,90,28734,1212,26850,N
1211,O,229,229,27231,695,29429,1212,27002,O
1211,P,2421,2421,29652,3780,33209,1212,27231,P
1212,AE,799,799,799,1656,1656,1213,0,A
1212,BE,926,127,926,3132,3132,1213,0,E
1212,BF,902,775,1701,90,1746,1213,799,B
1212,CF,830,830,2531,1250,2996,1213,1701,C
1212,DF,608,608,3139,3780,6776,1213,2531,D
1212,F,2261,48,3187,90,3222,1213,926,F
1212,G,879,879,4066,1250,4472,1213,3187,G
1212,H,169,169,4235,3780,8252,1213,4066,H
1212,M,3914,3914,8149,4610,12862,1213,4235,M
1212,N,726,726,8875,90,12952,1213,8149,N
1212,O,326,326,9201,705,13657,1213,8875,O
1212,P,1048,1048,10249,3780,17437,1213,9201,P
1213,AE,32,32,32,187,187,1214,0,A
1213,BE,76,44,76,869,869,1214,0,E
1213,BF,249,205,281,135,322,1214,32,B
1213,CF,228,228,509,285,607,1214,281,C
1213,DF,191,191,700,5160,5767,1214,509,D
1213,F,976,352,1052,240,1109,1214,76,F
1213,G,766,766,1818,1015,2124,1214,1052,G
1213,F,927,927,2745,650,2774,1214,1818,F
1213,G,138,138,2883,385,3159,1214,2745,G
1213,H,441,441,3324,3960,7119,1214,2883,H
1213,M,5043,5043,8367,6057,13176,1214,3324,M
1213,N,1039,1039,9406,90,13266,1214,8367,N
1213,O,852,852,10258,1240,14506,1214,9406,O
1213,P,1051,1051,11309,3780,18286,1214,10258,P
1214,AEI,91,91,91,236,236,1215,0,A
1214,BEI,350,350,441,240,476,1215,91,B
1214,CEI,808,367,808,1608,1608,1215,0,E
1214,CFI,876,509,1317,1045,1521,1215,441,C
1214,DFI,3,3,1320,3960,5481,1215,1317,D
1214,FI,827,315,1635,90,1698,1215,808,F
1214,GI,1917,282,1917,2151,2151,1215,0,I
1214,GJ,264,264,2181,90,2241,1215,1917,J
1214,GK,875,329,2510,1250,2948,1215,1635,G
1214,HK,12,12,2522,3780,6728,1215,2510,H
1214,K,692,351,2873,1105,3346,1215,2181,K
1214,L,129,129,3002,3780,7126,1215,2873,L
1214,M,1497,1497,4499,1778,8904,1215,3002,M
1214,N,321,321,4820,90,8994,1215,4499,N
1214,O,482,482,5302,850,9844,1215,4820,O
1214,P,748,748,6050,3780,13624,1215,5302,P
1215,AE,44,44,44,346,346,1216,0,E
1215,AF,119,75,119,1016,1016,1216,0,A
1215,BF,518,443,562,240,586,1216,44,F
1215,BG,226,226,788,380,966,1216,562,G
1215,BH,1017,348,1136,180,1196,1216,119,B
1215,CH,619,271,1407,5460,6426,1216,788,H
1215,C,897,626,2033,1050,2246,1216,1136,C
1215,B,781,781,2814,625,2871,1216,2033,B
1215,C,240,240,3054,380,3251,1216,2814,C
1215,D,1371,1371,4425,5580,8831,1216,3054,D
1215,M,526,526,4951,1109,9940,1216,4425,M
1215,N,679,679,5630,150,10090,1216,4951,N
1215,O,225,225,5855,185,10275,1216,5630,O
1215,N,319,319,6174,355,10630,1216,5855,N
1215,O,125,125,6299,120,10750,1216,6174,O
1215,P,1037,1037,7336,4230,14980,1216,6299,P
1216,AE,167,167,167,1178,1178,1217,0,A
1216,BE,1193,1193,1360,240,1418,1217,167,B
1216,CE,1550,190,1550,1540,1540,1217,0,E
1216,CF,253,253,1803,300,1840,1217,1550,F
1216,CG,669,226,2029,705,2123,1217,1360,C
1216,DG,767,541,2570,745,2585,1217,1803,G
1216,DH,136,136,2706,1560,4145,1217,2570,H
1216,D,1056,379,3085,5760,7883,1217,2029,D
1216,M,213,213,3298,910,8793,1217,3085,M
1216,N,953,953,4251,300,9093,1217,3298,N
1216,O,193,193,4444,1345,10438,1217,4251,O
1216,P,7202,7202,11646,3050,13488,1217,4444,P
1217,AEI,30,30,30,3960,3960,1218,0,I
1217,AEJ,561,531,561,830,830,1218,0,E
1217,AFJ,585,24,585,1708,1708,1218,0,A
1217,BFJ,338,314,899,150,980,1218,561,F
1217,BGJ,1454,1140,2039,420,2128,1218,585,B
1217,CGJ,1217,77,2116,1600,2580,1218,899,G
1217,CFJ,684,607,2723,900,3028,1218,2039,C
1217,BFJ,1304,1304,4027,1070,4098,1218,2723,B
1217,CFJ,178,178,4205,386,4484,1218,4027,C
1217,DFJ,4214,39,4244,420,4380,1218,30,J
1217,DFK,3335,1207,5451,2949,5529,1218,2116,F
1217,DGK,238,238,5689,228,5757,1218,5451,G
1217,DHK,2233,788,6477,269,4649,1218,4244,K
1217,DHL,1890,1102,7579,402,6159,1218,5689,H
1217,DL,1853,751,8330,651,5300,1218,6477,L
1217,D,4733,608,8938,1454,5938,1218,4205,D
1217,M,6946,6946,15884,7031,13190,1218,8938,M
1217,N,205,205,16089,180,13370,1218,15884,N
1217,O,271,271,16360,235,13605,1218,16089,O
1217,P,2481,2481,18841,550,14155,1218,16360,P
1218,A,61,61,61,15,15,1219,0,A
1218,B,140,140,201,240,255,1219,61,B
1218,C,177,177,378,150,405,1219,201,C
1218,D,3915,3915,4293,4230,4635,1219,378,D
1218,M,83,83,4376,54,4689,1219,4293,M
1218,N,73,73,4449,230,4919,1219,4376,N
1218,O,83,83,4532,100,5019,1219,4449,O
1218,P,149,149,4681,2820,7839,1219,4532,P
1219,A,33972,33972,33972,34676,34676,1220,0,A
1219,B,734,734,34706,90,34766,1220,33972,B
1219,C,879,879,35585,1240,36006,1220,34706,C
1219,D,155,155,35740,3780,39786,1220,35585,D
1219,M,1953,1953,37693,2216,42002,1220,35740,M
1219,N,297,297,37990,90,42092,1220,37693,N
1219,O,1471,1471,39461,1935,44027,1220,37990,O
1219,P,1284,1284,40745,3780,47807,1220,39461,P
1220,A,692,692,692,1495,1495,1221,0,A
1220,B,831,831,1523,90,1585,1221,692,B
1220,C,964,964,2487,1240,2825,1221,1523,C
1220,D,298,298,2785,3780,6605,1221,2487,D
1220,M,821,821,3606,1327,7932,1221,2785,M
1220,N,546,546,4152,90,8022,1221,3606,N
1220,O,653,653,4805,930,8952,1221,4152,O
1220,P,4100,4100,8905,3780,12732,1221,4805,P
1221,AE,14,14,14,95,95,1222,0,E
1221,AF,156,156,170,135,230,1222,14,F
1221,AG,286,286,456,285,515,1222,170,G
1221,AH,23,23,479,5160,5675,1222,456,H
1221,A,493,14,493,1320,1320,1222,0,A
1221,B,1149,1149,1642,300,1620,1222,493,B
1221,C,672,672,2314,775,2395,1222,1642,C
1221,D,141,141,2455,1140,3535,1222,2314,D
1221,M,792,792,3247,964,6639,1222,2455,M
1221,N,297,297,3544,180,6819,1222,3247,N
1221,O,756,756,4300,885,7704,1222,3544,O
1221,N,1239,1239,5539,1115,8819,1222,4300,N
1221,O,595,595,6134,680,9499,1222,5539,O
1221,P,2039,2039,8173,5460,14959,1222,6134,P
1222,AEI,6,6,6,920,920,1223,0,I
1222,AEJ,201,195,201,1022,1022,1223,0,E
1222,AFJ,465,264,465,1158,1158,1223,0,A
1222,BFJ,1134,675,1140,240,1160,1223,6,J
1222,BFK,958,19,1159,180,1202,1223,201,F
1222,BGK,813,119,1278,180,1338,1223,465,B
1222,CGK,511,373,1651,795,1955,1223,1140,K
1222,CGL,604,112,1763,655,1857,1223,1159,G
1222,CHL,1219,734,2497,1080,2418,1223,1278,C
1222,DHL,577,577,3074,6960,9378,1223,2497,D
1222,HL,4447,3136,6210,320,2177,1223,1763,H
1222,L,8888,4329,10539,3960,5915,1223,1651,L
1222,M,226,226,10765,499,9877,1223,10539,M
1222,N,300,300,11065,90,9967,1223,10765,N
1222,O,1482,1482,12547,1780,11747,1223,11065,O
1222,N,662,662,13209,345,12092,1223,12547,N
1222,O,578,578,13787,965,13057,1223,13209,O
1222,P,478,478,14265,3780,16837,1223,13787,P
1223,AEI,50,50,50,962,962,1224,0,A
1223,BEI,81,31,81,1036,1036,1224,0,I
1223,BEJ,213,132,213,271,271,1224,0,E
1223,BFJ,208,208,421,210,481,1224,213,F
1223,BGJ,154,154,575,255,736,1224,421,G
1223,BFJ,1091,566,1141,240,1202,1224,50,B
1223,CFJ,1154,94,1235,240,1276,1224,81,J
1223,CFK,924,264,1499,805,1541,1224,575,F
1223,CGK,811,453,1952,995,2197,1224,1141,C
1223,DGK,764,47,1999,995,2271,1224,1235,K
1223,DGL,112,112,2111,4680,6951,1224,1999,L
1223,DG,373,214,2325,4680,6877,1224,1952,D
1223,G,993,167,2492,1020,2561,1224,1499,G
1223,H,69,69,2561,4740,7301,1224,2492,H
1223,M,5274,5274,7835,5432,12733,1224,2561,M
1223,N,254,254,8089,90,12823,1224,7835,N
1223,O,736,736,8825,815,13638,1224,8089,O
1223,P,219,219,9044,3780,17418,1224,8825,P
1224,A,157,157,157,311,311,1225,0,A
1224,B,402,402,559,300,611,1225,157,B
1224,C,649,649,1208,825,1436,1225,559,C
1224,B,990,990,2198,835,2271,1225,1208,B
1224,C,146,146,2344,290,2561,1225,2198,C
1224,D,17,17,2361,5100,7661,1225,2344,D
1224,M,1334,1334,3695,1570,9231,1225,2361,M
1224,N,261,261,3956,120,9351,1225,3695,N
1224,O,169,169,4125,390,9741,1225,3956,O
1224,N,1489,1489,5614,1225,10966,1225,4125,N
1224,O,1021,1021,6635,970,11936,1225,5614,O
1224,P,718,718,7353,5160,17096,1225,6635,P
1225,AEI,128,128,128,227,227,1226,0,A
1225,BEI,149,21,149,774,774,1226,0,E
1225,BFI,171,22,171,895,895,1226,0,I
1225,BFJ,180,137,308,135,362,1226,128,B
1225,CFJ,239,239,547,285,647,1226,308,C
1225,DFJ,24,24,571,5160,5807,1226,547,D
1225,FJ,715,293,864,150,924,1226,149,F
1225,GJ,814,121,985,150,1045,1226,171,J
1225,GK,202,81,1066,540,1464,1226,864,G
1225,HK,180,99,1165,540,1585,1226,985,K
1225,HL,317,218,1383,720,2184,1226,1066,H
1225,L,268,50,1433,720,2305,1226,1165,L
1225,M,803,803,2236,1049,6856,1226,1433,M
1225,N,370,370,2606,180,7036,1226,2236,N
1225,O,623,623,3229,885,7921,1226,2606,O
1225,P,8053,8053,11282,6680,14601,1226,3229,P
1226,AEI,1030,1030,1030,2260,2260,1227,0,I
1226,AEJ,1509,1509,2539,300,2560,1227,1030,J
1226,AEK,882,882,3421,895,3455,1227,2539,K
1226,AEL,3837,416,3837,3988,3988,1227,0,A
1226,BEL,194,194,4031,90,4078,1227,3837,B
1226,CEL,839,229,4260,2220,5675,1227,3421,L
1226,CE,498,269,4529,815,4893,1227,4031,C
1226,BE,1418,1418,5947,1105,5998,1227,4529,B
1226,CE,1312,1312,7259,1850,7848,1227,5947,C
1226,DE,5555,5555,12814,3780,11628,1227,7259,D
1226,E,32279,19465,32279,33058,33058,1227,0,E
1226,F,924,924,33203,90,33148,1227,32279,F
1226,G,665,665,33868,1105,34253,1227,33203,G
1226,H,4175,4175,38043,3780,38033,1227,33868,H
1226,M,289,289,38332,1300,39333,1227,38043,M
1226,N,1266,1266,39598,300,39633,1227,38332,N
1226,O,652,652,40250,805,40438,1227,39598,O
1226,P,349,349,40599,2940,43378,1227,40250,P
1227,A,243,243,243,3516,3516,1228,0,A
1227,B,3211,3211,3454,90,3606,1228,243,B
1227,C,2124,2124,5578,1040,4646,1228,3454,C
1227,D,663,663,6241,3780,8426,1228,5578,D
1227,M,2036,2036,8277,4535,12961,1228,6241,M
1227,N,2524,2524,10801,90,13051,1228,8277,N
1227,O,576,576,11377,1015,14066,1228,10801,O
1227,P,2712,2712,14089,3780,17846,1228,11377,P
1228,AE,1467,1467,1467,1590,1590,1229,0,A
1228,BE,237,237,1704,150,1740,1229,1467,B
1228,CE,716,716,2420,760,2500,1229,1704,C
1228,DE,1057,1057,3477,4200,6700,1229,2420,D
1228,E,9955,6478,9955,11922,11922,1229,0,E
1228,F,1997,1997,11952,90,12012,1229,9955,F
1228,G,922,922,12874,1055,13067,1229,11952,G
1228,H,914,914,13788,3780,16847,1229,12874,H
1228,M,693,693,14481,1335,18182,1229,13788,M
1228,N,677,677,15158,90,18272,1229,14481,N
1228,O,996,996,16154,1225,19497,1229,15158,O
1228,N,489,489,16643,205,19702,1229,16154,N
1228,O,188,188,16831,585,20287,1229,16643,O
1228,P,8312,8312,25143,3780,24067,1229,16831,P
1229,A,224,224,224,284,284,1230,0,A
1229,B,274,274,498,240,524,1230,224,B
1229,C,697,697,1195,995,1519,1230,498,C
1229,B,1966,1966,3161,1690,3209,1230,1195,B
1229,C,514,514,3675,900,4109,1230,3161,C
1229,D,558,558,4233,3960,8069,1230,3675,D
1229,M,136,136,4369,500,8569,1230,4233,M
1229,N,1204,1204,5573,900,9469,1230,4369,N
1229,O,450,450,6023,630,10099,1230,5573,O
1229,N,1233,1233,7256,1055,11154,1230,6023,N
1229,O,1073,1073,8329,1206,12360,1230,7256,O
1229,P,206,206,8535,414,12774,1230,8329,P
1230,A,1036,1036,1036,1381,1381,1231,0,A
1230,B,450,450,1486,150,1531,1231,1036,B
1230,C,604,604,2090,620,2151,1231,1486,C
1230,D,461,461,2551,4200,6351,1231,2090,D
1230,M,11673,11673,14224,14655,21006,1231,2551,M
1230,N,3209,3209,17433,240,21246,1231,14224,N
1230,O,705,705,18138,860,22106,1231,17433,O
1230,P,615,615,18753,3960,26066,1231,18138,P
1231,AE,244,244,244,865,865,1232,0,E
1231,AF,955,955,1199,300,1165,1232,244,F
1231,AG,934,934,2133,930,2095,1232,1199,G
1231,AH,5212,3079,5212,6050,6050,1232,0,A
1231,BH,3753,674,5886,2760,4855,1232,2133,H
1231,B,871,197,6083,90,6140,1232,5212,B
1231,C,484,484,6567,905,7045,1232,6083,C
1231,D,33132,33132,39699,3780,10825,1232,6567,D
1231,M,92,92,39791,883,11708,1232,39699,M
1231,N,971,971,40762,240,11948,1232,39791,N
1231,O,738,738,41500,770,12718,1232,40762,O
1231,P,214,214,41714,550,13268,1232,41500,P
1232,AEI,215,215,215,349,349,1233,0,A
1232,BEI,338,123,338,415,415,1233,0,E
1232,BFI,254,131,469,150,499,1233,215,B
1232,CFI,287,156,625,240,655,1233,338,F
1232,CGI,237,81,706,145,644,1233,469,C
1232,BGI,453,453,1159,565,1209,1233,706,B
1232,CGI,104,104,1263,167,1376,1233,1159,C
1232,DGI,715,77,1340,798,1453,1233,625,G
1232,DHI,268,191,1531,393,1769,1233,1263,D
1232,HI,321,130,1661,402,1855,1233,1340,H
1232,I,4435,2774,4435,4615,4615,1233,0,I
1232,J,95,95,4530,180,4795,1233,4435,J
1232,K,1441,1441,5971,987,5782,1233,4530,K
1232,L,1008,1008,6979,1143,6925,1233,5971,L
1232,M,780,780,7759,1368,8293,1233,6979,M
1232,N,738,738,8497,240,8533,1233,7759,N
1232,O,2686,2686,11183,2340,10873,1233,8497,O
1232,N,1489,1489,12672,1775,12648,1233,11183,N
1232,O,668,668,13340,980,13628,1233,12672,O
1232,P,5524,5524,18864,780,14408,1233,13340,P
1233,A,96,96,96,120,120,1234,0,A
1233,B,125,125,221,150,270,1234,96,B
1233,C,115,115,336,110,380,1234,221,C
1233,B,1018,1018,1354,1015,1395,1234,336,B
1233,C,114,114,1468,135,1530,1234,1354,C
1233,D,275,275,1743,4230,5760,1234,1468,D
1233,M,229,229,1972,188,5948,1234,1743,M
1233,N,64,64,2036,150,6098,1234,1972,N
1233,O,163,163,2199,140,6238,1234,2036,O
1233,N,886,886,3085,900,7138,1234,2199,N
1233,O,309,309,3394,650,7788,1234,3085,O
1233,P,4524,4524,7918,4230,12018,1234,3394,P
1234,AEI,94,94,94,112,112,1235,0,I
1234,AEJ,190,96,190,1104,1104,1235,0,A
1234,BEJ,207,17,207,1137,1137,1235,0,E
1234,BFJ,258,145,352,300,412,1235,94,J
1234,BFK,582,582,934,770,1182,1235,352,K
1234,BFJ,1034,290,1224,180,1284,1235,190,B
1234,CFJ,1050,33,1257,180,1317,1235,207,F
1234,CGJ,1178,855,2112,1005,2187,1235,934,J
1234,CGK,933,78,2190,1055,2372,1235,1257,G
1234,CFK,1003,37,2227,1055,2339,1235,1224,C
1234,BFK,139,24,2251,240,2427,1235,2112,K
1234,BFL,5,5,2256,5040,7467,1235,2251,L
1234,BF,805,739,2995,700,3072,1235,2190,F
1234,BG,773,5,3000,700,3039,1235,2227,B
1234,CG,147,142,3142,240,3312,1235,2995,G
1234,CH,6,6,3148,5040,8352,1235,3142,H
1234,C,186,38,3186,240,3279,1235,3000,C
1234,D,110,110,3296,5040,8319,1235,3186,D
1234,M,86,86,3382,153,8505,1235,3296,M
1234,N,127,127,3509,120,8625,1235,3382,N
1234,O,126,126,3635,120,8745,1235,3509,O
1234,N,3546,3546,7181,3550,12295,1235,3635,N
1234,O,223,223,7404,260,12555,1235,7181,O
1234,P,167,167,7571,5100,17655,1235,7404,P
1235,AEI,251,251,251,1241,1241,1236,0,I
1235,AEJ,1067,1067,1318,90,1331,1236,251,J
1235,AEK,1107,1107,2425,1270,2601,1236,1318,K
1235,AEL,566,566,2991,3780,6381,1236,2425,L
1235,AE,11236,8245,11236,11344,11344,1236,0,A
1235,BE,131,131,11367,90,11434,1236,11236,B
1235,CE,757,757,12124,1105,12539,1236,11367,C
1235,DE,501,501,12625,3780,16319,1236,12124,D
1235,E,35772,23147,35772,37993,37993,1236,0,E
1235,F,2252,2252,38024,90,38083,1236,35772,F
1235,G,1019,1019,39043,1220,39303,1236,38024,G
1235,H,1258,1258,40301,4625,43928,1236,39043,H
1235,M,246,246,40547,640,44568,1236,40301,M
1235,N,425,425,40972,90,44658,1236,40547,N
1235,O,528,528,41500,845,45503,1236,40972,O
1235,P,427,427,41927,3780,49283,1236,41500,P
1236,AE,61,61,61,1085,1085,1237,0,A
1236,BE,1250,1189,1250,1620,1620,1237,0,E
1236,BF,1212,23,1273,240,1325,1237,61,B
1236,CF,629,606,1879,300,1920,1237,1250,F
1236,CG,684,78,1957,760,2085,1237,1273,C
1236,DG,70,70,2027,7680,9765,1237,1957,D
1236,G,850,702,2729,1045,2965,1237,1879,G
1236,H,1341,1341,4070,1140,4105,1237,2729,H
1236,M,264,264,4334,375,10140,1237,4070,M
1236,N,371,371,4705,300,10440,1237,4334,N
1236,O,540,540,5245,735,11175,1237,4705,O
1236,P,3926,3926,9171,4020,15195,1237,5245,P
1237,AE,55,55,55,319,319,1238,0,A
1237,BE,282,227,282,833,833,1238,0,E
1237,BF,506,279,561,300,619,1238,55,B
1237,CF,644,365,926,150,983,1238,282,F
1237,CG,140,140,1066,100,1083,1238,926,G
1237,CF,557,52,1118,825,1444,1238,561,C
1237,BF,390,338,1456,500,1583,1238,1066,F
1237,BG,135,135,1591,300,1883,1238,1456,G
1237,BH,43,43,1634,5100,6983,1238,1591,H
1237,B,1089,573,2207,835,2279,1238,1118,B
1237,C,96,96,2303,290,2569,1238,2207,C
1237,D,25,25,2328,5100,7669,1238,2303,D
1237,M,13,13,2341,1283,8952,1238,2328,M
1237,N,1325,1325,3666,120,9072,1238,2341,N
1237,O,400,400,4066,420,9492,1238,3666,O
1237,N,3399,3399,7465,3375,12867,1238,4066,N
1237,O,715,715,8180,820,13687,1238,7465,O
1237,P,2722,2722,10902,5040,18727,1238,8180,P
1238,AEI,68,68,68,37,37,1239,0,I
1238,AEJ,162,162,230,240,277,1239,68,J
1238,AEK,750,750,980,970,1247,1239,230,K
1238,AEL,116,116,1096,3960,5207,1239,980,L
1238,AE,1214,118,1214,1297,1297,1239,0,A
1238,BE,286,286,1500,240,1537,1239,1214,B
1238,CE,1876,376,1876,2164,2164,1239,0,E
1238,CF,718,342,2218,970,2507,1239,1500,C
1238,DF,253,253,2471,3960,6467,1239,2218,D
1238,F,809,214,2685,420,2584,1239,1876,F
1238,G,921,921,3606,1074,3658,1239,2685,G
1238,H,443,443,4049,356,4014,1239,3606,H
1238,M,3293,3293,7342,4106,10573,1239,4049,M
1238,N,838,838,8180,90,10663,1239,7342,N
1238,O,567,567,8747,905,11568,1239,8180,O
1238,N,429,429,9176,90,11658,1239,8747,N
1238,O,1505,1505,10681,2320,13978,1239,9176,O
1238,P,2607,2607,13288,3420,17398,1239,10681,P
1239,AEI,46,46,46,72,72,1240,0,E
1239,AFI,55,9,55,95,95,1240,0,I
1239,AFJ,104,95,150,135,207,1240,46,F
1239,AGJ,131,36,186,150,245,1240,55,J
1239,AGK,173,137,323,295,502,1240,150,G
1239,AHK,206,69,392,205,450,1240,186,K
1239,AHL,431,39,431,1077,1077,1240,0,A
1239,BHL,163,55,486,5160,5662,1240,323,H
1239,BL,115,21,507,2880,3330,1240,392,L
1239,B,694,618,1125,90,1167,1240,431,B
1239,C,943,943,2068,1285,2452,1240,1125,C
1239,D,3163,3163,5231,3780,6232,1240,2068,D
1239,M,1027,1027,6258,1909,8141,1240,5231,M
1239,N,914,914,7172,90,8231,1240,6258,N
1239,O,955,955,8127,1240,9471,1240,7172,O
1239,N,899,899,9026,595,10066,1240,8127,N
1239,O,881,881,9907,1080,11146,1240,9026,O
1239,P,388,388,10295,3780,14926,1240,9907,P
1240,AEI,136,136,136,741,741,1241,0,I
1240,AEJ,824,824,960,270,1011,1241,136,J
1240,AEK,1055,95,1055,1125,1125,1241,0,A
1240,BEK,265,265,1320,240,1365,1241,1055,B
1240,CEK,1407,87,1407,1473,1473,1241,0,E
1240,CFK,45,45,1452,120,1593,1241,1407,F
1240,CGK,751,619,2071,970,2335,1241,1320,C
1240,DGK,1192,81,2152,930,1941,1241,960,K
1240,DGL,1405,1324,3476,3960,6295,1241,2071,D
1240,GL,2368,344,3820,2550,4143,1241,1452,G
1240,FL,4995,3327,7147,435,2376,1241,2152,L
1240,F,5618,2291,9438,5335,9478,1241,3820,F
1240,G,986,986,10424,1074,10552,1241,9438,G
1240,H,580,580,11004,356,10908,1241,10424,H
1240,M,303,303,11307,1004,11912,1241,11004,M
1240,N,928,928,12235,240,12152,1241,11307,N
1240,O,1126,1126,13361,1015,13167,1241,12235,O
1240,P,893,893,14254,3960,17127,1241,13361,P
1241,AEI,1502,1502,1502,2832,2832,1242,0,E
1241,AFI,1590,88,1590,1615,1615,1242,0,I
1241,AFJ,429,429,2019,420,2035,1242,1590,J
1241,AFK,2753,734,2753,3121,3121,1242,0,A
1241,BFK,771,37,2790,1069,3104,1242,2019,K
1241,BFL,1706,418,3208,420,3252,1242,1502,F
1241,BGL,731,276,3484,420,3541,1242,2753,B
1241,CGL,877,877,4361,1069,4610,1242,3484,C
1241,DGL,1271,118,4479,1434,4686,1242,3208,G
1241,DHL,872,872,5351,356,5042,1242,4479,H
1241,DL,3711,1150,6501,356,3460,1242,2790,L
1241,D,4780,2640,9141,356,4966,1242,4361,D
1241,M,518,518,9659,1411,6453,1242,9141,M
1241,N,1004,1004,10663,150,6603,1242,9659,N
1241,O,773,773,11436,820,7423,1242,10663,O
1241,P,3928,3928,15364,4170,11593,1242,11436,P
1242,A,305,305,305,875,875,1243,0,A
1242,B,699,699,1004,180,1055,1243,305,B
1242,C,133,133,1137,355,1410,1243,1004,C
1242,B,400,400,1537,180,1590,1243,1137,B
1242,C,1003,1003,2540,1010,2600,1243,1537,C
1242,D,1213,1213,3753,1620,4220,1243,2540,D
1242,M,20576,20576,24329,21293,25513,1243,3753,M
1242,N,757,757,25086,90,25603,1243,24329,N
1242,O,915,915,26001,1240,26843,1243,25086,O
1242,N,358,358,26359,40,26883,1243,26001,N
1242,O,173,173,26532,585,27468,1243,26359,O
1242,P,153,153,26685,3780,31248,1243,26532,P
1243,A,1720,1720,1720,2418,2418,1244,0,A
1243,B,878,878,2598,240,2658,1244,1720,B
1243,C,146,146,2744,395,3053,1244,2598,C
1243,D,1111,1111,3855,9700,12753,1244,2744,D
1243,M,1181,1181,5036,1576,14329,1244,3855,M
1243,N,481,481,5517,150,14479,1244,5036,N
1243,O,177,177,5694,195,14674,1244,5517,O
1243,N,900,900,6594,860,15534,1244,5694,N
1243,O,436,436,7030,420,15954,1244,6594,O
1243,P,28,28,7058,4230,20184,1244,7030,P
1244,AEI,105,105,105,1130,1130,1245,0,I
1244,AEJ,179,74,179,1169,1169,1245,0,A
1244,BEJ,1227,1153,1332,240,1370,1245,105,J
1244,BEK,1173,20,1352,240,1409,1245,179,B
1244,CEK,705,685,2037,705,2075,1245,1332,K
1244,CEL,766,81,2118,685,2094,1245,1352,C
1244,DEL,1090,1090,3208,5760,7854,1245,2118,D
1244,EL,1221,50,3258,5760,7835,1245,2037,L
1244,E,7400,4142,7400,7475,7475,1245,0,E
1244,F,330,330,7730,310,7785,1245,7400,F
1244,G,820,820,8550,770,8555,1245,7730,G
1244,H,395,395,8945,1560,10115,1245,8550,H
1244,M,29,29,8974,1165,11280,1245,8945,M
1244,N,1385,1385,10359,300,11580,1245,8974,N
1244,O,530,530,10889,1365,12945,1245,10359,O
1244,P,2396,2396,13285,2820,15765,1245,10889,P
1245,AE,41,41,41,1886,1886,1246,0,A
1245,BE,1139,1098,1139,2458,2458,1246,0,E
1245,BF,1940,842,1981,150,2036,1246,41,B
1245,CF,469,469,2450,505,2541,1246,1981,C
1245,DF,1355,44,2494,90,2548,1246,1139,F
1245,DG,883,839,3333,4200,6741,1246,2450,D
1245,G,1291,452,3785,1195,3743,1246,2494,G
1245,H,2145,2145,5930,3780,7523,1246,3785,H
1245,M,58,58,5988,142,7665,1246,5930,M
1245,N,174,174,6162,150,7815,1246,5988,N
1245,O,182,182,6344,120,7935,1246,6162,O
1245,P,1141,1141,7485,4230,12165,1246,6344,P
1246,A,1265,1265,1265,3258,3258,1247,0,A
1246,B,2058,2058,3323,90,3348,1247,1265,B
1246,C,1393,1393,4716,1745,5093,1247,3323,C
1246,D,23,23,4739,3780,8873,1247,4716,D
1246,M,2155,2155,6894,2820,11693,1247,4739,M
1246,N,814,814,7708,90,11783,1247,6894,N
1246,O,239,239,7947,695,12478,1247,7708,O
1246,P,4592,4592,12539,3780,16258,1247,7947,P
1247,AE,77,77,77,1426,1426,1248,0,E
1247,AF,1536,1536,1613,240,1666,1248,77,F
1247,AG,2040,427,2040,2505,2505,1248,0,A
1247,BG,849,422,2462,890,2556,1248,1613,G
1247,BH,529,107,2569,90,2595,1248,2040,B
1247,CH,126,19,2588,5160,7716,1248,2462,H
1247,C,523,504,3092,880,3475,1248,2569,C
1247,D,6781,6781,9873,3780,7255,1248,3092,D
1247,M,936,936,10809,2885,10601,1248,9873,M
1247,N,2158,2158,12967,250,10851,1248,10809,N
1247,O,1034,1034,14001,1000,11851,1248,12967,O
1247,P,2154,2154,16155,550,12401,1248,14001,P
1248,AEI,213,213,213,45,45,1249,0,I
1248,AEJ,295,82,295,704,704,1249,0,A
1248,BEJ,309,14,309,393,393,1249,0,E
1248,BFJ,192,96,405,420,465,1249,213,J
1248,BFK,184,88,493,150,543,1249,309,F
1248,BGK,598,400,893,240,944,1249,295,B
1248,CGK,167,167,1060,425,1369,1249,893,C
1248,BGK,727,160,1220,605,1148,1249,493,G
1248,BFK,928,113,1333,945,1410,1249,405,K
1248,BFJ,317,44,1377,55,1424,1249,1060,B
1248,CFJ,171,171,1548,420,1844,1249,1377,C
1248,DFJ,397,182,1730,375,1785,1249,1333,J
1248,DFK,196,196,1926,220,2005,1249,1730,K
1248,DFL,950,572,2498,3960,5804,1249,1548,D
1248,FL,649,77,2575,5700,7705,1249,1926,L
1248,F,1911,556,3131,2015,3163,1249,1220,F
1248,G,240,240,3371,840,4003,1249,3131,G
1248,H,341,341,3712,3540,7543,1249,3371,H
1248,M,490,490,4202,1281,8986,1249,3712,M
1248,N,921,921,5123,240,9226,1249,4202,N
1248,O,1581,1581,6704,1680,10906,1249,5123,O
1248,N,2037,2037,8741,1895,12801,1249,6704,N
1248,O,1018,1018,9759,1235,14036,1249,8741,O
1248,P,953,953,10712,620,14656,1249,9759,P
1249,AE,925,925,925,1451,1451,1250,0,E
1249,AF,556,556,1481,90,1541,1250,925,F
1249,AG,395,395,1876,795,2336,1250,1481,G
1249,AH,874,874,2750,3780,6116,1250,1876,H
1249,A,6401,3651,6401,7441,7441,1250,0,A
1249,B,1325,1325,7726,90,7531,1250,6401,B
1249,C,1379,1379,9105,1635,9166,1250,7726,C
1249,B,248,248,9353,240,9406,1250,9105,B
1249,C,403,403,9756,795,10201,1250,9353,C
1249,D,1053,1053,10809,3780,13981,1250,9756,D
1249,M,1781,1781,12590,2617,16598,1250,10809,M
1249,N,968,968,13558,180,16778,1250,12590,N
1249,O,928,928,14486,1200,17978,1250,13558,O
1249,N,809,809,15295,550,18528,1250,14486,N
1249,O,480,480,15775,510,19038,1250,15295,O
1249,P,2440,2440,18215,1260,20298,1250,15775,P
1250,AEI,96,96,96,231,231,1251,0,I
1250,AEJ,209,113,209,396,396,1251,0,E
1250,AFJ,274,274,483,150,546,1251,209,F
1250,AGJ,628,241,724,90,321,1251,96,J
1250,AGK,679,438,1162,620,1166,1251,483,G
1250,AHK,631,193,1355,1005,1326,1251,724,K
1250,AHL,689,689,2044,3780,5106,1251,1355,L
1250,AH,1332,450,2494,4200,5366,1251,1162,H
1250,A,3227,733,3227,3762,3762,1251,0,A
1250,B,565,565,3792,90,3852,1251,3227,B
1250,C,457,457,4249,820,4672,1251,3792,C
1250,B,978,978,5227,600,5272,1251,4249,B
1250,C,1202,1202,6429,1565,6837,1251,5227,C
1250,D,920,920,7349,3780,10617,1251,6429,D
1250,M,2686,2686,10035,4084,14701,1251,7349,M
1250,N,1452,1452,11487,90,14791,1251,10035,N
1250,O,854,854,12341,1230,16021,1251,11487,O
1250,P,100,100,12441,3780,19801,1251,12341,P
1251,AE,112,112,112,212,212,1252,0,A
1251,BE,182,70,182,990,990,1252,0,E
1251,BF,310,240,422,270,482,1252,112,B
1251,CF,475,475,897,735,1217,1252,422,C
1251,BF,1048,333,1230,300,1290,1252,182,F
1251,BG,208,208,1438,315,1605,1252,1230,G
1251,BF,2471,2471,3909,2350,3955,1252,1438,F
1251,BG,163,163,4072,240,4195,1252,3909,G
1251,BH,10,10,4082,5040,9235,1252,4072,H
1251,B,4076,891,4973,3725,4942,1252,897,B
1251,C,194,194,5167,240,5182,1252,4973,C
1251,D,9,9,5176,5040,10222,1252,5167,D
1251,M,19,19,5195,69,10291,1252,5176,M
1251,N,110,110,5305,120,10411,1252,5195,N
1251,O,113,113,5418,120,10531,1252,5305,O
1251,N,672,672,6090,670,11201,1252,5418,N
1251,O,248,248,6338,265,11466,1252,6090,O
1251,P,7,7,6345,5100,16566,1252,6338,P
1252,A,7318,7318,7318,8035,8035,1253,0,A
1252,B,975,975,8293,300,8335,1253,7318,B
1252,C,947,947,9240,1335,9670,1253,8293,C
1252,D,2635,2635,11875,3840,13510,1253,9240,D
1252,M,304,304,12179,1544,15054,1253,11875,M
1252,N,1283,1283,13462,90,15144,1253,12179,N
1252,O,416,416,13878,700,15844,1253,13462,O
1252,N,488,488,14366,195,16039,1253,13878,N
1252,O,525,525,14891,930,16969,1253,14366,O
1252,P,1309,1309,16200,3780,20749,1253,14891,P
1253,AEI,3193,3193,3193,3567,3567,1254,0,I
1253,AEJ,829,829,4022,420,3987,1254,3193,J
1253,AEK,1166,1166,5188,1274,5261,1254,4022,K
1253,AEL,1026,1026,6214,486,5747,1254,5188,L
1253,AE,13066,6852,13066,14834,14834,1254,0,E
1253,AF,13372,306,13372,14665,14665,1254,0,A
1253,BF,1566,1566,14938,300,14965,1254,13372,B
1253,CF,2038,166,15104,300,15134,1254,13066,F
1253,CG,668,502,15606,870,15835,1254,14938,C
1253,DG,549,47,15653,765,15899,1254,15104,G
1253,DH,301,301,15954,1620,17519,1254,15653,H
1253,D,399,51,16005,1620,17455,1254,15606,D
1253,M,1826,1826,17831,2336,19855,1254,16005,M
1253,N,885,885,18716,420,20275,1254,17831,N
1253,O,962,962,19678,980,21255,1254,18716,O
1253,P,1974,1974,21652,550,21805,1254,19678,P
1254,A,380,380,380,1302,1302,1255,0,A
1254,B,1122,1122,1502,240,1542,1255,380,B
1254,C,733,733,2235,970,2512,1255,1502,C
1254,D,318,318,2553,3960,6472,1255,2235,D
1254,M,2028,2028,4581,2936,9408,1255,2553,M
1254,N,939,939,5520,90,9498,1255,4581,N
1254,O,495,495,6015,880,10378,1255,5520,O
1254,N,1112,1112,7127,725,11103,1255,6015,N
1254,O,732,732,7859,1155,12258,1255,7127,O
1254,P,60,60,7919,3780,16038,1255,7859,P
1255,AEI,104,104,104,324,324,1256,0,E
1255,AFI,112,8,112,772,772,1256,0,A
1255,BFI,343,335,447,90,414,1256,104,F
1255,BGI,634,634,1081,1010,1424,1256,447,G
1255,BHI,1055,86,1167,420,1192,1256,112,B
1255,CHI,297,211,1378,3780,5204,1256,1081,H
1255,CI,1371,1160,2538,1390,2582,1256,1167,C
1255,DI,2788,250,2788,2928,2928,1256,0,I
1255,DJ,395,145,2933,3960,6542,1256,2538,D
1255,J,316,171,3104,240,3168,1256,2788,J
1255,K,786,786,3890,855,4023,1256,3104,K
1255,L,84,84,3974,3960,7983,1256,3890,L
1255,M,19,19,3993,148,8131,1256,3974,M
1255,N,332,332,4325,240,8371,1256,3993,N
1255,O,828,828,5153,1035,9406,1256,4325,O
1255,P,3,3,5156,3960,13366,1256,5153,P
1256,AE,235,235,235,483,483,1257,0,E
1256,AF,621,386,621,1461,1461,1257,0,A
1256,BF,626,240,861,420,903,1257,235,F
1256,BG,1240,1000,1861,420,1881,1257,621,B
1256,CG,1135,135,1996,1079,1982,1257,861,G
1256,CH,888,753,2749,1079,2960,1257,1861,C
1256,DH,853,100,2849,356,2338,1257,1996,H
1256,D,1025,925,3774,356,3316,1257,2749,D
1256,M,106,106,3880,634,3950,1257,3774,M
1256,N,720,720,4600,240,4190,1257,3880,N
1256,O,943,943,5543,1200,5390,1257,4600,O
1256,N,2672,2672,8215,2410,7800,1257,5543,N
1256,O,881,881,9096,4936,12736,1257,8215,O
1256,P,672,672,9768,2234,14970,1257,9096,P
1257,AE,976,976,976,3430,3430,1258,0,E
1257,AF,2419,1443,2419,3103,3103,1258,0,A
1257,BF,1076,1076,3495,420,3523,1258,2419,B
1257,CF,2830,311,3806,420,3850,1258,976,F
1257,CG,806,495,4301,1046,4569,1258,3495,C
1257,DG,770,275,4576,1046,4896,1258,3806,G
1257,DH,1187,1187,5763,1049,5945,1258,4576,H
1257,D,2422,960,6723,1049,5618,1258,4301,D
1257,M,2760,2760,9483,3260,9205,1258,6723,M
1257,N,539,539,10022,90,9295,1258,9483,N
1257,O,331,331,10353,725,10020,1258,10022,O
1257,P,2070,2070,12423,3780,13800,1258,10353,P
1258,AE,58,58,58,890,890,1259,0,E
1258,AF,97,39,97,1006,1006,1259,0,A
1258,BF,925,886,983,150,1040,1259,58,F
1258,BG,1092,206,1189,240,1246,1259,97,B
1258,CG,328,122,1311,255,1295,1259,983,G
1258,CH,63,63,1374,2880,4175,1259,1311,H
1258,C,259,74,1448,380,1626,1259,1189,C
1258,D,3815,3815,5263,5460,7086,1259,1448,D
1258,M,3089,3089,8352,3901,10987,1259,5263,M
1258,N,1072,1072,9424,300,11287,1259,8352,N
1258,O,821,821,10245,765,12052,1259,9424,O
1258,P,3772,3772,14017,4080,16132,1259,10245,P
1259,AEI,6,6,6,40,40,1260,0,A
1259,BEI,54,48,54,83,83,1260,0,E
1259,BFI,115,67,121,135,175,1260,6,B
1259,CFI,107,40,161,135,218,1260,54,F
1259,CGI,167,6,167,189,189,1260,0,I
1259,CGJ,70,70,237,110,299,1260,167,J
1259,CGK,163,47,284,285,460,1260,121,C
1259,DGK,177,54,338,295,513,1260,161,G
1259,DHK,147,93,431,5160,5620,1260,284,D
1259,HK,150,57,488,5160,5673,1260,338,H
1259,K,284,33,521,285,584,1260,237,K
1259,L,504,504,1025,5160,5744,1260,521,L
1259,M,851,851,1876,1569,7313,1260,1025,M
1259,N,747,747,2623,90,7403,1260,1876,N
1259,O,874,874,3497,1250,8653,1260,2623,O
1259,P,553,553,4050,3780,12433,1260,3497,P
1260,A,502,502,502,1446,1446,1261,0,A
1260,B,1452,1452,1954,540,1986,1261,502,B
1260,C,742,742,2696,975,2961,1261,1954,C
1260,B,1661,1661,4357,1485,4446,1261,2696,B
1260,C,2361,2361,6718,2202,6648,1261,4357,C
1260,D,277,277,6995,453,7101,1261,6718,D
1260,M,348,348,7343,1082,8183,1261,6995,M
1260,N,843,843,8186,150,8333,1261,7343,N
1260,O,186,186,8372,190,8523,1261,8186,O
1260,N,385,385,8757,350,8873,1261,8372,N
1260,O,126,126,8883,125,8998,1261,8757,O
1260,P,1030,1030,9913,4230,13228,1261,8883,P
1261,A,4818,4818,4818,5056,5056,1262,0,A
1261,B,300,300,5118,90,5146,1262,4818,B
1261,C,1031,1031,6149,1285,6431,1262,5118,C
1261,D,2935,2935,9084,3780,10211,1262,6149,D
1261,M,1477,1477,10561,1551,11762,1262,9084,M
1261,N,194,194,10755,180,11942,1262,10561,N
1261,O,1022,1022,11777,870,12812,1262,10755,O
1261,P,98,98,11875,6680,19492,1262,11777,P
1262,A,213,213,213,680,680,1263,0,A
1262,B,796,796,1009,360,1040,1263,213,B
1262,C,553,553,1562,750,1790,1263,1009,C
1262,D,175,175,1737,1140,2930,1263,1562,D
1262,M,95,95,1832,435,3365,1263,1737,M
1262,N,515,515,2347,245,3610,1263,1832,N
1262,O,596,596,2943,525,4135,1263,2347,O
1262,P,50,50,2993,2880,7015,1263,2943,P
1263,AEI,1577,1577,1577,1742,1742,1264,0,A
1263,BEI,207,207,1784,90,1832,1264,1577,B
1263,CEI,2098,314,2098,2986,2986,1264,0,E
1263,CFI,638,324,2422,820,2652,1264,1784,C
1263,DFI,28,28,2450,3780,6432,1264,2422,D
1263,FI,914,562,3012,90,3076,1264,2098,F
1263,GI,1352,1352,4364,1430,4506,1264,3012,G
1263,HI,125,125,4489,3780,8286,1264,4364,H
1263,I,13953,9464,13953,14771,14771,1264,0,I
1263,J,839,839,14792,90,14861,1264,13953,J
1263,K,1198,1198,15990,1340,16201,1264,14792,K
1263,L,326,326,16316,3780,19981,1264,15990,L
1263,M,619,619,16935,1314,21295,1264,16316,M
1263,N,748,748,17683,90,21385,1264,16935,N
1263,O,894,894,18577,1285,22670,1264,17683,O
1263,P,1803,1803,20380,3780,26450,1264,18577,P
1264,AEI,20,20,20,64,64,1265,0,I
1264,AEJ,26,6,26,656,656,1265,0,E
1264,AFJ,35,9,35,1067,1067,1265,0,A
1264,BFJ,74,59,94,120,184,1265,20,J
1264,BFK,170,170,264,420,604,1265,94,K
1264,BFJ,827,589,853,240,896,1265,26,F
1264,BGJ,1211,393,1246,240,1307,1265,35,B
1264,CGJ,1024,42,1288,730,1334,1265,264,J
1264,CGK,649,214,1502,960,1856,1265,853,G
1264,CHK,379,379,1881,3960,5816,1265,1502,H
1264,CK,802,167,2048,940,2247,1265,1246,C
1264,DK,805,45,2093,940,2274,1265,1288,K
1264,DL,3968,3923,6016,7050,9297,1265,2048,D
1264,L,8538,4615,10631,6990,9264,1265,2093,L
1264,M,2686,2686,13317,2660,11957,1265,10631,M
1264,N,224,224,13541,300,12257,1265,13317,N
1264,O,989,989,14530,1005,13262,1265,13541,O
1264,P,495,495,15025,1200,14462,1265,14530,P
1265,AEI,495,495,495,560,560,1266,0,A
1265,BEI,195,195,690,210,770,1266,495,B
1265,CEI,45,45,735,480,1250,1266,690,C
1265,BEI,1220,485,1220,1334,1334,1266,0,E
1265,BFI,262,262,1482,150,1484,1266,1220,F
1265,BGI,1316,569,2051,860,2110,1266,735,B
1265,CGI,684,115,2166,585,2069,1266,1482,G
1265,CFI,612,612,2778,740,2809,1266,2166,F
1265,CGI,2803,25,2803,2915,2915,1266,0,I
1265,CGJ,780,28,2831,730,2840,1266,2051,C
1265,DGJ,129,76,2907,620,3429,1266,2778,G
1265,DHJ,529,453,3360,2880,5720,1266,2831,D
1265,HJ,692,135,3495,640,3555,1266,2803,J
1265,HK,836,836,4331,1100,4655,1266,3495,K
1265,HJ,758,758,5089,585,5240,1266,4331,J
1265,HK,4909,2727,7816,3740,7169,1266,2907,H
1265,K,2968,241,8057,3018,8258,1266,5089,K
1265,L,1381,1381,9438,402,8660,1266,8057,L
1265,M,7339,7339,16777,8124,16784,1266,9438,M
1265,N,874,874,17651,150,16934,1266,16777,N
1265,O,189,189,17840,320,17254,1266,17651,O
1265,N,155,155,17995,15,17269,1266,17840,N
1265,O,714,714,18709,810,18079,1266,17995,O
1265,P,72,72,18781,4110,22189,1266,18709,P
1266,AEI,62,62,62,250,250,1267,0,E
1266,AFI,84,22,84,742,742,1267,0,A
1266,BFI,103,19,103,309,309,1267,0,I
1266,BFJ,278,237,340,150,400,1267,62,F
1266,BGJ,40,40,380,690,1090,1267,340,G
1266,BHJ,713,436,816,570,879,1267,103,J
1266,BHK,65,65,881,80,959,1267,816,K
1266,BHL,836,39,920,240,982,1267,84,B
1266,CHL,109,70,990,2880,3839,1267,881,L
1266,CH,618,8,998,3600,4690,1267,380,H
1266,C,154,76,1074,290,1272,1267,920,C
1266,D,1556,1556,2630,5100,6372,1267,1074,D
1266,M,374,374,3004,1317,7689,1267,2630,M
1266,N,980,980,3984,90,7779,1267,3004,N
1266,O,840,840,4824,1200,8979,1267,3984,O
1266,P,183,183,5007,3780,12759,1267,4824,P
1267,AE,270,270,270,1207,1207,1268,0,E
1267,AF,977,977,1247,90,1297,1268,270,F
1267,AG,1021,1021,2268,1240,2537,1268,1247,G
1267,AH,4283,4283,6551,3780,6317,1268,2268,H
1267,A,8620,2069,8620,8698,8698,1268,0,A
1267,B,114,114,8734,90,8788,1268,8620,B
1267,C,743,743,9477,1105,9893,1268,8734,C
1267,D,462,462,9939,3780,13673,1268,9477,D
1267,M,470,470,10409,1166,14839,1268,9939,M
1267,N,726,726,11135,90,14929,1268,10409,N
1267,O,586,586,11721,935,15864,1268,11135,O
1267,P,2684,2684,14405,3780,19644,1268,11721,P
1268,A,108,108,108,125,125,1269,0,A
1268,B,372,372,480,150,275,1269,108,B
1268,C,209,209,689,520,795,1269,480,C
1268,D,1011,1011,1700,1200,1995,1269,689,D
1268,M,1477,1477,3177,3388,5383,1269,1700,M
1268,N,2093,2093,5270,240,5623,1269,3177,N
1268,O,1013,1013,6283,1290,6913,1269,5270,O
1268,P,94,94,6377,3780,10693,1269,6283,P
1269,AE,186,186,186,530,530,1270,0,A
1269,BE,525,525,711,300,830,1270,186,B
1269,CE,1091,1091,1802,985,1815,1270,711,C
1269,BE,576,576,2378,625,2440,1270,1802,B
1269,CE,139,139,2517,290,2730,1270,2378,C
1269,DE,226,226,2743,5100,7830,1270,2517,D
1269,E,4159,1416,4159,4329,4329,1270,0,E
1269,F,202,202,4361,90,4419,1270,4159,F
1269,G,902,902,5263,1270,5689,1270,4361,G
1269,H,263,263,5526,3780,9469,1270,5263,H
1269,M,1441,1441,6967,2656,12125,1270,5526,M
1269,N,1247,1247,8214,90,12215,1270,6967,N
1269,O,982,982,9196,1200,13415,1270,8214,O
1269,P,527,527,9723,3780,17195,1270,9196,P
1270,AE,259,259,259,380,380,1271,0,A
1270,BE,183,183,442,120,500,1271,259,B
1270,CE,237,237,679,110,610,1271,442,C
1270,BE,546,546,1225,665,1275,1271,679,B
1270,CE,74,74,1299,690,1965,1271,1225,C
1270,DE,1513,214,1513,2365,2365,1271,0,E
1270,DF,1039,1039,2552,240,2605,1271,1513,F
1270,DG,935,935,3487,1040,3645,1271,2552,G
1270,DF,3095,907,4394,2220,4185,1271,1299,D
1270,F,1098,191,4585,1120,4765,1271,3487,F
1270,G,1206,1206,5791,1340,6105,1271,4585,G
1270,H,4542,4542,10333,3960,10065,1271,5791,H
1270,M,1688,1688,12021,1874,11939,1271,10333,M
1270,N,851,851,12872,720,12659,1271,12021,N
1270,O,242,242,13114,270,12929,1271,12872,O
1270,N,216,216,13330,195,13124,1271,13114,N
1270,O,590,590,13920,710,13834,1271,13330,O
1270,P,1587,1587,15507,4080,17914,1271,13920,P
1271,AEI,65,65,65,33,33,1272,0,I
1271,AEJ,68,3,68,694,694,1272,0,E
1271,AFJ,154,86,154,395,395,1272,0,A
1271,BFJ,103,14,168,180,213,1272,65,J
1271,BFK,174,174,342,215,428,1272,168,K
1271,BFL,430,242,584,240,635,1272,154,B
1271,CFL,151,151,735,215,850,1272,584,C
1271,DFL,802,135,870,150,844,1272,68,F
1271,DGL,149,149,1019,225,1069,1272,870,G
1271,DHL,618,334,1353,4890,5740,1272,735,D
1271,HL,1541,530,1883,4140,4568,1272,342,L
1271,H,1909,1045,2928,4170,5239,1272,1019,H
1271,M,901,901,3829,934,6674,1272,2928,M
1271,N,269,269,4098,240,6914,1272,3829,N
1271,O,495,495,4593,785,7699,1272,4098,O
1271,P,1172,1172,5765,3960,11659,1272,4593,P
1272,AEI,143,143,143,712,712,1273,0,E
1272,AFI,279,136,279,820,820,1273,0,I
1272,AFJ,704,568,847,180,892,1273,143,F
1272,AGJ,675,107,954,180,1000,1273,279,J
1272,AGK,231,124,1078,260,1152,1273,847,G
1272,AFK,169,45,1123,220,1220,1273,954,K
1272,AFJ,373,373,1496,320,1540,1273,1123,J
1272,AFK,599,599,2095,735,2275,1273,1496,K
1272,AFL,1570,553,2648,1545,2697,1273,1078,F
1272,AGL,720,720,3368,705,3402,1273,2648,G
1272,AHL,1316,1316,4684,5760,9162,1273,3368,H
1272,AL,7205,2521,7205,7360,7360,1273,0,A
1272,BL,401,401,7606,300,7660,1273,7205,B
1272,CL,591,591,8197,785,8445,1273,7606,C
1272,DL,5908,5908,14105,1560,10005,1273,8197,D
1272,L,18500,6490,20595,4140,6415,1273,2095,L
1272,M,148,148,20743,393,10398,1273,20595,M
1272,N,358,358,21101,180,10578,1273,20743,N
1272,O,563,563,21664,855,11433,1273,21101,O
1272,N,1226,1226,22890,920,12353,1273,21664,N
1272,O,161,161,23051,215,12568,1273,22890,O
1272,P,413,413,23464,4890,17458,1273,23051,P
1273,AEI,626,626,626,1148,1148,1274,0,E
1273,AFI,107,107,733,140,1288,1274,626,F
1273,AGI,841,108,841,1469,1469,1274,0,I
1273,AGJ,496,388,1229,160,1448,1274,733,G
1273,AFJ,904,516,1745,330,1799,1274,841,J
1273,AFK,565,49,1794,390,1838,1274,1229,F
1273,AGK,2205,411,2205,2607,2607,1274,0,A
1273,BGK,813,353,2558,2049,3848,1274,1745,K
1273,BGL,861,97,2655,2049,3887,1274,1794,G
1273,BHL,583,133,2788,150,2757,1274,2205,B
1273,CHL,890,660,3448,886,4734,1274,2558,L
1273,CH,847,187,3635,850,3607,1274,2788,C
1273,BH,1324,344,3979,3746,7633,1274,2655,H
1273,B,475,131,4110,550,4157,1274,3635,B
1273,C,893,893,5003,2049,6206,1274,4110,C
1273,D,658,658,5661,1846,8052,1274,5003,D
1273,M,366,366,6027,1215,9267,1274,5661,M
1273,N,1393,1393,7420,600,9867,1274,6027,N
1273,O,841,841,8261,815,10682,1274,7420,O
1273,P,292,292,8553,385,11067,1274,8261,P
1274,AEI,117,117,117,120,120,1275,0,I
1274,AEJ,509,509,626,570,690,1275,117,J
1274,AEK,67,67,693,80,770,1275,626,K
1274,AEL,123,123,816,2880,3650,1275,693,L
1274,AE,1829,1013,1829,2311,2311,1275,0,E
1274,AF,509,509,2338,90,2401,1275,1829,F
1274,AG,554,554,2892,820,3221,1275,2338,G
1274,AF,3200,308,3200,3233,3233,1275,0,A
1274,BF,248,248,3448,240,3473,1275,3200,B
1274,CF,578,578,4026,725,4198,1275,3448,C
1274,BF,200,200,4226,250,4448,1275,4026,B
1274,CF,1772,438,4664,1505,4726,1275,2892,F
1274,CG,1273,835,5499,1210,5658,1275,4226,C
1274,DG,942,107,5606,1240,5966,1275,4664,G
1274,DH,2984,2984,8590,3780,9746,1275,5606,H
1274,D,4139,1048,9638,3960,9618,1275,5499,D
1274,M,23455,23455,33093,25229,34975,1275,9638,M
1274,N,2011,2011,35104,90,35065,1275,33093,N
1274,O,1106,1106,36210,1360,36425,1275,35104,O
1274,N,895,895,37105,845,37270,1275,36210,N
1274,O,711,711,37816,945,38215,1275,37105,O
1274,P,1516,1516,39332,3780,41995,1275,37816,P
1275,AEI,86,86,86,1086,1086,1276,0,I
1275,AEJ,161,75,161,1228,1228,1276,0,A
1275,BEJ,1200,1125,1286,240,1326,1276,86,J
1275,BEK,1250,125,1411,240,1468,1276,161,B
1275,CEK,743,618,2029,760,2086,1276,1286,K
1275,CEL,720,102,2131,760,2228,1276,1411,C
1275,DEL,2251,120,2251,4312,4312,1276,0,E
1275,DFL,2087,2087,4338,90,4402,1276,2251,F
1275,DGL,547,547,4885,1035,5437,1276,4338,G
1275,DHL,2895,141,5026,7680,9908,1276,2131,D
1275,HL,3669,672,5698,7680,9766,1276,2029,L
1275,H,1288,475,6173,3780,9217,1276,4885,H
1275,M,1257,1257,7430,1546,11454,1276,6173,M
1275,N,491,491,7921,240,11694,1276,7430,N
1275,O,592,592,8513,770,12464,1276,7921,O
1275,N,319,319,8832,285,12749,1276,8513,N
1275,O,872,872,9704,1260,14009,1276,8832,O
1275,P,648,648,10352,3960,17969,1276,9704,P
1276,A,96,96,96,1030,1030,1277,0,A
1276,B,1125,1125,1221,240,1270,1277,96,B
1276,C,864,864,2085,890,2160,1277,1221,C
1276,D,225,225,2310,5160,7320,1277,2085,D
1276,M,180,180,2490,1664,8984,1277,2310,M
1276,N,1711,1711,4201,250,9234,1277,2490,N
1276,O,916,916,5117,1180,10414,1277,4201,O
1276,N,1414,1414,6531,1175,11589,1277,5117,N
1276,O,1988,1988,8519,1872,13461,1277,6531,O
1276,P,7390,7390,15909,1353,14814,1277,8519,P
1277,AE,1457,1457,1457,1575,1575,1278,0,E
1277,AF,404,404,1861,300,1875,1278,1457,F
1277,AG,2167,306,2167,2266,2266,1278,0,A
1277,BG,140,140,2307,90,2356,1278,2167,B
1277,CG,791,345,2652,1095,2970,1278,1861,G
1277,CH,618,273,2925,815,3171,1278,2307,C
1277,BH,1527,1254,4179,1890,4860,1278,2652,H
1277,B,1420,166,4345,1105,4276,1278,2925,B
1277,C,1312,1312,5657,1850,6126,1278,4345,C
1277,D,1002,1002,6659,3780,9906,1278,5657,D
1277,M,503,503,7162,875,10781,1278,6659,M
1277,N,641,641,7803,300,11081,1278,7162,N
1277,O,916,916,8719,925,12006,1278,7803,O
1277,P,2578,2578,11297,2760,14766,1278,8719,P
1278,AEI,107,107,107,367,367,1279,0,A
1278,BEI,285,285,392,90,457,1279,107,B
1278,CEI,452,60,452,584,584,1279,0,E
1278,CFI,179,179,631,150,734,1279,452,F
1278,CGI,200,200,831,175,909,1279,631,G
1278,CHI,509,70,901,735,1192,1279,392,C
1278,BHI,215,145,1046,1520,2429,1279,831,H
1278,BI,2237,2092,3138,1995,3187,1279,901,B
1278,CI,1147,1147,4285,1315,4502,1279,3138,C
1278,DI,4329,44,4329,5259,5259,1279,0,I
1278,DJ,1189,1189,5518,300,5559,1279,4329,J
1278,DK,1153,1153,6671,1050,6609,1279,5518,K
1278,DJ,2991,605,7276,3780,8282,1279,4285,D
1278,J,1381,776,8052,1460,8069,1279,6671,J
1278,K,639,639,8691,900,8969,1279,8052,K
1278,L,578,578,9269,3960,12929,1279,8691,L
1278,M,112,112,9381,88,13017,1279,9269,M
1278,N,36,36,9417,120,13137,1279,9381,N
1278,O,541,541,9958,680,13817,1279,9417,O
1278,N,489,489,10447,345,14162,1279,9958,N
1278,O,685,685,11132,685,14847,1279,10447,O
1278,P,1057,1057,12189,5760,20607,1279,11132,P
1279,AE,1058,1058,1058,1351,1351,1280,0,E
1279,AF,398,398,1456,150,1501,1280,1058,F
1279,AG,1573,117,1573,1679,1679,1280,0,A
1279,BG,383,383,1956,300,1979,1280,1573,B
1279,CG,794,294,2250,590,2091,1280,1456,G
1279,CF,501,207,2457,811,2790,1280,1956,C
1279,DF,215,8,2465,425,2516,1280,2250,F
1279,DG,334,326,2791,2940,5730,1280,2457,D
1279,G,873,547,3338,105,2621,1280,2465,G
1279,H,678,678,4016,4230,6851,1280,3338,H
1279,M,4367,4367,8383,5406,12257,1280,4016,M
1279,N,1245,1245,9628,240,12497,1280,8383,N
1279,O,575,575,10203,995,13492,1280,9628,O
1279,P,679,679,10882,3580,17072,1280,10203,P
1280,A,267,267,267,985,985,1281,0,A
1280,B,909,909,1176,240,1225,1281,267,B
1280,C,787,787,1963,1015,2240,1281,1176,C
1280,D,1016,1016,2979,3960,6200,1281,1963,D
1280,M,947,947,3926,1257,7457,1281,2979,M
1280,N,574,574,4500,300,7757,1281,3926,N
1280,O,345,345,4845,450,8207,1281,4500,O
1280,P,2630,2630,7475,4020,12227,1281,4845,P
1281,AEI,114,114,114,1464,1464,1282,0,A
1281,BEI,133,19,133,385,385,1282,0,I
1281,BEJ,318,318,451,90,475,1282,133,J
1281,BEK,1460,1123,1574,180,1644,1282,114,B
1281,CEK,1333,210,1784,1865,2340,1282,451,K
1281,CEL,970,760,2544,950,2594,1282,1574,C
1281,BEL,156,156,2700,145,2739,1282,2544,B
1281,CEL,2017,1101,3801,3780,6120,1282,1784,L
1281,CE,1213,112,3913,1050,3789,1282,2700,C
1281,DE,4376,463,4376,4518,4518,1282,0,E
1281,DF,256,256,4632,180,4698,1282,4376,F
1281,DG,1019,1019,5651,950,5648,1282,4632,G
1281,DF,98,98,5749,145,5793,1282,5651,F
1281,DG,1238,1238,6987,1050,6843,1282,5749,G
1281,DH,9163,6089,13076,6960,10749,1282,3913,D
1281,H,13463,7374,20450,6960,13803,1282,6987,H
1281,M,295,295,20745,452,14255,1282,20450,M
1281,N,187,187,20932,90,14345,1282,20745,N
1281,O,1461,1461,22393,1780,16125,1282,20932,O
1281,N,391,391,22784,70,16195,1282,22393,N
1281,O,209,209,22993,625,16820,1282,22784,O
1281,P,17129,17129,40122,3780,20600,1282,22993,P
1282,A,126,126,126,188,188,1283,0,A
1282,B,242,242,368,240,428,1283,126,B
1282,C,277,277,645,515,943,1283,368,C
1282,D,682,682,1327,6150,7093,1283,645,D
1282,M,3877,3877,5204,4060,11153,1283,1327,M
1282,N,216,216,5420,90,11243,1283,5204,N
1282,O,823,823,6243,1135,12378,1283,5420,O
1282,P,131,131,6374,3780,16158,1283,6243,P
1283,AEI,51,51,51,3307,3307,1284,0,A
1283,BEI,658,607,658,1042,1042,1284,0,I
1283,BEJ,449,449,1107,90,1132,1284,658,J
1283,BEK,1437,330,1437,1933,1933,1284,0,E
1283,BFK,481,151,1588,860,1992,1284,1107,K
1283,BFL,97,97,1685,3780,5772,1284,1588,L
1283,BF,848,600,2285,420,2353,1284,1437,F
1283,BG,3376,1142,3427,165,3472,1284,51,B
1283,CG,1235,93,3520,1255,3608,1284,2285,G
1283,CH,279,279,3799,420,4028,1284,3520,H
1283,C,637,265,4064,895,4367,1284,3427,C
1283,D,1263,1263,5327,3960,8327,1284,4064,D
1283,M,488,488,5815,585,8912,1284,5327,M
1283,N,165,165,5980,90,9002,1284,5815,N
1283,O,545,545,6525,870,9872,1284,5980,O
1283,N,548,548,7073,240,10112,1284,6525,N
1283,O,646,646,7719,935,11047,1284,7073,O
1283,P,1106,1106,8825,3780,14827,1284,7719,P
1284,A,1955,1955,1955,2808,2808,1285,0,A
1284,B,944,944,2899,150,2958,1285,1955,B
1284,C,782,782,3681,1030,3988,1285,2899,C
1284,D,178,178,3859,3960,7948,1285,3681,D
1284,M,152,152,4011,2441,10389,1285,3859,M
1284,N,2487,2487,6498,240,10629,1285,4011,N
1284,O,471,471,6969,960,11589,1285,6498,O
1284,P,329,329,7298,3960,15549,1285,6969,P
1285,AE,155,155,155,1100,1100,1286,0,A
1285,BE,386,231,386,485,485,1286,0,E
1285,BF,301,301,687,240,725,1286,386,F
1285,BG,1041,509,1196,155,1255,1286,155,B
1285,CG,163,163,1359,180,1435,1286,1196,C
1285,DG,798,126,1485,995,1720,1286,687,G
1285,DH,262,136,1621,2850,4285,1286,1359,D
1285,H,434,298,1919,3960,5680,1286,1485,H
1285,M,101,101,2020,223,5903,1286,1919,M
1285,N,475,475,2495,240,6143,1286,2020,N
1285,O,610,610,3105,795,6938,1286,2495,O
1285,P,1890,1890,4995,3960,10898,1286,3105,P
1286,AE,157,157,157,367,367,1287,0,E
1286,AF,421,421,578,270,637,1287,157,F
1286,AG,626,48,626,3004,3004,1287,0,A
1286,BG,924,876,1502,930,1567,1287,578,G
1286,BH,2580,1704,3206,240,3244,1287,626,B
1286,CH,675,675,3881,815,4059,1287,3206,C
1286,DH,197,197,4078,9700,13759,1287,3881,D
1286,H,5143,2567,6645,435,2002,1287,1502,H
1286,M,4864,4864,11509,5590,19349,1287,6645,M
1286,N,919,919,12428,240,19589,1287,11509,N
1286,O,832,832,13260,1030,20619,1287,12428,O
1286,N,578,578,13838,485,21104,1287,13260,N
1286,O,323,323,14161,510,21614,1287,13838,O
1286,P,303,303,14464,3960,25574,1287,14161,P
1287,AEI,61,61,61,333,333,1288,0,I
1287,AEJ,359,359,420,135,468,1288,61,J
1287,AEK,615,195,615,1073,1073,1288,0,E
1287,AFK,253,58,673,295,763,1288,420,K
1287,AFL,52,52,725,5100,5863,1288,673,L
1287,AF,975,865,1590,540,1613,1288,615,F
1287,AG,1739,149,1739,2022,2022,1288,0,A
1287,BG,327,327,2066,90,2112,1288,1739,B
1287,CG,614,138,2204,900,2513,1288,1590,G
1287,CF,934,796,3000,1145,3257,1288,2066,C
1287,BF,1405,609,3609,1200,3713,1288,2204,F
1287,BG,675,66,3675,425,3682,1288,3000,B
1287,CG,1006,1006,4681,1465,5147,1288,3675,C
1287,DG,1209,137,4818,1572,5285,1288,3609,G
1287,DH,570,433,5251,3780,8927,1288,4681,D
1287,H,1088,655,5906,378,5663,1288,4818,H
1287,M,785,785,6691,1269,10196,1288,5906,M
1287,N,624,624,7315,180,10376,1288,6691,N
1287,O,761,761,8076,895,11271,1288,7315,O
1287,N,634,634,8710,130,11401,1288,8076,N
1287,O,348,348,9058,660,12061,1288,8710,O
1287,P,2570,2570,11628,6660,18721,1288,9058,P
1288,AE,23,23,23,181,181,1289,0,A
1288,BE,344,344,367,240,421,1289,23,B
1288,CE,389,22,389,1212,1212,1289,0,E
1288,CF,172,150,539,215,636,1289,367,C
1288,DF,940,790,1329,150,1362,1289,389,F
1288,DG,889,99,1428,4890,5526,1289,539,D
1288,G,757,658,2086,790,2152,1289,1329,G
1288,H,1377,1377,3463,4200,6352,1289,2086,H
1288,M,948,948,4411,1381,7733,1289,3463,M
1288,N,641,641,5052,240,7973,1289,4411,N
1288,O,366,366,5418,700,8673,1289,5052,O
1288,P,7869,7869,13287,3960,12633,1289,5418,P
1289,A,229,229,229,1046,1046,1290,0,A
1289,B,1111,1111,1340,300,1346,1290,229,B
1289,C,826,826,2166,920,2266,1290,1340,C
1289,B,736,736,2902,660,2926,1290,2166,B
1289,C,512,512,3414,385,3311,1290,2902,C
1289,D,66241,66241,69655,3960,7271,1290,3414,D
1289,M,1106,1106,70761,1332,8603,1290,69655,M
1289,N,687,687,71448,90,8693,1290,70761,N
1289,O,882,882,72330,1240,9933,1290,71448,O
1289,P,484,484,72814,3780,13713,1290,72330,P
1290,AE,76,76,76,135,135,1291,0,E
1290,AF,176,176,252,180,315,1291,76,F
1290,AG,144,144,396,145,460,1291,252,G
1290,AH,38,38,434,2880,3340,1291,396,H
1290,A,2567,2133,2567,2810,2810,1291,0,A
1290,B,332,332,2899,150,2960,1291,2567,B
1290,C,218,218,3117,100,3060,1291,2899,C
1290,D,613,613,3730,2880,5940,1291,3117,D
1290,M,3320,3320,7050,4293,10233,1291,3730,M
1290,N,1019,1019,8069,90,10323,1291,7050,N
1290,O,917,917,8986,1200,11523,1291,8069,O
1290,N,342,342,9328,50,11573,1291,8986,N
1290,O,239,239,9567,695,12268,1291,9328,O
1290,P,15306,15306,24873,3780,16048,1291,9567,P
1291,A,74,74,74,142,142,1292,0,A
1291,B,142,142,216,135,277,1292,74,B
1291,C,183,183,399,215,492,1292,216,C
1291,D,730,730,1129,4890,5382,1292,399,D
1291,M,2147,2147,3276,2903,8285,1292,1129,M
1291,N,786,786,4062,90,8375,1292,3276,N
1291,O,1228,1228,5290,1590,9965,1292,4062,O
1291,N,1250,1250,6540,860,10825,1292,5290,N
1291,O,155,155,6695,585,11410,1292,6540,O
1291,P,9708,9708,16403,3780,15190,1292,6695,P
1292,AEI,152,152,152,156,156,1293,0,A
1292,BEI,157,5,157,1091,1091,1293,0,E
1292,BFI,162,5,162,338,338,1293,0,I
1292,BFJ,193,183,345,240,396,1293,152,B
1292,CFJ,149,149,494,240,636,1293,345,C
1292,DFJ,374,42,536,240,578,1293,162,J
1292,DFK,1054,675,1211,180,1271,1293,157,F
1292,DGK,744,27,1238,5250,5886,1293,494,D
1292,GK,910,208,1446,910,1488,1293,536,K
1292,GL,772,537,1983,795,2066,1293,1211,G
1292,HL,1299,1299,3282,550,2616,1293,1983,H
1292,L,13717,11881,15163,570,2058,1293,1446,L
1292,M,7,7,15170,717,6603,1293,15163,M
1292,N,1070,1070,16240,420,7023,1293,15170,N
1292,O,612,612,16852,975,7998,1293,16240,O
1292,N,2298,2298,19150,1935,9933,1293,16852,N
1292,O,1203,1203,20353,1146,11079,1293,19150,O
1292,P,1685,1685,22038,384,11463,1293,20353,P
1293,AE,65,65,65,621,621,1294,0,A
1293,BE,233,168,233,1178,1178,1294,0,E
1293,BF,585,417,650,90,711,1294,65,B
1293,CF,975,558,1208,90,1268,1294,233,F
1293,CG,917,359,1567,1220,1931,1294,650,C
1293,DG,96,96,1663,3780,5711,1294,1567,D
1293,G,847,392,2055,1200,2468,1294,1208,G
1293,H,1704,1704,3759,3780,6248,1294,2055,H
1293,M,700,700,4459,1339,7587,1294,3759,M
1293,N,671,671,5130,90,7677,1294,4459,N
1293,O,146,146,5276,535,8212,1294,5130,O
1293,P,1382,1382,6658,3780,11992,1294,5276,P
1294,AEI,874,874,874,1229,1229,1295,0,A
1294,BEI,475,475,1349,180,1409,1295,874,B
1294,CEI,1615,266,1615,2334,2334,1295,0,E
1294,CFI,838,838,2453,180,2514,1295,1615,F
1294,CGI,2826,373,2826,3727,3727,1295,0,I
1294,CGJ,1765,288,3114,900,2309,1295,1349,C
1294,DGJ,943,282,3396,900,3414,1295,2453,G
1294,DHJ,1176,606,4002,300,4027,1295,2826,J
1294,DHK,1037,1037,5039,1050,5077,1295,4002,K
1294,DHJ,688,688,5727,720,5797,1295,5039,J
1294,DHK,603,603,6330,780,6577,1295,5727,K
1294,DHL,498,498,6828,3960,10537,1295,6330,L
1294,DH,4076,362,7190,550,2859,1295,3114,D
1294,H,4412,618,7808,550,3964,1295,3396,H
1294,M,328,328,8136,995,11532,1295,7808,M
1294,N,799,799,8935,180,11712,1295,8136,N
1294,O,785,785,9720,840,12552,1295,8935,O
1294,N,1183,1183,10903,1140,13692,1295,9720,N
1294,O,264,264,11167,405,14097,1295,10903,O
1294,P,35177,35177,46344,2580,16677,1295,11167,P
1295,A,418,418,418,1133,1133,1296,0,A
1295,B,744,744,1162,90,1223,1296,418,B
1295,C,570,570,1732,860,2083,1296,1162,C
1295,D,1265,1265,2997,3780,5863,1296,1732,D
1295,M,168,168,3165,473,6336,1296,2997,M
1295,N,350,350,3515,90,6426,1296,3165,N
1295,O,511,511,4026,870,7296,1296,3515,O
1295,N,1245,1245,5271,850,8146,1296,4026,N
1295,O,889,889,6160,1175,9321,1296,5271,O
1295,P,311,311,6471,3780,13101,1296,6160,P
1296,A,801,801,801,1184,1184,1297,0,A
1296,B,708,708,1509,330,1514,1297,801,B
1296,C,817,817,2326,952,2466,1297,1509,C
1296,D,564,564,2890,348,2814,1297,2326,D
1296,M,1575,1575,4465,1739,4553,1297,2890,M
1296,N,206,206,4671,90,4643,1297,4465,N
1296,O,638,638,5309,820,5463,1297,4671,O
1296,N,848,848,6157,660,6123,1297,5309,N
1296,O,253,253,6410,695,6818,1297,6157,O
1296,P,5836,5836,12246,3780,10598,1297,6410,P
1297,AE,114,114,114,292,292,1298,0,A
1297,BE,134,20,134,1672,1672,1298,0,E
1297,BF,345,325,459,180,472,1298,114,B
1297,CF,594,594,1053,683,1155,1298,459,C
1297,DF,1734,815,1868,240,1912,1298,134,F
1297,DG,894,894,2762,900,2812,1298,1868,G
1297,DH,4495,4495,7257,550,3362,1298,2762,H
1297,D,9798,3594,10851,4080,5235,1298,1053,D
1297,M,11872,11872,22723,12092,17327,1298,10851,M
1297,N,352,352,23075,180,17507,1298,22723,N
1297,O,1350,1350,24425,830,18337,1298,23075,O
1297,N,1613,1613,26038,705,19042,1298,24425,N
1297,O,620,620,26658,695,19737,1298,26038,O
1297,P,43161,43161,69819,6960,26697,1298,26658,P
1298,A,1156,1156,1156,1209,1209,1299,0,A
1298,B,142,142,1298,150,1359,1299,1156,B
1298,C,191,191,1489,165,1524,1299,1298,C
1298,D,189,189,1678,4200,5724,1299,1489,D
1298,M,1439,1439,3117,2510,8234,1299,1678,M
1298,N,1119,1119,4236,90,8324,1299,3117,N
1298,O,905,905,5141,1230,9554,1299,4236,O
1298,N,724,724,5865,385,9939,1299,5141,N
1298,O,917,917,6782,945,10884,1299,5865,O
1298,P,1844,1844,8626,3780,14664,1299,6782,P
1299,AEI,179,179,179,1099,1099,1300,0,E
1299,AFI,537,358,537,946,946,1300,0,I
1299,AFJ,702,165,702,1088,1088,1300,0,A
1299,BFJ,646,481,1183,300,1246,1300,537,J
1299,BFK,1040,36,1219,180,1279,1300,179,F
1299,BGK,538,21,1240,210,1298,1300,702,B
1299,CGK,157,157,1397,255,1553,1300,1240,C
1299,BGK,720,506,1903,820,2066,1300,1183,K
1299,BGJ,970,286,2189,1050,2329,1300,1219,G
1299,BFJ,1362,570,2759,1270,2823,1300,1397,B
1299,CFJ,170,170,2929,240,3063,1300,2759,C
1299,DFJ,775,35,2964,700,3029,1300,2189,F
1299,DGJ,1082,21,2985,995,3061,1300,1903,J
1299,DGK,141,85,3070,5040,8103,1300,2929,D
1299,GK,205,120,3190,240,3301,1300,2985,K
1299,GL,16,16,3206,5160,8461,1300,3190,L
1299,G,292,50,3256,240,3269,1300,2964,G
1299,H,36,36,3292,5040,8309,1300,3256,H
1299,M,1449,1449,4741,1471,9932,1300,3292,M
1299,N,82,82,4823,120,10052,1300,4741,N
1299,O,128,128,4951,120,10172,1300,4823,O
1299,N,659,659,5610,670,10842,1300,4951,N
1299,O,156,156,5766,260,11102,1300,5610,O
1299,P,84,84,5850,5100,16202,1300,5766,P
1300,A,1349,1349,1349,1407,1407,1301,0,A
1300,B,172,172,1521,150,1557,1301,1349,B
1300,C,581,581,2102,850,2407,1301,1521,C
1300,B,1502,1502,3604,1240,3647,1301,2102,B
1300,C,1140,1140,4744,1295,4942,1301,3604,C
1300,D,11955,11955,16699,3660,8602,1301,4744,D
1300,M,31,31,16730,1770,10372,1301,16699,M
1300,N,1927,1927,18657,240,10612,1301,16730,N
1300,O,1007,1007,19664,1005,11617,1301,18657,O
1300,N,368,368,20032,445,12062,1301,19664,N
1300,O,630,630,20662,810,12872,1301,20032,O
1300,P,855,855,21517,3960,16832,1301,20662,P
1301,AE,229,229,229,234,234,1302,0,E
1301,AF,112,112,341,150,384,1302,229,F
1301,AG,121,121,462,540,924,1302,341,G
1301,AH,709,709,1171,2850,3774,1302,462,H
1301,A,1340,169,1340,1398,1398,1302,0,A
1301,B,155,155,1495,150,1548,1302,1340,B
1301,C,609,609,2104,585,2133,1302,1495,C
1301,B,337,337,2441,340,2473,1302,2104,B
1301,C,121,121,2562,130,2603,1302,2441,C
1301,D,1159,1159,3721,4230,6833,1302,2562,D
1301,M,83,83,3804,86,6919,1302,3721,M
1301,N,131,131,3935,150,7069,1302,3804,N
1301,O,801,801,4736,410,7479,1302,3935,O
1301,N,206,206,4942,615,8094,1302,4736,N
1301,O,474,474,5416,575,8669,1302,4942,O
1301,P,14835,14835,20251,4230,12899,1302,5416,P
1302,AE,945,945,945,1018,1018,1303,0,A
1302,BE,167,167,1112,150,1168,1303,945,B
1302,CE,226,226,1338,160,1328,1303,1112,C
1302,BE,1391,53,1391,1435,1435,1303,0,E
1302,BF,154,154,1545,150,1585,1303,1391,F
1302,BG,704,704,2249,700,2285,1303,1545,G
1302,BF,1358,447,2696,1400,2728,1303,1338,B
1302,CF,651,651,3347,705,3433,1303,2696,C
1302,DF,1121,23,3370,1120,3405,1303,2249,F
1302,DG,650,650,4020,705,4110,1303,3370,G
1302,DH,2663,1990,6010,4230,7663,1303,3347,D
1302,H,4044,2054,8064,4230,8340,1303,4020,H
1302,M,600,600,8664,260,8600,1303,8064,M
1302,N,211,211,8875,600,9200,1303,8664,N
1302,O,238,238,9113,420,9620,1303,8875,O
1302,N,1403,1403,10516,1215,10835,1303,9113,N
1302,O,272,272,10788,425,11260,1303,10516,O
1302,P,5426,5426,16214,3720,14980,1303,10788,P
1303,AEI,304,304,304,1245,1245,1304,0,A
1303,BEI,578,274,578,2026,2026,1304,0,I
1303,BEJ,1130,552,1130,1430,1430,1304,0,E
1303,BFJ,968,142,1272,90,1335,1304,304,B
1303,CFJ,330,188,1460,90,1520,1304,1130,F
1303,CGJ,1468,586,2046,90,2116,1304,578,J
1303,CGK,1017,243,2289,1220,2555,1304,1272,C
1303,DGK,884,55,2344,1110,2630,1304,1460,G
1303,DHK,62,7,2351,3780,6335,1304,2289,D
1303,HK,89,82,2433,3780,6410,1304,2344,H
1303,K,1191,804,3237,1360,3476,1304,2046,K
1303,L,197,197,3434,3780,7256,1304,3237,L
1303,M,128,128,3562,302,7558,1304,3434,M
1303,N,202,202,3764,90,7648,1304,3562,N
1303,O,429,429,4193,860,8508,1304,3764,O
1303,P,406,406,4599,3780,12288,1304,4193,P
1304,AE,105,105,105,940,940,1305,0,E
1304,AF,1055,1055,1160,240,1180,1305,105,F
1304,AG,825,825,1985,1030,2210,1305,1160,G
1304,AF,470,470,2455,485,2695,1305,1985,F
1304,AG,422,422,2877,510,3205,1305,2455,G
1304,AH,123,123,3000,3960,7165,1305,2877,H
1304,A,3137,137,3137,3313,3313,1305,0,A
1304,B,370,370,3507,240,3553,1305,3137,B
1304,C,806,806,4313,970,4523,1305,3507,C
1304,B,737,737,5050,780,5303,1305,4313,B
1304,C,840,840,5890,510,5813,1305,5050,C
1304,D,1123,1123,7013,3960,9773,1305,5890,D
1304,M,729,729,7742,1672,11445,1305,7013,M
1304,N,969,969,8711,90,11535,1305,7742,N
1304,O,784,784,9495,995,12530,1305,8711,O
1304,P,24600,24600,34095,3780,16310,1305,9495,P
1305,AEI,154,154,154,333,333,1306,0,I
1305,AEJ,355,355,509,240,573,1306,154,J
1305,AEK,1573,1064,1573,2413,2413,1306,0,A
1305,BEK,1674,101,1674,1752,1752,1306,0,E
1305,BFK,1166,1,1675,1165,1738,1306,509,K
1305,BFL,190,189,1864,180,1932,1306,1674,F
1305,BGL,320,131,1995,550,2288,1306,1675,L
1305,BG,708,577,2572,950,2882,1306,1864,G
1305,BF,1068,69,2641,240,2653,1306,1573,B
1305,CF,590,521,3162,330,3212,1306,2572,F
1305,CG,887,366,3528,1050,3703,1306,2641,C
1305,BG,458,92,3620,585,3797,1306,3162,G
1305,BH,445,353,3973,470,4173,1306,3528,B
1305,CH,672,672,4645,450,4623,1306,3973,C
1305,DH,1483,458,5103,6960,10757,1306,3620,H
1305,D,1653,1195,6298,3900,8523,1306,4645,D
1305,M,604,604,6902,1017,11774,1306,6298,M
1305,N,533,533,7435,150,11924,1306,6902,N
1305,O,76,76,7511,50,11974,1306,7435,O
1305,N,1234,1234,8745,1280,13254,1306,7511,N
1305,O,252,252,8997,260,13514,1306,8745,O
1305,P,34,34,9031,5100,18614,1306,8997,P
1306,A,42,42,42,1004,1004,1307,0,A
1306,B,1145,1145,1187,240,1244,1307,42,B
1306,C,824,824,2011,890,2134,1307,1187,C
1306,D,260,260,2271,5160,7294,1307,2011,D
1306,M,151,151,2422,1690,8984,1307,2271,M
1306,N,1737,1737,4159,250,9234,1307,2422,N
1306,O,1030,1030,5189,990,10224,1307,4159,O
1306,P,351,351,5540,550,10774,1307,5189,P
1307,A,1331,1331,1331,1412,1412,1308,0,A
1307,B,186,186,1517,150,1562,1308,1331,B
1307,C,594,594,2111,850,2412,1308,1517,C
1307,B,352,352,2463,100,2512,1308,2111,B
1307,C,109,109,2572,125,2637,1308,2463,C
1307,D,1365,1365,3937,4230,6867,1308,2572,D
1307,M,75,75,4012,104,6971,1308,3937,M
1307,N,148,148,4160,150,7121,1308,4012,N
1307,O,160,160,4320,125,7246,1308,4160,O
1307,N,805,805,5125,845,8091,1308,4320,N
1307,O,281,281,5406,110,8201,1308,5125,O
1307,P,351,351,5757,4230,12431,1308,5406,P
1308,A,467,467,467,1059,1059,1309,0,A
1308,B,702,702,1169,150,1209,1309,467,B
1308,C,164,164,1333,155,1364,1309,1169,C
1308,B,1548,1548,2881,1530,2894,1309,1333,B
1308,C,339,339,3220,650,3544,1309,2881,C
1308,D,1828,1828,5048,4230,7774,1309,3220,D
1308,M,1575,1575,6623,1687,9461,1309,5048,M
1308,N,562,562,7185,150,9611,1309,6623,N
1308,O,604,604,7789,580,10191,1309,7185,O
1308,N,334,334,8123,710,10901,1309,7789,N
1308,O,734,734,8857,835,11736,1309,8123,O
1308,P,5855,5855,14712,3630,15366,1309,8857,P
1309,A,14213,14213,14213,14715,14715,1310,0,A
1309,B,782,782,14995,300,15015,1310,14213,B
1309,C,704,704,15699,735,15750,1310,14995,C
1309,D,16,16,15715,1560,17310,1310,15699,D
1309,M,1375,1375,17090,1590,18900,1310,15715,M
1309,N,483,483,17573,300,19200,1310,17090,N
1309,O,706,706,18279,855,20055,1310,17573,O
1309,P,731,731,19010,1590,21645,1310,18279,P
1310,AEI,832,832,832,2060,2060,1311,0,E
1310,AFI,1424,592,1424,1220,1220,1311,0,A
1310,BFI,76,76,1500,300,1520,1311,1424,B
1310,CFI,1507,839,2339,300,2360,1311,832,F
1310,CGI,1346,507,2846,895,2415,1311,1500,C
1310,DGI,778,271,3117,895,3255,1311,2339,G
1310,DHI,347,76,3193,2220,4635,1311,2846,D
1310,HI,3590,397,3590,3746,3746,1311,0,I
1310,HJ,246,246,3836,90,3836,1311,3590,J
1310,HK,434,434,4270,815,4651,1311,3836,K
1310,HJ,1403,250,4520,2760,6015,1311,3117,H
1310,J,1425,1175,5695,1105,5756,1311,4270,J
1310,K,1323,1323,7018,1850,7606,1311,5695,K
1310,L,2656,2656,9674,3780,11386,1311,7018,L
1310,M,385,385,10059,505,11891,1311,9674,M
1310,N,387,387,10446,300,12191,1311,10059,N
1310,O,791,791,11237,885,13076,1311,10446,O
1310,P,144,144,11381,2880,15956,1311,11237,P
1311,A,427,427,427,350,350,1312,0,A
1311,B,358,358,785,435,785,1312,427,B
1311,C,493,493,1278,585,1370,1312,785,C
1311,B,1862,1862,3140,1830,3200,1312,1278,B
1311,C,2568,2568,5708,1440,4640,1312,3140,C
1311,D,1447,1447,7155,2280,6920,1312,5708,D
1311,M,318,318,7473,1083,8003,1312,7155,M
1311,N,901,901,8374,180,8183,1312,7473,N
1311,O,544,544,8918,555,8738,1312,8374,O
1311,N,380,380,9298,365,9103,1312,8918,N
1311,O,98,98,9396,167,9270,1312,9298,O
1311,P,408,408,9804,393,9663,1312,9396,P
1312,AEI,302,302,302,425,425,1313,0,I
1312,AEJ,301,301,603,240,665,1313,302,J
1312,AEK,871,268,871,1155,1155,1313,0,A
1312,BEK,961,90,961,1305,1305,1313,0,E
1312,BFK,627,269,1230,770,1435,1313,603,K
1312,BFJ,443,84,1314,150,1305,1313,871,B
1312,CFJ,456,103,1417,150,1455,1313,961,F
1312,CGJ,174,71,1488,390,1695,1313,1314,C
1312,BGJ,114,43,1531,390,1845,1313,1417,G
1312,BFJ,219,176,1707,50,1745,1313,1488,B
1312,CFJ,115,115,1822,125,1870,1313,1707,C
1312,DFJ,850,258,2080,665,2100,1313,1230,J
1312,DFK,573,24,2104,285,2130,1313,1531,F
1312,DGK,538,538,2642,120,2250,1313,2104,G
1312,DHK,1103,283,2925,4230,6100,1313,1822,D
1312,HK,949,104,3029,835,2935,1313,2080,K
1312,HJ,1706,1706,4735,1860,4795,1313,3029,J
1312,HK,833,833,5568,870,5665,1313,4735,K
1312,HL,367,367,5935,4230,9895,1313,5568,L
1312,H,6188,2895,8830,4230,6480,1313,2642,H
1312,M,144,144,8974,740,10635,1313,8830,M
1312,N,789,789,9763,240,10875,1313,8974,N
1312,O,170,170,9933,390,11265,1313,9763,O
1312,N,1461,1461,11394,1235,12500,1313,9933,N
1312,O,1095,1095,12489,435,12935,1313,11394,O
1312,P,7523,7523,20012,3960,16895,1313,12489,P
1313,AE,707,707,707,1065,1065,1314,0,E
1313,AF,387,387,1094,90,1155,1314,707,F
1313,AG,967,967,2061,1240,2395,1314,1094,G
1313,AH,6,6,2067,3780,6175,1314,2061,H
1313,A,17007,14940,17007,17574,17574,1314,0,A
1313,B,607,607,17614,90,17664,1314,17007,B
1313,C,898,898,18512,1215,18879,1314,17614,C
1313,D,263,263,18775,3780,22659,1314,18512,D
1313,M,3892,3892,22667,4709,27368,1314,18775,M
1313,N,860,860,23527,90,27458,1314,22667,N
1313,O,298,298,23825,705,28163,1314,23527,O
1313,P,2525,2525,26350,3780,31943,1314,23825,P
1314,A,179,179,179,212,212,1315,0,A
1314,B,140,140,319,150,362,1315,179,B
1314,C,209,209,528,890,1252,1315,319,C
1314,D,798,798,1326,3490,4742,1315,528,D
1314,M,1806,1806,3132,2345,7087,1315,1326,M
1314,N,728,728,3860,240,7327,1315,3132,N
1314,O,595,595,4455,725,8052,1315,3860,O
1314,N,369,369,4824,400,8452,1315,4455,N
1314,O,2192,2192,7016,2160,10612,1315,4824,O
1314,P,6224,6224,13240,4140,14752,1315,7016,P
1315,A,983,983,983,1376,1376,1316,0,A
1315,B,423,423,1406,90,1466,1316,983,B
1315,C,722,722,2128,1230,2696,1316,1406,C
1315,D,1197,1197,3325,3780,6476,1316,2128,D
1315,M,799,799,4124,1390,7866,1316,3325,M
1315,N,624,624,4748,90,7956,1316,4124,N
1315,O,622,622,5370,935,8891,1316,4748,O
1315,P,362,362,5732,3780,12671,1316,5370,P
1316,A,77,77,77,237,237,1317,0,A
1316,B,245,245,322,135,372,1317,77,B
1316,C,194,194,516,285,657,1317,322,C
1316,D,184,184,700,5160,5817,1317,516,D
1316,M,763,763,1463,1736,7553,1317,700,M
1316,N,1003,1003,2466,90,7643,1317,1463,N
1316,O,1348,1348,3814,1625,9268,1317,2466,O
1316,N,4292,4292,8106,4005,13273,1317,3814,N
1316,O,1762,1762,9868,1210,14483,1317,8106,O
1316,P,11928,11928,21796,3780,18263,1317,9868,P
1317,AEI,105,105,105,69,69,1318,0,E
1317,AFI,238,133,238,1683,1683,1318,0,A
1317,BFI,205,72,310,240,309,1318,105,F
1317,BGI,312,2,312,480,480,1318,0,I
1317,BGJ,180,178,490,840,1149,1318,310,G
1317,BHJ,271,93,583,150,630,1318,312,J
1317,BHK,883,790,1373,3540,4689,1318,490,H
1317,BK,1058,268,1641,1005,1635,1318,583,K
1317,BJ,1624,221,1862,240,1923,1318,238,B
1317,CJ,814,593,2455,860,2495,1318,1641,J
1317,CK,680,87,2542,745,2668,1318,1862,C
1317,BK,221,134,2676,840,3335,1318,2455,K
1317,BL,521,387,3063,515,3183,1318,2542,B
1317,CL,752,365,3428,3600,6935,1318,2676,L
1317,C,1406,1041,4469,810,3993,1318,3063,C
1317,B,15,15,4484,810,4803,1318,4469,B
1317,C,1414,1414,5898,840,5643,1318,4484,C
1317,D,720,720,6618,5700,11343,1318,5898,D
1317,M,358,358,6976,1406,12749,1318,6618,M
1317,N,1228,1228,8204,240,12989,1318,6976,N
1317,O,187,187,8391,310,13299,1318,8204,O
1317,N,1596,1596,9987,1450,14749,1318,8391,N
1317,O,754,754,10741,5001,19750,1318,9987,O
1317,P,2414,2414,13155,2214,21964,1318,10741,P
1318,AEI,246,246,246,1250,1250,1319,0,A
1318,BEI,486,240,486,1405,1405,1319,0,I
1318,BEJ,636,150,636,1253,1253,1319,0,E
1318,BFJ,648,648,1284,90,1343,1319,636,F
1318,BGJ,1112,74,1358,150,1400,1319,246,B
1318,CGJ,977,105,1463,90,1495,1319,486,J
1318,CGK,140,35,1498,100,1500,1319,1358,C
1318,BGK,414,200,1698,800,2143,1319,1284,G
1318,BHK,355,120,1818,800,2295,1319,1463,K
1318,BHL,539,219,2037,570,2070,1319,1498,B
1318,CHL,964,625,2662,3780,5923,1319,1698,H
1318,CL,698,73,2735,660,2730,1319,2037,C
1318,DL,1515,598,3333,3780,6075,1319,1818,L
1318,D,1308,710,4043,4230,6960,1319,2735,D
1318,M,479,479,4522,744,7704,1319,4043,M
1318,N,305,305,4827,90,7794,1319,4522,N
1318,O,587,587,5414,795,8589,1319,4827,O
1318,N,1522,1522,6936,1320,9909,1319,5414,N
1318,O,242,242,7178,695,10604,1319,6936,O
1318,P,4066,4066,11244,3840,14444,1319,7178,P
1319,A,163,163,163,229,229,1320,0,A
1319,B,410,410,573,240,469,1320,163,B
1319,C,660,660,1233,770,1239,1320,573,C
1319,B,173,173,1406,205,1444,1320,1233,B
1319,C,162,162,1568,385,1829,1320,1406,C
1319,D,1292,1292,2860,3960,5789,1320,1568,D
1319,M,13528,13528,16388,13644,19433,1320,2860,M
1319,N,442,442,16830,360,19793,1320,16388,N
1319,O,676,676,17506,1775,21568,1320,16830,O
1319,P,4418,4418,21924,1890,23458,1320,17506,P
1320,A,13491,13491,13491,13480,13480,1321,0,A
1320,B,253,253,13744,300,13780,1321,13491,B
1320,C,540,540,14284,740,14520,1321,13744,C
1320,D,111,111,14395,1560,16080,1321,14284,D
1320,M,1560,1560,15955,1730,17810,1321,14395,M
1320,N,459,459,16414,300,18110,1321,15955,N
1320,O,799,799,17213,835,18945,1321,16414,O
1320,P,4689,4689,21902,1140,20085,1321,17213,P
1321,AE,154,154,154,2738,2738,1322,0,E
1321,AF,2153,1999,2153,2533,2533,1322,0,A
1321,BF,3003,1004,3157,240,2978,1322,154,F
1321,BG,1369,365,3522,180,2713,1322,2153,B
1321,CG,509,144,3666,735,3713,1322,3157,G
1321,CH,161,17,3683,895,3608,1322,3522,C
1321,BH,160,160,3843,295,3903,1322,3683,B
1321,CH,492,315,4158,9700,13413,1322,3666,H
1321,C,590,275,4433,760,4663,1322,3843,C
1321,D,60251,60251,64684,1140,5803,1322,4433,D
1321,M,2812,2812,67496,2935,16348,1322,64684,M
1321,N,213,213,67709,150,16498,1322,67496,N
1321,O,1011,1011,68720,990,17488,1322,67709,O
1321,N,1569,1569,70289,1545,19033,1322,68720,N
1321,O,1092,1092,71381,2174,21207,1322,70289,O
1321,P,1220,1220,72601,1781,22988,1322,71381,P
1322,A,94,94,94,180,180,1323,0,A
1322,B,271,271,365,240,420,1323,94,B
1322,C,863,863,1228,945,1365,1323,365,C
1322,D,674,674,1902,5160,6525,1323,1228,D
1322,M,654,654,2556,1164,7689,1323,1902,M
1322,N,564,564,3120,90,7779,1323,2556,N
1322,O,351,351,3471,710,8489,1323,3120,O
1322,P,43,43,3514,3780,12269,1323,3471,P
1323,A,279,279,279,799,799,1324,0,A
1323,B,626,626,905,150,949,1324,279,B
1323,C,194,194,1099,125,1074,1324,905,C
1323,B,494,494,1593,545,1619,1324,1099,B
1323,C,683,683,2276,720,2339,1324,1593,C
1323,D,94,94,2370,4170,6509,1324,2276,D
1323,M,6598,6598,8968,6791,13300,1324,2370,M
1323,N,218,218,9186,90,13390,1324,8968,N
1323,O,570,570,9756,795,14185,1324,9186,O
1323,N,1052,1052,10808,825,15010,1324,9756,N
1323,O,186,186,10994,535,15545,1324,10808,O
1323,P,73,73,11067,3780,19325,1324,10994,P
1324,A,283,283,283,245,245,1325,0,A
1324,B,67,67,350,150,395,1325,283,B
1324,C,163,163,513,140,535,1325,350,C
1324,B,886,886,1399,900,1435,1325,513,B
1324,C,308,308,1707,650,2085,1325,1399,C
1324,D,3394,3394,5101,4230,6315,1325,1707,D
1324,M,2673,2673,7774,2761,9076,1325,5101,M
1324,N,275,275,8049,240,9316,1325,7774,N
1324,O,766,766,8815,855,10171,1325,8049,O
1324,N,1040,1040,9855,210,10381,1325,8815,N
1324,O,297,297,10152,1210,11591,1325,9855,O
1324,P,4260,4260,14412,3960,15551,1325,10152,P
1325,A,130,130,130,115,115,1326,0,A
1325,B,314,314,444,360,475,1326,130,B
1325,C,476,476,920,715,1190,1326,444,C
1325,B,484,484,1404,265,1455,1326,920,B
1325,C,357,357,1761,440,1895,1326,1404,C
1325,D,3024,3024,4785,1560,3455,1326,1761,D
1325,M,127,127,4912,190,3645,1326,4785,M
1325,N,374,374,5286,300,3945,1326,4912,N
1325,O,628,628,5914,820,4765,1326,5286,O
1325,P,241,241,6155,3960,8725,1326,5914,P
1326,AE,2212,2212,2212,994,994,1327,0,E
1326,AF,193,193,2405,210,1204,1327,2212,F
1326,AG,262,262,2667,290,1494,1327,2405,G
1326,AH,49,49,2716,1230,2724,1327,2667,H
1326,A,4856,2140,4856,5563,5563,1327,0,A
1326,B,797,797,5653,90,5653,1327,4856,B
1326,C,989,989,6642,1380,7033,1327,5653,C
1326,B,422,422,7064,85,7118,1327,6642,B
1326,C,378,378,7442,795,7913,1327,7064,C
1326,D,445,445,7887,3780,11693,1327,7442,D
1326,M,2873,2873,10760,3009,14702,1327,7887,M
1326,N,169,169,10929,90,14792,1327,10760,N
1326,O,477,477,11406,820,15612,1327,10929,O
1326,P,66,66,11472,3780,19392,1327,11406,P
1327,AE,19,19,19,122,122,1328,0,A
1327,BE,311,311,330,240,362,1328,19,B
1327,CE,778,778,1108,1035,1397,1328,330,C
1327,DE,19,19,1127,3960,5357,1328,1108,D
1327,E,6512,5385,6512,7484,7484,1328,0,E
1327,F,1019,1019,7531,90,7574,1328,6512,F
1327,G,824,824,8355,1215,8789,1328,7531,G
1327,H,1082,1082,9437,3780,12569,1328,8355,H
1327,M,471,471,9908,1621,14190,1328,9437,M
1327,N,1193,1193,11101,90,14280,1328,9908,N
1327,O,752,752,11853,1195,15475,1328,11101,O
1327,P,70,70,11923,3780,19255,1328,11853,P
1328,AE,25,25,25,111,111,1329,0,E
1328,AF,161,161,186,135,246,1329,25,F
1328,AG,140,140,326,215,461,1329,186,G
1328,AH,126,126,452,4890,5351,1329,326,H
1328,A,1544,1092,1544,1948,1948,1329,0,A
1328,B,465,465,2009,90,2038,1329,1544,B
1328,C,878,878,2887,1275,3313,1329,2009,C
1328,D,292,292,3179,3780,7093,1329,2887,D
1328,M,2182,2182,5361,2997,10090,1329,3179,M
1328,N,840,840,6201,90,10180,1329,5361,N
1328,O,1259,1259,7460,1480,11660,1329,6201,O
1328,N,1558,1558,9018,1332,12992,1329,7460,N
1328,O,366,366,9384,786,13778,1329,9018,O
1328,P,410,410,9794,3780,17558,1329,9384,P
1329,A,21,21,21,99,99,1330,0,A
1329,B,159,159,180,135,234,1330,21,B
1329,C,158,158,338,290,524,1330,180,C
1329,D,107,107,445,5160,5684,1330,338,D
1329,M,19355,19355,19800,21157,26841,1330,445,M
1329,N,1838,1838,21638,90,26931,1330,19800,N
1329,O,1009,1009,22647,1240,28171,1330,21638,O
1329,N,746,746,23393,495,28666,1330,22647,N
1329,O,712,712,24105,900,29566,1330,23393,O
1329,P,1162,1162,25267,3780,33346,1330,24105,P
1330,AEI,44,44,44,389,389,1331,0,E
1330,AFI,274,230,274,504,504,1331,0,I
1330,AFJ,263,263,537,90,594,1331,274,J
1330,AFK,797,304,841,506,895,1331,44,F
1330,AGK,223,223,1064,215,1110,1331,841,G
1330,AHK,1135,608,1672,1315,1909,1331,537,K
1330,AHL,45,45,1717,3780,5689,1331,1672,L
1330,AH,3014,1297,3014,3335,3335,1331,0,A
1330,BH,569,569,3583,300,3635,1331,3014,B
1330,CH,473,473,4056,680,4315,1331,3583,C
1330,DH,3037,45,4101,2850,3960,1331,1064,H
1330,D,362,317,4418,4020,8335,1331,4056,D
1330,M,7602,7602,12020,8389,16724,1331,4418,M
1330,N,817,817,12837,90,16814,1331,12020,N
1330,O,852,852,13689,1240,18054,1331,12837,O
1330,N,760,760,14449,330,18384,1331,13689,N
1330,O,535,535,14984,945,19329,1331,14449,O
1330,P,316,316,15300,3780,23109,1331,14984,P
1331,A,158,158,158,393,393,1332,0,A
1331,B,383,383,541,180,573,1332,158,B
1331,C,589,589,1130,677,1250,1332,541,C
1331,D,35,35,1165,4080,5330,1332,1130,D
1331,M,1950,1950,3115,4078,9408,1332,1165,M
1331,N,2708,2708,5823,90,9498,1332,3115,N
1331,O,1159,1159,6982,1355,10853,1332,5823,O
1331,P,1351,1351,8333,3780,14633,1332,6982,P
1332,AEI,445,445,445,1821,1821,1333,0,A
1332,BEI,696,251,696,1127,1127,1333,0,E
1332,BFI,879,879,1575,90,1217,1333,696,F
1332,BGI,1406,276,1851,90,1911,1333,445,B
1332,CGI,889,613,2464,1250,2467,1333,1575,G
1332,CHI,293,293,2757,3780,6247,1333,2464,H
1332,CI,1461,555,3312,1780,3691,1333,1851,C
1332,DI,544,544,3856,3780,7471,1333,3312,D
1332,I,37239,33383,37239,37991,37991,1333,0,I
1332,J,781,781,38020,90,38081,1333,37239,J
1332,K,1043,1043,39063,1220,39301,1333,38020,K
1332,L,445,445,39508,3780,43081,1333,39063,L
1332,M,466,466,39974,426,43507,1333,39508,M
1332,N,215,215,40189,300,43807,1333,39974,N
1332,O,851,851,41040,1070,44877,1333,40189,O
1332,N,419,419,41459,185,45062,1333,41040,N
1332,O,374,374,41833,700,45762,1333,41459,O
1332,P,33908,33908,75741,3960,49722,1333,41833,P
1333,AE,67,67,67,844,844,1334,0,A
1333,BE,419,352,419,1038,1038,1334,0,E
1333,BF,867,515,934,150,994,1334,67,B
1333,CF,160,160,1094,540,1534,1334,934,C
1333,DF,754,79,1173,150,1188,1334,419,F
1333,DG,129,50,1223,720,2254,1334,1094,D
1333,G,685,635,1858,640,1828,1334,1173,G
1333,F,277,277,2135,285,2113,1334,1858,F
1333,G,132,132,2267,110,2223,1334,2135,G
1333,H,162,162,2429,4230,6453,1334,2267,H
1333,M,2081,2081,4510,2469,8922,1334,2429,M
1333,N,498,498,5008,150,9072,1334,4510,N
1333,O,1103,1103,6111,1680,10752,1334,5008,O
1333,P,2906,2906,9017,6000,16752,1334,6111,P
1334,A,38,38,38,1352,1352,1335,0,A
1334,B,1513,1513,1551,240,1592,1335,38,B
1334,C,760,760,2311,760,2352,1335,1551,C
1334,D,3686,3686,5997,7680,10032,1335,2311,D
1334,M,4860,4860,10857,6156,16188,1335,5997,M
1334,N,1326,1326,12183,90,16278,1335,10857,N
1334,O,2760,2760,14943,1955,18233,1335,12183,O
1334,P,29280,29280,44223,3780,22013,1335,14943,P
1335,A,383,383,383,596,596,1336,0,A
1335,B,390,390,773,240,836,1336,383,B
1335,C,926,926,1699,985,1821,1336,773,C
1335,D,340,340,2039,3960,5781,1336,1699,D
1335,M,20,20,2059,75,5856,1336,2039,M
1335,N,254,254,2313,240,6096,1336,2059,N
1335,O,658,658,2971,880,6976,1336,2313,O
1335,P,1104,1104,4075,3960,10936,1336,2971,P
1336,A,8,8,8,50,50,1337,0,A
1336,B,209,209,217,240,290,1337,8,B
1336,C,798,798,1015,975,1265,1337,217,C
1336,B,800,800,1815,605,1870,1337,1015,B
1336,C,187,187,2002,260,2130,1337,1815,C
1336,D,3139,3139,5141,5160,7290,1337,2002,D
1336,M,262,262,5403,450,7740,1337,5141,M
1336,N,279,279,5682,155,7895,1337,5403,N
1336,O,122,122,5804,90,7985,1337,5682,O
1336,P,765,765,6569,3330,11315,1337,5804,P
1337,AE,30,30,30,151,151,1338,0,E
1337,AF,426,426,456,330,481,1338,30,F
1337,AG,883,883,1339,947,1428,1338,456,G
1337,AH,141,141,1480,348,1776,1338,1339,H
1337,A,1913,433,1913,2163,2163,1338,0,A
1337,B,629,629,2542,420,2583,1338,1913,B
1337,C,1020,1020,3562,1240,3823,1338,2542,C
1337,D,130,130,3692,335,4158,1338,3562,D
1337,M,2390,2390,6082,2532,6690,1338,3692,M
1337,N,270,270,6352,90,6780,1338,6082,N
1337,O,662,662,7014,815,7595,1338,6352,O
1337,N,2978,2978,9992,2925,10520,1338,7014,N
1337,O,382,382,10374,740,11260,1338,9992,O
1337,P,1043,1043,11417,3780,15040,1338,10374,P
1338,A,299,299,299,307,307,1339,0,A
1338,B,85,85,384,150,457,1339,299,B
1338,C,79,79,463,60,517,1339,384,C
1338,D,136,136,599,2880,3397,1339,463,D
1338,M,189,189,788,199,3596,1339,599,M
1338,N,105,105,893,150,3746,1339,788,N
1338,O,161,161,1054,125,3871,1339,893,O
1338,N,858,858,1912,865,4736,1339,1054,N
1338,O,680,680,2592,655,5391,1339,1912,O
1338,P,37006,37006,39598,4230,9621,1339,2592,P
1339,A,268,268,268,309,309,1340,0,A
1339,B,191,191,459,210,519,1340,268,B
1339,C,409,409,868,465,984,1340,459,C
1339,B,1139,1139,2007,1060,2044,1340,868,B
1339,C,856,856,2863,828,2872,1340,2007,C
1339,D,1587,1587,4450,372,3244,1340,2863,D
1339,M,259,259,4709,1564,4808,1340,4450,M
1339,N,1565,1565,6274,300,5108,1340,4709,N
1339,O,826,826,7100,777,5885,1340,6274,O
1339,P,22,22,7122,8393,14278,1340,7100,P
1340,AE,1634,1634,1634,1742,1742,1341,0,E
1340,AF,221,221,1855,90,1832,1341,1634,F
1340,AG,463,463,2318,820,2652,1341,1855,G
1340,AH,157,157,2475,3780,6432,1341,2318,H
1340,A,2942,467,2942,3134,3134,1341,0,A
1340,B,216,216,3158,90,3224,1341,2942,B
1340,C,514,514,3672,905,4129,1341,3158,C
1340,D,286,286,3958,3780,7909,1341,3672,D
1340,M,837,837,4795,1358,9267,1341,3958,M
1340,N,553,553,5348,90,9357,1341,4795,N
1340,O,511,511,5859,905,10262,1341,5348,O
1340,P,5353,5353,11212,3780,14042,1341,5859,P
1341,AEI,160,160,160,1372,1372,1342,0,A
1341,BEI,434,274,434,2669,2669,1342,0,I
1341,BEJ,1415,1141,1575,240,1612,1342,160,B
1341,CEJ,843,843,2418,995,2607,1342,1575,C
1341,DEJ,162,162,2580,4680,7287,1342,2418,D
1341,EJ,2267,121,2701,90,2759,1342,434,J
1341,EK,366,366,3067,800,3559,1342,2701,K
1341,EL,4326,1259,4326,5360,5360,1342,0,E
1341,FL,1781,522,4848,3780,7339,1342,3067,L
1341,F,1111,589,5437,90,5450,1342,4326,F
1341,G,1098,1098,6535,1370,6820,1342,5437,G
1341,F,327,327,6862,100,6920,1342,6535,F
1341,G,362,362,7224,795,7715,1342,6862,G
1341,H,503,503,7727,3780,11495,1342,7224,H
1341,M,1641,1641,9368,1751,13246,1342,7727,M
1341,N,223,223,9591,90,13336,1342,9368,N
1341,O,463,463,10054,820,14156,1342,9591,O
1341,N,4229,4229,14283,3950,18106,1342,10054,N
1341,O,675,675,14958,900,19006,1342,14283,O
1341,P,2931,2931,17889,3780,22786,1342,14958,P
1342,AEI,68,68,68,77,77,1343,0,A
1342,BEI,111,43,111,122,122,1343,0,I
1342,BEJ,83,40,151,135,212,1343,68,B
1342,CEJ,159,8,159,168,168,1343,0,E
1342,CFJ,85,37,196,135,257,1343,111,J
1342,CFK,189,144,340,295,507,1343,151,C
1342,DFK,195,14,354,240,408,1343,159,F
1342,DGK,212,54,408,285,542,1343,196,K
1342,DGL,143,75,483,5160,5667,1343,340,D
1342,GL,245,116,599,285,693,1343,354,G
1342,HL,467,276,875,5160,5702,1343,408,L
1342,H,1405,1129,2004,5160,5853,1343,599,H
1342,M,361,361,2365,863,6716,1343,2004,M
1342,N,532,532,2897,90,6806,1343,2365,N
1342,O,911,911,3808,1250,8056,1343,2897,O
1342,P,4,4,3812,3840,11896,1343,3808,P
1343,AE,180,180,180,676,676,1344,0,A
1343,BE,479,299,479,1262,1262,1344,0,E
1343,BF,690,391,870,240,916,1344,180,B
1343,CF,161,161,1031,205,1121,1344,870,C
1343,DF,972,420,1451,240,1502,1344,479,F
1343,DG,776,776,2227,1030,2532,1344,1451,G
1343,DF,1572,376,2603,5220,6341,1344,1031,D
1343,F,686,310,2913,485,3017,1344,2227,F
1343,G,374,374,3287,510,3527,1344,2913,G
1343,H,81,81,3368,3960,7487,1344,3287,H
1343,M,839,839,4207,1967,9454,1344,3368,M
1343,N,1284,1284,5491,90,9544,1344,4207,N
1343,O,1014,1014,6505,1395,10939,1344,5491,O
1343,N,1362,1362,7867,1090,12029,1344,6505,N
1343,O,705,705,8572,1060,13089,1344,7867,O
1343,P,34,34,8606,3780,16869,1344,8572,P
1344,A,365,365,365,1343,1343,1345,0,A
1344,B,1036,1036,1401,90,1433,1345,365,B
1344,C,1289,1289,2690,1665,3098,1345,1401,C
1344,D,512,512,3202,3780,6878,1345,2690,D
1344,M,777,777,3979,1276,8154,1345,3202,M
1344,N,530,530,4509,90,8244,1345,3979,N
1344,O,401,401,4910,795,9039,1345,4509,O
1344,P,1797,1797,6707,3780,12819,1345,4910,P
1345,AEI,91,91,91,1022,1022,1346,0,E
1345,AFI,128,37,128,1025,1025,1346,0,A
1345,BFI,1118,1081,1209,240,1262,1346,91,F
1345,BGI,1087,6,1215,240,1265,1346,128,B
1345,CGI,871,865,2080,1020,2282,1346,1209,G
1345,CHI,884,19,2099,1020,2285,1346,1215,C
1345,DHI,136,136,2235,4680,6965,1346,2099,D
1345,HI,339,184,2419,4680,6962,1346,2080,H
1345,I,11148,8729,11148,12220,12220,1346,0,I
1345,J,1441,1441,12589,420,12640,1346,11148,J
1345,K,1139,1139,13728,1240,13880,1346,12589,K
1345,L,3,3,13731,335,14215,1346,13728,L
1345,M,2887,2887,16618,3069,17284,1346,13731,M
1345,N,215,215,16833,90,17374,1346,16618,N
1345,O,655,655,17488,820,18194,1346,16833,O
1345,N,1004,1004,18492,845,19039,1346,17488,N
1345,O,435,435,18927,740,19779,1346,18492,O
1345,P,932,932,19859,3780,23559,1346,18927,P
1346,AEI,63,63,63,273,273,1347,0,A
1346,BEI,400,400,463,240,513,1347,63,B
1346,CEI,155,155,618,215,728,1347,463,C
1346,DEI,1608,990,1608,1513,1513,1347,0,I
1346,DEJ,1816,208,1816,2185,2185,1347,0,E
1346,DFJ,1395,197,2013,4890,5618,1347,618,D
1346,FJ,532,127,2140,300,1813,1347,1608,J
1346,FK,575,251,2391,240,2425,1347,1816,F
1346,GK,760,760,3151,920,3345,1347,2391,G
1346,HK,1019,8,3159,970,2783,1347,2140,K
1346,HL,202,194,3353,3960,7305,1347,3151,H
1346,L,785,591,3944,3960,6743,1347,3159,L
1346,M,29,29,3973,26,7331,1347,3944,M
1346,N,192,192,4165,240,7571,1347,3973,N
1346,O,280,280,4445,980,8551,1347,4165,O
1346,P,424,424,4869,3470,12021,1347,4445,P
1347,AEI,172,172,172,1117,1117,1348,0,A
1347,BEI,565,393,565,2939,2939,1348,0,E
1347,BFI,1128,563,1128,1269,1269,1348,0,I
1347,BFJ,1045,89,1217,150,1267,1348,172,B
1347,CFJ,259,170,1387,150,1419,1348,1128,J
1347,CFK,763,593,1980,760,2027,1348,1217,C
1347,BFK,816,223,2203,565,1984,1348,1387,K
1347,BFJ,80,80,2283,345,2329,1348,2203,J
1347,BFK,305,2,2285,300,2327,1348,1980,B
1347,CFK,135,135,2420,625,2952,1348,2285,C
1347,DFK,141,4,2424,130,2459,1348,2283,K
1347,DFL,2606,747,3171,270,3209,1348,565,F
1347,DGL,932,185,3356,4230,6689,1348,2424,L
1347,DG,277,92,3448,120,3329,1348,3171,G
1347,DF,2077,1049,4497,3740,6692,1348,2420,D
1347,F,1384,335,4832,1490,4819,1348,3448,F
1347,G,325,325,5157,430,5249,1348,4832,G
1347,H,609,609,5766,2530,7779,1348,5157,H
1347,M,45,45,5811,52,7831,1348,5766,M
1347,N,112,112,5923,150,7981,1348,5811,N
1347,O,213,213,6136,130,8111,1348,5923,O
1347,N,1484,1484,7620,1545,9656,1348,6136,N
1347,O,824,824,8444,775,10431,1348,7620,O
1347,P,306,306,8750,4230,14661,1348,8444,P
1348,AE,327,327,327,512,512,1349,0,E
1348,AF,210,210,537,90,602,1349,327,F
1348,AG,751,214,751,1414,1414,1349,0,A
1348,BG,714,714,1465,90,1504,1349,751,B
1348,CG,982,54,1519,1330,1932,1349,537,G
1348,CH,122,122,1641,3780,5712,1349,1519,H
1348,C,924,748,2389,1285,2789,1349,1465,C
1348,D,1271,1271,3660,3780,6569,1349,2389,D
1348,M,949,949,4609,1126,7695,1349,3660,M
1348,N,380,380,4989,240,7935,1349,4609,N
1348,O,206,206,5195,275,8210,1349,4989,O
1348,P,276,276,5471,360,8570,1349,5195,P
1349,AE,688,688,688,1037,1037,1350,0,E
1349,AF,1058,370,1058,1299,1299,1350,0,A
1349,BF,376,6,1064,90,1127,1350,688,F
1349,BG,703,697,1761,90,1389,1350,1058,B
1349,CG,965,268,2029,1250,2377,1350,1064,G
1349,CH,7,7,2036,3780,6157,1350,2029,H
1349,C,905,630,2666,1250,2639,1350,1761,C
1349,D,162,162,2828,3780,6419,1350,2666,D
1349,M,508,508,3336,943,7362,1350,2828,M
1349,N,462,462,3798,90,7452,1350,3336,N
1349,O,214,214,4012,625,8077,1350,3798,O
1349,P,4514,4514,8526,3780,11857,1350,4012,P
1350,AE,278,278,278,1021,1021,1351,0,A
1350,BE,838,838,1116,150,1171,1351,278,B
1350,CE,120,120,1236,100,1271,1351,1116,C
1350,BE,584,584,1820,570,1841,1351,1236,B
1350,CE,2394,574,2394,4754,4754,1351,0,E
1350,CF,692,118,2512,660,2501,1351,1820,C
1350,DF,1325,1325,3837,4230,6731,1351,2512,D
1350,F,2413,970,4807,90,4844,1351,2394,F
1350,G,372,372,5179,800,5644,1351,4807,G
1350,H,2398,2398,7577,3780,9424,1351,5179,H
1350,M,1756,1756,9333,2295,11719,1351,7577,M
1350,N,662,662,9995,180,11899,1351,9333,N
1350,O,886,886,10881,890,12789,1351,9995,O
1350,P,2490,2490,13371,550,13339,1351,10881,P
1351,AE,86,86,86,148,148,1352,0,A
1351,BE,251,251,337,240,388,1352,86,B
1351,CE,168,168,505,215,603,1352,337,C
1351,DE,663,663,1168,5010,5613,1352,505,D
1351,E,1653,485,1653,2046,2046,1352,0,E
1351,F,610,610,2263,240,2286,1352,1653,F
1351,G,98,98,2361,390,2676,1352,2263,G
1351,H,619,619,2980,3960,6636,1352,2361,H
1351,M,920,920,3900,1367,8003,1352,2980,M
1351,N,641,641,4541,240,8243,1352,3900,N
1351,O,566,566,5107,765,9008,1352,4541,O
1351,P,576,576,5683,3960,12968,1352,5107,P
1352,A,1205,1205,1205,1575,1575,1353,0,A
1352,B,619,619,1824,300,1875,1353,1205,B
1352,C,965,965,2789,1045,2920,1353,1824,C
1352,D,1407,1407,4196,1140,4060,1353,2789,D
1352,M,323,323,4519,380,4440,1353,4196,M
1352,N,372,372,4891,300,4740,1353,4519,N
1352,O,504,504,5395,700,5440,1353,4891,O
1352,P,65,65,5460,1140,6580,1353,5395,P
1353,A,22,22,22,1100,1100,1354,0,A
1353,B,1281,1281,1303,240,1340,1354,22,B
1353,C,698,698,2001,880,2220,1354,1303,C
1353,D,119,119,2120,3960,6180,1354,2001,D
1353,M,1370,1370,3490,1501,7681,1354,2120,M
1353,N,321,321,3811,240,7921,1354,3490,N
1353,O,727,727,4538,860,8781,1354,3811,O
1353,N,250,250,4788,165,8946,1354,4538,N
1353,O,1480,1480,6268,2420,11366,1354,4788,O
1353,N,1460,1460,7728,690,12056,1354,6268,N
1353,O,915,915,8643,900,12956,1354,7728,O
1353,P,1251,1251,9894,3960,16916,1354,8643,P
1354,A,1068,1068,1068,1139,1139,1355,0,A
1354,B,268,268,1336,240,1379,1355,1068,B
1354,C,751,751,2087,970,2349,1355,1336,C
1354,D,87,87,2174,3960,6309,1355,2087,D
1354,M,160,160,2334,404,6713,1355,2174,M
1354,N,444,444,2778,240,6953,1355,2334,N
1354,O,1172,1172,3950,1165,8118,1355,2778,O
1354,P,6072,6072,10022,550,8668,1355,3950,P
1355,AE,18,18,18,44,44,1356,0,E
1355,AF,114,114,132,135,179,1356,18,F
1355,AG,163,31,163,155,155,1356,0,A
1355,BG,87,87,250,150,305,1356,163,B
1355,CG,209,91,341,295,474,1356,132,G
1355,CH,155,64,405,125,430,1356,250,C
1355,BH,126,62,467,5100,5574,1356,341,H
1355,B,821,759,1226,845,1275,1356,405,B
1355,C,116,116,1342,110,1385,1356,1226,C
1355,D,574,574,1916,4230,5615,1356,1342,D
1355,M,568,568,2484,765,6380,1356,1916,M
1355,N,322,322,2806,660,7040,1356,2484,N
1355,O,1640,1640,4446,2041,9081,1356,2806,O
1355,N,8857,8857,13303,7944,17025,1356,4446,N
1355,O,599,599,13902,960,17985,1356,13303,O
1355,P,4228,4228,18130,3960,21945,1356,13902,P
1356,AE,264,264,264,518,518,1357,0,A
1356,BE,362,362,626,150,668,1357,264,B
1356,CE,484,484,1110,500,1168,1357,626,C
1356,DE,1354,244,1354,1621,1621,1357,0,E
1356,DF,312,312,1666,90,1711,1357,1354,F
1356,DG,294,294,1960,600,2311,1357,1666,G
1356,DF,1844,994,2954,4200,5368,1357,1110,D
1356,F,2711,1717,4671,2420,4731,1357,1960,F
1356,G,1246,1246,5917,1610,6341,1357,4671,G
1356,H,1548,1548,7465,3780,10121,1357,5917,H
1356,M,304,304,7769,370,10491,1357,7465,M
1356,N,195,195,7964,180,10671,1357,7769,N
1356,O,168,168,8132,260,10931,1357,7964,O
1356,N,1312,1312,9444,1230,12161,1357,8132,N
1356,O,816,816,10260,200,12361,1357,9444,O
1356,P,4375,4375,14635,5220,17581,1357,10260,P
1357,A,1316,1316,1316,1730,1730,1358,0,A
1357,B,544,544,1860,180,1910,1358,1316,B
1357,C,1094,1094,2954,1855,3765,1358,1860,C
1357,B,836,836,3790,95,3860,1358,2954,B
1357,C,254,254,4044,540,4400,1358,3790,C
1357,D,5782,5782,9826,9780,14180,1358,4044,D
1357,M,201,201,10027,322,14502,1358,9826,M
1357,N,241,241,10268,180,14682,1358,10027,N
1357,O,529,529,10797,840,15522,1358,10268,O
1357,P,126,126,10923,6680,22202,1358,10797,P
1358,AE,110,110,110,1053,1053,1359,0,A
1358,BE,1121,1121,1231,240,1293,1359,110,B
1358,CE,1600,369,1600,1176,1176,1359,0,E
1358,CF,363,363,1963,90,1266,1359,1600,F
1358,CG,795,63,2026,930,2223,1359,1231,C
1358,DG,567,504,2530,815,2081,1359,1963,G
1358,DF,617,617,3147,1075,3156,1359,2530,F
1358,DG,1229,1229,4376,1790,4946,1359,3147,G
1358,DH,1011,1011,5387,3780,8726,1359,4376,H
1358,D,7361,4000,9387,6990,9213,1359,2026,D
1358,M,14646,14646,24033,14600,23813,1359,9387,M
1358,N,226,226,24259,300,24113,1359,24033,N
1358,O,919,919,25178,1005,25118,1359,24259,O
1358,P,491,491,25669,1200,26318,1359,25178,P
1359,AEI,256,256,256,1203,1203,1360,0,A
1359,BEI,961,705,961,1158,1158,1360,0,I
1359,BEJ,225,225,1186,90,1248,1360,961,J
1359,BEK,987,57,1243,90,1293,1360,256,B
1359,CEK,2000,757,2000,5416,5416,1360,0,E
1359,CFK,978,164,2164,1240,2488,1360,1186,K
1359,CFL,1024,103,2267,1240,2533,1360,1243,C
1359,DFL,498,395,2662,3780,6268,1360,2164,L
1359,DF,2836,2441,5103,3780,6313,1360,2267,D
1359,F,3510,407,5510,90,5506,1360,2000,F
1359,G,1101,1101,6611,1380,6886,1360,5510,G
1359,H,197,197,6808,3780,10666,1360,6611,H
1359,M,442,442,7250,918,11584,1360,6808,M
1359,N,516,516,7766,90,11674,1360,7250,N
1359,O,554,554,8320,845,12519,1360,7766,O
1359,P,16531,16531,24851,3780,16299,1360,8320,P
1360,A,123,123,123,146,146,1361,0,A
1360,B,113,113,236,150,296,1361,123,B
1360,C,577,577,813,500,796,1361,236,C
1360,D,2972,2972,3785,385,1181,1361,813,D
1360,M,29,29,3814,746,1927,1361,3785,M
1360,N,1096,1096,4910,420,2347,1361,3814,N
1360,O,1292,1292,6202,1410,3757,1361,4910,O
1360,P,1561,1561,7763,320,4077,1361,6202,P
1361,AE,27,27,27,570,570,1362,0,A
1361,BE,776,776,803,240,810,1362,27,B
1361,CE,653,653,1456,960,1770,1362,803,C
1361,DE,280,280,1736,3960,5730,1362,1456,D
1361,E,4552,2816,4552,5854,5854,1362,0,E
1361,F,1422,1422,5974,180,6034,1362,4552,F
1361,G,411,411,6385,510,6544,1362,5974,G
1361,F,1009,1009,7394,830,7374,1362,6385,F
1361,G,1030,1030,8424,1307,8681,1362,7394,G
1361,H,7152,7152,15576,473,9154,1362,8424,H
1361,M,1281,1281,16857,6030,15184,1362,15576,M
1361,N,4976,4976,21833,90,15274,1362,16857,N
1361,O,1551,1551,23384,1865,17139,1362,21833,O
1361,P,7,7,23391,3780,20919,1362,23384,P
1362,AEI,722,722,722,1472,1472,1363,0,A
1362,BEI,1439,717,1439,2567,2567,1363,0,E
1362,BFI,840,123,1562,180,1652,1363,722,B
1362,CFI,1610,48,1610,4658,4658,1363,0,I
1362,CFJ,545,497,2107,740,2392,1363,1562,C
1362,BFJ,733,733,2840,505,2897,1363,2107,B
1362,CFJ,1498,97,2937,420,2987,1363,1439,F
1362,CGJ,223,223,3160,310,3297,1363,2937,G
1362,CFJ,380,60,3220,535,3432,1363,2840,C
1362,DFJ,918,858,4078,790,4087,1363,3160,F
1362,DGJ,543,543,4621,535,4622,1363,4078,G
1362,DHJ,3049,38,4659,120,4778,1363,1610,J
1362,DHK,662,662,5321,931,5709,1363,4659,K
1362,DHJ,2258,2258,7579,1800,7509,1363,5321,J
1362,DHK,324,324,7903,725,8234,1363,7579,K
1362,DHL,8617,3934,11837,2880,6312,1363,3220,D
1362,HL,15353,8137,19974,2880,7502,1363,4621,H
1362,L,16270,4199,24173,3780,12014,1363,7903,L
1362,M,60,60,24233,296,12310,1363,24173,M
1362,N,413,413,24646,180,12490,1363,24233,N
1362,O,220,220,24866,545,13035,1363,24646,O
1362,N,692,692,25558,415,13450,1363,24866,N
1362,O,214,214,25772,165,13615,1363,25558,O
1362,P,1536,1536,27308,5100,18715,1363,25772,P
1363,AE,33,33,33,205,205,1364,0,E
1363,AF,200,167,200,382,382,1364,0,A
1363,BF,267,100,300,150,355,1364,33,F
1363,BG,82,82,382,80,435,1364,300,G
1363,BH,102,102,484,2880,3315,1364,382,H
1363,B,295,11,495,150,532,1364,200,B
1363,C,500,500,995,470,1002,1364,495,C
1363,B,438,438,1433,475,1477,1364,995,B
1363,C,154,154,1587,110,1587,1364,1433,C
1363,D,937,937,2524,4230,5817,1364,1587,D
1363,M,290,290,2814,749,6566,1364,2524,M
1363,N,591,591,3405,180,6746,1364,2814,N
1363,O,207,207,3612,205,6951,1364,3405,O
1363,N,726,726,4338,725,7676,1364,3612,N
1363,O,100,100,4438,600,8276,1364,4338,O
1363,P,711,711,5149,3750,12026,1364,4438,P
1364,A,35,35,35,179,179,1365,0,A
1364,B,237,237,272,150,329,1365,35,B
1364,C,120,120,392,80,409,1365,272,C
1364,D,17,17,409,2880,3289,1365,392,D
1364,M,292,292,701,1237,4526,1365,409,M
1364,N,975,975,1676,90,4616,1365,701,N
1364,O,1048,1048,2724,1200,5816,1365,1676,O
1364,P,2789,2789,5513,3780,9596,1365,2724,P
1365,AEI,1025,1025,1025,3523,3523,1366,0,E
1365,AFI,2556,2556,3581,90,3613,1366,1025,F
1365,AGI,3663,82,3663,4256,4256,1366,0,I
1365,AGJ,630,548,4211,805,4418,1366,3581,G
1365,AFJ,626,78,4289,90,4346,1366,3663,J
1365,AFK,813,813,5102,1200,5546,1366,4289,K
1365,AFJ,848,848,5950,465,6011,1366,5102,J
1365,AFK,6086,136,6086,7527,7527,1366,0,A
1365,BFK,2010,135,6221,1860,6278,1366,4211,F
1365,BGK,794,523,6744,1060,7071,1366,5950,K
1365,BGL,758,235,6979,1080,7358,1366,6221,G
1365,BHL,785,550,7529,3780,10851,1366,6744,L
1365,BH,1575,132,7661,90,7617,1366,6086,B
1365,CH,808,126,7787,3780,11138,1366,6979,H
1365,C,1550,1424,9211,1865,9482,1366,7661,C
1365,B,359,359,9570,135,9617,1366,9211,B
1365,C,688,688,10258,1060,10677,1366,9570,C
1365,D,930,930,11188,3780,14457,1366,10258,D
1365,M,2840,2840,14028,3090,17547,1366,11188,M
1365,N,277,277,14305,90,17637,1366,14028,N
1365,O,811,811,15116,1105,18742,1366,14305,O
1365,N,1549,1549,16665,1240,19982,1366,15116,N
1365,O,2178,2178,18843,1340,21322,1366,16665,O
1365,P,4440,4440,23283,3780,25102,1366,18843,P
1366,AE,992,992,992,1041,1041,1367,0,E
1366,AF,249,249,1241,240,1281,1367,992,F
1366,AG,735,735,1976,970,2251,1367,1241,G
1366,AH,110,110,2086,3960,6211,1367,1976,H
1366,A,2995,909,2995,3513,3513,1367,0,A
1366,B,900,900,3895,420,3933,1367,2995,B
1366,C,878,878,4773,1074,5007,1367,3895,C
1366,D,799,799,5572,356,5363,1367,4773,D
1366,M,186,186,5758,1007,7218,1367,5572,M
1366,N,1004,1004,6762,240,7458,1367,5758,N
1366,O,969,969,7731,1030,8488,1367,6762,O
1366,P,887,887,8618,3960,12448,1367,7731,P
1367,AE,91,91,91,294,294,1368,0,E
1367,AF,130,39,130,220,220,1368,0,A
1367,BF,210,210,340,180,400,1368,130,B
1367,CF,283,34,374,180,474,1368,91,F
1367,CG,360,326,700,660,1060,1368,340,C
1367,DG,359,33,733,660,1134,1368,374,G
1367,DH,310,277,1010,3960,5020,1368,700,D
1367,H,4647,4370,5380,3960,5094,1368,733,H
1367,M,21,21,5401,100,5194,1368,5380,M
1367,N,170,170,5571,150,5344,1368,5401,N
1367,O,204,204,5775,275,5619,1368,5571,O
1367,P,71,71,5846,2880,8499,1368,5775,P
1368,A,12719,12719,12719,13644,13644,1369,0,A
1368,B,1256,1256,13975,360,14004,1369,12719,B
1368,C,809,809,14784,845,14849,1369,13975,C
1368,D,70,70,14854,2700,17549,1369,14784,D
1368,M,1848,1848,16702,4355,21904,1369,14854,M
1368,N,2761,2761,19463,300,22204,1369,16702,N
1368,O,643,643,20106,790,22994,1369,19463,O
1368,P,1760,1760,21866,1620,24614,1369,20106,P
1369,AEI,215,215,215,478,478,1370,0,I
1369,AEJ,667,452,667,1051,1051,1370,0,E
1369,AFJ,526,526,1193,180,1231,1370,667,F
1369,AGJ,192,192,1385,150,1381,1370,1193,G
1369,AHJ,79,79,1464,385,1766,1370,1385,H
1369,AJ,1255,6,1470,905,1383,1370,215,J
1369,AK,1256,1256,2726,1380,2763,1370,1470,K
1369,AL,3,3,2729,335,3098,1370,2726,L
1369,A,3462,733,3462,4770,4770,1370,0,A
1369,B,1679,1679,5141,420,5190,1370,3462,B
1369,C,1093,1093,6234,1015,6205,1370,5141,C
1369,D,1487,1487,7721,460,6665,1370,6234,D
1369,M,172,172,7893,212,6877,1370,7721,M
1369,N,297,297,8190,270,7147,1370,7893,N
1369,O,995,995,9185,1100,8247,1370,8190,O
1369,P,643,643,9828,695,8942,1370,9185,P
1370,AE,692,692,692,1167,1167,1371,0,A
1370,BE,642,642,1334,180,1347,1371,692,B
1370,CE,1621,287,1621,1839,1839,1371,0,E
1370,CF,353,353,1974,195,2034,1371,1621,F
1370,CG,865,225,2199,930,2277,1371,1334,C
1370,DG,702,477,2676,695,2729,1371,1974,G
1370,DH,193,193,2869,385,3114,1371,2676,H
1370,D,1551,881,3750,550,2827,1371,2199,D
1370,M,587,587,4337,867,3981,1371,3750,M
1370,N,392,392,4729,150,4131,1371,4337,N
1370,O,1112,1112,5841,1102,5233,1371,4729,O
1370,P,22,22,5863,368,5601,1371,5841,P
1371,AEI,88,88,88,201,201,1372,0,E
1371,AFI,227,227,315,180,381,1372,88,F
1371,AGI,466,151,466,1379,1379,1372,0,I
1371,AGJ,189,38,504,230,611,1372,315,G
1371,AHJ,48,48,552,4140,4751,1372,504,H
1371,AJ,1003,917,1469,150,1529,1372,466,J
1371,AK,796,796,2265,790,2319,1372,1469,K
1371,AL,3048,783,3048,3396,3396,1372,0,A
1371,BL,1273,490,3538,4200,6519,1372,2265,L
1371,B,555,65,3603,240,3636,1372,3048,B
1371,C,720,720,4323,920,4556,1372,3603,C
1371,D,876,876,5199,3960,8516,1372,4323,D
1371,M,1859,1859,7058,4365,12881,1372,5199,M
1371,N,2746,2746,9804,300,13181,1372,7058,N
1371,O,729,729,10533,780,13961,1372,9804,O
1371,N,1598,1598,12131,1530,15491,1372,10533,N
1371,O,542,542,12673,770,16261,1372,12131,O
1371,P,1366,1366,14039,3960,20221,1372,12673,P
1372,AE,43,43,43,292,292,1373,0,E
1372,AF,131,88,131,221,221,1373,0,A
1372,BF,268,180,311,90,382,1373,43,F
1372,BG,192,12,323,150,371,1373,131,B
1372,CG,580,580,903,620,991,1373,323,C
1372,DG,656,64,967,1010,1392,1373,311,G
1372,DH,618,554,1521,4200,5191,1373,903,D
1372,H,1069,515,2036,3780,5172,1373,967,H
1372,M,58,58,2094,132,5323,1373,2036,M
1372,N,171,171,2265,150,5473,1373,2094,N
1372,O,281,281,2546,140,5613,1373,2265,O
1372,P,89,89,2635,4230,9843,1373,2546,P
1373,AE,207,207,207,1480,1480,1374,0,A
1373,BE,1682,1682,1889,420,1900,1374,207,B
1373,CE,651,651,2540,1215,3115,1374,1889,C
1373,DE,10231,7691,10231,10512,10512,1374,0,E
1373,DF,298,298,10529,90,10602,1374,10231,F
1373,DG,515,515,11044,880,11482,1374,10529,G
1373,DF,1119,1119,12163,745,12227,1374,11044,F
1373,DG,10370,747,12910,9480,12595,1374,2540,D
1373,G,2528,1781,14691,1245,13472,1374,12163,G
1373,H,14894,14894,29585,3840,17312,1374,14691,H
1373,M,2484,2484,32069,3706,21018,1374,29585,M
1373,N,1325,1325,33394,180,21198,1374,32069,N
1373,O,1050,1050,34444,1030,22228,1374,33394,O
1373,N,3230,3230,37674,3215,25443,1374,34444,N
1373,O,567,567,38241,825,26268,1374,37674,O
1373,P,12653,12653,50894,6720,32988,1374,38241,P
1374,A,92,92,92,208,208,1375,0,A
1374,B,325,325,417,240,448,1375,92,B
1374,C,289,289,706,290,738,1375,417,C
1374,D,1836,1836,2542,5160,5898,1375,706,D
1374,M,258,258,2800,948,6846,1375,2542,M
1374,N,723,723,3523,90,6936,1375,2800,N
1374,O,985,985,4508,1250,8186,1375,3523,O
1374,P,9,9,4517,3780,11966,1375,4508,P
1375,AEI,44,44,44,74,74,1376,0,E
1375,AFI,87,43,87,102,102,1376,0,I
1375,AFJ,118,118,205,150,252,1376,87,J
1375,AFK,166,5,210,150,224,1376,44,F
1375,AGK,123,118,328,445,697,1376,205,K
1375,AGL,696,578,906,675,899,1376,210,G
1375,AHL,556,556,1462,4200,5099,1376,906,H
1375,AL,1500,366,1828,3900,4597,1376,328,L
1375,A,11627,9799,11627,11994,11994,1376,0,A
1375,B,578,578,12205,240,12234,1376,11627,B
1375,C,612,612,12817,920,13154,1376,12205,C
1375,D,310,310,13127,3960,17114,1376,12817,D
1375,M,1776,1776,14903,1962,19076,1376,13127,M
1375,N,302,302,15205,150,19226,1376,14903,N
1375,O,709,709,15914,706,19932,1376,15205,O
1375,P,4534,4534,20448,3630,23562,1376,15914,P
1376,AEI,18,18,18,279,279,1377,0,E
1376,AFI,234,216,234,809,809,1377,0,A
1376,BFI,657,441,675,420,699,1377,18,F
1376,BGI,615,174,849,90,899,1377,234,B
1376,CGI,393,393,1242,795,1694,1377,849,C
1376,DGI,949,382,1624,1240,1939,1377,675,G
1376,DHI,283,283,1907,335,2274,1377,1624,H
1376,DI,1717,1052,2959,3780,5474,1377,1242,D
1376,I,4496,1537,4496,4740,4740,1377,0,I
1376,J,247,247,4743,90,4830,1377,4496,J
1376,K,304,304,5047,715,5545,1377,4743,K
1376,L,1646,1646,6693,3780,9325,1377,5047,L
1376,M,578,578,7271,2340,11665,1377,6693,M
1376,N,1882,1882,9153,180,11845,1377,7271,N
1376,O,954,954,10107,900,12745,1377,9153,O
1376,P,518,518,10625,550,13295,1377,10107,P
1377,AEI,168,168,168,1012,1012,1378,0,I
1377,AEJ,475,307,475,473,473,1378,0,A
1377,BEJ,103,103,578,150,623,1378,475,B
1377,CEJ,624,46,624,1474,1474,1378,0,E
1377,CFJ,158,112,736,140,763,1378,578,C
1377,BFJ,869,301,1037,90,1102,1378,168,J
1377,BFK,877,464,1501,90,1564,1378,624,F
1377,BGK,542,78,1579,880,1982,1378,1037,K
1377,BGJ,886,43,1622,900,1663,1378,736,B
1377,CGJ,546,425,2047,905,2469,1378,1501,G
1377,CFJ,472,4,2051,110,2092,1378,1579,J
1377,CFK,460,31,2082,650,2313,1378,1622,C
1377,DFK,451,416,2498,90,2559,1378,2047,F
1377,DGK,1415,968,3466,2315,4407,1378,2051,K
1377,DGL,1517,549,4015,2320,4879,1378,2498,G
1377,DHL,1535,1535,5550,3420,8299,1378,4015,H
1377,DL,5979,2511,8061,4230,6543,1378,2082,D
1377,L,24799,20204,28265,3420,7827,1378,3466,L
1377,M,1665,1665,29930,4433,12732,1378,28265,M
1377,N,2798,2798,32728,90,12822,1378,29930,N
1377,O,1628,1628,34356,1875,14697,1378,32728,O
1377,N,698,698,35054,450,15147,1378,34356,N
1377,O,746,746,35800,940,16087,1378,35054,O
1377,P,2601,2601,38401,3780,19867,1378,35800,P
1378,AEI,2438,2438,2438,2543,2543,1379,0,E
1378,AFI,212,212,2650,90,2633,1379,2438,F
1378,AGI,504,504,3154,815,3448,1379,2650,G
1378,AFI,866,866,4020,220,3668,1379,3154,F
1378,AGI,909,909,4929,1280,4948,1379,4020,G
1378,AHI,162,162,5091,3780,8728,1379,4929,H
1378,AI,11391,6300,11391,16116,16116,1379,0,A
1378,BI,4775,4775,16166,90,16206,1379,11391,B
1378,CI,1031,1031,17197,1340,17546,1379,16166,C
1378,BI,1930,1930,19127,1635,19181,1379,17197,B
1378,CI,960,960,20087,1280,20461,1379,19127,C
1378,DI,515,515,20602,3780,24241,1379,20087,D
1378,I,36219,15617,36219,36372,36372,1379,0,I
1378,J,186,186,36405,90,36462,1379,36219,J
1378,K,1224,1224,37629,1445,37907,1379,36405,K
1378,J,1368,1368,38997,1140,39047,1379,37629,J
1378,K,753,753,39750,1080,40127,1379,38997,K
1378,L,102,102,39852,3780,43907,1379,39750,L
1378,M,31576,31576,71428,31655,75562,1379,39852,M
1378,N,115,115,71543,90,75652,1379,71428,N
1378,O,743,743,72286,1105,76757,1379,71543,O
1378,N,771,771,73057,410,77167,1379,72286,N
1378,O,187,187,73244,605,77772,1379,73057,O
1378,P,105,105,73349,3780,81552,1379,73244,P
1379,AE,175,175,175,1278,1278,1380,0,A
1379,BE,823,648,823,1267,1267,1380,0,E
1379,BF,1223,575,1398,180,1458,1380,175,B
1379,CF,581,6,1404,180,1447,1380,823,F
1379,CG,587,581,1985,585,2043,1380,1398,C
1379,DG,942,361,2346,920,2367,1380,1404,G
1379,DH,1097,1097,3443,550,2917,1380,2346,H
1379,D,1845,387,3830,6960,9003,1380,1985,D
1379,M,26367,26367,30197,26575,35578,1380,3830,M
1379,N,434,434,30631,270,35848,1380,30197,N
1379,O,792,792,31423,878,36726,1380,30631,O
1379,P,1262,1262,32685,1217,37943,1380,31423,P
1380,AEI,14,14,14,141,141,1381,0,E
1380,AFI,249,249,263,150,291,1381,14,F
1380,AGI,156,156,419,830,1121,1381,263,G
1380,AHI,935,516,935,1443,1443,1381,0,I
1380,AHJ,1215,280,1215,1435,1435,1381,0,A
1380,BHJ,857,61,1276,3490,4611,1381,419,H
1380,BJ,334,273,1549,180,1615,1381,1215,B
1380,CJ,711,97,1646,270,1713,1381,935,J
1380,CK,516,419,2065,510,2125,1381,1549,C
1380,BK,646,227,2292,735,2448,1381,1646,K
1380,BJ,394,167,2459,395,2520,1381,2065,B
1380,CJ,141,141,2600,130,2650,1381,2459,C
1380,DJ,992,684,3284,895,3343,1381,2292,J
1380,DK,201,201,3485,260,3603,1381,3284,K
1380,DL,1651,1651,5136,5160,8763,1381,3485,L
1380,D,4039,1503,6639,2850,5500,1381,2600,D
1380,M,620,620,7259,914,9677,1381,6639,M
1380,N,763,763,8022,496,10173,1381,7259,N
1380,O,412,412,8434,215,10388,1381,8022,O
1380,P,1293,1293,9727,2850,13238,1381,8434,P
1381,AE,1,1,1,614,614,1382,0,E
1381,AF,1108,1108,1109,541,1155,1382,1,F
1381,AG,253,253,1362,442,1597,1382,1109,G
1381,AF,1655,293,1655,1689,1689,1382,0,A
1381,BF,321,28,1683,118,1715,1382,1362,F
1381,BG,313,285,1968,300,1989,1382,1655,B
1381,CG,527,242,2210,740,2455,1382,1683,G
1381,CH,505,263,2473,811,2800,1382,1968,C
1381,DH,88,88,2561,2940,5740,1382,2473,D
1381,H,4585,4234,6795,3960,6415,1382,2210,H
1381,M,14,14,6809,197,6612,1382,6795,M
1381,N,244,244,7053,120,6732,1382,6809,N
1381,O,133,133,7186,250,6982,1382,7053,O
1381,N,846,846,8032,730,7712,1382,7186,N
1381,O,287,287,8319,590,8302,1382,8032,O
1381,P,56,56,8375,5100,13402,1382,8319,P
1382,AE,120,120,120,707,707,1383,0,E
1382,AF,687,687,807,150,857,1383,120,F
1382,AG,127,127,934,115,972,1383,807,G
1382,AF,1214,280,1214,3125,3125,1383,0,A
1382,BF,535,255,1469,535,1507,1383,934,F
1382,BG,885,885,2354,715,2222,1383,1469,G
1382,BH,1943,803,3157,90,3215,1383,1214,B
1382,CH,510,510,3667,730,3945,1383,3157,C
1382,DH,3289,3289,6956,3780,7725,1383,3667,D
1382,H,5472,870,7826,4230,6452,1383,2354,H
1382,M,3013,3013,10839,4037,11762,1383,7826,M
1382,N,1219,1219,12058,240,12002,1383,10839,N
1382,O,1056,1056,13114,1050,13052,1383,12058,O
1382,N,998,998,14112,1090,14142,1383,13114,N
1382,O,923,923,15035,1210,15352,1383,14112,O
1382,P,355,355,15390,3960,19312,1383,15035,P
1383,AEI,1414,1414,1414,1528,1528,1384,0,A
1383,BEI,227,227,1641,150,1678,1384,1414,B
1383,CEI,708,708,2349,730,2408,1384,1641,C
1383,DEI,790,790,3139,4200,6608,1384,2349,D
1383,EI,3141,2,3141,3932,3932,1384,0,I
1383,EJ,1042,1042,4183,240,4172,1384,3141,J
1383,EK,803,803,4986,1040,5212,1384,4183,K
1383,EL,871,871,5857,3960,9172,1384,4986,L
1383,E,7054,1197,7054,7266,7266,1384,0,E
1383,F,419,419,7473,240,7506,1384,7054,F
1383,G,711,711,8184,920,8426,1384,7473,G
1383,H,179,179,8363,3960,12386,1384,8184,H
1383,M,111,111,8474,159,12545,1384,8363,M
1383,N,155,155,8629,150,12695,1384,8474,N
1383,O,719,719,9348,765,13460,1384,8629,O
1383,P,3462,3462,12810,3600,17060,1384,9348,P
1384,AE,45,45,45,972,972,1385,0,E
1384,AF,582,537,582,936,936,1385,0,A
1384,BF,484,484,1066,150,1086,1385,582,B
1384,CF,1110,89,1155,240,1212,1385,45,F
1384,CG,213,124,1279,140,1226,1385,1066,C
1384,BG,414,414,1693,470,1696,1385,1279,B
1384,CG,862,324,2017,1020,2232,1385,1155,G
1384,CH,213,213,2230,4680,6912,1385,2017,H
1384,C,695,158,2388,720,2416,1385,1693,C
1384,D,1230,1230,3618,4170,6586,1385,2388,D
1384,M,442,442,4060,2250,9162,1385,3618,M
1384,N,1942,1942,6002,180,9342,1385,4060,N
1384,O,881,881,6883,900,10242,1385,6002,O
1384,P,2248,2248,9131,550,10792,1385,6883,P
1385,AEI,174,174,174,955,955,1386,0,A
1385,BEI,597,423,597,1740,1740,1386,0,E
1385,BFI,749,152,749,1315,1315,1386,0,I
1385,BFJ,1036,461,1210,300,1255,1386,174,B
1385,CFJ,825,364,1574,300,1615,1386,749,J
1385,CFK,178,178,1752,370,1985,1386,1574,K
1385,CFJ,709,167,1919,920,2175,1386,1210,C
1385,BFJ,1419,97,2016,300,2040,1386,597,F
1385,BGJ,353,89,2105,150,2135,1386,1752,J
1385,BGK,516,427,2532,665,2705,1386,2016,G
1385,BHK,476,49,2581,665,2800,1386,2105,K
1385,BHL,1909,1247,3828,1445,3620,1386,1919,B
1385,CHL,1464,217,4045,4020,6820,1386,2581,L
1385,CH,1740,227,4272,4020,6725,1386,2532,H
1385,C,2008,1564,5836,2660,6280,1386,3828,C
1385,D,229,229,6065,3960,10240,1386,5836,D
1385,M,7315,7315,13380,7400,17640,1386,6065,M
1385,N,261,261,13641,210,17850,1386,13380,N
1385,O,259,259,13900,175,18025,1386,13641,O
1385,N,1006,1006,14906,1055,19080,1386,13900,N
1385,O,1077,1077,15983,1238,20318,1386,14906,O
1385,P,800,800,16783,382,20700,1386,15983,P
1386,AEI,30,30,30,684,684,1387,0,E
1386,AFI,110,80,110,250,250,1387,0,I
1386,AFJ,377,377,487,270,520,1387,110,J
1386,AFK,778,321,808,180,864,1387,30,F
1386,AGK,783,462,1270,810,1330,1387,487,K
1386,AGL,1566,296,1566,2402,2402,1387,0,A
1386,BGL,866,108,1674,780,1644,1387,808,G
1386,BHL,1236,1236,2910,385,2029,1387,1674,H
1386,BL,1436,92,3002,660,3062,1387,1566,B
1386,CL,2458,726,3728,550,1880,1387,1270,L
1386,C,2950,2224,5952,900,3962,1387,3002,C
1386,D,3276,3276,9228,550,4512,1387,5952,D
1386,M,81,81,9309,380,4892,1387,9228,M
1386,N,419,419,9728,180,5072,1387,9309,N
1386,O,537,537,10265,840,5912,1387,9728,O
1386,P,83,83,10348,6680,12592,1387,10265,P
1387,A,115,115,115,188,188,1388,0,A
1387,B,188,188,303,150,338,1388,115,B
1387,C,105,105,408,490,828,1388,303,C
1387,D,41,41,449,2490,3318,1388,408,D
1387,M,74,74,523,125,3443,1388,449,M
1387,N,45,45,568,165,3608,1388,523,N
1387,O,126,126,694,90,3698,1388,568,O
1387,P,767,767,1461,2880,6578,1388,694,P
1388,AE,47,47,47,1171,1171,1389,0,E
1388,AF,1140,1093,1140,1620,1620,1389,0,A
1388,BF,1314,221,1361,240,1411,1389,47,F
1388,BG,772,551,1912,300,1920,1389,1140,B
1388,CG,699,148,2060,780,2191,1389,1361,G
1388,CH,855,707,2767,1045,2965,1389,1912,C
1388,DH,806,99,2866,7680,9871,1389,2060,H
1388,D,2773,2674,5540,1140,4105,1389,2767,D
1388,M,463,463,6003,699,10570,1389,5540,M
1388,N,471,471,6474,260,10830,1389,6003,N
1388,O,1249,1249,7723,1510,12340,1389,6474,O
1388,P,974,974,8697,720,13060,1389,7723,P
1389,AE,245,245,245,440,440,1390,0,E
1389,AF,246,1,246,895,895,1390,0,A
1389,BF,455,454,700,300,740,1390,245,F
1389,BG,918,464,1164,300,1195,1390,246,B
1389,CG,805,341,1505,1015,1755,1390,700,G
1389,CF,330,330,1835,120,1875,1390,1505,F
1389,CG,673,2,1837,760,1955,1390,1164,C
1389,DG,878,876,2713,1170,3045,1390,1835,G
1389,DH,172,172,2885,1650,4695,1390,2713,H
1389,D,1340,292,3177,3960,5915,1390,1837,D
1389,M,152,152,3329,239,6154,1390,3177,M
1389,N,288,288,3617,240,6394,1390,3329,N
1389,O,811,811,4428,695,7089,1390,3617,O
1389,N,2871,2871,7299,3250,10339,1390,4428,N
1389,O,1424,1424,8723,1620,11959,1390,7299,O
1389,P,1336,1336,10059,3960,15919,1390,8723,P
1390,AEI,1280,1280,1280,1926,1926,1391,0,E
1390,AFI,1861,581,1861,2097,2097,1391,0,I
1390,AFJ,698,117,1978,90,2016,1391,1280,F
1390,AGJ,428,311,2289,240,2337,1391,1861,J
1390,AGK,935,624,2913,1310,3326,1391,1978,G
1390,AHK,763,139,3052,970,3307,1391,2289,K
1390,AHL,287,148,3200,3780,7106,1391,2913,H
1390,AL,3210,10,3210,3387,3387,1391,0,A
1390,BL,394,394,3604,240,3627,1391,3210,B
1390,CL,566,14,3618,3960,7267,1391,3052,L
1390,C,822,808,4426,995,4622,1391,3604,C
1390,D,117,117,4543,3960,8582,1391,4426,D
1390,M,3851,3851,8394,4072,12654,1391,4543,M
1390,N,430,430,8824,240,12894,1391,8394,N
1390,O,519,519,9343,740,13634,1391,8824,O
1390,P,73,73,9416,3960,17594,1391,9343,P
1391,AEI,811,811,811,1774,1774,1392,0,A
1391,BEI,850,39,850,1425,1425,1392,0,E
1391,BFI,634,634,1484,90,1515,1392,850,F
1391,BGI,1010,337,1821,90,1864,1392,811,B
1391,CGI,2007,186,2007,2920,2920,1392,0,I
1391,CGJ,960,437,2444,1230,2745,1392,1484,G
1391,CFJ,831,208,2652,1215,3079,1392,1821,C
1391,BFJ,945,300,2952,90,3010,1392,2007,J
1391,BFK,620,112,3064,360,3105,1392,2444,F
1391,BGK,530,418,3482,880,3890,1392,2952,K
1391,BGJ,661,243,3725,1060,4165,1392,3064,G
1391,BHJ,32,32,3757,3780,7945,1392,3725,H
1391,BJ,2991,1886,5643,2610,5689,1392,2652,B
1391,CJ,656,656,6299,1060,6749,1392,5643,C
1391,DJ,40,40,6339,3780,10529,1392,6299,D
1391,J,2929,72,6411,2585,6475,1392,3482,J
1391,K,705,705,7116,1060,7535,1392,6411,K
1391,L,50,50,7166,3840,11375,1392,7116,L
1391,M,4074,4074,11240,5660,17035,1392,7166,M
1391,N,1618,1618,12858,90,17125,1392,11240,N
1391,O,725,725,13583,1115,18240,1392,12858,O
1391,N,1037,1037,14620,650,18890,1392,13583,N
1391,O,384,384,15004,755,19645,1392,14620,O
1391,P,4235,4235,19239,3780,23425,1392,15004,P
1392,AEI,1347,1347,1347,1482,1482,1393,0,E
1392,AFI,318,318,1665,240,1722,1393,1347,F
1392,AGI,105,105,1770,255,1977,1393,1665,G
1392,AHI,2238,468,2238,3134,3134,1393,0,I
1392,AHJ,980,512,2750,5160,7137,1393,1770,H
1392,AJ,1192,680,3430,300,3434,1393,2238,J
1392,AK,482,482,3912,811,4245,1393,3430,K
1392,AL,184,184,4096,4005,8250,1393,3912,L
1392,A,5395,1299,5395,5688,5688,1393,0,A
1392,B,326,326,5721,90,5778,1393,5395,B
1392,C,1134,1134,6855,1315,7093,1393,5721,C
1392,D,346,346,7201,3780,10873,1393,6855,D
1392,M,8881,8881,16082,9863,20736,1393,7201,M
1392,N,1182,1182,17264,240,20976,1393,16082,N
1392,O,1420,1420,18684,3050,24026,1393,17264,O
1392,P,1566,1566,20250,2400,26426,1393,18684,P
1393,AE,7,7,7,114,114,1394,0,E
1393,AF,208,208,215,150,264,1394,7,F
1393,AG,684,684,899,765,1029,1394,215,G
1393,AH,1550,651,1550,1603,1603,1394,0,A
1393,BH,233,233,1783,240,1843,1394,1550,B
1393,CH,972,972,2755,970,2813,1394,1783,C
1393,BH,1466,1466,4221,260,3073,1394,2755,B
1393,CH,3367,45,4266,3600,4629,1394,899,H
1393,C,205,160,4426,410,3483,1394,4221,C
1393,D,1685,1685,6111,3960,7443,1394,4426,D
1393,M,1001,1001,7112,1095,8538,1394,6111,M
1393,N,183,183,7295,150,8688,1394,7112,N
1393,O,100,100,7395,50,8738,1394,7295,O
1393,N,1546,1546,8941,1595,10333,1394,7395,N
1393,O,121,121,9062,125,10458,1394,8941,O
1393,P,1425,1425,10487,2880,13338,1394,9062,P
1394,A,1455,1455,1455,1852,1852,1395,0,A
1394,B,544,544,1999,90,1942,1395,1455,B
1394,C,983,983,2982,1250,3192,1395,1999,C
1394,D,192,192,3174,3780,6972,1395,2982,D
1394,M,139,139,3313,1318,8290,1395,3174,M
1394,N,1208,1208,4521,90,8380,1395,3313,N
1394,O,547,547,5068,845,9225,1395,4521,O
1394,P,1320,1320,6388,3780,13005,1395,5068,P
1395,AEI,51,51,51,251,251,1396,0,A
1395,BEI,208,157,208,1201,1201,1396,0,I
1395,BEJ,243,86,294,90,341,1396,51,B
1395,CEJ,777,777,1071,1005,1346,1396,294,C
1395,DEJ,1,1,1072,3780,5126,1396,1071,D
1395,EJ,1086,222,1294,150,1351,1396,208,J
1395,EK,1538,244,1538,1681,1681,1396,0,E
1395,FK,263,263,1801,150,1831,1396,1538,F
1395,GK,758,251,2052,755,2106,1396,1294,K
1395,GL,676,425,2477,730,2561,1396,1801,G
1395,HL,1197,772,3249,4200,6306,1396,2052,L
1395,H,1428,656,3905,4200,6761,1396,2477,H
1395,M,31,31,3936,641,7402,1396,3905,M
1395,N,822,822,4758,240,7642,1396,3936,N
1395,O,701,701,5459,960,8602,1396,4758,O
1395,P,265,265,5724,3960,12562,1396,5459,P
1396,A,4328,4328,4328,4620,4620,1397,0,A
1396,B,522,522,4850,260,4880,1397,4328,B
1396,C,808,808,5658,1165,6045,1397,4850,C
1396,D,405,405,6063,600,6645,1397,5658,D
1396,M,10439,10439,16502,11481,18126,1397,6063,M
1396,N,1238,1238,17740,240,18366,1397,16502,N
1396,O,1374,1374,19114,1790,20156,1397,17740,O
1396,P,6375,6375,25489,3840,23996,1397,19114,P
1397,AE,335,335,335,453,453,1398,0,E
1397,AF,148,148,483,90,543,1398,335,F
1397,AG,884,884,1367,1240,1783,1398,483,G
1397,AH,2,2,1369,3780,5563,1398,1367,H
1397,A,1817,448,1817,3026,3026,1398,0,A
1397,B,1469,1469,3286,90,3116,1398,1817,B
1397,C,1314,1314,4600,1430,4546,1398,3286,C
1397,D,99,99,4699,3780,8326,1398,4600,D
1397,M,5057,5057,9756,5468,13794,1398,4699,M
1397,N,453,453,10209,90,13884,1398,9756,N
1397,O,461,461,10670,735,14619,1398,10209,O
1397,P,10900,10900,21570,3780,18399,1398,10670,P
1398,AEI,146,146,146,105,105,1399,0,A
1398,BEI,64,64,210,300,405,1399,146,B
1398,CEI,317,107,317,822,822,1399,0,I
1398,CEJ,837,520,837,921,921,1399,0,E
1398,CFJ,748,121,958,690,1095,1399,210,C
1398,BFJ,244,123,1081,180,1101,1399,837,F
1398,BGJ,799,35,1116,360,1182,1399,317,J
1398,BGK,526,368,1484,390,1485,1399,958,B
1398,CGK,1004,601,2085,930,2031,1399,1081,G
1398,CHK,645,44,2129,750,2235,1399,1484,C
1398,DHK,1030,17,2146,1125,2307,1399,1116,K
1398,DHJ,181,181,2327,80,2387,1399,2146,J
1398,DHK,146,146,2473,120,2507,1399,2327,K
1398,DHL,1569,1181,3654,550,2581,1399,2085,H
1398,DL,4777,3252,6906,3960,6195,1399,2129,D
1398,L,4870,437,7343,550,3057,1399,2473,L
1398,M,266,266,7609,1814,8009,1399,7343,M
1398,N,2287,2287,9896,780,8789,1399,7609,N
1398,O,794,794,10690,2342,11131,1399,9896,O
1398,P,1845,1845,12535,918,12049,1399,10690,P
1399,A,67,67,67,748,748,1400,0,A
1399,B,778,778,845,135,883,1400,67,B
1399,C,219,219,1064,290,1173,1400,845,C
1399,D,176,176,1240,5160,6333,1400,1064,D
1399,M,150,150,1390,194,6527,1400,1240,M
1399,N,184,184,1574,180,6707,1400,1390,N
1399,O,139,139,1713,166,6873,1400,1574,O
1399,P,69,69,1782,379,7252,1400,1713,P
1400,AE,701,701,701,1150,1150,1401,0,A
1400,BE,477,477,1178,90,1240,1401,701,B
1400,CE,196,196,1374,625,1865,1401,1178,C
1400,DE,214,214,1588,3780,5645,1401,1374,D
1400,E,1592,4,1592,1768,1768,1401,0,E
1400,F,208,208,1800,90,1858,1401,1592,F
1400,G,451,451,2251,875,2733,1401,1800,G
1400,H,327,327,2578,3780,6513,1401,2251,H
1400,M,1868,1868,4446,2020,8533,1401,2578,M
1400,N,334,334,4780,240,8773,1401,4446,N
1400,O,715,715,5495,910,9683,1401,4780,O
1400,P,3202,3202,8697,4020,13703,1401,5495,P
1401,AE,693,693,693,1239,1239,1402,0,A
1401,BE,743,743,1436,240,1479,1402,693,B
1401,CE,605,605,2041,725,2204,1402,1436,C
1401,BE,363,363,2404,400,2604,1402,2041,B
1401,CE,3594,1190,3594,3748,3748,1402,0,E
1401,CF,244,244,3838,90,3838,1402,3594,F
1401,CG,434,434,4272,815,4653,1402,3838,G
1401,CF,2180,312,4584,2400,5004,1402,2404,C
1401,DF,1425,1113,5697,1105,5758,1402,4272,F
1401,DG,1326,1326,7023,1850,7608,1402,5697,G
1401,DH,1257,1257,8280,3780,11388,1402,7023,H
1401,D,7440,3744,12024,3060,8064,1402,4584,D
1401,M,239,239,12263,305,11693,1402,12024,M
1401,N,750,750,13013,725,12418,1402,12263,N
1401,O,1010,1010,14023,930,13348,1402,13013,O
1401,P,1389,1389,15412,2760,16108,1402,14023,P
1402,A,2536,2536,2536,2758,2758,1403,0,A
1402,B,479,479,3015,240,2998,1403,2536,B
1402,C,871,871,3886,855,3853,1403,3015,C
1402,B,400,400,4286,470,4323,1403,3886,B
1402,C,150,150,4436,710,5033,1403,4286,C
1402,D,2146,2146,6582,3650,8683,1403,4436,D
1402,M,1497,1497,8079,1473,10156,1403,6582,M
1402,N,92,92,8171,180,10336,1403,8079,N
1402,O,148,148,8319,230,10566,1403,8171,O
1402,N,935,935,9254,810,11376,1403,8319,N
1402,O,358,358,9612,740,12116,1403,9254,O
1402,N,348,348,9960,125,12241,1403,9612,N
1402,O,792,792,10752,1140,13381,1403,9960,O
1402,P,6350,6350,17102,3960,17341,1403,10752,P
1403,AEI,62,62,62,141,141,1404,0,E
1403,AFI,172,172,234,150,291,1404,62,F
1403,AGI,664,664,898,705,996,1404,234,G
1403,AHI,791,791,1689,5820,6816,1404,898,H
1403,AI,2855,1166,2855,2960,2960,1404,0,I
1403,AJ,355,355,3210,300,3260,1404,2855,J
1403,AK,622,622,3832,810,4070,1404,3210,K
1403,AL,5530,1698,5530,5900,5900,1404,0,A
1403,BL,630,630,6160,300,6200,1404,5530,B
1403,CL,984,984,7144,1045,7245,1404,6160,C
1403,BL,3364,52,7196,1560,5630,1404,3832,L
1403,B,714,662,7858,665,7910,1404,7144,B
1403,C,215,215,8073,420,8330,1404,7858,C
1403,D,6102,6102,14175,1560,9890,1404,8073,D
1403,M,1338,1338,15513,1666,11556,1404,14175,M
1403,N,428,428,15941,165,11721,1404,15513,N
1403,O,604,604,16545,555,12276,1404,15941,O
1403,N,1177,1177,17722,1215,13491,1404,16545,N
1403,O,229,229,17951,290,13781,1404,17722,O
1403,P,1336,1336,19287,5190,18971,1404,17951,P
1404,A,312,312,312,1450,1450,1405,0,A
1404,B,1389,1389,1701,240,1690,1405,312,B
1404,C,805,805,2506,1045,2735,1405,1701,C
1404,D,639,639,3145,3960,6695,1405,2506,D
1404,M,1662,1662,4807,2060,8755,1405,3145,M
1404,N,431,431,5238,90,8845,1405,4807,N
1404,O,583,583,5821,850,9695,1405,5238,O
1404,P,638,638,6459,3840,13535,1405,5821,P
1405,AEI,111,111,111,235,235,1406,0,A
1405,BEI,119,8,119,241,241,1406,0,I
1405,BEJ,315,315,434,240,481,1406,119,J
1405,BEK,400,77,511,300,535,1406,111,B
1405,CEK,139,62,573,280,761,1406,434,K
1405,CEL,674,612,1185,795,1330,1406,511,C
1405,DEL,1398,213,1398,1439,1439,1406,0,E
1405,DFL,127,127,1525,150,1589,1406,1398,F
1405,DGL,296,296,1821,280,1869,1406,1525,G
1405,DHL,891,255,2076,1140,2470,1406,1185,D
1405,HL,480,225,2301,5160,7029,1406,1821,H
1405,L,2146,418,2719,5160,5921,1406,573,L
1405,M,793,793,3512,1219,8248,1406,2719,M
1405,N,637,637,4149,240,8488,1406,3512,N
1405,O,127,127,4276,380,8868,1406,4149,O
1405,N,976,976,5252,730,9598,1406,4276,N
1405,O,653,653,5905,810,10408,1406,5252,O
1405,P,1764,1764,7669,3960,14368,1406,5905,P
1406,AE,2083,2083,2083,2227,2227,1407,0,A
1406,BE,300,300,2383,90,2317,1407,2083,B
1406,CE,603,603,2986,795,3112,1407,2383,C
1406,BE,522,522,3508,440,3552,1407,2986,B
1406,CE,4110,602,4110,4453,4453,1407,0,E
1406,CF,680,78,4188,1130,4682,1407,3508,C
1406,DF,368,290,4478,120,4573,1407,4110,F
1406,DG,168,168,4646,390,4963,1407,4478,G
1406,DF,1898,1440,6086,3780,8462,1407,4188,D
1406,F,1498,58,6144,1225,6188,1407,4646,F
1406,G,686,686,6830,820,7008,1407,6144,G
1406,H,177,177,7007,5040,12048,1407,6830,H
1406,M,1382,1382,8389,1617,13665,1407,7007,M
1406,N,427,427,8816,240,13905,1407,8389,N
1406,O,693,693,9509,970,14875,1407,8816,O
1406,N,356,356,9865,140,15015,1407,9509,N
1406,O,1735,1735,11600,2470,17485,1407,9865,O
1406,P,981,981,12581,3960,21445,1407,11600,P
1407,A,449,449,449,420,420,1408,0,A
1407,B,232,232,681,300,720,1408,449,B
1407,C,633,633,1314,820,1540,1408,681,C
1407,D,166,166,1480,3960,5500,1408,1314,D
1407,M,7340,7340,8820,7285,12785,1408,1480,M
1407,N,304,304,9124,365,13150,1408,8820,N
1407,O,849,849,9973,900,14050,1408,9124,O
1407,N,712,712,10685,715,14765,1408,9973,N
1407,O,698,698,11383,780,15545,1408,10685,O
1407,P,4559,4559,15942,4020,19565,1408,11383,P
1408,A,29,29,29,701,701,1409,0,A
1408,B,797,797,826,180,881,1409,29,B
1408,C,166,166,992,230,1111,1409,826,C
1408,B,363,363,1355,295,1406,1409,992,B
1408,C,243,243,1598,205,1611,1409,1355,C
1408,D,5694,5694,7292,4140,5751,1409,1598,D
1408,M,48,48,7340,181,5932,1409,7292,M
1408,N,127,127,7467,240,6172,1409,7340,N
1408,O,822,822,8289,2221,8393,1409,7467,O
1408,N,4206,4206,12495,1175,9568,1409,8289,N
1408,O,591,591,13086,890,10458,1409,12495,O
1408,P,10720,10720,23806,3900,14358,1409,13086,P
1409,AEI,1,1,1,180,180,1410,0,I
1409,AEJ,453,453,454,300,480,1410,1,J
1409,AEK,621,167,621,1078,1078,1410,0,A
1409,BEK,720,553,1174,835,1315,1410,454,K
1409,BEL,653,100,1274,240,1318,1410,621,B
1409,CEL,514,514,1788,785,2103,1410,1274,C
1409,DEL,1052,1052,2840,3960,6063,1410,1788,D
1409,EL,2329,663,3503,3960,5275,1410,1174,L
1409,E,6674,3171,6674,9867,9867,1410,0,E
1409,F,3416,3416,10090,240,10107,1410,6674,F
1409,G,549,549,10639,780,10887,1410,10090,G
1409,H,688,688,11327,3960,14847,1410,10639,H
1409,M,1702,1702,13029,2040,16887,1410,11327,M
1409,N,912,912,13941,610,17497,1410,13029,N
1409,O,276,276,14217,455,17952,1410,13941,O
1409,N,1399,1399,15616,1210,19162,1410,14217,N
1409,O,177,177,15793,2940,22102,1410,15616,O
1409,P,26064,26064,41857,1440,23542,1410,15793,P
1410,A,36,36,36,256,256,1411,0,A
1410,B,298,298,334,135,391,1411,36,B
1410,C,180,180,514,280,671,1411,334,C
1410,D,4010,4010,4524,5160,5831,1411,514,D
1410,M,479,479,5003,1119,6950,1411,4524,M
1410,N,678,678,5681,90,7040,1411,5003,N
1410,O,1059,1059,6740,1310,8350,1411,5681,O
1410,N,449,449,7189,200,8550,1411,6740,N
1410,O,250,250,7439,585,9135,1411,7189,O
1410,P,2410,2410,9849,3780,12915,1411,7439,P
1411,A,3113,3113,3113,3039,3039,1412,0,A
1411,B,1643,1643,4756,300,3339,1412,3113,B
1411,C,560,560,5316,720,4059,1412,4756,C
1411,D,13545,13545,18861,3960,8019,1412,5316,D
1411,M,1824,1824,20685,3065,11084,1412,18861,M
1411,N,1645,1645,22330,420,11504,1412,20685,N
1411,O,1103,1103,23433,2265,13769,1412,22330,O
1411,P,467,467,23900,1680,15449,1412,23433,P
1412,AEI,67,67,67,1468,1468,1413,0,I
1412,AEJ,447,380,447,1825,1825,1413,0,A
1412,BEJ,1437,990,1437,1719,1719,1413,0,E
1412,BFJ,1466,96,1533,90,1558,1413,67,J
1412,BFK,326,230,1763,90,1809,1413,1437,F
1412,BGK,1576,260,2023,240,2065,1413,447,B
1412,CGK,867,867,2890,1055,3120,1413,2023,C
1412,DGK,1428,71,2961,1745,3303,1413,1533,K
1412,DGL,59,59,3020,3840,7143,1413,2961,L
1412,DG,1453,196,3216,1780,3589,1413,1763,G
1412,DH,90,90,3306,3780,7369,1413,3216,H
1412,D,527,111,3417,3960,7080,1413,2890,D
1412,M,2205,2205,5622,2689,10058,1413,3417,M
1412,N,526,526,6148,90,10148,1413,5622,N
1412,O,178,178,6326,585,10733,1413,6148,O
1412,P,4352,4352,10678,3780,14513,1413,6326,P
1413,AEI,15,15,15,160,160,1414,0,A
1413,BEI,122,107,122,1938,1938,1414,0,E
1413,BFI,586,479,601,300,460,1414,15,B
1413,CFI,756,756,1357,910,1370,1414,601,C
1413,DFI,1670,313,1670,1840,1840,1414,0,I
1413,DFJ,451,451,2121,300,2140,1414,1670,J
1413,DFK,2103,104,2225,240,2178,1414,122,F
1413,DGK,1097,229,2454,3960,5330,1414,1357,D
1413,GK,629,296,2750,745,2885,1414,2121,K
1413,GL,20,20,2770,1560,4445,1414,2750,L
1413,G,680,135,2905,1075,3253,1414,2225,G
1413,H,1450,1450,4355,3960,7213,1414,2905,H
1413,M,289,289,4644,245,7458,1414,4355,M
1413,N,217,217,4861,300,7758,1414,4644,N
1413,O,663,663,5524,840,8598,1414,4861,O
1413,P,4971,4971,10495,1140,9738,1414,5524,P
1414,AEI,46,46,46,1580,1580,1415,0,E
1414,AFI,179,133,179,864,864,1415,0,A
1414,BFI,722,722,901,90,954,1415,179,B
1414,CFI,353,353,1254,705,1659,1415,901,C
1414,DFI,7,7,1261,3840,5499,1415,1254,D
1414,FI,1732,517,1778,240,1820,1415,46,F
1414,GI,905,905,2683,945,2765,1415,1778,G
1414,HI,4478,1795,4478,4738,4738,1415,0,I
1414,HJ,2018,223,4701,5160,7925,1415,2683,H
1414,J,293,70,4771,90,4828,1415,4478,J
1414,K,369,369,5140,705,5533,1415,4771,K
1414,L,2721,2721,7861,3780,9313,1415,5140,L
1414,M,1149,1149,9010,1295,10608,1415,7861,M
1414,N,352,352,9362,240,10848,1415,9010,N
1414,O,1087,1087,10449,1195,12043,1415,9362,O
1414,P,803,803,11252,3960,16003,1415,10449,P
1415,AEI,128,128,128,129,129,1416,0,I
1415,AEJ,142,142,270,180,309,1416,128,J
1415,AEK,145,145,415,220,529,1416,270,K
1415,AEL,449,34,449,660,660,1416,0,E
1415,AFL,312,312,761,150,810,1416,449,F
1415,AGL,768,422,1183,4140,4669,1416,415,L
1415,AG,592,170,1353,500,1310,1416,761,G
1415,AH,1447,94,1447,1534,1534,1416,0,A
1415,BH,166,166,1613,150,1684,1416,1447,B
1415,CH,582,582,2195,615,2299,1416,1613,C
1415,DH,1422,580,2775,4200,5510,1416,1353,H
1415,D,1883,1303,4078,4200,6499,1416,2195,D
1415,M,105,105,4183,124,6623,1416,4078,M
1415,N,225,225,4408,240,6863,1416,4183,N
1415,O,905,905,5313,1200,8063,1416,4408,O
1415,P,177,177,5490,3960,12023,1416,5313,P
1416,AEI,1,1,1,323,323,1417,0,E
1416,AFI,286,285,286,713,713,1417,0,I
1416,AFJ,458,173,459,150,473,1417,1,F
1416,AGJ,819,360,819,925,925,1417,0,A
1416,BGJ,304,304,1123,180,1105,1417,819,B
1416,CGJ,763,99,1222,1035,1508,1417,459,G
1416,CFJ,1174,238,1460,785,1498,1417,286,J
1416,CFK,469,469,1929,1305,2803,1417,1460,K
1416,CFL,997,191,2120,880,1985,1417,1123,C
1416,DFL,1134,236,2356,810,2318,1417,1222,F
1416,DGL,798,371,2727,410,3213,1417,1929,L
1416,DG,545,174,2901,570,2888,1417,2356,G
1416,DH,740,740,3641,4230,7118,1417,2901,H
1416,D,2421,900,4541,6660,8645,1417,2120,D
1416,M,684,684,5225,2141,10786,1417,4541,M
1416,N,1486,1486,6711,90,10876,1417,5225,N
1416,O,532,532,7243,820,11696,1417,6711,O
1416,N,774,774,8017,475,12171,1417,7243,N
1416,O,1222,1222,9239,1405,13576,1417,8017,O
1416,P,306,306,9545,3780,17356,1417,9239,P
1417,A,761,761,761,1084,1084,1418,0,A
1417,B,378,378,1139,90,1174,1418,761,B
1417,C,899,899,2038,1250,2424,1418,1139,C
1417,D,3,3,2041,3780,6204,1418,2038,D
1417,M,625,625,2666,1281,7485,1418,2041,M
1417,N,697,697,3363,90,7575,1418,2666,N
1417,O,563,563,3926,935,8510,1418,3363,O
1417,P,414,414,4340,3780,12290,1418,3926,P
1418,A,5405,5405,5405,4205,4205,1419,0,A
1418,B,165,165,5570,1420,5625,1419,5405,B
1418,C,300,300,5870,485,6110,1419,5570,C
1418,B,526,526,6396,300,6410,1419,5870,B
1418,C,656,656,7052,755,7165,1419,6396,C
1418,D,1419,1419,8471,1140,8305,1419,7052,D
1418,M,2056,2056,10527,4072,12377,1419,8471,M
1418,N,2279,2279,12806,300,12677,1419,10527,N
1418,O,609,609,13415,760,13437,1419,12806,O
1418,P,1628,1628,15043,4080,17517,1419,13415,P
1419,A,96,96,96,250,250,1420,0,A
1419,B,274,274,370,180,430,1420,96,B
1419,C,380,380,750,660,1090,1420,370,C
1419,D,3204,3204,3954,3960,5050,1420,750,D
1419,M,72,72,4026,159,5209,1420,3954,M
1419,N,183,183,4209,150,5359,1420,4026,N
1419,O,616,616,4825,660,6019,1420,4209,O
1419,P,24473,24473,29298,2880,8899,1420,4825,P
1420,A,503,503,503,696,696,1421,0,A
1420,B,247,247,750,120,816,1421,503,B
1420,C,407,407,1157,865,1681,1421,750,C
1420,D,177,177,1334,3360,5041,1421,1157,D
1420,M,7422,7422,8756,8144,13185,1421,1334,M
1420,N,954,954,9710,240,13425,1421,8756,N
1420,O,1388,1388,11098,3050,16475,1421,9710,O
1420,P,1610,1610,12708,2400,18875,1421,11098,P
1421,AE,2676,2676,2676,3276,3276,1422,0,A
1421,BE,2697,21,2697,3449,3449,1422,0,E
1421,BF,632,611,3308,90,3366,1422,2676,B
1421,CF,198,198,3506,720,4086,1422,3308,C
1421,DF,1952,1143,4649,1260,4709,1422,2697,F
1421,DG,987,987,5636,400,5109,1422,4649,G
1421,DH,4900,2770,8406,3780,7866,1422,3506,D
1421,H,5204,2434,10840,425,5534,1422,5636,H
1421,M,130,130,10970,350,8216,1422,10840,M
1421,N,343,343,11313,90,8306,1422,10970,N
1421,O,593,593,11906,1010,9316,1422,11313,O
1421,P,92,92,11998,3780,13096,1422,11906,P
1422,AEI,60,60,60,55,55,1423,0,E
1422,AFI,80,20,80,100,100,1423,0,A
1422,BFI,114,94,174,155,210,1423,60,F
1422,BGI,70,70,244,90,300,1423,174,G
1422,BHI,8,8,252,2880,3180,1423,244,H
1422,BI,204,32,284,240,340,1423,80,B
1422,CI,623,339,623,1603,1603,1423,0,I
1422,CJ,678,339,962,765,1105,1423,284,C
1422,DJ,5,5,967,3600,4705,1423,962,D
1422,J,1100,756,1723,180,1783,1423,623,J
1422,K,1127,1127,2850,1140,2923,1423,1723,K
1422,J,1638,1638,4488,1660,4583,1423,2850,J
1422,K,2574,2574,7062,2360,6943,1423,4488,K
1422,L,80,80,7142,5160,12103,1423,7062,L
1422,M,708,708,7850,1123,13226,1423,7142,M
1422,N,514,514,8364,150,13376,1423,7850,N
1422,O,243,243,8607,140,13516,1423,8364,O
1422,N,1680,1680,10287,1780,15296,1423,8607,N
1422,O,896,896,11183,815,16111,1423,10287,O
1422,P,457,457,11640,3840,19951,1423,11183,P
1423,AEI,296,296,296,366,366,1424,0,I
1423,AEJ,189,189,485,150,516,1424,296,J
1423,AEK,709,224,709,1352,1352,1424,0,E
1423,AFK,456,232,941,470,986,1424,485,K
1423,AFL,214,214,1155,4230,5216,1424,941,L
1423,AF,1416,261,1416,1522,1522,1424,0,A
1423,BF,892,185,1601,300,1652,1424,709,F
1423,BG,332,147,1748,240,1762,1424,1416,B
1423,CG,895,748,2496,1050,2702,1424,1601,G
1423,CH,889,141,2637,855,2617,1424,1748,C
1423,DH,1204,1063,3700,3960,6662,1424,2496,H
1423,D,1157,94,3794,3960,6577,1424,2637,D
1423,M,95,95,3889,1214,7876,1424,3794,M
1423,N,1311,1311,5200,240,8116,1424,3889,N
1423,O,806,806,6006,970,9086,1424,5200,O
1423,P,48,48,6054,3960,13046,1424,6006,P
1424,A,97,97,97,665,665,1425,0,A
1424,B,822,822,919,300,965,1425,97,B
1424,C,871,871,1790,925,1890,1425,919,C
1424,D,66,66,1856,2760,4650,1425,1790,D
1424,M,145,145,2001,1077,5727,1425,1856,M
1424,N,1052,1052,3053,180,5907,1425,2001,N
1424,O,791,791,3844,1050,6957,1425,3053,O
1424,N,1021,1021,4865,755,7712,1425,3844,N
1424,O,714,714,5579,760,8472,1425,4865,O
1424,P,5464,5464,11043,5160,13632,1425,5579,P
1425,AE,28,28,28,603,603,1426,0,E
1425,AF,262,234,262,638,638,1426,0,A
1425,BF,438,438,700,90,728,1426,262,B
1425,CF,675,3,703,150,753,1426,28,F
1425,CG,174,174,877,110,863,1426,703,G
1425,CF,812,635,1512,1035,1763,1426,700,C
1425,DF,728,93,1605,790,1653,1426,877,F
1425,DG,852,852,2457,775,2428,1426,1605,G
1425,DH,320,320,2777,4230,6658,1426,2457,H
1425,D,1372,107,2884,3780,5543,1426,1512,D
1425,M,780,780,3664,1375,8033,1426,2884,M
1425,N,631,631,4295,90,8123,1426,3664,N
1425,O,649,649,4944,850,8973,1426,4295,O
1425,P,4119,4119,9063,3780,12753,1426,4944,P
1426,AEI,207,207,207,759,759,1427,0,A
1426,BEI,777,570,777,1054,1054,1427,0,I
1426,BEJ,653,83,860,150,909,1427,207,B
1426,CEJ,196,196,1056,400,1309,1427,860,C
1426,BEJ,1232,176,1232,1224,1224,1427,0,E
1426,BFJ,555,100,1332,300,1354,1427,777,J
1426,BFK,110,10,1342,180,1404,1427,1232,F
1426,BGK,283,283,1625,335,1739,1427,1342,G
1426,BFK,923,630,2255,830,2184,1427,1332,K
1426,BFL,1137,507,2762,1065,2804,1427,1625,F
1426,BGL,1952,246,3008,1470,2779,1427,1056,B
1426,CGL,576,330,3338,540,3344,1427,2762,G
1426,CFL,76,76,3414,130,3474,1427,3338,F
1426,CGL,494,88,3502,515,3294,1427,3008,C
1426,DGL,2214,967,4469,3960,6144,1427,2255,L
1426,DG,1063,8,4477,1200,4674,1427,3414,G
1426,DH,1612,1612,6089,5160,9834,1427,4477,H
1426,D,5108,2521,8610,4230,7524,1427,3502,D
1426,M,2932,2932,11542,3137,12971,1427,8610,M
1426,N,1801,1801,13343,1560,14531,1427,11542,N
1426,O,817,817,14160,840,15371,1427,13343,O
1426,P,369,369,14529,550,15921,1427,14160,P
1427,A,212,212,212,1354,1354,1428,0,A
1427,B,1175,1175,1387,90,1444,1428,212,B
1427,C,994,994,2381,1220,2664,1428,1387,C
1427,D,77,77,2458,3780,6444,1428,2381,D
1427,M,1360,1360,3818,1705,8149,1428,2458,M
1427,N,385,385,4203,90,8239,1428,3818,N
1427,O,490,490,4693,705,8944,1428,4203,O
1427,P,410,410,5103,3780,12724,1428,4693,P
1428,A,35,35,35,115,115,1429,0,A
1428,B,261,261,296,240,355,1429,35,B
1428,C,213,213,509,195,550,1429,296,C
1428,D,504,504,1013,5220,5770,1429,509,D
1428,M,6587,6587,7600,6931,12701,1429,1013,M
1428,N,649,649,8249,90,12791,1429,7600,N
1428,O,1254,1254,9503,1385,14176,1429,8249,O
1428,N,339,339,9842,485,14661,1429,9503,N
1428,O,174,174,10016,585,15246,1429,9842,O
1428,P,3698,3698,13714,3780,19026,1429,10016,P
1429,A,2403,2403,2403,3515,3515,1430,0,A
1429,B,1142,1142,3545,90,3605,1430,2403,B
1429,C,544,544,4089,805,4410,1430,3545,C
1429,B,417,417,4506,150,4560,1430,4089,B
1429,C,193,193,4699,535,5095,1430,4506,C
1429,D,720,720,5419,3780,8875,1430,4699,D
1429,M,436,436,5855,483,9358,1430,5419,M
1429,N,290,290,6145,300,9658,1430,5855,N
1429,O,962,962,7107,965,10623,1430,6145,O
1429,P,2168,2168,9275,550,11173,1430,7107,P
1430,AE,1367,1367,1367,1448,1448,1431,0,E
1430,AF,1438,71,1438,1639,1639,1431,0,A
1430,BF,318,318,1756,180,1819,1431,1438,B
1430,CF,149,149,1905,610,2429,1431,1756,C
1430,DF,731,193,2098,710,2158,1431,1367,F
1430,DG,659,466,2564,2880,5309,1431,1905,D
1430,G,803,337,2901,1095,3253,1431,2098,G
1430,F,936,936,3837,650,3903,1431,2901,F
1430,G,2475,2475,6312,2603,6506,1431,3837,G
1430,H,1577,1577,7889,402,6908,1431,6312,H
1430,M,151,151,8040,185,7093,1431,7889,M
1430,N,120,120,8160,150,7243,1431,8040,N
1430,O,129,129,8289,125,7368,1431,8160,O
1430,P,1106,1106,9395,4200,11568,1431,8289,P
1431,AEI,39,39,39,360,360,1432,0,I
1431,AEJ,70,31,70,753,753,1432,0,E
1431,AFJ,320,250,320,347,347,1432,0,A
1431,BFJ,398,117,437,135,495,1432,39,J
1431,BFK,135,18,455,135,482,1432,320,B
1431,CFK,175,175,630,295,777,1432,455,C
1431,DFK,217,24,654,295,790,1432,437,K
1431,DFL,69,69,723,5100,5890,1432,654,L
1431,DF,114,21,744,5100,5877,1432,630,D
1431,F,760,86,830,135,888,1432,70,F
1431,G,200,200,1030,300,1188,1432,830,G
1431,H,125,125,1155,5100,6288,1432,1030,H
1431,M,510,510,1665,1093,7381,1432,1155,M
1431,N,904,904,2569,180,7561,1432,1665,N
1431,O,631,631,3200,895,8456,1432,2569,O
1431,N,828,828,4028,315,8771,1432,3200,N
1431,O,1287,1287,5315,360,9131,1432,4028,O
1431,P,11867,11867,17182,7020,16151,1432,5315,P
1432,AEI,524,524,524,1519,1519,1433,0,A
1432,BEI,1037,1037,1561,90,1609,1433,524,B
1432,CEI,1042,1042,2603,1200,2809,1433,1561,C
1432,DEI,297,297,2900,3780,6589,1433,2603,D
1432,EI,4060,1160,4060,4219,4219,1433,0,E
1432,FI,183,183,4243,90,4309,1433,4060,F
1432,GI,722,722,4965,1105,5414,1433,4243,G
1432,HI,421,421,5386,3780,9194,1433,4965,H
1432,I,22122,16736,22122,22841,22841,1433,0,I
1432,J,2147,2147,24269,90,22931,1433,22122,J
1432,K,1082,1082,25351,1340,24271,1433,24269,K
1432,L,205,205,25556,3780,28051,1433,25351,L
1432,M,1775,1775,27331,2523,30574,1433,25556,M
1432,N,781,781,28112,90,30664,1433,27331,N
1432,O,246,246,28358,695,31359,1433,28112,O
1432,P,20398,20398,48756,3840,35199,1433,28358,P
1433,A,3586,3586,3586,4003,4003,1434,0,A
1433,B,519,519,4105,150,4153,1434,3586,B
1433,C,196,196,4301,120,4273,1434,4105,C
1433,B,1529,1529,5830,1585,5858,1434,4301,B
1433,C,329,329,6159,645,6503,1434,5830,C
1433,D,3296,3296,9455,4230,10733,1434,6159,D
1433,M,1500,1500,10955,1560,12293,1434,9455,M
1433,N,161,161,11116,150,12443,1434,10955,N
1433,O,561,561,11677,585,13028,1434,11116,O
1433,N,412,412,12089,385,13413,1434,11677,N
1433,O,382,382,12471,700,14113,1434,12089,O
1433,P,45526,45526,57997,3960,18073,1434,12471,P
1434,A,169,169,169,330,330,1435,0,A
1434,B,266,266,435,180,510,1435,169,B
1434,C,395,395,830,660,1170,1435,435,C
1434,D,399,399,1229,3960,5130,1435,830,D
1434,M,104,104,1333,235,5365,1435,1229,M
1434,N,224,224,1557,150,5515,1435,1333,N
1434,O,655,655,2212,660,6175,1435,1557,O
1434,P,1312,1312,3524,2880,9055,1435,2212,P
1435,AE,17,17,17,75,75,1436,0,E
1435,AF,142,125,142,195,195,1436,0,A
1435,BF,318,193,335,300,375,1436,17,F
1435,BG,384,191,526,300,495,1436,142,B
1435,CG,703,512,1038,800,1175,1436,335,G
1435,CH,724,212,1250,795,1290,1436,526,C
1435,DH,870,658,1908,1140,2315,1436,1038,H
1435,D,662,4,1912,1140,2430,1436,1250,D
1435,M,8740,8740,10652,9118,11548,1436,1912,M
1435,N,507,507,11159,180,11728,1436,10652,N
1435,O,772,772,11931,885,12613,1436,11159,O
1435,N,584,584,12515,405,13018,1436,11931,N
1435,O,494,494,13009,565,13583,1436,12515,O
1435,P,1502,1502,14511,6960,20543,1436,13009,P
1436,AEI,11,11,11,1279,1279,1437,0,E
1436,AFI,1358,1358,1369,120,1399,1437,11,F
1436,AGI,254,254,1623,420,1819,1437,1369,G
1436,AFI,624,624,2247,495,2314,1437,1623,F
1436,AGI,2512,265,2512,4891,4891,1437,0,I
1436,AGJ,690,425,2937,810,3124,1437,2247,G
1436,AHJ,4086,1149,4086,4351,4351,1437,0,A
1436,BHJ,440,440,4526,180,4531,1437,4086,B
1436,CHJ,1806,217,4743,5040,8164,1437,2937,H
1436,CJ,655,438,5181,855,5386,1437,4526,C
1436,BJ,2754,85,5266,420,5311,1437,2512,J
1436,BK,623,538,5804,455,5841,1437,5181,B
1436,CK,781,243,6047,1046,6357,1437,5266,K
1436,CL,586,343,6390,755,6596,1437,5804,C
1436,DL,242,242,6632,1140,7736,1437,6390,D
1436,L,2881,2296,8928,1049,7406,1437,6047,L
1436,M,387,387,9315,688,8852,1437,8928,M
1436,N,488,488,9803,240,9092,1437,9315,N
1436,O,947,947,10750,970,10062,1437,9803,O
1436,N,759,759,11509,750,10812,1437,10750,N
1436,O,343,343,11852,660,11472,1437,11509,O
1436,P,5757,5757,17609,3960,15432,1437,11852,P
1437,A,581,581,581,1418,1418,1438,0,A
1437,B,1101,1101,1682,240,1658,1438,581,B
1437,C,936,936,2618,1040,2698,1438,1682,C
1437,B,215,215,2833,720,3418,1438,2618,B
1437,C,726,726,3559,90,3508,1438,2833,C
1437,D,1243,1243,4802,3960,7468,1438,3559,D
1437,M,2231,2231,7033,2452,9920,1438,4802,M
1437,N,368,368,7401,90,10010,1438,7033,N
1437,O,1182,1182,8583,1385,11395,1438,7401,O
1437,N,436,436,9019,330,11725,1438,8583,N
1437,O,460,460,9479,790,12515,1438,9019,O
1437,P,1799,1799,11278,3780,16295,1438,9479,P
1438,AE,53,53,53,160,160,1439,0,A
1438,BE,273,220,273,987,987,1439,0,E
1438,BF,286,66,339,240,400,1439,53,B
1438,CF,442,442,781,285,685,1439,339,C
1438,DF,804,296,1077,150,1137,1439,273,F
1438,DG,170,170,1247,540,1677,1439,1077,G
1438,DH,173,173,1420,720,2397,1439,1247,H
1438,D,1311,672,2092,5160,5845,1439,781,D
1438,M,843,843,2935,2987,8832,1439,2092,M
1438,N,2272,2272,5207,180,9012,1439,2935,N
1438,O,916,916,6123,885,9897,1439,5207,O
1438,N,356,356,6479,395,10292,1439,6123,N
1438,O,664,664,7143,665,10957,1439,6479,O
1438,P,3502,3502,10645,5460,16417,1439,7143,P
1439,AEI,139,139,139,918,918,1440,0,E
1439,AFI,251,112,251,1003,1003,1440,0,A
1439,BFI,959,847,1098,240,1158,1440,139,F
1439,BGI,954,107,1205,240,1243,1440,251,B
1439,CGI,1835,630,1835,2538,2538,1440,0,I
1439,CGJ,801,64,1899,995,2153,1440,1098,G
1439,CHJ,821,127,2026,1020,2263,1440,1205,C
1439,DHJ,747,556,2582,90,2628,1440,1835,J
1439,DHK,398,398,2980,795,3423,1440,2582,K
1439,DHL,1477,396,3376,4680,6833,1440,1899,H
1439,DL,1585,235,3611,4680,6943,1440,2026,D
1439,L,1682,1051,4662,3780,7203,1440,2980,L
1439,M,1120,1120,5782,1600,8803,1440,4662,M
1439,N,744,744,6526,300,9103,1440,5782,N
1439,O,803,803,7329,1045,10148,1440,6526,O
1439,P,233,233,7562,1140,11288,1440,7329,P
1440,AE,316,316,316,1036,1036,1441,0,A
1440,BE,835,835,1151,150,1186,1441,316,B
1440,CE,1257,106,1257,1361,1361,1441,0,E
1440,CF,174,68,1325,155,1341,1441,1151,C
1440,DF,295,227,1552,240,1601,1441,1257,F
1440,DG,327,100,1652,4200,5541,1441,1325,D
1440,G,657,557,2209,910,2511,1441,1552,G
1440,H,2736,2736,4945,3900,6411,1441,2209,H
1440,M,2,2,4947,125,6536,1441,4945,M
1440,N,345,345,5292,240,6776,1441,4947,N
1440,O,714,714,6006,965,7741,1441,5292,O
1440,P,81,81,6087,3960,11701,1441,6006,P
1441,AEI,364,364,364,926,926,1442,0,A
1441,BEI,875,875,1239,360,1286,1442,364,B
1441,CEI,140,140,1379,355,1641,1442,1239,C
1441,BEI,1581,202,1581,1631,1631,1442,0,E
1441,BFI,259,259,1840,250,1881,1442,1581,F
1441,BGI,944,483,2323,740,2381,1442,1379,B
1441,CGI,1044,561,2884,1265,3146,1442,1840,G
1441,CFI,787,226,3110,5001,7382,1442,2323,C
1441,DFI,3573,463,3573,5435,5435,1442,0,I
1441,DFJ,1946,1257,4830,1725,4871,1442,2884,F
1441,DGJ,2207,487,5317,2034,9416,1442,3110,D
1441,GJ,794,307,5624,2342,7213,1442,4830,G
1441,HJ,2241,190,5814,420,5855,1442,3573,J
1441,HK,788,788,6602,2049,7904,1442,5814,K
1441,HL,1845,867,7469,918,8131,1442,5624,H
1441,L,1274,407,7876,846,8750,1442,6602,L
1441,M,228,228,8104,222,9638,1442,7876,M
1441,N,669,669,8773,780,10418,1442,8104,N
1441,O,224,224,8997,170,10588,1442,8773,O
1441,N,701,701,9698,710,11298,1442,8997,N
1441,O,2349,2349,12047,2268,13566,1442,9698,O
1441,P,1,1,12048,762,14328,1442,12047,P
1442,A,2665,2665,2665,2589,2589,1443,0,A
1442,B,175,175,2840,300,2889,1443,2665,B
1442,C,741,741,3581,970,3859,1443,2840,C
1442,D,1087,1087,4668,3960,7819,1443,3581,D
1442,M,4,4,4672,276,8095,1443,4668,M
1442,N,490,490,5162,240,8335,1443,4672,N
1442,O,490,490,5652,780,9115,1443,5162,O
1442,P,780,780,6432,3960,13075,1443,5652,P
1443,A,3158,3158,3158,3868,3868,1444,0,A
1443,B,985,985,4143,180,4048,1444,3158,B
1443,C,953,953,5096,910,4958,1444,4143,C
1443,D,1092,1092,6188,550,5508,1444,5096,D
1443,M,266,266,6454,1483,6991,1444,6188,M
1443,N,1337,1337,7791,180,7171,1444,6454,N
1443,O,629,629,8420,830,8001,1444,7791,O
1443,N,511,511,8931,310,8311,1444,8420,N
1443,O,479,479,9410,360,8671,1444,8931,O
1443,P,12757,12757,22167,7020,15691,1444,9410,P
1444,A,15,15,15,268,268,1445,0,A
1444,B,450,450,465,240,508,1445,15,B
1444,C,731,731,1196,1045,1553,1445,465,C
1444,D,3626,3626,4822,3960,5513,1445,1196,D
1444,M,1,1,4823,77,5590,1445,4822,M
1444,N,285,285,5108,240,5830,1445,4823,N
1444,O,829,829,5937,1135,6965,1445,5108,O
1444,P,1273,1273,7210,3960,10925,1445,5937,P
1445,A,775,775,775,1460,1460,1446,0,A
1445,B,805,805,1580,180,1640,1446,775,B
1445,C,737,737,2317,795,2435,1446,1580,C
1445,D,849,849,3166,550,2985,1446,2317,D
1445,M,2452,2452,5618,7306,10291,1446,3166,M
1445,N,4884,4884,10502,90,10381,1446,5618,N
1445,O,811,811,11313,1215,11596,1446,10502,O
1445,N,869,869,12182,455,12051,1446,11313,N
1445,O,733,733,12915,1080,13131,1446,12182,O
1445,P,132,132,13047,3780,16911,1446,12915,P
1446,AEI,800,800,800,3010,3010,1447,0,A
1446,BEI,1538,738,1538,1651,1651,1447,0,E
1446,BFI,242,242,1780,150,1801,1447,1538,F
1446,BGI,2107,327,2107,2290,2290,1447,0,I
1446,BGJ,612,285,2392,585,2386,1447,1780,G
1446,BFJ,287,2,2394,150,2440,1447,2107,J
1446,BFK,161,159,2553,205,2591,1447,2392,F
1446,BGK,228,69,2622,160,2600,1447,2394,K
1446,BGJ,137,68,2690,135,2726,1447,2553,G
1446,BHJ,2295,405,3095,150,3160,1447,800,B
1446,CHJ,96,96,3191,80,3240,1447,3095,C
1446,DHJ,626,57,3248,695,3295,1447,2622,J
1446,DHK,93,93,3341,625,3920,1447,3248,K
1446,DHL,1382,731,4072,4230,6956,1447,2690,H
1446,DL,955,224,4296,3740,7660,1447,3341,L
1446,D,7388,6283,10579,2880,6120,1447,3191,D
1446,M,293,293,10872,291,7951,1447,10579,M
1446,N,121,121,10993,150,8101,1447,10872,N
1446,O,169,169,11162,140,8241,1447,10993,O
1446,N,871,871,12033,905,9146,1447,11162,N
1446,O,716,716,12749,665,9811,1447,12033,O
1446,P,11448,11448,24197,4230,14041,1447,12749,P
1447,AE,128,128,128,123,123,1448,0,E
1447,AF,115,115,243,180,303,1448,128,F
1447,AG,408,165,408,1037,1037,1448,0,A
1447,BG,294,129,537,335,638,1448,243,G
1447,BF,826,697,1234,240,1277,1448,408,B
1447,CF,509,509,1743,775,2052,1448,1234,C
1447,DF,1394,188,1931,1345,1983,1448,537,F
1447,DG,585,585,2516,620,2603,1448,1931,G
1447,DH,1850,1077,3593,3960,6012,1448,1743,D
1447,H,5674,4597,8190,6300,8903,1448,2516,H
1447,M,261,261,8451,224,9127,1448,8190,M
1447,N,203,203,8654,300,9427,1448,8451,N
1447,O,555,555,9209,690,10117,1448,8654,O
1447,N,541,541,9750,390,10507,1448,9209,N
1447,O,582,582,10332,720,11227,1448,9750,O
1447,P,4452,4452,14784,3960,15187,1448,10332,P
1448,A,21,21,21,50,50,1449,0,A
1448,B,114,114,135,135,185,1449,21,B
1448,C,228,228,363,295,480,1449,135,C
1448,D,168,168,531,5160,5640,1449,363,D
1448,M,316,316,847,435,6075,1449,531,M
1448,N,239,239,1086,180,6255,1449,847,N
1448,O,181,181,1267,140,6395,1449,1086,O
1448,P,1474,1474,2741,2880,9275,1449,1267,P
1449,AEI,132,132,132,119,119,1450,0,A
1449,BEI,152,20,152,323,323,1450,0,E
1449,BFI,118,98,250,180,299,1450,132,B
1449,CFI,193,95,345,240,563,1450,152,F
1449,CGI,133,38,383,230,529,1450,250,C
1449,BGI,428,45,428,691,691,1450,0,I
1449,BGJ,343,343,771,140,831,1450,428,J
1449,BGK,763,375,1146,665,1194,1450,383,B
1449,CGK,955,580,1726,960,1791,1450,771,K
1449,CGJ,677,677,2403,665,2456,1450,1726,J
1449,CGK,1265,8,2411,1305,2499,1450,1146,C
1449,DGK,2827,761,3172,2400,2963,1450,345,G
1449,DFK,783,14,3186,920,3376,1450,2403,K
1449,DFL,232,218,3404,500,3463,1450,3172,F
1449,DGL,751,751,4155,1060,4523,1450,3404,G
1449,DHL,2697,1728,5883,1175,4551,1450,3186,L
1449,DH,2976,1248,7131,3840,8363,1450,4155,H
1449,D,5898,1178,8309,3670,6169,1450,2411,D
1449,M,2,2,8311,1280,9643,1450,8309,M
1449,N,1578,1578,9889,360,10003,1450,8311,N
1449,O,725,725,10614,695,10698,1450,9889,O
1449,P,4390,4390,15004,550,11248,1450,10614,P
1450,A,1905,1905,1905,5347,5347,1451,0,A
1450,B,3446,3446,5351,90,5437,1451,1905,B
1450,C,689,689,6040,1015,6452,1451,5351,C
1450,D,15698,15698,21738,3780,10232,1451,6040,D
1450,M,1979,1979,23717,2160,12392,1451,21738,M
1450,N,481,481,24198,360,12752,1451,23717,N
1450,O,699,699,24897,655,13407,1451,24198,O
1450,P,634,634,25531,550,13957,1451,24897,P
1451,AEI,44,44,44,220,220,1452,0,E
1451,AFI,74,30,74,151,151,1452,0,A
1451,BFI,168,168,242,135,286,1452,74,B
1451,CFI,318,76,318,1149,1149,1452,0,I
1451,CFJ,380,106,424,240,460,1452,44,F
1451,CGJ,257,75,499,215,501,1452,242,C
1451,DGJ,15,15,514,4890,5391,1452,499,D
1451,GJ,146,56,570,215,675,1452,424,G
1451,HJ,288,288,858,4890,5565,1452,570,H
1451,J,1051,511,1369,240,1389,1452,318,J
1451,K,826,826,2195,1030,2419,1452,1369,K
1451,L,1052,1052,3247,3960,6379,1452,2195,L
1451,M,281,281,3528,595,6974,1452,3247,M
1451,N,534,534,4062,240,7214,1452,3528,N
1451,O,693,693,4755,905,8119,1452,4062,O
1451,P,2553,2553,7308,3960,12079,1452,4755,P
1452,AEI,10241,10241,10241,10255,10255,1453,0,I
1452,AEJ,294,294,10535,300,10555,1453,10241,J
1452,AEK,567,567,11102,735,11290,1453,10535,K
1452,AEL,73,73,11175,1560,12850,1453,11102,L
1452,AE,13456,2281,13456,13479,13479,1453,0,E
1452,AF,286,286,13742,300,13779,1453,13456,F
1452,AG,581,581,14323,740,14519,1453,13742,G
1452,AH,14416,93,14416,14854,14854,1453,0,A
1452,BH,271,178,14594,1560,16079,1453,14323,H
1452,B,696,518,15112,300,15154,1453,14416,B
1452,C,601,601,15713,735,15889,1453,15112,C
1452,D,176,176,15889,1560,17449,1453,15713,D
1452,M,1545,1545,17434,1760,19209,1453,15889,M
1452,N,461,461,17895,300,19509,1453,17434,N
1452,O,792,792,18687,850,20359,1453,17895,O
1452,N,267,267,18954,200,20559,1453,18687,N
1452,O,175,175,19129,380,20939,1453,18954,O
1452,P,6855,6855,25984,4020,24959,1453,19129,P
1453,AEI,250,250,250,839,839,1454,0,I
1453,AEJ,617,367,617,1131,1131,1454,0,A
1453,BEJ,785,418,1035,150,989,1454,250,J
1453,BEK,544,126,1161,90,1221,1454,617,B
1453,CEK,176,50,1211,140,1129,1454,1035,K
1453,CEJ,1557,346,1557,1852,1852,1454,0,E
1453,CFJ,665,319,1876,740,1869,1454,1211,J
1453,CFK,321,2,1878,90,1942,1454,1557,F
1453,CGK,1039,322,2200,1250,2471,1454,1161,C
1453,DGK,3,3,2203,3780,6251,1454,2200,D
1453,GK,534,209,2412,905,2847,1454,1878,G
1453,HK,158,158,2570,3780,6627,1454,2412,H
1453,K,876,182,2752,765,2634,1454,1876,K
1453,L,45,45,2797,4230,6864,1454,2752,L
1453,M,2421,2421,5218,5039,11903,1454,2797,M
1453,N,2660,2660,7878,90,11993,1454,5218,N
1453,O,204,204,8082,630,12623,1454,7878,O
1453,P,4339,4339,12421,3780,16403,1454,8082,P
1454,A,12073,12073,12073,13108,13108,1455,0,A
1454,B,1065,1065,13138,90,13198,1455,12073,B
1454,C,417,417,13555,690,13888,1455,13138,C
1454,B,1635,1635,15190,1345,15233,1455,13555,B
1454,C,1414,1414,16604,1935,17168,1455,15190,C
1454,D,2703,2703,19307,3780,20948,1455,16604,D
1454,M,244,244,19551,1095,22043,1455,19307,M
1454,N,1114,1114,20665,300,22343,1455,19551,N
1454,O,232,232,20897,1460,23803,1455,20665,O
1454,P,3085,3085,23982,3030,26833,1455,20897,P
1455,AEI,80,80,80,65,65,1456,0,E
1455,AFI,168,88,168,207,207,1456,0,I
1455,AFJ,152,64,232,225,290,1456,80,F
1455,AGJ,239,7,239,624,624,1456,0,A
1455,BGJ,83,76,315,85,375,1456,232,G
1455,BHJ,148,1,316,150,357,1456,168,J
1455,BHK,510,433,749,150,774,1456,239,B
1455,CHK,644,211,960,765,1122,1456,316,K
1455,CHL,793,148,1108,2810,3185,1456,315,H
1455,CL,818,459,1567,800,1574,1456,749,C
1455,BL,661,54,1621,3600,4722,1456,960,L
1455,B,196,142,1763,240,1814,1456,1567,B
1455,C,205,205,1968,135,1949,1456,1763,C
1455,D,3130,3130,5098,4290,6239,1456,1968,D
1455,M,369,369,5467,831,7070,1456,5098,M
1455,N,557,557,6024,150,7220,1456,5467,N
1455,O,180,180,6204,140,7360,1456,6024,O
1455,N,719,719,6923,730,8090,1456,6204,N
1455,O,892,892,7815,775,8865,1456,6923,O
1455,P,936,936,8751,4230,13095,1456,7815,P
1456,AE,275,275,275,868,868,1457,0,E
1456,AF,544,269,544,1388,1388,1457,0,A
1456,BF,533,264,808,180,1048,1457,275,F
1456,BG,979,979,1787,1050,2098,1457,808,G
1456,BF,2464,1221,3008,240,1628,1457,544,B
1456,CF,2586,1365,4373,2325,4423,1457,1787,F
1456,CG,1828,463,4836,820,2448,1457,3008,C
1456,DG,681,218,5054,820,5243,1457,4373,G
1456,DH,460,460,5514,9760,15003,1457,5054,H
1456,D,2021,1343,6857,9700,12148,1457,4836,D
1456,M,1039,1039,7896,2341,17344,1457,6857,M
1456,N,1422,1422,9318,180,17524,1457,7896,N
1456,O,1087,1087,10405,1055,18579,1457,9318,O
1456,N,755,755,11160,780,19359,1457,10405,N
1456,O,495,495,11655,470,19829,1457,11160,O
1456,P,1404,1404,13059,5760,25589,1457,11655,P
1457,A,32,32,32,678,678,1458,0,A
1457,B,835,835,867,240,918,1458,32,B
1457,C,845,845,1712,970,1888,1458,867,C
1457,B,182,182,1894,160,2048,1458,1712,B
1457,C,1262,1262,3156,1340,3388,1458,1894,C
1457,D,60540,60540,63696,3960,7348,1458,3156,D
1457,M,160,160,63856,1370,8718,1458,63696,M
1457,N,1210,1210,65066,150,8868,1458,63856,N
1457,O,48,48,65114,270,9138,1458,65066,O
1457,N,1491,1491,66605,1155,10293,1458,65114,N
1457,O,705,705,67310,800,11093,1458,66605,O
1457,P,231,231,67541,4170,15263,1458,67310,P
1458,AE,225,225,225,434,434,1459,0,A
1458,BE,416,191,416,8224,8224,1459,0,E
1458,BF,940,749,1165,780,1214,1459,225,B
1458,CF,1790,1790,2955,1727,2941,1459,1165,C
1458,DF,8168,5629,8584,420,8644,1459,416,F
1458,DG,1134,1134,9718,1130,9774,1459,8584,G
1458,DH,374,374,10092,335,10109,1459,9718,H
1458,D,13843,6706,16798,338,3279,1459,2955,D
1458,M,447,447,17245,1081,11190,1459,16798,M
1458,N,753,753,17998,180,11370,1459,17245,N
1458,O,953,953,18951,1170,12540,1459,17998,O
1458,N,2427,2427,21378,2240,14780,1459,18951,N
1458,O,367,367,21745,480,15260,1459,21378,O
1458,P,5200,5200,26945,1050,16310,1459,21745,P
1459,AE,1172,1172,1172,1555,1555,1460,0,A
1459,BE,653,653,1825,300,1855,1460,1172,B
1459,CE,732,732,2557,865,2720,1460,1825,C
1459,DE,83,83,2640,1620,4340,1460,2557,D
1459,E,13237,10597,13237,14894,14894,1460,0,E
1459,F,1970,1970,15207,300,15194,1460,13237,F
1459,G,572,572,15779,765,15959,1460,15207,G
1459,H,50,50,15829,1620,17579,1460,15779,H
1459,M,3302,3302,19131,3618,21197,1460,15829,M
1459,N,1396,1396,20527,1140,22337,1460,19131,N
1459,O,1228,1228,21755,1170,23507,1460,20527,O
1459,N,847,847,22602,890,24397,1460,21755,N
1459,O,1147,1147,23749,785,25182,1460,22602,O
1459,P,1775,1775,25524,900,26082,1460,23749,P
1460,A,2910,2910,2910,8661,8661,1461,0,A
1460,B,553,553,3463,490,9151,1461,2910,B
1460,C,6617,6617,10080,990,10141,1461,3463,C
1460,D,3220,3220,13300,3960,14101,1461,10080,D
1460,M,9,9,13309,50,14151,1461,13300,M
1460,N,266,266,13575,240,14391,1461,13309,N
1460,O,615,615,14190,785,15176,1461,13575,O
1460,P,98,98,14288,3960,19136,1461,14190,P
1461,A,10513,10513,10513,10503,10503,1462,0,A
1461,B,199,199,10712,250,10753,1462,10513,B
1461,C,1232,1232,11944,1110,11863,1462,10712,C
1461,D,1293,1293,13237,550,12413,1462,11944,D
1461,M,1037,1037,14274,2018,14431,1462,13237,M
1461,N,1118,1118,15392,180,14611,1462,14274,N
1461,O,1068,1068,16460,830,15441,1462,15392,O
1461,N,182,182,16642,430,15871,1462,16460,N
1461,O,451,451,17093,760,16631,1462,16642,O
1461,P,1765,1765,18858,1140,17771,1462,17093,P
1462,A,1210,1210,1210,1690,1690,1463,0,A
1462,B,725,725,1935,300,1990,1463,1210,B
1462,C,809,809,2744,1050,3040,1463,1935,C
1462,D,206,206,2950,1140,4180,1463,2744,D
1462,M,207,207,3157,194,4374,1463,2950,M
1462,N,232,232,3389,265,4639,1463,3157,N
1462,O,536,536,3925,625,5264,1463,3389,O
1462,P,1285,1285,5210,375,5639,1463,3925,P
1463,AEI,228,228,228,878,878,1464,0,I
1463,AEJ,336,108,336,308,308,1464,0,A
1463,BEJ,93,93,429,180,488,1464,336,B
1463,CEJ,1095,894,1323,480,1358,1464,228,J
1463,CEK,1075,181,1504,965,1453,1464,429,C
1463,DEK,263,82,1586,235,1593,1464,1323,K
1463,DEL,721,639,2225,385,1838,1464,1504,D
1463,EL,4826,2601,4826,5797,5797,1464,0,E
1463,FL,4035,795,5621,550,2143,1464,1586,L
1463,F,991,196,5817,90,5887,1464,4826,F
1463,G,512,512,6329,905,6792,1464,5817,G
1463,F,1176,1176,7505,770,7562,1464,6329,F
1463,G,855,855,8360,1300,8862,1464,7505,G
1463,H,2135,2135,10495,3780,12642,1464,8360,H
1463,M,540,540,11035,1065,13707,1464,10495,M
1463,N,917,917,11952,420,14127,1464,11035,N
1463,O,659,659,12611,885,15012,1464,11952,O
1463,P,771,771,13382,3960,18972,1464,12611,P
1464,A,336,336,336,1633,1633,1465,0,A
1464,B,1475,1475,1811,240,1873,1465,336,B
1464,C,778,778,2589,975,2848,1465,1811,C
1464,B,817,817,3406,615,3463,1465,2589,B
1464,C,230,230,3636,255,3718,1465,3406,C
1464,D,1374,1374,5010,5160,8878,1465,3636,D
1464,M,334,334,5344,936,9814,1465,5010,M
1464,N,694,694,6038,150,9964,1465,5344,N
1464,O,176,176,6214,155,10119,1465,6038,O
1464,N,315,315,6529,325,10444,1465,6214,N
1464,O,539,539,7068,809,11253,1465,6529,O
1464,P,997,997,8065,3840,15093,1465,7068,P
1465,AEI,7,7,7,352,352,1466,0,E
1465,AFI,384,377,384,1059,1059,1466,0,A
1465,BFI,565,188,572,240,592,1466,7,F
1465,BGI,595,23,595,1523,1523,1466,0,I
1465,BGJ,858,647,1242,240,1299,1466,384,B
1465,CGJ,778,108,1350,920,1512,1466,572,G
1465,CHJ,161,161,1511,3960,5472,1466,1350,H
1465,CJ,1179,263,1774,300,1823,1466,595,J
1465,CK,785,785,2559,1000,2823,1466,1774,K
1465,CL,1476,159,2718,1030,2329,1466,1242,C
1465,DL,1045,886,3604,3960,6783,1466,2559,L
1465,D,933,47,3651,3960,6289,1466,2718,D
1465,M,541,541,4192,1593,8376,1466,3651,M
1465,N,1252,1252,5444,240,8616,1466,4192,N
1465,O,755,755,6199,815,9431,1466,5444,O
1465,P,3099,3099,9298,3960,13391,1466,6199,P
1466,AEI,190,190,190,150,150,1467,0,I
1466,AEJ,275,85,275,960,960,1467,0,E
1466,AFJ,240,155,430,300,450,1467,190,J
1466,AFK,597,597,1027,745,1195,1467,430,K
1466,AFL,951,199,1226,300,1260,1467,275,F
1466,AGL,911,911,2137,870,2130,1467,1226,G
1466,AHL,2,2,2139,1560,3690,1467,2137,H
1466,AL,3500,1361,3500,3470,3470,1467,0,A
1466,BL,234,234,3734,300,3770,1467,3500,B
1466,CL,862,862,4596,750,4520,1467,3734,C
1466,DL,5922,2353,6949,1560,2755,1467,1027,L
1466,D,2984,631,7580,1560,6080,1467,4596,D
1466,M,14591,14591,22171,14854,20934,1467,7580,M
1466,N,570,570,22741,300,21234,1467,22171,N
1466,O,639,639,23380,735,21969,1467,22741,O
1466,P,77,77,23457,1560,23529,1467,23380,P
1467,AEI,111,111,111,1038,1038,1468,0,I
1467,AEJ,182,71,182,1046,1046,1468,0,E
1467,AFJ,959,959,1141,150,1196,1468,182,F
1467,AGJ,1127,97,1238,240,1278,1468,111,J
1467,AGK,160,63,1301,370,1566,1468,1141,G
1467,AFK,1674,373,1674,1565,1565,1468,0,A
1467,BFK,150,150,1824,300,1865,1468,1674,B
1467,CFK,526,3,1827,300,1866,1468,1301,F
1467,CGK,903,314,2141,1020,2298,1468,1238,K
1467,CGL,324,324,2465,4680,6978,1468,2141,L
1467,CG,729,91,2556,660,2526,1468,1827,G
1467,CH,950,218,2774,1005,2870,1468,1824,C
1467,DH,595,595,3369,1200,4070,1468,2774,D
1467,H,1269,456,3825,4230,6756,1468,2556,H
1467,M,3618,3618,7443,3788,10766,1468,3825,M
1467,N,237,237,7680,90,10856,1468,7443,N
1467,O,528,528,8208,815,11671,1468,7680,O
1467,N,260,260,8468,5,11676,1468,8208,N
1467,O,469,469,8937,790,12466,1468,8468,O
1467,P,444,444,9381,3780,16246,1468,8937,P
1468,AEI,27,27,27,101,101,1469,0,I
1468,AEJ,267,267,294,240,341,1469,27,J
1468,AEK,304,10,304,4515,4515,1469,0,A
1468,BEK,484,180,484,934,934,1469,0,E
1468,BFK,688,498,982,970,1311,1469,294,K
1468,BFL,645,147,1129,240,1174,1469,484,F
1468,BGL,325,178,1307,3960,5271,1469,982,L
1468,BG,236,58,1365,390,1564,1469,1129,G
1468,BF,1712,1712,3077,1550,3114,1469,1365,F
1468,BG,830,830,3907,970,4084,1469,3077,G
1468,BH,4610,1007,4914,420,4935,1469,304,B
1468,CH,1168,1168,6082,1439,6374,1469,4914,C
1468,DH,3405,3405,9487,356,6730,1469,6082,D
1468,H,6073,493,9980,3960,8044,1469,3907,H
1468,M,1948,1948,11928,2753,10797,1469,9980,M
1468,N,903,903,12831,150,10947,1469,11928,N
1468,O,744,744,13575,760,11707,1469,12831,O
1468,N,1429,1429,15004,1410,13117,1469,13575,N
1468,O,584,584,15588,480,13597,1469,15004,O
1468,P,788,788,16376,4230,17827,1469,15588,P
1469,A,3407,3407,3407,3579,3579,1470,0,A
1469,B,294,294,3701,180,3759,1470,3407,B
1469,C,461,461,4162,535,4294,1470,3701,C
1469,B,494,494,4656,410,4704,1470,4162,B
1469,C,679,679,5335,760,5464,1470,4656,C
1469,D,3915,3915,9250,7680,13144,1470,5335,D
1469,M,6066,6066,15316,7110,20254,1470,9250,M
1469,N,1324,1324,16640,300,20554,1470,15316,N
1469,O,1156,1156,17796,1045,21599,1470,16640,O
1469,P,614,614,18410,1200,22799,1470,17796,P
1470,AEI,22,22,22,471,471,1471,0,A
1470,BEI,117,95,117,110,110,1471,0,I
1470,BEJ,220,103,220,1230,1230,1471,0,E
1470,BFJ,278,175,395,300,410,1471,117,J
1470,BFK,742,369,764,330,801,1471,22,B
1470,CFK,949,580,1344,1005,1415,1471,395,K
1470,CFL,1197,73,1417,240,1470,1471,220,F
1470,CGL,916,263,1680,952,1753,1471,764,C
1470,DGL,208,208,1888,348,2101,1471,1680,D
1470,GL,701,157,2045,1200,2615,1471,1344,L
1470,G,851,223,2268,995,2465,1471,1417,G
1470,H,226,226,2494,4680,7145,1471,2268,H
1470,M,1632,1632,4126,1741,8886,1471,2494,M
1470,N,222,222,4348,90,8976,1471,4126,N
1470,O,463,463,4811,820,9796,1471,4348,O
1470,P,612,612,5423,3780,13576,1471,4811,P
1471,A,1055,1055,1055,1189,1189,1472,0,A
1471,B,230,230,1285,150,1339,1472,1055,B
1471,C,570,570,1855,585,1924,1472,1285,C
1471,B,224,224,2079,205,2129,1472,1855,B
1471,C,106,106,2185,135,2264,1472,2079,C
1471,D,2718,2718,4903,4230,6494,1472,2185,D
1471,M,88,88,4991,32,6526,1472,4903,M
1471,N,63,63,5054,180,6706,1472,4991,N
1471,O,169,169,5223,220,6926,1472,5054,O
1471,N,741,741,5964,675,7601,1472,5223,N
1471,O,535,535,6499,820,8421,1472,5964,O
1471,P,4655,4655,11154,3960,12381,1472,6499,P
1472,AEI,101,101,101,218,218,1473,0,A
1472,BEI,182,81,182,254,254,1473,0,I
1472,BEJ,227,146,328,150,368,1473,101,B
1472,CEJ,102,102,430,120,488,1473,328,C
1472,DEJ,259,11,441,240,494,1473,182,J
1472,DEK,28,17,458,4230,4718,1473,430,D
1472,EK,782,324,782,1073,1073,1473,0,E
1472,FK,541,200,982,640,1134,1473,441,K
1472,FL,257,257,1239,3730,4864,1473,982,L
1472,F,465,8,1247,150,1223,1473,782,F
1472,G,107,107,1354,115,1338,1473,1247,G
1472,F,497,497,1851,560,1898,1473,1354,F
1472,G,108,108,1959,115,2013,1473,1851,G
1472,H,664,664,2623,4230,6243,1473,1959,H
1472,M,80,80,2703,364,6607,1473,2623,M
1472,N,385,385,3088,150,6757,1473,2703,N
1472,O,134,134,3222,125,6882,1473,3088,O
1472,N,895,895,4117,905,7787,1473,3222,N
1472,O,517,517,4634,525,8312,1473,4117,O
1472,P,14558,14558,19192,4230,12542,1473,4634,P
1473,A,50,50,50,156,156,1474,0,A
1473,B,302,302,352,240,396,1474,50,B
1473,C,709,709,1061,970,1366,1474,352,C
1473,D,177,177,1238,3960,5326,1474,1061,D
1473,M,2004,2004,3242,2904,8230,1474,1238,M
1473,N,925,925,4167,90,8320,1474,3242,N
1473,O,525,525,4692,905,9225,1474,4167,O
1473,N,1156,1156,5848,770,9995,1474,4692,N
1473,O,828,828,6676,1300,11295,1474,5848,O
1473,P,485,485,7161,3780,15075,1474,6676,P
1474,AE,154,154,154,2771,2771,1475,0,A
1474,BE,2825,2825,2979,240,3011,1475,154,B
1474,CE,588,588,3567,855,3866,1475,2979,C
1474,DE,5789,2222,5789,5915,5915,1475,0,E
1474,DF,378,378,6167,300,6215,1475,5789,F
1474,DG,637,637,6804,810,7025,1475,6167,G
1474,DH,317,317,7121,1560,8585,1475,6804,H
1474,D,5527,1973,9094,4020,7886,1475,3567,D
1474,M,397,397,9491,385,8970,1475,9094,M
1474,N,297,297,9788,300,9270,1475,9491,N
1474,O,597,597,10385,810,10080,1475,9788,O
1474,P,374,374,10759,1620,11700,1475,10385,P
1475,AE,34,34,34,17,17,1476,0,E
1475,AF,279,245,279,1713,1713,1476,0,A
1475,BF,246,1,280,300,317,1476,34,F
1475,BG,1452,1451,1731,90,1803,1476,279,B
1475,CG,2104,653,2384,1275,1592,1476,280,G
1475,CF,111,111,2495,1065,2657,1476,2384,F
1475,CG,919,155,2650,1045,2848,1476,1731,C
1475,DG,478,323,2973,510,3167,1476,2495,G
1475,DH,89,89,3062,3960,7127,1476,2973,H
1475,D,890,478,3540,3780,6628,1476,2650,D
1475,M,3466,3466,7006,4708,11835,1476,3540,M
1475,N,1277,1277,8283,90,11925,1476,7006,N
1475,O,1157,1157,9440,1375,13300,1476,8283,O
1475,N,1370,1370,10810,1155,14455,1476,9440,N
1475,O,767,767,11577,970,15425,1476,10810,O
1475,P,1139,1139,12716,3780,19205,1476,11577,P
1476,A,56,56,56,2376,2376,1477,0,A
1476,B,2516,2516,2572,240,2616,1477,56,B
1476,C,738,738,3310,970,3586,1477,2572,C
1476,D,114,114,3424,3960,7546,1477,3310,D
1476,M,1635,1635,5059,2572,10118,1477,3424,M
1476,N,955,955,6014,90,10208,1477,5059,N
1476,O,557,557,6571,905,11113,1477,6014,O
1476,N,1758,1758,8329,1370,12483,1477,6571,N
1476,O,1104,1104,9433,1315,13798,1477,8329,O
1476,P,3004,3004,12437,3780,17578,1477,9433,P
1477,A,418,418,418,1208,1208,1478,0,A
1477,B,1097,1097,1515,300,1508,1478,418,B
1477,C,887,887,2402,1040,2548,1478,1515,C
1477,B,309,309,2711,720,3268,1478,2402,B
1477,C,491,491,3202,90,3358,1478,2711,C
1477,D,96,96,3298,4020,7378,1478,3202,D
1477,M,7487,7487,10785,8865,16243,1478,3298,M
1477,N,1415,1415,12200,90,16333,1478,10785,N
1477,O,1082,1082,13282,1370,17703,1478,12200,O
1477,P,39,39,13321,3780,21483,1478,13282,P
1478,A,220,220,220,530,530,1479,0,A
1478,B,375,375,595,90,620,1479,220,B
1478,C,1439,1439,2034,1745,2365,1479,595,C
1478,D,705,705,2739,3780,6145,1479,2034,D
1478,M,3047,3047,5786,4146,10291,1479,2739,M
1478,N,1129,1129,6915,90,10381,1479,5786,N
1478,O,474,474,7389,850,11231,1479,6915,O
1478,P,1446,1446,8835,3780,15011,1479,7389,P
1479,AEI,5,5,5,81,81,1480,0,I
1479,AEJ,33,28,33,85,85,1480,0,A
1479,BEJ,121,88,121,125,125,1480,0,E
1479,BFJ,148,60,181,150,235,1480,33,B
1479,CFJ,185,9,190,150,231,1480,5,J
1479,CFK,93,24,214,150,275,1480,121,F
1479,CGK,109,76,290,100,335,1480,181,C
1479,DGK,80,4,294,100,375,1480,214,G
1479,DHK,6,2,296,3315,3650,1480,290,D
1479,HK,3,1,297,3315,3690,1480,294,H
1479,K,675,568,865,765,996,1480,190,K
1479,L,3535,3535,4400,3660,4656,1480,865,L
1479,M,357,357,4757,752,5408,1480,4400,M
1479,N,620,620,5377,240,5648,1480,4757,N
1479,O,204,204,5581,425,6073,1480,5377,O
1479,N,641,641,6222,430,6503,1480,5581,N
1479,O,872,872,7094,1200,7703,1480,6222,O
1479,P,2698,2698,9792,3960,11663,1480,7094,P
1480,AEI,619,619,619,2428,2428,1481,0,A
1480,BEI,1827,1827,2446,90,2518,1481,619,B
1480,CEI,2754,308,2754,2872,2872,1481,0,E
1480,CFI,267,267,3021,240,3112,1481,2754,F
1480,CGI,1244,669,3690,1365,3883,1481,2446,C
1480,BGI,200,200,3890,70,3953,1481,3690,B
1480,CGI,170,170,4060,535,4488,1481,3890,C
1480,DGI,215,215,4275,3780,8268,1481,4060,D
1480,GI,5083,3829,8104,3001,6113,1481,3021,G
1480,FI,9775,1671,9775,10261,10261,1481,0,I
1480,FJ,681,681,10456,240,10501,1481,9775,J
1480,FK,2404,52,10508,3135,9248,1481,8104,F
1480,GK,225,225,10733,1630,10878,1481,10508,G
1480,HK,729,452,11185,1025,11526,1481,10456,K
1480,HL,1504,1052,12237,3960,14838,1481,10733,H
1480,L,1134,82,12319,3960,15486,1481,11185,L
1480,M,224,224,12543,227,15713,1481,12319,M
1480,N,253,253,12796,300,16013,1481,12543,N
1480,O,1086,1086,13882,965,16978,1481,12796,O
1480,P,1871,1871,15753,550,17528,1481,13882,P
1481,AE,5,5,5,863,863,1482,0,A
1481,BE,278,273,278,1201,1201,1482,0,E
1481,BF,1063,790,1068,240,1103,1482,5,B
1481,CF,1125,335,1403,240,1441,1482,278,F
1481,CG,685,350,1753,960,2063,1482,1068,C
1481,DG,249,249,2002,3960,6023,1482,1753,D
1481,G,792,193,2195,930,2371,1482,1403,G
1481,H,259,259,2454,6990,9361,1482,2195,H
1481,M,17154,17154,19608,17424,26785,1482,2454,M
1481,N,352,352,19960,90,26875,1482,19608,N
1481,O,1004,1004,20964,1525,28400,1482,19960,O
1481,P,598,598,21562,3780,32180,1482,20964,P
1482,A,5608,5608,5608,5966,5966,1483,0,A
1482,B,463,463,6071,180,6146,1483,5608,B
1482,C,1085,1085,7156,1235,7381,1483,6071,C
1482,B,1555,1555,8711,1390,8771,1483,7156,B
1482,C,565,565,9276,620,9391,1483,8711,C
1482,D,1120,1120,10396,6960,16351,1483,9276,D
1482,M,124,124,10520,279,16630,1483,10396,M
1482,N,275,275,10795,180,16810,1483,10520,N
1482,O,996,996,11791,935,17745,1483,10795,O
1482,P,865,865,12656,385,18130,1483,11791,P
1483,A,60,60,60,75,75,1484,0,A
1483,B,166,166,226,135,210,1484,60,B
1483,C,138,138,364,280,490,1484,226,C
1483,D,247,247,611,5160,5650,1484,364,D
1483,M,701,701,1312,1215,6865,1484,611,M
1483,N,545,545,1857,90,6955,1484,1312,N
1483,O,973,973,2830,1250,8205,1484,1857,O
1483,P,860,860,3690,3780,11985,1484,2830,P
1484,A,1070,1070,1070,1199,1199,1485,0,A
1484,B,326,326,1396,240,1439,1485,1070,B
1484,C,856,856,2252,855,2294,1485,1396,C
1484,D,98,98,2350,3960,6254,1485,2252,D
1484,M,16,16,2366,792,7046,1485,2350,M
1484,N,1001,1001,3367,240,7286,1485,2366,N
1484,O,615,615,3982,785,8071,1485,3367,O
1484,P,978,978,4960,3960,12031,1485,3982,P
1485,A,295,295,295,882,882,1486,0,A
1485,B,617,617,912,90,972,1486,295,B
1485,C,485,485,1397,805,1777,1486,912,C
1485,D,3253,3253,4650,3780,5557,1486,1397,D
1485,M,4158,4158,8808,4714,10271,1486,4650,M
1485,N,583,583,9391,90,10361,1486,8808,N
1485,O,335,335,9726,625,10986,1486,9391,O
1485,P,1513,1513,11239,3780,14766,1486,9726,P
1486,AE,538,538,538,1421,1421,1487,0,E
1486,AF,929,929,1467,90,1511,1487,538,F
1486,AG,1068,1068,2535,1200,2711,1487,1467,G
1486,AH,1198,1198,3733,3780,6491,1487,2535,H
1486,A,11639,7906,11639,15405,15405,1487,0,A
1486,B,3796,3796,15435,90,15495,1487,11639,B
1486,C,574,574,16009,935,16430,1487,15435,C
1486,D,535,535,16544,3780,20210,1487,16009,D
1486,M,733,733,17277,1387,21597,1487,16544,M
1486,N,683,683,17960,90,21687,1487,17277,N
1486,O,487,487,18447,845,22532,1487,17960,O
1486,P,24454,24454,42901,3780,26312,1487,18447,P
1487,AEI,77,77,77,862,862,1488,0,I
1487,AEJ,191,114,191,711,711,1488,0,E
1487,AFJ,309,118,309,376,376,1488,0,A
1487,BFJ,62,62,371,120,496,1488,309,B
1487,CFJ,752,572,943,240,951,1488,191,F
1487,CGJ,982,116,1059,240,1102,1488,77,J
1487,CGK,396,280,1339,400,1351,1488,943,G
1487,CFK,1192,224,1563,1470,1966,1488,371,C
1487,BFK,737,233,1796,970,2072,1488,1059,K
1487,BFL,118,118,1914,3960,6032,1488,1796,L
1487,BF,1474,899,2813,1500,2851,1488,1339,F
1487,BG,711,711,3524,970,3821,1488,2813,G
1487,BH,249,249,3773,3960,7781,1488,3524,H
1487,B,2304,94,3867,1980,3946,1488,1563,B
1487,C,1074,1074,4941,1069,5015,1488,3867,C
1487,D,5133,5133,10074,356,5371,1488,4941,D
1487,M,135,135,10209,1755,9536,1488,10074,M
1487,N,1793,1793,12002,240,9776,1488,10209,N
1487,O,1180,1180,13182,1410,11186,1488,12002,O
1487,N,709,709,13891,520,11706,1488,13182,N
1487,O,320,320,14211,520,12226,1488,13891,O
1487,P,1695,1695,15906,555,12781,1488,14211,P
1488,AEI,253,253,253,813,813,1489,0,A
1488,BEI,667,414,667,1402,1402,1489,0,E
1488,BFI,662,248,915,150,963,1489,253,B
1488,CFI,163,163,1078,115,1078,1489,915,C
1488,BFI,761,350,1428,90,1492,1489,667,F
1488,BGI,532,182,1610,585,1663,1489,1078,B
1488,CGI,1830,220,1830,2603,2603,1489,0,I
1488,CGJ,525,123,1953,860,2352,1489,1428,G
1488,CHJ,582,239,2192,635,2298,1489,1610,C
1488,DHJ,318,318,2510,4230,6528,1489,2192,D
1488,HJ,812,132,2642,90,2693,1489,1830,J
1488,HK,478,478,3120,860,3553,1489,2642,K
1488,HL,1255,88,3208,3780,6132,1489,1953,H
1488,L,817,729,3937,3780,7333,1489,3120,L
1488,M,520,520,4457,1460,8793,1489,3937,M
1488,N,1209,1209,5666,300,9093,1489,4457,N
1488,O,862,862,6528,1000,10093,1489,5666,O
1488,N,396,396,6924,355,10448,1489,6528,N
1488,O,198,198,7122,390,10838,1489,6924,O
1488,P,248,248,7370,3960,14798,1489,7122,P
1489,A,46,46,46,374,374,1490,0,A
1489,B,502,502,548,165,539,1490,46,B
1489,C,622,622,1170,910,1449,1490,548,C
1489,D,122,122,1292,3960,5409,1490,1170,D
1489,M,1512,1512,2804,2301,7710,1490,1292,M
1489,N,843,843,3647,90,7800,1490,2804,N
1489,O,501,501,4148,855,8655,1490,3647,O
1489,P,842,842,4990,3780,12435,1490,4148,P
1490,A,42,42,42,147,147,1491,0,A
1490,B,287,287,329,240,387,1491,42,B
1490,C,348,348,677,285,672,1491,329,C
1490,D,1318,1318,1995,5160,5832,1491,677,D
1490,M,1203,1203,3198,1297,7129,1491,1995,M
1490,N,221,221,3419,180,7309,1491,3198,N
1490,O,863,863,4282,885,8194,1491,3419,O
1490,N,855,855,5137,840,9034,1491,4282,N
1490,O,942,942,6079,1070,10104,1491,5137,O
1490,P,861,861,6940,6900,17004,1491,6079,P
1491,AE,136,136,136,1555,1555,1492,0,E
1491,AF,193,57,193,375,375,1492,0,A
1491,BF,448,448,641,300,675,1492,193,B
1491,CF,574,574,1215,765,1440,1492,641,C
1491,DF,113,113,1328,1620,3060,1492,1215,D
1491,F,1629,437,1765,270,1825,1492,136,F
1491,G,443,443,2208,780,2605,1492,1765,G
1491,F,3608,3608,5816,3250,5855,1492,2208,F
1491,G,1122,1122,6938,1259,7114,1492,5816,G
1491,H,641,641,7579,351,7465,1492,6938,H
1491,M,66,66,7645,667,8132,1492,7579,M
1491,N,961,961,8606,420,8552,1492,7645,N
1491,O,1072,1072,9678,975,9527,1492,8606,O
1491,P,1120,1120,10798,460,9987,1492,9678,P
1492,AEI,165,165,165,652,652,1493,0,E
1492,AFI,372,207,372,749,749,1493,0,A
1492,BFI,399,27,399,595,595,1493,0,I
1492,BFJ,316,316,715,185,780,1493,399,J
1492,BFK,430,87,802,90,839,1493,372,B
1492,CFK,668,31,833,240,892,1493,165,F
1492,CGK,142,142,975,285,1177,1493,833,G
1492,CHK,535,275,1250,525,1305,1493,715,K
1492,CHL,25,25,1275,2880,4185,1493,1250,L
1492,CH,734,261,1536,1240,2079,1493,802,C
1492,DH,3322,3322,4858,3780,5859,1493,1536,D
1492,H,4254,371,5229,5220,6397,1493,975,H
1492,M,36,36,5265,114,6511,1493,5229,M
1492,N,171,171,5436,150,6661,1493,5265,N
1492,O,108,108,5544,100,6761,1493,5436,O
1492,P,694,694,6238,3315,10076,1493,5544,P
1493,A,238,238,238,1348,1348,1494,0,A
1493,B,1327,1327,1565,240,1588,1494,238,B
1493,C,289,289,1854,915,2503,1494,1565,C
1493,D,1604,1604,3458,3960,6463,1494,1854,D
1493,M,1610,1610,5068,1665,8128,1494,3458,M
1493,N,163,163,5231,150,8278,1494,5068,N
1493,O,591,591,5822,585,8863,1494,5231,O
1493,N,180,180,6002,175,9038,1494,5822,N
1493,O,556,556,6558,705,9743,1494,6002,O
1493,P,5092,5092,11650,3690,13433,1494,6558,P
1494,AE,506,506,506,730,730,1495,0,E
1494,AF,328,328,834,150,880,1495,506,F
1494,AG,144,144,978,120,1000,1495,834,G
1494,AH,423,423,1401,4230,5230,1495,978,H
1494,A,13069,11668,13069,13188,13188,1495,0,A
1494,B,385,385,13454,240,13428,1495,13069,B
1494,C,783,783,14237,1055,14483,1495,13454,C
1494,D,23,23,14260,3960,18443,1495,14237,D
1494,M,289,289,14549,1801,20244,1495,14260,M
1494,N,1822,1822,16371,360,20604,1495,14549,N
1494,O,129,129,16500,386,20990,1495,16371,O
1494,P,2021,2021,18521,514,21504,1495,16500,P
1495,A,30,30,30,834,834,1496,0,A
1495,B,907,907,937,90,924,1496,30,B
1495,C,954,954,1891,1220,2144,1496,937,C
1495,D,771,771,2662,3780,5924,1496,1891,D
1495,M,323,323,2985,826,6750,1496,2662,M
1495,N,528,528,3513,90,6840,1496,2985,N
1495,O,503,503,4016,860,7700,1496,3513,O
1495,P,1766,1766,5782,3780,11480,1496,4016,P
1496,AE,3428,3428,3428,5780,5780,1497,0,E
1496,AF,2491,2491,5919,180,5960,1497,3428,F
1496,AG,474,474,6393,385,6345,1497,5919,G
1496,AH,8540,2147,8540,9980,9980,1497,0,A
1496,BH,1847,1847,10387,410,10390,1497,8540,B
1496,CH,815,815,11202,1085,11475,1497,10387,C
1496,BH,3471,3471,14673,3240,14715,1497,11202,B
1496,CH,486,486,15159,740,15455,1497,14673,C
1496,DH,5,5,15164,1455,16910,1497,15159,D
1496,H,48657,39886,55050,240,6585,1497,6393,H
1496,M,2844,2844,57894,2814,19724,1497,55050,M
1496,N,150,150,58044,240,19964,1497,57894,N
1496,O,449,449,58493,195,20159,1497,58044,O
1496,P,292,292,58785,660,20819,1497,58493,P
1497,AEI,19,19,19,52,52,1498,0,A
1497,BEI,129,129,148,150,202,1498,19,B
1497,CEI,265,117,265,410,410,1498,0,E
1497,CFI,175,58,323,110,312,1498,148,C
1497,DFI,3,3,326,4230,4542,1498,323,D
1497,FI,320,259,585,240,650,1498,265,F
1497,GI,901,901,1486,975,1625,1498,585,G
1497,FI,1803,317,1803,3407,3407,1498,0,I
1497,FJ,707,390,2193,625,2250,1498,1486,F
1497,GJ,249,249,2442,285,2535,1498,2193,G
1497,HJ,119,119,2561,5100,7635,1498,2442,H
1497,J,1629,871,3432,90,3497,1498,1803,J
1497,K,461,461,3893,825,4322,1498,3432,K
1497,J,941,941,4834,565,4887,1498,3893,J
1497,K,945,945,5779,1270,6157,1498,4834,K
1497,L,1698,1698,7477,3780,9937,1498,5779,L
1497,M,374,374,7851,2030,11967,1498,7477,M
1497,N,1891,1891,9742,90,12057,1498,7851,N
1497,O,1154,1154,10896,1365,13422,1498,9742,O
1497,P,82,82,10978,3780,17202,1498,10896,P
1498,AE,9066,9066,9066,10573,10573,1499,0,E
1498,AF,1542,1542,10608,90,10663,1499,9066,F
1498,AG,11043,435,11043,11732,11732,1499,0,A
1498,BG,901,466,11509,1215,11878,1499,10608,G
1498,BH,225,225,11734,3780,15658,1499,11509,H
1498,B,733,42,11776,90,11822,1499,11043,B
1498,C,653,653,12429,1055,12877,1499,11776,C
1498,D,31,31,12460,3780,16657,1499,12429,D
1498,M,189,189,12649,440,17097,1499,12460,M
1498,N,317,317,12966,90,17187,1499,12649,N
1498,O,373,373,13339,795,17982,1499,12966,O
1498,P,1365,1365,14704,3780,21762,1499,13339,P
1499,AE,218,218,218,427,427,1500,0,E
1499,AF,273,273,491,90,517,1500,218,F
1499,AG,1477,1477,1968,1745,2262,1500,491,G
1499,AF,657,657,2625,395,2657,1500,1968,F
1499,AG,2674,49,2674,3141,3141,1500,0,A
1499,BG,513,513,3187,90,3231,1500,2674,B
1499,CG,664,102,3289,1060,3717,1500,2625,G
1499,CH,735,633,3922,1060,4291,1500,3187,C
1499,DH,1027,394,4316,3780,7497,1500,3289,H
1499,D,863,469,4785,3780,8071,1500,3922,D
1499,M,14410,14410,19195,14555,22626,1500,4785,M
1499,N,174,174,19369,90,22716,1500,19195,N
1499,O,716,716,20085,1130,23846,1500,19369,O
1499,P,513,513,20598,3780,27626,1500,20085,P
1500,AEI,116,116,116,633,633,1501,0,A
1500,BEI,413,297,413,612,612,1501,0,I
1500,BEJ,605,308,721,150,783,1501,116,B
1500,CEJ,379,71,792,240,852,1501,413,J
1500,CEK,799,7,799,2112,2112,1501,0,E
1500,CFK,142,64,863,140,923,1501,721,C
1500,DFK,895,824,1687,1075,1927,1501,792,K
1500,DFJ,528,528,2215,345,2272,1501,1687,J
1500,DFK,1486,70,2285,180,2292,1501,799,F
1500,DGK,151,81,2366,85,2357,1501,2215,K
1500,DGL,1586,83,2449,2900,3823,1501,863,D
1500,GL,843,679,3128,920,3212,1501,2285,G
1500,FL,1217,455,3583,5060,7417,1501,2366,L
1500,F,839,384,3967,815,4027,1501,3128,F
1500,G,593,593,4560,615,4642,1501,3967,G
1500,H,1407,1407,5967,6960,11602,1501,4560,H
1500,M,348,348,6315,407,12009,1501,5967,M
1500,N,150,150,6465,150,12159,1501,6315,N
1500,O,168,168,6633,280,12439,1501,6465,O
1500,P,1192,1192,7825,5160,17599,1501,6633,P
1501,AEI,15,15,15,115,115,1502,0,I
1501,AEJ,92,77,92,278,278,1502,0,E
1501,AFJ,223,146,238,150,265,1502,15,J
1501,AFK,330,184,422,180,458,1502,92,F
1501,AGK,641,457,879,120,385,1502,238,K
1501,AGL,672,215,1094,670,1128,1502,422,G
1501,AFL,1269,175,1269,1449,1449,1502,0,A
1501,BFL,281,281,1550,150,1599,1502,1269,B
1501,CFL,629,173,1723,640,1768,1502,1094,F
1501,CGL,718,545,2268,915,2514,1502,1550,C
1501,BGL,686,141,2409,210,1978,1502,1723,G
1501,BHL,244,103,2512,40,2554,1502,2268,B
1501,CHL,1216,1216,3728,2495,5049,1502,2512,C
1501,DHL,1367,1367,5095,1860,6909,1502,3728,D
1501,HL,4452,236,5331,4230,4615,1502,879,L
1501,H,3249,327,5658,4140,6118,1502,2409,H
1501,M,268,268,5926,259,7168,1502,5658,M
1501,N,119,119,6045,180,7348,1502,5926,N
1501,O,194,194,6239,215,7563,1502,6045,O
1501,N,2217,2217,8456,2200,9763,1502,6239,N
1501,O,242,242,8698,205,9968,1502,8456,O
1501,P,2934,2934,11632,4140,14108,1502,8698,P
1502,AE,409,409,409,909,909,1503,0,E
1502,AF,534,534,943,90,999,1503,409,F
1502,AG,1580,637,1580,1751,1751,1503,0,A
1502,BG,352,352,1932,240,1991,1503,1580,B
1502,CG,1215,226,2158,1565,2564,1503,943,G
1502,CH,1096,870,3028,1005,2996,1503,1932,C
1502,DH,172,172,3200,3960,6956,1503,3028,D
1502,H,1283,241,3441,3780,6344,1503,2158,H
1502,M,23,23,3464,765,7721,1503,3441,M
1502,N,934,934,4398,240,7961,1503,3464,N
1502,O,758,758,5156,810,8771,1503,4398,O
1502,P,183,183,5339,3960,12731,1503,5156,P
1503,AE,307,307,307,859,859,1504,0,A
1503,BE,738,431,738,1141,1141,1504,0,E
1503,BF,918,487,1225,420,1279,1504,307,B
1503,CF,523,36,1261,180,1321,1504,738,F
1503,CG,981,945,2206,975,2254,1504,1225,C
1503,DG,1109,164,2370,1045,2366,1504,1261,G
1503,DH,882,882,3252,550,2916,1504,2370,H
1503,D,2042,996,4248,550,2804,1504,2206,D
1503,M,7962,7962,12210,8060,10976,1504,4248,M
1503,N,218,218,12428,150,11126,1504,12210,N
1503,O,59,59,12487,50,11176,1504,12428,O
1503,N,143,143,12630,185,11361,1504,12487,N
1503,O,95,95,12725,200,11561,1504,12630,O
1503,P,127,127,12852,3780,15341,1504,12725,P
1504,AEI,118,118,118,354,354,1505,0,A
1504,BEI,340,222,340,759,759,1505,0,I
1504,BEJ,335,113,453,150,504,1505,118,B
1504,CEJ,609,156,609,1278,1278,1505,0,E
1504,CFJ,173,17,626,125,629,1505,453,C
1504,BFJ,599,313,939,240,999,1505,340,J
1504,BFK,151,151,1090,380,1379,1505,939,K
1504,BFL,659,195,1285,700,1329,1505,626,B
1504,CFL,164,164,1449,175,1504,1505,1285,C
1504,DFL,849,9,1458,240,1518,1505,609,F
1504,DGL,152,152,1610,395,1913,1505,1458,G
1504,DHL,343,182,1792,4230,5734,1505,1449,D
1504,HL,1591,889,2681,9700,11079,1505,1090,L
1504,H,1120,49,2730,9700,11613,1505,1610,H
1504,M,367,367,3097,460,12073,1505,2730,M
1504,N,258,258,3355,230,12303,1505,3097,N
1504,O,703,703,4058,715,13018,1505,3355,O
1504,N,704,704,4762,690,13708,1505,4058,N
1504,O,680,680,5442,740,14448,1505,4762,O
1504,N,1183,1183,6625,1120,15568,1505,5442,N
1504,O,872,872,7497,906,16474,1505,6625,O
1504,P,328,328,7825,399,16873,1505,7497,P
1505,AE,5301,5301,5301,6420,6420,1506,0,A
1505,BE,675,675,5976,240,6660,1506,5301,B
1505,CE,6041,65,6041,6160,6160,1506,0,E
1505,CF,345,280,6321,1711,8371,1506,5976,C
1505,BF,765,485,6806,660,6820,1506,6041,F
1505,BG,2432,1947,8753,425,8796,1506,6321,B
1505,CG,2523,576,9329,1230,8050,1506,6806,G
1505,CF,747,171,9500,920,9716,1506,8753,C
1505,DF,240,240,9740,3960,13676,1506,9500,D
1505,F,676,265,10005,1985,10035,1506,9329,F
1505,G,60,60,10065,55,10090,1506,10005,G
1505,F,671,671,10736,865,10955,1506,10065,F
1505,G,1112,1112,11848,1145,12100,1506,10736,G
1505,H,1707,1707,13555,3960,16060,1506,11848,H
1505,M,335,335,13890,670,16730,1506,13555,M
1505,N,604,604,14494,300,17030,1506,13890,N
1505,O,916,916,15410,925,17955,1506,14494,O
1505,P,13,13,15423,2760,20715,1506,15410,P
1506,AE,28,28,28,1151,1151,1507,0,E
1506,AF,1345,1345,1373,240,1391,1507,28,F
1506,AG,1790,417,1790,2272,2272,1507,0,A
1506,BG,707,290,2080,880,2271,1507,1373,G
1506,BH,133,133,2213,3960,6231,1507,2080,H
1506,B,668,245,2458,240,2512,1507,1790,B
1506,C,134,134,2592,400,2912,1507,2458,C
1506,B,1758,1758,4350,1460,4372,1507,2592,B
1506,C,701,701,5051,895,5267,1507,4350,C
1506,D,5722,5722,10773,3960,9227,1507,5051,D
1506,M,1544,1544,12317,2731,11958,1507,10773,M
1506,N,1373,1373,13690,240,12198,1507,12317,N
1506,O,802,802,14492,875,13073,1507,13690,O
1506,N,1178,1178,15670,1100,14173,1507,14492,N
1506,O,1140,1140,16810,1245,15418,1507,15670,O
1506,P,3199,3199,20009,3670,19088,1507,16810,P
1507,A,49,49,49,1132,1132,1508,0,A
1507,B,1268,1268,1317,240,1372,1508,49,B
1507,C,756,756,2073,685,2057,1508,1317,C
1507,D,4116,4116,6189,5760,7817,1508,2073,D
1507,M,1292,1292,7481,1580,9397,1508,6189,M
1507,N,588,588,8069,300,9697,1508,7481,N
1507,O,641,641,8710,2200,11897,1508,8069,O
1507,P,1319,1319,10029,2580,14477,1508,8710,P
1508,AEI,885,885,885,1590,1590,1509,0,A
1508,BEI,961,961,1846,300,1890,1509,885,B
1508,CEI,2360,514,2360,2730,2730,1509,0,E
1508,CFI,865,351,2711,1220,3110,1509,1846,C
1508,BFI,632,281,2992,300,3030,1509,2360,F
1508,BGI,841,560,3552,490,3600,1509,2711,B
1508,CGI,1006,446,3998,1045,4075,1509,2992,G
1508,CFI,470,24,4022,955,4555,1509,3552,C
1508,DFI,572,548,4570,545,4620,1509,3998,F
1508,DGI,262,262,4832,410,5030,1509,4570,G
1508,DHI,261,261,5093,1560,6590,1509,4832,H
1508,DI,5825,732,5825,5865,5865,1509,0,I
1508,DJ,305,305,6130,310,6175,1509,5825,J
1508,DK,2623,515,6645,1560,6115,1509,4022,D
1508,K,761,246,6891,770,6945,1509,6130,K
1508,L,1454,1454,8345,1560,8505,1509,6891,L
1508,M,14654,14654,22999,14669,23174,1509,8345,M
1508,N,273,273,23272,300,23474,1509,22999,N
1508,O,812,812,24084,745,24219,1509,23272,O
1508,P,95,95,24179,1560,25779,1509,24084,P
1509,AEI,154,154,154,155,155,1510,0,A
1509,BEI,194,40,194,200,200,1510,0,I
1509,BEJ,83,43,237,135,290,1510,154,B
1509,CEJ,65,22,259,110,310,1510,194,J
1509,CEK,144,144,403,280,590,1510,259,K
1509,CEL,298,132,535,280,570,1510,237,C
1509,DEL,169,37,572,5160,5750,1510,403,L
1509,DE,4924,4887,5459,5280,5850,1510,535,D
1509,E,10139,4680,10139,11959,11959,1510,0,E
1509,F,1854,1854,11993,90,12049,1510,10139,F
1509,G,227,227,12220,735,12784,1510,11993,G
1509,F,1607,1607,13827,1100,13884,1510,12220,F
1509,G,1258,1258,15085,1330,15214,1510,13827,G
1509,H,610,610,15695,3780,18994,1510,15085,H
1509,M,625,625,16320,1285,20279,1510,15695,M
1509,N,800,800,17120,180,20459,1510,16320,N
1509,O,633,633,17753,885,21344,1510,17120,O
1509,P,877,877,18630,6680,28024,1510,17753,P
1510,AEI,129,129,129,128,128,1511,0,A
1510,BEI,194,194,323,240,368,1511,129,B
1510,CEI,433,110,433,918,918,1511,0,E
1510,CFI,202,92,525,285,653,1511,323,C
1510,DFI,522,430,955,90,1008,1511,433,F
1510,DGI,1188,758,1713,5160,5813,1511,525,D
1510,GI,1060,302,2015,1330,2338,1511,955,G
1510,HI,2055,40,2055,2279,2279,1511,0,I
1510,HJ,319,319,2374,155,2434,1511,2055,J
1510,HK,947,947,3321,1195,3629,1511,2374,K
1510,HJ,2368,1062,4383,3780,6118,1511,2015,H
1510,J,1534,472,4855,1360,4989,1511,3321,J
1510,K,852,852,5707,1360,6349,1511,4855,K
1510,L,1992,1992,7699,420,6769,1511,5707,L
1510,M,3890,3890,11589,4344,11113,1511,7699,M
1510,N,527,527,12116,90,11203,1511,11589,N
1510,O,990,990,13106,1250,12453,1511,12116,O
1510,N,725,725,13831,510,12963,1511,13106,N
1510,O,723,723,14554,890,13853,1511,13831,O
1510,P,18925,18925,33479,3780,17633,1511,14554,P
1511,AEI,348,348,348,1235,1235,1512,0,I
1511,AEJ,917,917,1265,90,1325,1512,348,J
1511,AEK,1359,94,1359,1773,1773,1512,0,E
1511,AFK,633,633,1992,240,2013,1512,1359,F
1511,AGK,924,197,2189,1200,2525,1512,1265,K
1511,AGL,134,134,2323,3780,6305,1512,2189,L
1511,AG,799,468,2791,1040,3053,1512,1992,G
1511,AH,495,495,3286,3960,7013,1512,2791,H
1511,A,35832,32546,35832,38054,38054,1512,0,A
1511,B,2325,2325,38157,90,38144,1512,35832,B
1511,C,957,957,39114,1220,39364,1512,38157,C
1511,D,1235,1235,40349,4625,43989,1512,39114,D
1511,M,830,830,41179,1161,45150,1512,40349,M
1511,N,361,361,41540,90,45240,1512,41179,N
1511,O,420,420,41960,815,46055,1512,41540,O
1511,P,3000,3000,44960,3780,49835,1512,41960,P
1512,A,1473,1473,1473,1936,1936,1513,0,A
1512,B,648,648,2121,240,2176,1513,1473,B
1512,C,639,639,2760,725,2901,1513,2121,C
1512,B,346,346,3106,320,3221,1513,2760,B
1512,C,2577,2577,5683,2340,5561,1513,3106,C
1512,D,3011,3011,8694,3960,9521,1513,5683,D
1512,M,23,23,8717,84,9605,1513,8694,M
1512,N,158,158,8875,150,9755,1513,8717,N
1512,O,125,125,9000,100,9855,1513,8875,O
1512,P,8510,8510,17510,2880,12735,1513,9000,P
1513,AE,57,57,57,364,364,1514,0,A
1513,BE,400,400,457,150,514,1514,57,B
1513,CE,829,829,1286,945,1459,1514,457,C
1513,DE,1195,1195,2481,5160,6619,1514,1286,D
1513,E,6878,4397,6878,8115,8115,1514,0,E
1513,F,1297,1297,8175,120,8235,1514,6878,F
1513,G,150,150,8325,420,8655,1514,8175,G
1513,F,732,732,9057,460,9115,1514,8325,F
1513,G,820,820,9877,945,10060,1514,9057,G
1513,H,826,826,10703,5160,15220,1514,9877,H
1513,M,26699,26699,37402,26903,42123,1514,10703,M
1513,N,234,234,37636,90,42213,1514,37402,N
1513,O,441,441,38077,666,42879,1514,37636,O
1513,N,458,458,38535,200,43079,1514,38077,N
1513,O,617,617,39152,880,43959,1514,38535,O
1513,P,1404,1404,40556,3780,47739,1514,39152,P
1514,AE,1949,1949,1949,2808,2808,1515,0,E
1514,AF,888,888,2837,90,2898,1515,1949,F
1514,AG,608,608,3445,905,3803,1515,2837,G
1514,AF,386,386,3831,90,3893,1515,3445,F
1514,AG,1525,1525,5356,2320,6213,1515,3831,G
1514,AH,1485,1485,6841,3420,9633,1515,5356,H
1514,A,11339,4498,11339,11924,11924,1515,0,A
1514,B,615,615,11954,90,12014,1515,11339,B
1514,C,10834,10834,22788,1560,13574,1515,11954,C
1514,B,1533,1533,24321,3570,17144,1515,22788,B
1514,C,642,642,24963,1000,18144,1515,24321,C
1514,D,2939,2939,27902,780,18924,1515,24963,D
1514,M,1638,1638,29540,2896,21820,1515,27902,M
1514,N,1301,1301,30841,90,21910,1515,29540,N
1514,O,1616,1616,32457,1875,23785,1515,30841,O
1514,N,554,554,33011,300,24085,1515,32457,N
1514,O,288,288,33299,535,24620,1515,33011,O
1514,P,647,647,33946,3780,28400,1515,33299,P
1515,AE,390,390,390,275,275,1516,0,E
1515,AF,18,18,408,180,455,1516,390,F
1515,AG,969,969,1377,935,1390,1516,408,G
1515,AH,733,733,2110,385,1775,1516,1377,H
1515,A,2987,877,2987,5008,5008,1516,0,A
1515,B,2182,2182,5169,180,5188,1516,2987,B
1515,C,754,754,5923,785,5973,1516,5169,C
1515,D,1930,1930,7853,550,6523,1516,5923,D
1515,M,1105,1105,8958,1349,7872,1516,7853,M
1515,N,364,364,9322,180,8052,1516,8958,N
1515,O,330,330,9652,890,8942,1516,9322,O
1515,N,1634,1634,11286,1030,9972,1516,9652,N
1515,O,1010,1010,12296,1030,11002,1516,11286,O
1515,P,732,732,13028,6960,17962,1516,12296,P
1516,AE,577,577,577,838,838,1517,0,E
1516,AF,478,478,1055,240,1078,1517,577,F
1516,AG,685,685,1740,960,2038,1517,1055,G
1516,AH,2659,919,2659,3951,3951,1517,0,A
1516,BH,1433,514,3173,3960,5998,1517,1740,H
1516,B,1521,1007,4180,300,4251,1517,2659,B
1516,C,705,705,4885,825,5076,1517,4180,C
1516,B,1169,1169,6054,1045,6121,1517,4885,B
1516,C,357,357,6411,480,6601,1517,6054,C
1516,D,1814,1814,8225,5280,11881,1517,6411,D
1516,M,6203,6203,14428,6273,18154,1517,8225,M
1516,N,152,152,14580,90,18244,1517,14428,N
1516,O,1513,1513,16093,1865,20109,1517,14580,O
1516,N,477,477,16570,145,20254,1517,16093,N
1516,O,641,641,17211,940,21194,1517,16570,O
1516,P,1253,1253,18464,3780,24974,1517,17211,P
1517,AE,5697,5697,5697,5730,5730,1518,0,A
1517,BE,1169,1169,6866,1245,6975,1518,5697,B
1517,CE,1289,1289,8155,1260,8235,1518,6866,C
1517,BE,1634,1634,9789,1425,9660,1518,8155,B
1517,CE,600,600,10389,850,10510,1518,9789,C
1517,DE,11894,1505,11894,12038,12038,1518,0,E
1517,DF,320,320,12214,240,12278,1518,11894,F
1517,DG,1165,1165,13379,1165,13443,1518,12214,G
1517,DH,1690,1690,15069,550,13993,1518,13379,H
1517,D,8850,4170,19239,340,10850,1518,10389,D
1517,M,551,551,19790,1298,15291,1518,19239,M
1517,N,1122,1122,20912,420,15711,1518,19790,N
1517,O,704,704,21616,888,16599,1518,20912,O
1517,P,151,151,21767,402,17001,1518,21616,P
1518,AEI,119,119,119,149,149,1519,0,A
1518,BEI,285,285,404,300,449,1519,119,B
1518,CEI,565,161,565,1005,1005,1519,0,I
1518,CEJ,590,590,1155,210,1215,1519,565,J
1518,CEK,1005,254,1409,965,1414,1519,404,C
1518,DEK,283,283,1692,550,1964,1519,1409,D
1518,EK,1739,47,1739,1860,1860,1519,0,E
1518,FK,286,286,2025,230,2090,1519,1739,F
1518,GK,1266,396,2421,1330,2545,1519,1155,K
1518,GL,584,188,2609,575,2665,1519,2025,G
1518,HL,1244,1056,3665,550,3095,1519,2421,L
1518,H,1425,369,4034,385,3050,1519,2609,H
1518,M,1761,1761,5795,2811,5906,1519,4034,M
1518,N,1474,1474,7269,420,6326,1519,5795,N
1518,O,953,953,8222,2337,8663,1519,7269,O
1518,P,315,315,8537,918,9581,1519,8222,P
1519,AEI,111,111,111,131,131,1520,0,A
1519,BEI,50,50,161,90,221,1520,111,B
1519,CEI,361,200,361,1746,1746,1520,0,E
1519,CFI,1834,1473,1834,1911,1911,1520,0,I
1519,CFJ,1583,110,1944,240,1986,1520,361,F
1519,CGJ,173,63,2007,90,2001,1520,1834,J
1519,CGK,458,458,2465,860,2861,1520,2007,K
1519,CGL,134,134,2599,3780,6641,1520,2465,L
1519,CG,2462,24,2623,2095,2316,1520,161,C
1519,DG,867,188,2811,1055,3041,1520,1944,G
1519,DH,169,169,2980,3960,7001,1520,2811,H
1519,D,1580,1223,4203,3780,6096,1520,2623,D
1519,M,179,179,4382,451,7452,1520,4203,M
1519,N,301,301,4683,90,7542,1520,4382,N
1519,O,514,514,5197,850,8392,1520,4683,O
1519,P,672,672,5869,3780,12172,1520,5197,P
1520,A,106,106,106,754,754,1521,0,A
1520,B,862,862,968,270,1024,1521,106,B
1520,C,787,787,1755,878,1902,1521,968,C
1520,D,1141,1141,2896,1217,3119,1521,1755,D
1520,M,1142,1142,4038,1204,4323,1521,2896,M
1520,N,362,362,4400,360,4683,1521,4038,N
1520,O,782,782,5182,695,5378,1521,4400,O
1520,P,390,390,5572,550,5928,1521,5182,P
1521,AE,453,453,453,1301,1301,1522,0,E
1521,AF,720,267,720,1067,1067,1522,0,A
1521,BF,392,392,1112,90,1157,1522,720,B
1521,CF,891,232,1344,90,1391,1522,453,F
1521,CG,499,499,1843,855,2246,1522,1344,G
1521,CH,928,197,2040,1240,2397,1522,1112,C
1521,DH,27,27,2067,3780,6177,1522,2040,D
1521,H,419,195,2262,3780,6026,1522,1843,H
1521,M,3267,3267,5529,3823,10000,1522,2262,M
1521,N,584,584,6113,90,10090,1522,5529,N
1521,O,371,371,6484,800,10890,1522,6113,O
1521,P,1011,1011,7495,3840,14730,1522,6484,P
1522,AEI,245,245,245,1200,1200,1523,0,E
1522,AFI,725,480,725,1265,1265,1523,0,A
1522,BFI,1198,718,1443,300,1500,1523,245,F
1522,BGI,806,88,1531,300,1565,1523,725,B
1522,CGI,261,173,1704,820,2320,1523,1443,G
1522,CFI,614,441,2145,845,2410,1523,1531,C
1522,DFI,874,433,2578,315,2635,1523,1704,F
1522,DGI,656,223,2801,3960,6370,1523,2145,D
1522,GI,257,34,2835,1505,4140,1523,2578,G
1522,HI,2481,2481,5316,2640,6780,1523,2835,H
1522,I,9145,3829,9145,9210,9210,1523,0,I
1522,J,337,337,9482,300,9510,1523,9145,J
1522,K,690,690,10172,850,10360,1523,9482,K
1522,J,351,351,10523,195,10555,1523,10172,J
1522,K,429,429,10952,410,10965,1523,10523,K
1522,L,3515,3515,14467,2070,13035,1523,10952,L
1522,M,3939,3939,18406,4561,17596,1523,14467,M
1522,N,727,727,19133,180,17776,1523,18406,N
1522,O,1303,1303,20436,1240,19016,1523,19133,O
1522,N,2824,2824,23260,2820,21836,1523,20436,N
1522,O,594,594,23854,635,22471,1523,23260,O
1522,P,1303,1303,25157,6960,29431,1523,23854,P
1523,AE,36,36,36,413,413,1524,0,E
1523,AF,481,481,517,150,563,1524,36,F
1523,AG,647,647,1164,620,1183,1524,517,G
1523,AH,1238,74,1238,1173,1173,1524,0,A
1523,BH,198,198,1436,300,1473,1524,1238,B
1523,CH,717,445,1881,4200,5383,1524,1164,H
1523,C,831,386,2267,970,2443,1524,1436,C
1523,D,2380,2380,4647,3960,6403,1524,2267,D
1523,M,11986,11986,16633,12981,19384,1524,4647,M
1523,N,1026,1026,17659,90,19474,1524,16633,N
1523,O,419,419,18078,865,20339,1524,17659,O
1523,P,805,805,18883,3780,24119,1524,18078,P
1524,AE,264,264,264,411,411,1525,0,E
1524,AF,322,322,586,240,651,1525,264,F
1524,AG,884,884,1470,975,1626,1525,586,G
1524,AF,703,703,2173,605,2231,1525,1470,F
1524,AG,195,195,2368,260,2491,1525,2173,G
1524,AH,612,612,2980,5160,7651,1525,2368,H
1524,A,5586,2606,5586,5755,5755,1525,0,A
1524,B,542,542,6128,420,6175,1525,5586,B
1524,C,809,809,6937,945,7120,1525,6128,C
1524,B,448,448,7385,325,7445,1525,6937,B
1524,C,202,202,7587,260,7705,1525,7385,C
1524,D,1047,1047,8634,5160,12865,1525,7587,D
1524,M,232,232,8866,1037,13902,1525,8634,M
1524,N,908,908,9774,150,14052,1525,8866,N
1524,O,177,177,9951,190,14242,1525,9774,O
1524,P,512,512,10463,4260,18502,1525,9951,P
1525,AEI,358,358,358,392,392,1526,0,A
1525,BEI,366,8,366,3816,3816,1526,0,E
1525,BFI,235,227,593,240,632,1526,358,B
1525,CFI,685,92,685,778,778,1526,0,I
1525,CFJ,418,418,1103,360,1138,1526,685,J
1525,CFK,922,412,1515,910,1542,1526,593,C
1525,DFK,611,199,1714,655,1793,1526,1103,K
1525,DFL,394,195,1909,550,2092,1526,1515,D
1525,FL,1566,1371,3280,460,2253,1526,1714,L
1525,F,3582,668,3948,180,3996,1526,366,F
1525,G,873,873,4821,870,4866,1526,3948,G
1525,H,2045,2045,6866,310,5176,1526,4821,H
1525,M,682,682,7548,1092,6268,1526,6866,M
1525,N,1152,1152,8700,780,7048,1526,7548,N
1525,O,955,955,9655,1159,8207,1526,8700,O
1525,P,859,859,10514,341,8548,1526,9655,P
1526,A,401,401,401,1628,1628,1527,0,A
1526,B,1293,1293,1694,180,1808,1527,401,B
1526,C,344,344,2038,480,2288,1527,1694,C
1526,B,515,515,2553,320,2608,1527,2038,B
1526,C,942,942,3495,860,3468,1527,2553,C
1526,B,1048,1048,4543,1135,4603,1527,3495,B
1526,C,593,593,5136,740,5343,1527,4543,C
1526,D,3357,3357,8493,1140,6483,1527,5136,D
1526,M,282,282,8775,1993,8476,1527,8493,M
1526,N,1896,1896,10671,240,8716,1527,8775,N
1526,O,844,844,11515,976,9692,1527,10671,O
1526,N,728,728,12243,495,10187,1527,11515,N
1526,O,607,607,12850,810,10997,1527,12243,O
1526,P,238,238,13088,3960,14957,1527,12850,P
1527,AE,312,312,312,610,610,1528,0,E
1527,AF,335,23,335,975,975,1528,0,A
1527,BF,404,381,716,150,760,1528,312,F
1527,BG,675,294,1010,90,1065,1528,335,B
1527,CG,659,365,1375,655,1415,1528,716,G
1527,CF,484,119,1494,845,1910,1528,1010,C
1527,DF,444,444,1938,3780,5690,1528,1494,D
1527,F,1555,992,2930,1555,2970,1528,1375,F
1527,G,699,699,3629,590,3560,1528,2930,G
1527,H,467,467,4096,4230,7790,1528,3629,H
1527,M,701,701,4797,1441,9231,1528,4096,M
1527,N,845,845,5642,150,9381,1528,4797,N
1527,O,617,617,6259,650,10031,1528,5642,O
1527,N,949,949,7208,920,10951,1528,6259,N
1527,O,249,249,7457,145,11096,1528,7208,O
1527,P,3068,3068,10525,4230,15326,1528,7457,P
1528,A,1855,1855,1855,2950,2950,1529,0,A
1528,B,1125,1125,2980,90,3040,1529,1855,B
1528,C,359,359,3339,690,3730,1529,2980,C
1528,B,3196,3196,6535,2855,6585,1529,3339,B
1528,C,970,970,7505,1270,7855,1529,6535,C
1528,D,127,127,7632,3780,11635,1529,7505,D
1528,M,229,229,7861,930,12565,1529,7632,M
1528,N,793,793,8654,150,12715,1529,7861,N
1528,O,371,371,9025,255,12970,1529,8654,O
1528,P,24,24,9049,2880,15850,1529,9025,P
1529,A,2102,2102,2102,2251,2251,1530,0,A
1529,B,223,223,2325,90,2341,1530,2102,B
1529,C,613,613,2938,790,3131,1530,2325,C
1529,B,1061,1061,3999,325,3456,1530,2938,B
1529,C,1382,1382,5381,1885,5341,1530,3999,C
1529,D,2676,2676,8057,3780,9121,1530,5381,D
1529,M,134,134,8191,675,9796,1530,8057,M
1529,N,796,796,8987,300,10096,1530,8191,N
1529,O,917,917,9904,925,11021,1530,8987,O
1529,P,163,163,10067,2760,13781,1530,9904,P
1530,AEI,16,16,16,889,889,1531,0,I
1530,AEJ,1239,1239,1255,420,1309,1531,16,J
1530,AEK,1315,60,1315,1545,1545,1531,0,E
1530,AFK,425,425,1740,240,1785,1531,1315,F
1530,AGK,1951,211,1951,5685,5685,1531,0,A
1530,BGK,1272,576,2527,1470,2779,1531,1255,K
1530,BGL,898,111,2638,900,2685,1531,1740,G
1530,BFL,415,415,3053,400,3085,1531,2638,F
1530,BGL,682,682,3735,800,3885,1531,3053,G
1530,BHL,3045,1837,5572,320,3099,1531,2527,L
1530,BH,4092,471,6043,420,6105,1531,1951,B
1530,CH,1364,1364,7407,1411,7516,1531,6043,C
1530,DH,4481,809,8216,4140,8025,1531,3735,H
1530,D,4501,3692,11908,504,8020,1531,7407,D
1530,M,67,67,11975,366,8391,1531,11908,M
1530,N,505,505,12480,240,8631,1531,11975,N
1530,O,640,640,13120,920,9551,1531,12480,O
1530,P,1549,1549,14669,3960,13511,1531,13120,P
1531,AE,556,556,556,2104,2104,1532,0,E
1531,AF,2106,1550,2106,2197,2197,1532,0,A
1531,BF,1613,63,2169,90,2194,1532,556,F
1531,BG,116,53,2222,90,2287,1532,2106,B
1531,CG,622,622,2844,820,3107,1532,2222,C
1531,DG,7,7,2851,3780,6887,1532,2844,D
1531,G,1422,740,3591,1745,3939,1532,2169,G
1531,H,1,1,3592,3780,7719,1532,3591,H
1531,M,2832,2832,6424,3402,11121,1532,3592,M
1531,N,721,721,7145,90,11211,1532,6424,N
1531,O,699,699,7844,1135,12346,1532,7145,O
1531,P,47874,47874,55718,3780,16126,1532,7844,P
1532,A,578,578,578,1564,1564,1533,0,A
1532,B,1345,1345,1923,385,1949,1533,578,B
1532,C,1116,1116,3039,1105,3054,1533,1923,C
1532,B,670,670,3709,760,3814,1533,3039,B
1532,C,683,683,4392,754,4568,1533,3709,C
1532,D,141,141,4533,466,5034,1533,4392,D
1532,M,131,131,4664,150,5184,1533,4533,M
1532,N,109,109,4773,150,5334,1533,4664,N
1532,O,175,175,4948,95,5429,1533,4773,O
1532,N,1088,1088,6036,1095,6524,1533,4948,N
1532,O,1065,1065,7101,1334,7858,1533,6036,O
1532,P,115,115,7216,736,8594,1533,7101,P
1533,A,1089,1089,1089,2053,2053,1534,0,A
1533,B,990,990,2079,90,2143,1534,1089,B
1533,C,585,585,2664,820,2963,1534,2079,C
1533,B,746,746,3410,500,3463,1534,2664,B
1533,C,1036,1036,4446,1275,4738,1534,3410,C
1533,D,588,588,5034,3780,8518,1534,4446,D
1533,M,70,70,5104,889,9407,1534,5034,M
1533,N,1024,1024,6128,240,9647,1534,5104,N
1533,O,661,661,6789,880,10527,1534,6128,O
1533,P,6,6,6795,3960,14487,1534,6789,P
1534,AEI,132,132,132,382,382,1535,0,I
1534,AEJ,261,129,261,1659,1659,1535,0,E
1534,AFJ,78,78,339,180,1839,1535,261,F
1534,AGJ,433,226,565,240,622,1535,132,J
1534,AGK,685,459,1024,660,2499,1535,339,G
1534,AFK,429,429,1453,990,3489,1535,1024,F
1534,AGK,1139,251,1704,1165,1787,1535,565,K
1534,AGL,67,67,1771,550,2337,1535,1704,L
1534,AG,757,439,2210,720,4209,1535,1453,G
1534,AH,200,200,2410,550,4759,1535,2210,H
1534,A,3116,706,3116,3462,3462,1535,0,A
1534,B,492,492,3608,180,3642,1535,3116,B
1534,C,1065,1065,4673,1160,4802,1535,3608,C
1534,D,379,379,5052,960,5762,1535,4673,D
1534,M,22933,22933,27985,23672,29434,1535,5052,M
1534,N,767,767,28752,90,29524,1535,27985,N
1534,O,882,882,29634,1215,30739,1535,28752,O
1534,P,213,213,29847,3780,34519,1535,29634,P
1535,AE,200,200,200,694,694,1536,0,E
1535,AF,332,132,332,945,945,1536,0,A
1535,BF,895,763,1095,420,1114,1536,200,F
1535,BG,1115,352,1447,600,1545,1536,332,B
1535,CG,870,518,1965,855,1969,1536,1095,G
1535,CH,780,262,2227,690,2235,1536,1447,C
1535,BH,147,147,2374,155,2390,1536,2227,B
1535,CH,746,746,3120,740,3130,1536,2374,C
1535,DH,212,212,3332,385,3515,1536,3120,D
1535,H,1403,36,3368,550,2519,1536,1965,H
1535,M,677,677,4045,1723,5238,1536,3368,M
1535,N,1159,1159,5204,150,5388,1536,4045,N
1535,O,817,817,6021,828,6216,1536,5204,O
1535,P,1601,1601,7622,372,6588,1536,6021,P
1536,AE,443,443,443,2175,2175,1537,0,A
1536,BE,453,10,453,612,612,1537,0,E
1536,BF,211,211,664,90,702,1537,453,F
1536,BG,1442,1442,2106,1935,2637,1537,664,G
1536,BH,2496,833,2939,780,2955,1537,443,B
1536,CH,506,506,3445,805,3760,1537,2939,C
1536,DH,4523,3184,6629,3780,6417,1537,2106,H
1536,D,7652,4468,11097,300,4060,1537,3445,D
1536,M,468,468,11565,1930,8347,1537,11097,M
1536,N,1527,1527,13092,90,8437,1537,11565,N
1536,O,1435,1435,14527,1745,10182,1537,13092,O
1536,P,30,30,14557,3780,13962,1537,14527,P
1537,AE,121,121,121,780,780,1538,0,A
1537,BE,749,749,870,150,930,1538,121,B
1537,CE,170,170,1040,130,1060,1538,870,C
1537,BE,217,217,1257,235,1295,1538,1040,B
1537,CE,1509,252,1509,1515,1515,1538,0,E
1537,CF,468,216,1725,520,1815,1538,1257,C
1537,DF,268,52,1777,300,1815,1538,1509,F
1537,DG,631,631,2408,840,2655,1538,1777,G
1537,DH,2509,1826,4234,4230,6045,1538,1725,D
1537,H,3132,1306,5540,1140,3795,1538,2408,H
1537,M,1358,1358,6898,1710,7755,1538,5540,M
1537,N,628,628,7526,300,8055,1538,6898,N
1537,O,739,739,8265,865,8920,1538,7526,O
1537,P,70,70,8335,1620,10540,1538,8265,P
1538,AE,671,671,671,1313,1313,1539,0,E
1538,AF,673,673,1344,90,1403,1539,671,F
1538,AG,409,409,1753,800,2203,1539,1344,G
1538,AH,844,844,2597,3780,5983,1539,1753,H
1538,A,5176,2579,5176,5888,5888,1539,0,A
1538,B,734,734,5910,90,5978,1539,5176,B
1538,C,1185,1185,7095,1430,7408,1539,5910,C
1538,B,1015,1015,8110,740,8148,1539,7095,B
1538,C,417,417,8527,800,8948,1539,8110,C
1538,D,958,958,9485,3780,12728,1539,8527,D
1538,M,530,530,10015,1157,13885,1539,9485,M
1538,N,747,747,10762,180,14065,1539,10015,N
1538,O,775,775,11537,795,14860,1539,10762,O
1538,P,1207,1207,12744,550,15410,1539,11537,P
1539,AEI,212,212,212,482,482,1540,0,E
1539,AFI,325,113,325,1415,1415,1540,0,A
1539,BFI,335,222,547,90,572,1540,212,F
1539,BGI,1120,898,1445,90,1505,1540,325,B
1539,CGI,1436,538,1983,1745,2317,1540,547,G
1539,CHI,51,51,2034,3840,6157,1540,1983,H
1539,CI,942,353,2387,1240,2745,1540,1445,C
1539,DI,2925,2925,5312,3780,6525,1540,2387,D
1539,I,37086,31774,37086,38353,38353,1540,0,I
1539,J,1397,1397,38483,90,38443,1540,37086,J
1539,K,1048,1048,39531,1450,39893,1540,38483,K
1539,L,231,231,39762,3780,43673,1540,39531,L
1539,M,450,450,40212,1130,44803,1540,39762,M
1539,N,730,730,40942,90,44893,1540,40212,N
1539,O,492,492,41434,905,45798,1540,40942,O
1539,P,5187,5187,46621,3780,49578,1540,41434,P
1540,A,500,500,500,781,781,1541,0,A
1540,B,329,329,829,90,871,1541,500,B
1540,C,412,412,1241,800,1671,1541,829,C
1540,D,1397,1397,2638,3780,5451,1541,1241,D
1540,M,1933,1933,4571,2377,7828,1541,2638,M
1540,N,503,503,5074,120,7948,1541,4571,N
1540,O,959,959,6033,870,8818,1541,5074,O
1540,N,127,127,6160,210,9028,1541,6033,N
1540,O,1878,1878,8038,2169,11197,1541,6160,O
1540,P,5,5,8043,1881,13078,1541,8038,P
1541,AE,1045,1045,1045,1597,1597,1542,0,A
1541,BE,580,580,1625,90,1687,1542,1045,B
1541,CE,594,594,2219,820,2507,1542,1625,C
1541,DE,111,111,2330,3780,6287,1542,2219,D
1541,E,4736,2406,4736,5041,5041,1542,0,E
1541,F,346,346,5082,90,5131,1542,4736,F
1541,G,493,493,5575,815,5946,1542,5082,G
1541,H,135,135,5710,3780,9726,1542,5575,H
1541,M,841,841,6551,1336,11062,1542,5710,M
1541,N,528,528,7079,90,11152,1542,6551,N
1541,O,246,246,7325,695,11847,1542,7079,O
1541,P,11823,11823,19148,3840,15687,1542,7325,P
1542,A,127,127,127,178,178,1543,0,A
1542,B,161,161,288,150,328,1543,127,B
1542,C,625,625,913,765,1093,1543,288,C
1542,D,700,700,1613,3600,4693,1543,913,D
1542,M,416,416,2029,610,5303,1543,1613,M
1542,N,341,341,2370,150,5453,1543,2029,N
1542,O,410,410,2780,475,5928,1543,2370,O
1542,N,142,142,2922,120,6048,1543,2780,N
1542,O,125,125,3047,125,6173,1543,2922,O
1542,P,628,628,3675,2880,9053,1543,3047,P
1543,AEI,27,27,27,124,124,1544,0,E
1543,AFI,86,59,86,90,90,1544,0,I
1543,AFJ,137,51,137,160,160,1544,0,A
1543,BFJ,124,73,210,180,270,1544,86,J
1543,BFK,277,94,304,240,364,1544,27,F
1543,BGK,213,46,350,240,400,1544,137,B
1543,CGK,163,163,513,285,685,1544,350,C
1543,DGK,321,18,531,265,535,1544,210,K
1543,DGJ,372,372,903,425,960,1544,531,J
1543,DGK,811,212,1115,285,649,1544,304,G
1543,DHK,705,103,1218,5160,5845,1544,513,D
1543,HK,338,23,1241,280,1240,1544,903,K
1543,HL,154,28,1269,5160,5809,1544,1115,H
1543,L,1197,1169,2438,5160,6400,1544,1241,L
1543,M,4774,4774,7212,4910,11310,1544,2438,M
1543,N,436,436,7648,360,11670,1544,7212,N
1543,O,1877,1877,9525,1495,13165,1544,7648,O
1543,N,743,743,10268,1115,14280,1544,9525,N
1543,O,1077,1077,11345,1190,15470,1544,10268,O
1543,P,1004,1004,12349,665,16135,1544,11345,P
1544,A,1410,1410,1410,1735,1735,1545,0,A
1544,B,445,445,1855,180,1915,1545,1410,B
1544,C,864,864,2719,780,2695,1545,1855,C
1544,D,1533,1533,4252,550,3245,1545,2719,D
1544,M,320,320,4572,958,4203,1545,4252,M
1544,N,767,767,5339,150,4353,1545,4572,N
1544,O,1024,1024,6363,1016,5369,1545,5339,O
1544,P,279,279,6642,434,5803,1545,6363,P
1545,AE,84,84,84,139,139,1546,0,A
1545,BE,152,152,236,150,289,1546,84,B
1545,BE,236,0,236,2441,2441,1546,0,E
1545,CF,653,653,889,620,909,1546,236,C
1545,DF,633,633,1522,4200,5109,1546,889,D
1545,F,2517,1231,2753,360,2801,1546,236,F
1545,G,1139,1139,3892,995,3796,1546,2753,G
1545,H,703,703,4595,3960,7756,1546,3892,H
1545,M,1021,1021,5616,1428,9184,1546,4595,M
1545,N,723,723,6339,90,9274,1546,5616,N
1545,O,1080,1080,7419,1430,10704,1546,6339,O
1545,P,100,100,7519,3780,14484,1546,7419,P
1546,AE,58,58,58,390,390,1547,0,E
1546,AF,343,285,343,777,777,1547,0,A
1546,BF,407,122,465,135,525,1547,58,F
1546,BG,217,217,682,295,820,1547,465,G
1546,BH,112,112,794,5100,5920,1547,682,H
1546,B,466,15,809,90,867,1547,343,B
1546,C,1077,1077,1886,1425,2292,1547,809,C
1546,D,144,144,2030,3780,6072,1547,1886,D
1546,M,2046,2046,4076,2720,8792,1547,2030,M
1546,N,768,768,4844,90,8882,1547,4076,N
1546,O,1091,1091,5935,1385,10267,1547,4844,O
1546,N,785,785,6720,535,10802,1547,5935,N
1546,O,588,588,7308,940,11742,1547,6720,O
1546,P,1121,1121,8429,3780,15522,1547,7308,P
1547,AE,165,165,165,1051,1051,1548,0,E
1547,AF,310,145,310,341,341,1548,0,A
1547,BF,181,181,491,210,551,1548,310,B
1547,CF,160,160,651,250,801,1548,491,C
1547,BF,1006,520,1171,180,1231,1548,165,F
1547,BG,677,157,1328,580,1381,1548,651,B
1547,CG,144,144,1472,240,1621,1548,1328,C
1547,DG,9,9,1481,5040,6661,1548,1472,D
1547,G,998,688,2169,1050,2281,1548,1171,G
1547,F,2094,2094,4263,1990,4271,1548,2169,F
1547,G,145,145,4408,240,4511,1548,4263,G
1547,H,67,67,4475,5040,9551,1548,4408,H
1547,M,8640,8640,13115,9911,19462,1548,4475,M
1547,N,1421,1421,14536,210,19672,1548,13115,N
1547,O,927,927,15463,1141,20813,1548,14536,O
1547,N,2048,2048,17511,1809,22622,1548,15463,N
1547,O,1290,1290,18801,611,23233,1548,17511,O
1547,P,297,297,19098,1209,24442,1548,18801,P
1548,AE,554,554,554,720,720,1549,0,E
1548,AF,577,23,577,1578,1578,1549,0,A
1548,BF,235,212,789,90,810,1549,554,F
1548,BG,589,589,1378,815,1625,1549,789,G
1548,BH,1048,247,1625,90,1668,1549,577,B
1548,CH,1237,990,2615,3780,5405,1549,1378,H
1548,C,1094,104,2719,1210,2878,1549,1625,C
1548,D,386,386,3105,3780,6658,1549,2719,D
1548,M,399,399,3504,1235,7893,1549,3105,M
1548,N,869,869,4373,90,7983,1549,3504,N
1548,O,243,243,4616,695,8678,1549,4373,O
1548,P,6194,6194,10810,3780,12458,1549,4616,P
1549,AEI,23,23,23,155,155,1550,0,E
1549,AFI,338,338,361,240,395,1550,23,F
1549,AGI,799,799,1160,1045,1440,1550,361,G
1549,AHI,170,170,1330,3960,5400,1550,1160,H
1549,AI,2424,1094,2424,2541,2541,1550,0,A
1549,BI,274,274,2698,90,2631,1550,2424,B
1549,CI,696,696,3394,795,3426,1550,2698,C
1549,DI,229,229,3623,3840,7266,1550,3394,D
1549,I,13653,10030,13653,12442,12442,1550,0,I
1549,J,439,439,14092,240,12682,1550,13653,J
1549,K,768,768,14860,1035,13717,1550,14092,K
1549,J,1784,1784,16644,1470,15187,1550,14860,J
1549,K,810,810,17454,1040,16227,1550,16644,K
1549,L,155,155,17609,3960,20187,1550,17454,L
1549,M,366,366,17975,1324,21511,1550,17609,M
1549,N,998,998,18973,90,21601,1550,17975,N
1549,O,244,244,19217,695,22296,1550,18973,O
1549,P,3453,3453,22670,3780,26076,1550,19217,P
1550,AEI,210,210,210,708,708,1551,0,A
1550,BEI,401,191,401,1338,1338,1551,0,E
1550,BFI,605,414,815,150,858,1551,210,B
1550,CFI,156,156,971,125,983,1551,815,C
1550,BFI,132,132,1103,155,1138,1551,971,B
1550,CFI,963,261,1364,90,1428,1551,401,F
1550,CGI,299,38,1402,650,1788,1551,1103,C
1550,DGI,1608,206,1608,2139,2139,1551,0,I
1550,DGJ,522,278,1886,905,2333,1551,1364,G
1550,DFJ,560,282,2168,90,2229,1551,1608,J
1550,DFK,478,196,2364,90,2423,1551,1886,F
1550,DGK,1517,1321,3685,2320,4549,1551,2168,K
1550,DGL,2729,1408,5093,2320,4743,1551,2364,G
1550,DHL,359,359,5452,3420,8163,1551,5093,H
1550,DL,4427,377,5829,4230,6018,1551,1402,D
1550,L,4535,2391,8220,3420,7969,1551,3685,L
1550,M,1365,1365,9585,1385,9548,1551,8220,M
1550,N,240,240,9825,240,9788,1551,9585,N
1550,O,749,749,10574,855,10643,1551,9825,O
1550,P,461,461,11035,3960,14603,1551,10574,P
1551,AEI,91,91,91,100,100,1552,0,A
1551,BEI,168,77,168,1101,1101,1552,0,E
1551,BFI,107,30,198,150,250,1552,91,B
1551,CFI,161,161,359,295,545,1552,198,C
1551,BFI,1053,862,1221,180,1281,1552,168,F
1551,BGI,1752,890,2111,1630,2175,1552,359,B
1551,CGI,904,14,2125,1050,2331,1552,1221,G
1551,CFI,690,676,2801,810,2985,1552,2111,C
1551,DFI,279,279,3080,5040,8025,1552,2801,D
1551,FI,1704,749,3829,1555,3886,1552,2125,F
1551,GI,723,723,4552,810,4696,1552,3829,G
1551,HI,97,97,4649,5040,9736,1552,4552,H
1551,I,5917,1268,5917,6094,6094,1552,0,I
1551,J,357,357,6274,240,6334,1552,5917,J
1551,K,860,860,7134,960,7294,1552,6274,K
1551,J,1150,1150,8284,840,8134,1552,7134,J
1551,K,687,687,8971,1324,9458,1552,8284,K
1551,L,6523,6523,15494,621,10079,1552,8971,L
1551,M,1316,1316,16810,3423,13502,1552,15494,M
1551,N,2314,2314,19124,90,13592,1552,16810,N
1551,O,373,373,19497,725,14317,1552,19124,O
1551,P,1785,1785,21282,3780,18097,1552,19497,P
1552,AE,78,78,78,159,159,1553,0,E
1552,AF,210,132,210,215,215,1553,0,A
1552,BF,266,134,344,240,399,1553,78,F
1552,BG,284,150,494,300,515,1553,210,B
1552,CG,226,76,570,285,684,1553,344,G
1552,CH,597,521,1091,800,1315,1553,494,C
1552,DH,133,133,1224,1140,2455,1553,1091,D
1552,H,1762,1108,2332,5280,5964,1553,570,H
1552,M,1497,1497,3829,1814,7778,1553,2332,M
1552,N,341,341,4170,90,7868,1553,3829,N
1552,O,893,893,5063,1250,9118,1553,4170,O
1552,P,435,435,5498,3780,12898,1553,5063,P
1553,AEI,562,562,562,1448,1448,1554,0,E
1553,AFI,1069,507,1069,1503,1503,1554,0,A
1553,BFI,916,409,1478,90,1538,1554,562,F
1553,BGI,470,61,1539,90,1593,1554,1069,B
1553,CGI,530,530,2069,970,2563,1554,1539,C
1553,DGI,69,69,2138,3780,6343,1554,2069,D
1553,GI,928,268,2406,1200,2738,1554,1478,G
1553,HI,2519,113,2519,3085,3085,1554,0,I
1553,HJ,132,19,2538,3780,6518,1554,2406,H
1553,J,596,577,3115,90,3175,1554,2519,J
1553,K,522,522,3637,750,3925,1554,3115,K
1553,L,507,507,4144,3780,7705,1554,3637,L
1553,M,1841,1841,5985,2186,9891,1554,4144,M
1553,N,378,378,6363,90,9981,1554,5985,N
1553,O,927,927,7290,1175,11156,1554,6363,O
1553,P,24614,24614,31904,3780,14936,1554,7290,P
1554,AE,842,842,842,1169,1169,1555,0,A
1554,BE,447,447,1289,180,1349,1555,842,B
1554,CE,1597,308,1597,1851,1851,1555,0,E
1554,CF,374,374,1971,180,2031,1555,1597,F
1554,CG,961,279,2250,1200,2549,1555,1289,C
1554,BG,928,649,2899,900,2931,1555,1971,G
1554,BF,801,152,3051,550,3099,1555,2250,B
1554,CF,105,105,3156,152,3251,1555,3051,C
1554,DF,384,127,3283,405,3336,1555,2899,F
1554,DG,82,82,3365,131,3467,1555,3283,G
1554,DH,314,105,3470,363,3614,1555,3156,D
1554,H,164,59,3529,414,3881,1555,3365,H
1554,M,138,138,3667,82,3963,1555,3529,M
1554,N,134,134,3801,240,4203,1555,3667,N
1554,O,119,119,3920,380,4583,1555,3801,O
1554,N,1035,1035,4955,770,5353,1555,3920,N
1554,O,626,626,5581,825,6178,1555,4955,O
1554,P,2184,2184,7765,3960,10138,1555,5581,P
1555,AE,1411,1411,1411,1475,1475,1556,0,E
1555,AF,1677,266,1677,2098,2098,1556,0,A
1555,BF,334,68,1745,300,1775,1556,1411,F
1555,BG,601,533,2278,240,2338,1556,1677,B
1555,CG,816,283,2561,1035,2810,1556,1745,G
1555,CH,610,327,2888,1020,3358,1556,2278,C
1555,BH,1552,1225,4113,1890,4700,1556,2561,H
1555,B,1316,91,4204,875,4233,1556,2888,B
1555,C,738,738,4942,942,5175,1556,4204,C
1555,D,3167,3167,8109,973,6148,1556,4942,D
1555,M,640,640,8749,2146,8294,1556,8109,M
1555,N,1536,1536,10285,90,8384,1556,8749,N
1555,O,1826,1826,12111,2185,10569,1556,10285,O
1555,N,426,426,12537,40,10609,1556,12111,N
1555,O,588,588,13125,945,11554,1556,12537,O
1555,P,1297,1297,14422,3780,15334,1556,13125,P
1556,A,583,583,583,508,508,1557,0,A
1556,B,284,284,867,135,643,1557,583,B
1556,C,4999,4999,5866,865,1508,1557,867,C
1556,D,1,1,5867,1200,2708,1557,5866,D
1556,M,135,135,6002,220,2928,1557,5867,M
1556,N,201,201,6203,180,3108,1557,6002,N
1556,O,175,175,6378,540,3648,1557,6203,O
1556,P,587,587,6965,2860,6508,1557,6378,P
1557,AEI,39,39,39,1119,1119,1558,0,I
1557,AEJ,677,638,677,1269,1269,1558,0,A
1557,BEJ,1129,452,1129,1344,1344,1558,0,E
1557,BFJ,642,190,1319,90,1359,1558,677,B
1557,CFJ,1330,50,1369,165,1284,1558,39,J
1557,CFK,251,11,1380,90,1434,1558,1129,F
1557,CGK,433,433,1813,795,2229,1558,1380,G
1557,CFK,553,59,1872,860,2219,1558,1319,C
1557,DFK,607,104,1976,825,2109,1558,1369,K
1557,DFL,619,456,2432,255,2484,1558,1813,F
1557,DGL,485,485,2917,850,3334,1558,2432,G
1557,DHL,87,87,3004,3780,7114,1558,2917,H
1557,DL,1310,178,3182,3780,5999,1558,1872,D
1557,L,1564,358,3540,3960,6069,1558,1976,L
1557,M,506,506,4046,1502,8616,1558,3540,M
1557,N,1266,1266,5312,300,8916,1558,4046,N
1557,O,702,702,6014,970,9886,1558,5312,O
1557,N,512,512,6526,350,10236,1558,6014,N
1557,O,233,233,6759,390,10626,1558,6526,O
1557,P,413,413,7172,3960,14586,1558,6759,P
1558,AE,53,53,53,209,209,1559,0,A
1558,BE,358,358,411,240,449,1559,53,B
1558,CE,202,202,613,225,674,1559,411,C
1558,DE,1307,694,1307,1802,1802,1559,0,E
1558,DF,675,675,1982,240,2042,1559,1307,F
1558,DG,1481,112,2094,4890,5564,1559,613,D
1558,G,804,692,2786,695,2737,1559,1982,G
1558,H,478,478,3264,3960,6697,1559,2786,H
1558,M,314,314,3578,414,7111,1559,3264,M
1558,N,299,299,3877,240,7351,1559,3578,N
1558,O,674,674,4551,960,8311,1559,3877,O
1558,P,298,298,4849,3960,12271,1559,4551,P
1559,AEI,1250,1250,1250,1524,1524,1560,0,A
1559,BEI,1473,223,1473,1584,1584,1560,0,I
1559,BEJ,304,81,1554,90,1614,1560,1250,B
1559,CEJ,224,143,1697,90,1674,1560,1473,J
1559,CEK,394,251,1948,744,2358,1560,1554,C
1559,DEK,526,275,2223,820,2494,1560,1697,K
1559,DEJ,1059,1059,3282,845,3339,1560,2223,J
1559,DEK,456,456,3738,740,4079,1560,3282,K
1559,DEL,5893,2155,5893,7711,7711,1560,0,E
1559,DFL,3963,18,5911,3780,6138,1560,1948,D
1559,FL,2537,364,6275,3780,7859,1560,3738,L
1559,F,1839,1457,7732,90,7801,1560,5893,F
1559,G,1409,1409,9141,1680,9481,1560,7732,G
1559,H,7644,7644,16785,3780,13261,1560,9141,H
1559,M,531,531,17316,986,14247,1560,16785,M
1559,N,495,495,17811,90,14337,1560,17316,N
1559,O,656,656,18467,655,14992,1560,17811,O
1559,P,1246,1246,19713,550,15542,1560,18467,P
1560,A,23,23,23,350,350,1561,0,A
1560,B,844,844,867,540,890,1561,23,B
1560,C,227,227,1094,420,1310,1561,867,C
1560,D,2948,2948,4042,2820,4130,1561,1094,D
1560,M,291,291,4333,350,4480,1561,4042,M
1560,N,813,813,5146,730,5210,1561,4333,N
1560,O,961,961,6107,925,6135,1561,5146,O
1560,P,1427,1427,7534,2760,8895,1561,6107,P
1561,AE,209,209,209,202,202,1562,0,A
1561,BE,88,88,297,150,352,1562,209,B
1561,CE,146,146,443,140,492,1562,297,C
1561,BE,910,910,1353,900,1392,1562,443,B
1561,CE,347,347,1700,650,2042,1562,1353,C
1561,DE,1948,248,1948,1956,1956,1562,0,E
1561,DF,128,128,2076,180,2136,1562,1948,F
1561,DG,521,521,2597,790,2926,1562,2076,G
1561,DF,1954,1954,4551,1650,4576,1562,2597,F
1561,DG,1043,1043,5594,1121,5697,1562,4551,G
1561,DH,4840,946,6540,4230,6272,1562,1700,D
1561,H,5253,4307,10847,564,6261,1562,5594,H
1561,M,2751,2751,13598,2743,9015,1562,10847,M
1561,N,209,209,13807,240,9255,1562,13598,N
1561,O,1160,1160,14967,855,10110,1562,13807,O
1561,N,162,162,15129,490,10600,1562,14967,N
1561,O,120,120,15249,600,11200,1562,15129,O
1561,P,7768,7768,23017,3810,15010,1562,15249,P
1562,AEI,265,265,265,547,547,1563,0,E
1562,AFI,292,27,292,536,536,1563,0,A
1562,BFI,275,275,567,90,626,1563,292,B
1562,CFI,306,4,571,90,637,1563,265,F
1562,CGI,1067,496,1067,1592,1592,1563,0,I
1562,CGJ,868,372,1439,1105,1742,1563,571,G
1562,CHJ,180,180,1619,3780,5522,1563,1439,H
1562,CHJ,552,0,1619,90,1682,1563,1067,J
1562,CK,1467,415,2034,1745,2371,1563,567,C
1562,DK,52,52,2086,3780,6151,1563,2034,D
1562,K,951,484,2570,1250,2932,1563,1619,K
1562,L,8,8,2578,3780,6712,1563,2570,L
1562,M,1815,1815,4393,2400,9112,1563,2578,M
1562,N,741,741,5134,90,9202,1563,4393,N
1562,O,414,414,5548,815,10017,1563,5134,O
1562,P,7290,7290,12838,3780,13797,1563,5548,P
1563,AEI,196,196,196,754,754,1564,0,E
1563,AFI,380,184,380,415,415,1564,0,A
1563,BFI,501,121,501,1232,1232,1564,0,I
1563,BFJ,689,384,885,180,934,1564,196,F
1563,BGJ,600,95,980,595,1010,1564,380,B
1563,CGJ,100,5,985,205,1139,1564,885,G
1563,CFJ,259,254,1239,405,1415,1564,980,C
1563,BFJ,830,92,1331,150,1382,1564,501,J
1563,BFK,406,314,1645,210,1625,1564,1239,B
1563,CFK,195,195,1840,2480,4105,1564,1645,C
1563,DFK,808,299,2139,1030,2412,1564,1331,K
1563,DFJ,1874,720,2859,1680,2819,1564,985,F
1563,DGJ,1165,445,3304,925,3337,1564,2139,J
1563,DGK,643,198,3502,780,3599,1564,2859,G
1563,DHK,634,436,3938,705,4042,1564,3304,K
1563,DHL,2305,207,4145,1955,6060,1564,1840,D
1563,HL,1434,1227,5372,4230,8272,1564,3938,L
1563,H,2702,832,6204,4140,7739,1564,3502,H
1563,M,635,635,6839,295,8567,1564,6204,M
1563,N,211,211,7050,600,9167,1564,6839,N
1563,O,241,241,7291,420,9587,1564,7050,O
1563,N,432,432,7723,245,9832,1564,7291,N
1563,O,2341,2341,10064,2545,12377,1564,7723,O
1563,P,40,40,10104,1800,14177,1564,10064,P
1564,A,74,74,74,986,986,1565,0,A
1564,B,1099,1099,1173,240,1226,1565,74,B
1564,C,872,872,2045,1020,2246,1565,1173,C
1564,D,83,83,2128,4680,6926,1565,2045,D
1564,M,2340,2340,4468,3105,10031,1565,2128,M
1564,N,1026,1026,5494,300,10331,1565,4468,N
1564,O,1326,1326,6820,1220,11551,1565,5494,O
1564,N,133,133,6953,235,11786,1565,6820,N
1564,O,344,344,7297,535,12321,1565,6953,O
1564,N,425,425,7722,250,12571,1565,7297,N
1564,O,554,554,8276,790,13361,1565,7722,O
1564,P,2800,2800,11076,4020,17381,1565,8276,P
1565,AE,16,16,16,1501,1501,1566,0,E
1565,AF,503,487,503,598,598,1566,0,A
1565,BF,219,219,722,185,783,1566,503,B
1565,CF,545,545,1267,525,1308,1566,722,C
1565,DF,22,22,1289,2880,4188,1566,1267,D
1565,F,1671,398,1687,240,1741,1566,16,F
1565,G,614,614,2301,745,2486,1566,1687,G
1565,F,485,485,2786,360,2846,1566,2301,F
1565,G,387,387,3173,290,3136,1566,2786,G
1565,H,3480,3480,6653,5100,8236,1566,3173,H
1565,M,454,454,7107,667,8903,1566,6653,M
1565,N,404,404,7511,240,9143,1566,7107,N
1565,O,150,150,7661,395,9538,1566,7511,O
1565,N,374,374,8035,120,9658,1566,7661,N
1565,O,1030,1030,9065,809,10467,1566,8035,O
1565,P,7554,7554,16619,3840,14307,1566,9065,P
1566,A,22,22,22,89,89,1567,0,A
1566,B,265,265,287,240,329,1567,22,B
1566,C,711,711,998,930,1259,1567,287,C
1566,D,1307,1307,2305,3960,5219,1567,998,D
1566,M,240,240,2545,916,6135,1567,2305,M
1566,N,797,797,3342,180,6315,1567,2545,N
1566,O,890,890,4232,900,7215,1567,3342,O
1566,P,2706,2706,6938,550,7765,1567,4232,P
1567,AEI,6,6,6,1270,1270,1568,0,I
1567,AEJ,96,90,96,2471,2471,1568,0,E
1567,AFJ,434,338,434,819,819,1568,0,A
1567,BFJ,415,415,849,90,909,1568,434,B
1567,CFJ,369,369,1218,800,1709,1568,849,C
1567,DFJ,1553,341,1559,300,1570,1568,6,J
1567,DFK,936,936,2495,1000,2570,1568,1559,K
1567,DFL,2561,162,2657,240,2711,1568,96,F
1567,DGL,1729,290,2947,3780,5489,1568,1218,D
1567,GL,519,67,3014,1200,3770,1568,2495,L
1567,G,805,448,3462,995,3706,1568,2657,G
1567,H,4397,4397,7859,4680,8386,1568,3462,H
1567,M,1044,1044,8903,1596,9982,1568,7859,M
1567,N,580,580,9483,90,10072,1568,8903,N
1567,O,594,594,10077,820,10892,1568,9483,O
1567,N,535,535,10612,305,11197,1568,10077,N
1567,O,143,143,10755,535,11732,1568,10612,O
1567,P,113,113,10868,3780,15512,1568,10755,P
1568,AE,37,37,37,922,922,1569,0,E
1568,AF,1072,1072,1109,240,1162,1569,37,F
1568,AG,1268,159,1268,1383,1383,1569,0,A
1568,BG,473,314,1582,750,1912,1569,1109,G
1568,BH,342,28,1610,300,1683,1569,1268,B
1568,CH,567,567,2177,775,2458,1569,1610,C
1568,BH,1486,1486,3663,1255,3713,1569,2177,B
1568,CH,2150,69,3732,3540,5452,1569,1582,H
1568,C,470,401,4133,760,4473,1569,3663,C
1568,D,2181,2181,6314,3540,8013,1569,4133,D
1568,M,371,371,6685,1335,9348,1569,6314,M
1568,N,1204,1204,7889,180,9528,1569,6685,N
1568,O,1223,1223,9112,875,10403,1569,7889,O
1568,N,1072,1072,10184,1540,11943,1569,9112,N
1568,O,408,408,10592,700,12643,1569,10184,O
1568,P,13018,13018,23610,6840,19483,1569,10592,P
1569,A,4342,4342,4342,4889,4889,1570,0,A
1569,B,600,600,4942,90,4979,1570,4342,B
1569,C,760,760,5702,1130,6109,1570,4942,C
1569,D,170,170,5872,3780,9889,1570,5702,D
1569,M,1,1,5873,558,10447,1570,5872,M
1569,N,586,586,6459,90,10537,1570,5873,N
1569,O,585,585,7044,850,11387,1570,6459,O
1569,P,572,572,7616,3780,15167,1570,7044,P
1570,AEI,141,141,141,185,185,1571,0,A
1570,BEI,166,25,166,689,689,1571,0,E
1570,BFI,142,117,283,150,335,1571,141,B
1570,CFI,157,157,440,805,1140,1571,283,C
1570,DFI,498,58,498,1009,1009,1571,0,I
1570,DFJ,79,21,519,3600,4740,1571,440,D
1570,FJ,703,350,869,240,929,1571,166,F
1570,GJ,158,158,1027,380,1309,1571,869,G
1570,HJ,691,162,1189,240,1249,1571,498,J
1570,HK,142,142,1331,395,1644,1571,1189,K
1570,HL,2847,2847,4178,9700,11344,1571,1331,L
1570,H,4688,1537,5715,9700,11009,1571,1027,H
1570,M,369,369,6084,1584,12928,1571,5715,M
1570,N,1316,1316,7400,150,13078,1571,6084,N
1570,O,195,195,7595,180,13258,1571,7400,O
1570,N,1346,1346,8941,1345,14603,1571,7595,N
1570,O,702,702,9643,775,15378,1571,8941,O
1570,P,2074,2074,11717,4230,19608,1571,9643,P
1571,AE,457,457,457,2125,2125,1572,0,E
1571,AF,836,379,836,928,928,1572,0,A
1571,BF,190,190,1026,150,1078,1572,836,B
1571,CF,129,129,1155,170,1248,1572,1026,C
1571,DF,473,473,1628,4200,5448,1572,1155,D
1571,F,2043,872,2500,420,2545,1572,457,F
1571,G,3792,3792,6292,1390,3935,1572,2500,G
1571,H,40238,40238,46530,3960,7895,1572,6292,H
1571,M,22149,22149,68679,23059,30954,1572,46530,M
1571,N,1490,1490,70169,90,31044,1572,68679,N
1571,O,518,518,70687,865,31909,1572,70169,O
1571,P,490,490,71177,3780,35689,1572,70687,P
1572,A,32973,32973,32973,33151,33151,1573,0,A
1572,B,205,205,33178,90,33241,1573,32973,B
1572,C,832,832,34010,1165,34406,1573,33178,C
1572,B,770,770,34780,435,34841,1573,34010,B
1572,C,182,182,34962,605,35446,1573,34780,C
1572,D,5947,5947,40909,3780,39226,1573,34962,D
1572,M,3,3,40912,1621,40847,1573,40909,M
1572,N,1865,1865,42777,300,41147,1573,40912,N
1572,O,909,909,43686,895,42042,1573,42777,O
1572,P,1488,1488,45174,550,42592,1573,43686,P
1573,AEI,1745,1745,1745,2657,2657,1574,0,I
1573,AEJ,1828,83,1828,4102,4102,1574,0,E
1573,AFJ,2138,310,2138,2839,2839,1574,0,A
1573,BFJ,953,560,2698,90,2747,1574,1745,J
1573,BFK,741,181,2879,90,2929,1574,2138,B
1573,CFK,548,367,3246,880,3627,1574,2698,K
1573,CFJ,433,66,3312,805,3734,1574,2879,C
1573,BFJ,803,737,4049,485,4112,1574,3246,J
1573,BFK,2308,87,4136,90,4192,1574,1828,F
1573,BGK,787,700,4836,1060,5172,1574,4049,K
1573,BGL,1017,317,5153,1210,5402,1574,4136,G
1573,BFL,482,165,5318,3780,8952,1574,4836,L
1573,BF,621,456,5774,430,5832,1574,5153,F
1573,BG,756,756,6530,1060,6892,1574,5774,G
1573,BH,3558,340,6870,3180,6914,1574,3312,B
1573,CH,812,472,7342,3780,10672,1574,6530,H
1573,C,815,343,7685,1060,7974,1574,6870,C
1573,D,97,97,7782,3780,11754,1574,7685,D
1573,M,1360,1360,9142,1580,13334,1574,7782,M
1573,N,248,248,9390,90,13424,1574,9142,N
1573,O,356,356,9746,720,14144,1574,9390,O
1573,P,2329,2329,12075,3780,17924,1574,9746,P
1574,AEI,65,65,65,49,49,1575,0,A
1574,BEI,67,2,67,172,172,1575,0,I
1574,BEJ,81,79,146,135,184,1575,65,B
1574,CEJ,275,129,275,268,268,1575,0,E
1574,CFJ,149,20,295,285,469,1575,146,C
1574,DFJ,93,73,368,150,418,1575,275,F
1574,DFJ,301,0,368,240,412,1575,67,J
1574,DGK,135,135,503,130,548,1575,368,G
1574,DFK,334,199,702,290,702,1575,368,K
1574,DFL,717,310,1012,5160,5629,1575,295,D
1574,FL,721,212,1224,700,1248,1575,503,F
1574,GL,127,127,1351,115,1363,1575,1224,G
1574,HL,1358,709,2060,5160,5862,1575,702,L
1574,H,2293,1584,3644,4230,5593,1575,1351,H
1574,M,578,578,4222,891,6753,1575,3644,M
1574,N,465,465,4687,180,6933,1575,4222,N
1574,O,890,890,5577,885,7818,1575,4687,O
1574,P,3428,3428,9005,6680,14498,1575,5577,P
1575,AE,632,632,632,974,974,1576,0,E
1575,AF,432,432,1064,150,1124,1576,632,F
1575,AG,1079,15,1079,1131,1131,1576,0,A
1575,BG,64,49,1128,50,1174,1576,1064,G
1575,BF,207,158,1286,210,1341,1576,1079,B
1575,CF,251,251,1537,260,1601,1576,1286,C
1575,BF,1681,1681,3218,1655,3256,1576,1537,B
1575,CF,2209,119,3337,2215,3389,1576,1128,F
1575,CG,691,572,3909,810,4066,1576,3218,C
1575,DG,664,92,4001,810,4199,1576,3337,G
1575,DH,1474,1382,5383,5040,9106,1576,3909,D
1575,H,1502,120,5503,5040,9239,1576,4001,H
1575,M,1330,1330,6833,1491,10730,1576,5503,M
1575,N,296,296,7129,195,10925,1576,6833,N
1575,O,723,723,7852,695,11620,1576,7129,O
1575,P,269,269,8121,385,12005,1576,7852,P
1576,AE,66,66,66,115,115,1577,0,A
1576,BE,209,143,209,774,774,1577,0,E
1576,BF,321,178,387,300,415,1577,66,B
1576,CF,750,572,959,240,1014,1577,209,F
1576,CG,696,124,1083,800,1215,1577,387,C
1576,DG,265,141,1224,290,1304,1577,959,G
1576,DH,742,742,1966,5160,6464,1577,1224,H
1576,D,1806,923,2889,1140,2355,1577,1083,D
1576,M,869,869,3758,1132,7596,1577,2889,M
1576,N,725,725,4483,90,7686,1577,3758,N
1576,O,896,896,5379,1250,8936,1577,4483,O
1576,P,172,172,5551,3780,12716,1577,5379,P
1577,AE,38,38,38,59,59,1578,0,A
1577,BE,110,110,148,150,209,1578,38,B
1577,CE,169,169,317,160,369,1578,148,C
1577,DE,1212,895,1212,1598,1598,1578,0,E
1577,DF,575,575,1787,240,1838,1578,1212,F
1577,DG,925,925,2712,835,2673,1578,1787,G
1577,DH,261,261,2973,3960,6633,1578,2712,H
1577,D,3753,1097,4070,4200,4569,1578,317,D
1577,M,1309,1309,5379,1414,8047,1578,4070,M
1577,N,297,297,5676,240,8287,1578,5379,N
1577,O,625,625,6301,1050,9337,1578,5676,O
1577,P,3806,3806,10107,3960,13297,1578,6301,P
1578,AEI,244,244,244,685,685,1579,0,A
1578,BEI,540,540,784,150,835,1579,244,B
1578,CEI,178,178,962,140,975,1579,784,C
1578,BEI,726,726,1688,730,1705,1579,962,B
1578,CEI,867,867,2555,775,2480,1579,1688,C
1578,DEI,262,262,2817,4230,6710,1579,2555,D
1578,EI,29197,26380,29197,30131,30131,1579,0,I
1578,EJ,957,957,30154,90,30221,1579,29197,J
1578,EK,30740,586,30740,31583,31583,1579,0,E
1578,FK,1185,599,31339,1430,31651,1579,30154,K
1578,FL,336,336,31675,3780,35431,1579,31339,L
1578,F,1806,871,32546,90,31673,1579,30740,F
1578,G,1313,1313,33859,1430,33103,1579,32546,G
1578,H,10,10,33869,3780,36883,1579,33859,H
1578,M,674,674,34543,1251,38134,1579,33869,M
1578,N,607,607,35150,90,38224,1579,34543,N
1578,O,173,173,35323,535,38759,1579,35150,O
1578,P,45,45,35368,3780,42539,1579,35323,P
1579,A,5389,5389,5389,7640,7640,1580,0,A
1579,B,2628,2628,8017,420,8060,1580,5389,B
1579,C,832,832,8849,1069,9129,1580,8017,C
1579,D,27,27,8876,356,9485,1580,8849,D
1579,M,510,510,9386,1216,10701,1580,8876,M
1579,N,738,738,10124,90,10791,1580,9386,N
1579,O,526,526,10650,880,11671,1580,10124,O
1579,N,474,474,11124,110,11781,1580,10650,N
1579,O,4343,4343,15467,2315,14096,1580,11124,O
1579,P,1500,1500,16967,3420,17516,1580,15467,P
1580,A,208,208,208,234,234,1581,0,A
1580,B,181,181,389,210,444,1581,208,B
1580,C,183,183,572,255,699,1581,389,C
1580,B,1463,1463,2035,1395,2094,1581,572,B
1580,C,676,676,2711,810,2904,1581,2035,C
1580,D,321,321,3032,5040,7944,1581,2711,D
1580,M,1202,1202,4234,1520,9464,1581,3032,M
1580,N,618,618,4852,360,9824,1581,4234,N
1580,O,734,734,5586,700,10524,1581,4852,O
1580,P,2602,2602,8188,550,11074,1581,5586,P
1581,AE,82,82,82,1011,1011,1582,0,E
1581,AF,1020,938,1020,2396,2396,1582,0,A
1581,BF,1118,180,1200,240,1251,1582,82,F
1581,BG,903,903,2103,1020,2271,1582,1200,G
1581,BH,214,214,2317,4680,6951,1582,2103,H
1581,B,1551,254,2571,240,2636,1582,1020,B
1581,C,841,841,3412,995,3631,1582,2571,C
1581,D,208,208,3620,4680,8311,1582,3412,D
1581,M,2142,2142,5762,2255,10566,1582,3620,M
1581,N,141,141,5903,90,10656,1582,5762,N
1581,O,443,443,6346,820,11476,1582,5903,O
1581,N,756,756,7102,375,11851,1582,6346,N
1581,O,473,473,7575,740,12591,1582,7102,O
1581,P,2490,2490,10065,3780,16371,1582,7575,P
1582,AEI,74,74,74,170,170,1583,0,I
1582,AEJ,185,185,259,150,320,1583,74,J
1582,AEK,42,42,301,110,430,1583,259,K
1582,AEJ,304,3,304,968,968,1583,0,A
1582,BEJ,450,447,751,375,805,1583,301,J
1582,BEK,754,307,1058,150,1118,1583,304,B
1582,CEK,1212,154,1212,1526,1526,1583,0,E
1582,CFK,192,38,1250,120,1238,1583,1058,C
1582,BFK,500,1,1251,465,1270,1583,751,K
1582,BFL,294,294,1545,5760,7030,1583,1251,L
1582,BF,554,221,1766,300,1826,1583,1212,F
1582,BG,637,637,2403,820,2646,1583,1766,G
1582,BF,1259,106,2509,1330,2568,1583,1250,B
1582,CF,607,501,3010,410,3056,1583,2403,F
1582,CG,561,60,3070,470,3038,1583,2509,C
1582,DG,512,452,3522,465,3521,1583,3010,G
1582,DH,4131,3679,7201,5760,8798,1583,3070,D
1582,H,31237,27558,34759,5760,9281,1583,3522,H
1582,M,482,482,35241,1035,10316,1583,34759,M
1582,N,663,663,35904,150,10466,1583,35241,N
1582,O,466,466,36370,315,10781,1583,35904,O
1582,N,530,530,36900,680,11461,1583,36370,N
1582,O,197,197,37097,120,11581,1583,36900,O
1582,P,966,966,38063,4230,15811,1583,37097,P
1583,AEI,118,118,118,407,407,1584,0,E
1583,AFI,514,514,632,270,677,1584,118,F
1583,AGI,667,35,667,458,458,1584,0,I
1583,AGJ,781,746,1413,878,1555,1584,632,G
1583,AHJ,791,45,1458,90,548,1584,667,J
1583,AHK,1760,302,1760,2810,2810,1584,0,A
1583,BHK,652,350,2110,1135,1683,1584,1458,K
1583,BHL,1247,550,2660,1217,2772,1584,1413,H
1583,BL,592,42,2702,3780,5463,1584,2110,L
1583,B,2130,1188,3890,1140,3950,1584,1760,B
1583,C,1035,1035,4925,985,4935,1584,3890,C
1583,B,2653,2653,7578,2700,7635,1584,4925,B
1583,C,819,819,8397,1382,9017,1584,7578,C
1583,D,1141,1141,9538,713,9730,1584,8397,D
1583,M,291,291,9829,2100,11830,1584,9538,M
1583,N,2001,2001,11830,240,12070,1584,9829,N
1583,O,996,996,12826,976,13046,1584,11830,O
1583,N,547,547,13373,495,13541,1584,12826,N
1583,O,906,906,14279,810,14351,1584,13373,O
1583,P,3089,3089,17368,3960,18311,1584,14279,P
1584,AEI,70,70,70,2535,2535,1585,0,E
1584,AFI,150,80,150,165,165,1585,0,I
1584,AFJ,259,259,409,300,465,1585,150,J
1584,AFK,337,337,746,845,1310,1585,409,K
1584,AFL,864,864,1610,1590,2900,1585,746,L
1584,AF,2169,559,2169,2268,2268,1585,0,A
1584,BF,140,140,2309,90,2358,1585,2169,B
1584,CF,2721,482,2791,300,2835,1585,70,F
1584,CG,617,135,2926,815,3173,1585,2309,C
1584,BG,730,595,3521,895,3730,1585,2791,G
1584,BH,274,274,3795,2700,6430,1585,3521,H
1584,B,1421,552,4347,1105,4278,1585,2926,B
1584,C,1312,1312,5659,1850,6128,1585,4347,C
1584,D,2203,2203,7862,3780,9908,1585,5659,D
1584,M,207,207,8069,675,10583,1585,7862,M
1584,N,725,725,8794,300,10883,1585,8069,N
1584,O,1007,1007,9801,925,11808,1585,8794,O
1584,P,2522,2522,12323,2820,14628,1585,9801,P
1585,A,204,204,204,1106,1106,1586,0,A
1585,B,1091,1091,1295,240,1346,1586,204,B
1585,C,918,918,2213,1020,2366,1586,1295,C
1585,D,300,300,2513,4680,7046,1586,2213,D
1585,M,3666,3666,6179,4012,11058,1586,2513,M
1585,N,719,719,6898,90,11148,1586,6179,N
1585,O,681,681,7579,815,11963,1586,6898,O
1585,P,924,924,8503,3780,15743,1586,7579,P
1586,A,4735,4735,4735,5332,5332,1587,0,A
1586,B,996,996,5731,420,5752,1587,4735,B
1586,C,1115,1115,6846,1259,7011,1587,5731,C
1586,D,1882,1882,8728,351,7362,1587,6846,D
1586,M,1943,1943,10671,4841,12203,1587,8728,M
1586,N,3368,3368,14039,420,12623,1587,10671,N
1586,O,956,956,14995,1015,13638,1587,14039,O
1586,P,2021,2021,17016,550,14188,1587,14995,P
1587,AE,56,56,56,997,997,1588,0,E
1587,AF,363,307,363,521,521,1588,0,A
1587,BF,204,204,567,240,761,1588,363,B
1587,CF,1128,617,1184,240,1237,1588,56,F
1587,CG,1512,895,2079,1680,2441,1588,567,C
1587,BG,1078,183,2262,1020,2257,1588,1184,G
1587,BH,142,142,2404,4680,6937,1588,2262,H
1587,B,2241,1916,4320,1926,4367,1588,2079,B
1587,C,1168,1168,5488,1240,5607,1588,4320,C
1587,D,300,300,5788,335,5942,1588,5488,D
1587,M,477,477,6265,648,7585,1588,5788,M
1587,N,201,201,6466,90,7675,1588,6265,N
1587,O,590,590,7056,820,8495,1588,6466,O
1587,P,74,74,7130,3780,12275,1588,7056,P
1588,AEI,83,83,83,773,773,1589,0,E
1588,AFI,385,302,385,908,908,1589,0,I
1588,AFJ,864,479,864,1241,1241,1589,0,A
1588,BFJ,876,95,959,240,1013,1589,83,F
1588,BGJ,694,120,1079,180,1088,1589,385,J
1588,BGK,168,48,1127,250,1263,1589,959,G
1588,BHK,638,375,1502,180,1421,1589,864,B
1588,CHK,941,518,2020,930,2018,1589,1079,K
1588,CHL,1281,388,2408,5250,6513,1589,1127,H
1588,CL,988,82,2490,920,2341,1589,1502,C
1588,DL,585,115,2605,550,2568,1589,2020,L
1588,D,284,169,2774,550,2891,1589,2490,D
1588,M,10011,10011,12785,10711,17224,1589,2774,M
1588,N,1076,1076,13861,420,17644,1589,12785,N
1588,O,1154,1154,15015,1205,18849,1589,13861,O
1588,N,2360,2360,17375,2325,21174,1589,15015,N
1588,O,2630,2630,20005,2568,23742,1589,17375,O
1588,P,1,1,20006,762,24504,1589,20005,P
1589,AE,81,81,81,814,814,1590,0,A
1589,BE,153,72,153,1069,1069,1590,0,E
1589,BF,925,853,1006,240,1054,1590,81,B
1589,CF,108,108,1114,295,1349,1590,1006,C
1589,DF,1096,135,1249,240,1309,1590,153,F
1589,DG,162,162,1411,395,1704,1590,1249,G
1589,DH,1275,1275,2686,9700,11404,1590,1411,H
1589,D,1668,96,2782,9700,11049,1590,1114,D
1589,M,200,200,2982,230,11634,1590,2782,M
1589,N,124,124,3106,270,11904,1590,2982,N
1589,O,3165,3165,6271,2910,14814,1590,3106,O
1589,N,9231,9231,15502,9370,24184,1590,6271,N
1589,O,983,983,16485,1150,25334,1590,15502,O
1589,P,968,968,17453,350,25684,1590,16485,P
1590,AE,113,113,113,790,790,1591,0,E
1590,AF,567,454,567,1608,1608,1591,0,A
1590,BF,774,320,887,150,940,1591,113,F
1590,BG,758,758,1645,165,1105,1591,887,G
1590,BH,1141,63,1708,150,1758,1591,567,B
1590,CH,769,769,2477,730,2488,1591,1708,C
1590,DH,981,149,2626,4200,5305,1591,1645,H
1590,D,1183,1034,3660,4200,6688,1591,2477,D
1590,M,589,589,4249,1144,7832,1591,3660,M
1590,N,588,588,4837,90,7922,1591,4249,N
1590,O,1061,1061,5898,1230,9152,1591,4837,O
1590,N,541,541,6439,375,9527,1591,5898,N
1590,O,510,510,6949,815,10342,1591,6439,O
1590,P,29400,29400,36349,3780,14122,1591,6949,P
1591,AE,208,208,208,200,200,1592,0,A
1591,BE,178,178,386,240,440,1592,208,B
1591,CE,156,156,542,420,860,1592,386,C
1591,BE,718,176,718,880,880,1592,0,E
1591,BF,302,302,1020,150,1030,1592,718,F
1591,BG,831,353,1373,555,1415,1592,542,B
1591,CG,139,139,1512,395,1810,1592,1373,C
1591,DG,691,199,1711,315,1345,1592,1020,G
1591,DF,296,296,2007,705,2050,1592,1711,F
1591,DG,110,110,2117,120,2170,1592,2007,G
1591,DH,1314,709,2826,3960,5770,1592,1512,D
1591,H,3730,3021,5847,4230,6400,1592,2117,H
1591,M,195,195,6042,851,7251,1592,5847,M
1591,N,756,756,6798,150,7401,1592,6042,N
1591,O,197,197,6995,130,7531,1592,6798,O
1591,N,208,208,7203,250,7781,1592,6995,N
1591,O,619,619,7822,610,8391,1592,7203,O
1591,P,1104,1104,8926,4230,12621,1592,7822,P
1592,A,1888,1888,1888,2519,2519,1593,0,A
1592,B,811,811,2699,240,2759,1593,1888,B
1592,C,146,146,2845,395,3154,1593,2699,C
1592,D,1545,1545,4390,9700,12854,1593,2845,D
1592,M,93,93,4483,739,13593,1593,4390,M
1592,N,1368,1368,5851,240,13833,1593,4483,N
1592,O,820,820,6671,825,14658,1593,5851,O
1592,P,430,430,7101,9700,24358,1593,6671,P
1593,AE,871,871,871,1679,1679,1594,0,A
1593,BE,1124,253,1124,2350,2350,1594,0,E
1593,BF,821,568,1692,90,1769,1594,871,B
1593,CF,611,611,2303,1105,2874,1594,1692,C
1593,DF,1505,326,2629,300,2650,1594,1124,F
1593,DG,850,850,3479,895,3545,1594,2629,G
1593,DH,1331,1331,4810,2760,6305,1594,3479,H
1593,D,4296,1789,6599,3780,6654,1594,2303,D
1593,M,350,350,6949,975,7629,1594,6599,M
1593,N,929,929,7878,300,7929,1594,6949,N
1593,O,962,962,8840,930,8859,1594,7878,O
1593,P,3869,3869,12709,2760,11619,1594,8840,P
1594,A,87,87,87,245,245,1595,0,A
1594,B,306,306,393,180,425,1595,87,B
1594,C,248,248,641,156,581,1595,393,C
1594,D,17,17,658,379,960,1595,641,D
1594,M,475,475,1133,1383,2343,1595,658,M
1594,N,1194,1194,2327,330,2673,1595,1133,N
1594,O,941,941,3268,995,3668,1595,2327,O
1594,P,2221,2221,5489,350,4018,1595,3268,P
1595,AEI,1,1,1,117,117,1596,0,I
1595,AEJ,34,33,34,187,187,1596,0,A
1595,BEJ,216,183,217,150,267,1596,1,J
1595,BEK,236,53,270,135,322,1596,34,B
1595,CEK,284,14,284,800,800,1596,0,E
1595,CFK,120,53,337,110,377,1596,217,K
1595,CFJ,836,769,1106,940,1262,1596,270,C
1595,DFJ,787,18,1124,760,1137,1596,337,J
1595,DFK,865,25,1149,360,1160,1596,284,F
1595,DGK,700,675,1824,690,1827,1596,1124,K
1595,DGL,794,119,1943,930,2090,1596,1149,G
1595,DHL,51,51,1994,1410,3500,1596,1943,H
1595,DL,441,271,2265,4230,6057,1596,1824,L
1595,D,1680,521,2786,6990,8252,1596,1106,D
1595,M,13052,13052,15838,13000,21252,1596,2786,M
1595,N,225,225,16063,300,21552,1596,15838,N
1595,O,899,899,16962,1005,22557,1596,16063,O
1595,P,607,607,17569,1200,23757,1596,16962,P
1596,AE,467,467,467,1226,1226,1597,0,E
1596,AF,1009,1009,1476,300,1526,1597,467,F
1596,AG,1559,83,1559,1886,1886,1597,0,A
1596,BG,360,360,1919,90,1976,1597,1559,B
1596,CG,749,306,2225,995,2521,1597,1476,G
1596,CH,752,446,2671,1130,3106,1597,1919,C
1596,DH,234,234,2905,3780,6886,1597,2671,D
1596,H,1067,387,3292,3960,6481,1597,2225,H
1596,M,516,516,3808,556,7442,1597,3292,M
1596,N,283,283,4091,240,7682,1597,3808,N
1596,O,989,989,5080,780,8462,1597,4091,O
1596,P,646,646,5726,3960,12422,1597,5080,P
1597,A,1546,1546,1546,2750,2750,1598,0,A
1597,B,1408,1408,2954,240,2990,1598,1546,B
1597,C,166,166,3120,295,3285,1598,2954,C
1597,B,629,629,3749,515,3800,1598,3120,B
1597,C,223,223,3972,295,4095,1598,3749,C
1597,D,3774,3774,7746,5160,9255,1598,3972,D
1597,M,937,937,8683,1389,10644,1598,7746,M
1597,N,484,484,9167,90,10734,1598,8683,N
1597,O,962,962,10129,1240,11974,1598,9167,O
1597,P,4,4,10133,3780,15754,1598,10129,P
1598,A,133,133,133,347,347,1599,0,A
1598,B,373,373,506,180,527,1599,133,B
1598,C,639,639,1145,683,1210,1599,506,C
1598,D,6882,6882,8027,4080,5290,1599,1145,D
1598,M,590,590,8617,3088,8378,1599,8027,M
1598,N,2876,2876,11493,420,8798,1599,8617,N
1598,O,792,792,12285,1046,9844,1599,11493,O
1598,P,1171,1171,13456,1049,10893,1599,12285,P
1599,AE,111,111,111,180,180,1600,0,E
1599,AF,254,143,254,838,838,1600,0,A
1599,BF,167,24,278,135,315,1600,111,F
1599,BG,782,758,1036,240,1078,1600,254,B
1599,CG,795,37,1073,930,1245,1600,278,G
1599,CH,298,298,1371,7050,8295,1600,1073,H
1599,C,617,282,1653,960,2038,1600,1036,C
1599,D,155,155,1808,3960,5998,1600,1653,D
1599,M,14348,14348,16156,14310,22605,1600,1808,M
1599,N,247,247,16403,300,22905,1600,16156,N
1599,O,864,864,17267,1005,23910,1600,16403,O
1599,P,633,633,17900,1200,25110,1600,17267,P
1600,AE,190,190,190,667,667,1601,0,E
1600,AF,948,758,948,4176,4176,1601,0,A
1600,BF,881,123,1071,420,1087,1601,190,F
1600,BG,841,841,1912,1069,2156,1601,1071,G
1600,BH,3958,2994,4906,780,4956,1601,948,B
1600,CH,925,925,5831,1124,6080,1601,4906,C
1600,DH,1276,1276,7107,356,6436,1601,5831,D
1600,H,6612,1417,8524,356,2512,1601,1912,H
1600,M,3128,3128,11652,3781,10217,1601,8524,M
1600,N,851,851,12503,240,10457,1601,11652,N
1600,O,755,755,13258,1015,11472,1601,12503,O
1600,N,1082,1082,14340,820,12292,1601,13258,N
1600,O,104,104,14444,2655,14947,1601,14340,O
1600,P,2710,2710,17154,1680,16627,1601,14444,P
1601,AEI,90,90,90,184,184,1602,0,I
1601,AEJ,204,204,294,180,364,1602,90,J
1601,AEK,491,197,491,1025,1025,1602,0,A
1601,BEK,507,310,801,840,1204,1602,294,K
1601,BEJ,742,432,1233,240,1265,1602,491,B
1601,CEJ,297,297,1530,400,1665,1602,1233,C
1601,BEJ,1536,6,1536,1776,1776,1602,0,E
1601,BFJ,609,609,2145,420,2196,1602,1536,F
1601,BGJ,932,932,3077,1069,3265,1602,2145,G
1601,BHJ,1586,39,3116,1500,3165,1602,1530,B
1601,CHJ,702,702,3818,970,4135,1602,3116,C
1601,DHJ,3828,811,4629,3475,4679,1602,801,J
1601,DHK,1677,866,5495,3960,8095,1602,3818,D
1601,HK,905,39,5534,1124,5803,1602,4629,K
1601,HL,5234,2777,8311,356,3621,1602,3077,H
1601,L,9382,6605,14916,356,6159,1602,5534,L
1601,M,1502,1502,16418,1695,9790,1602,14916,M
1601,N,216,216,16634,90,9880,1602,16418,N
1601,O,671,671,17305,905,10785,1602,16634,O
1601,P,2503,2503,19808,3780,14565,1602,17305,P
1602,AE,116,116,116,1505,1505,1603,0,A
1602,BE,1062,946,1062,1172,1172,1603,0,E
1602,BF,1419,473,1535,90,1595,1603,116,B
1602,CF,795,322,1857,90,1262,1603,1062,F
1602,CG,995,673,2530,1230,2825,1603,1535,C
1602,DG,118,118,2648,3780,6605,1603,2530,D
1602,G,971,180,2828,1310,2572,1603,1857,G
1602,H,76,76,2904,3780,6352,1603,2828,H
1602,M,850,850,3754,1367,7972,1603,2904,M
1602,N,548,548,4302,90,8062,1603,3754,N
1602,O,384,384,4686,800,8862,1603,4302,O
1602,P,1787,1787,6473,3780,12642,1603,4686,P
1603,AE,1562,1562,1562,1781,1781,1604,0,E
1603,AF,245,245,1807,90,1871,1604,1562,F
1603,AG,490,490,2297,880,2751,1604,1807,G
1603,AH,208,208,2505,3780,6531,1604,2297,H
1603,A,35570,33065,35570,36761,36761,1604,0,A
1603,B,1216,1216,36786,90,36851,1604,35570,B
1603,C,1370,1370,38156,1635,38486,1604,36786,C
1603,D,84,84,38240,3780,42266,1604,38156,D
1603,M,386,386,38626,683,42949,1604,38240,M
1603,N,560,560,39186,300,43249,1604,38626,N
1603,O,920,920,40106,1110,44359,1604,39186,O
1603,N,1138,1138,41244,995,45354,1604,40106,N
1603,O,286,286,41530,390,45744,1604,41244,O
1603,P,268,268,41798,3960,49704,1604,41530,P
1604,AE,1432,1432,1432,2560,2560,1605,0,A
1604,BE,1498,1498,2930,420,2980,1605,1432,B
1604,CE,2992,62,2992,3316,3316,1605,0,E
1604,CF,223,161,3153,310,3290,1605,2930,C
1604,BF,367,206,3359,90,3406,1605,2992,F
1604,BG,418,418,3777,820,4226,1605,3359,G
1604,BF,918,294,4071,790,4080,1605,3153,B
1604,CF,543,543,4614,535,4615,1605,4071,C
1604,DF,1086,249,4863,690,4916,1605,3777,F
1604,DG,822,822,5685,1275,6191,1605,4863,G
1604,DH,8315,7244,12929,2880,7495,1605,4614,D
1604,H,11932,4688,17617,3780,9971,1605,5685,H
1604,M,1666,1666,19283,1591,11562,1605,17617,M
1604,N,105,105,19388,240,11802,1605,19283,N
1604,O,368,368,19756,195,11997,1605,19388,O
1604,P,3251,3251,23007,660,12657,1605,19756,P
1605,AEI,1,1,1,602,602,1606,0,I
1605,AEJ,135,134,135,694,694,1606,0,A
1605,BEJ,548,413,548,648,648,1606,0,E
1605,BFJ,702,155,703,150,752,1606,1,J
1605,BFK,295,140,843,240,888,1606,548,F
1605,BGK,170,30,873,170,922,1606,703,K
1605,BGL,763,25,898,240,934,1606,135,B
1605,CGL,198,198,1096,215,1149,1606,898,C
1605,DGL,442,189,1285,740,1628,1606,843,G
1605,DHL,458,46,1331,4200,5122,1606,873,L
1605,DH,1600,1365,2696,4890,6039,1606,1096,D
1605,H,1835,424,3120,3960,5588,1606,1285,H
1605,M,24,24,3144,115,6154,1606,3120,M
1605,N,203,203,3347,150,6304,1606,3144,N
1605,O,101,101,3448,390,6694,1606,3347,O
1605,P,738,738,4186,3960,10654,1606,3448,P
1606,AE,312,312,312,374,374,1607,0,A
1606,BE,272,272,584,240,614,1607,312,B
1606,CE,754,170,754,1599,1599,1607,0,E
1606,CF,756,586,1340,1035,1649,1607,584,C
1606,DF,23,23,1363,3960,5609,1607,1340,D
1606,F,897,288,1651,90,1689,1607,754,F
1606,G,907,907,2558,1240,2929,1607,1651,G
1606,H,1524,1524,4082,3780,6709,1607,2558,H
1606,M,395,395,4477,590,7299,1607,4082,M
1606,N,226,226,4703,90,7389,1607,4477,N
1606,O,380,380,5083,795,8184,1607,4703,O
1606,P,1694,1694,6777,3780,11964,1607,5083,P
1607,AEI,290,290,290,2000,2000,1608,0,A
1607,BEI,1742,1452,1742,2002,2002,1608,0,E
1607,BFI,1663,211,1953,90,2090,1608,290,B
1607,CFI,299,88,2041,90,2092,1608,1742,F
1607,CGI,502,502,2543,880,2972,1608,2041,G
1607,CHI,200,200,2743,3780,6752,1608,2543,H
1607,CI,1151,361,3104,1365,3455,1608,1953,C
1607,DI,222,222,3326,3780,7235,1608,3104,D
1607,I,37026,33700,37026,37994,37994,1608,0,I
1607,J,992,992,38018,90,38084,1608,37026,J
1607,K,1024,1024,39042,1220,39304,1608,38018,K
1607,L,23,23,39065,3780,43084,1608,39042,L
1607,M,513,513,39578,991,44075,1608,39065,M
1607,N,505,505,40083,90,44165,1608,39578,N
1607,O,421,421,40504,800,44965,1608,40083,O
1607,P,940,940,41444,3780,48745,1608,40504,P
1608,AEI,77,77,77,81,81,1609,0,E
1608,AFI,157,157,234,180,261,1609,77,F
1608,AGI,169,169,403,230,491,1609,234,G
1608,AFI,865,462,865,1671,1671,1609,0,I
1608,AFJ,886,21,886,1437,1437,1609,0,A
1608,BFJ,596,596,1482,90,1527,1609,886,B
1608,CFJ,830,213,1695,90,1761,1609,865,J
1608,CFK,1475,183,1878,1435,1926,1609,403,F
1608,CGK,935,539,2417,1240,2767,1609,1482,C
1608,DGK,19,19,2436,3780,6547,1609,2417,D
1608,GK,937,196,2632,1250,3011,1609,1695,K
1608,GL,793,39,2671,860,2786,1609,1878,G
1608,HL,107,107,2778,4140,6926,1609,2671,H
1608,L,396,250,3028,3780,6791,1609,2632,L
1608,M,1569,1569,4597,2759,9685,1609,3028,M
1608,N,1222,1222,5819,90,9775,1609,4597,N
1608,O,188,188,6007,690,10465,1609,5819,O
1608,P,8899,8899,14906,3780,14245,1609,6007,P
1609,AE,103,103,103,180,180,1610,0,A
1609,BE,167,167,270,135,315,1610,103,B
1609,CE,123,123,393,215,530,1610,270,C
1609,DE,61,61,454,4890,5420,1610,393,D
1609,E,783,329,783,979,979,1610,0,E
1609,F,391,391,1174,240,1219,1610,783,F
1609,G,647,647,1821,915,2134,1610,1174,G
1609,H,249,249,2070,3960,6094,1610,1821,H
1609,M,36670,36670,38740,37892,43986,1610,2070,M
1609,N,1384,1384,40124,90,44076,1610,38740,N
1609,O,1216,1216,41340,1430,45506,1610,40124,O
1609,N,627,627,41967,540,46046,1610,41340,N
1609,O,187,187,42154,675,46721,1610,41967,O
1609,P,384,384,42538,3780,50501,1610,42154,P
1610,AE,45,45,45,101,101,1611,0,A
1610,BE,131,131,176,135,236,1611,45,B
1610,CE,119,119,295,215,451,1611,176,C
1610,DE,142,142,437,4890,5341,1611,295,D
1610,E,3159,2722,3159,3528,3528,1611,0,E
1610,F,463,463,3622,90,3618,1611,3159,F
1610,G,918,918,4540,1360,4978,1611,3622,G
1610,H,1094,1094,5634,3780,8758,1611,4540,H
1610,M,4632,4632,10266,5932,14690,1611,5634,M
1610,N,1466,1466,11732,240,14930,1611,10266,N
1610,O,727,727,12459,800,15730,1611,11732,O
1610,P,1720,1720,14179,3960,19690,1611,12459,P
1611,AE,142,142,142,190,190,1612,0,E
1611,AF,304,304,446,300,490,1612,142,F
1611,AG,657,657,1103,780,1270,1612,446,G
1611,AH,1113,10,1113,1385,1385,1612,0,A
1611,BH,416,416,1529,150,1535,1612,1113,B
1611,CH,195,195,1724,280,1815,1612,1529,C
1611,DH,1850,1229,2953,1140,2410,1612,1103,H
1611,D,2816,1587,4540,5160,6975,1612,1724,D
1611,M,103,103,4643,189,7164,1612,4540,M
1611,N,189,189,4832,150,7314,1612,4643,N
1611,O,123,123,4955,145,7459,1612,4832,O
1611,P,27,27,4982,4200,11659,1612,4955,P
1612,AEI,184,184,184,403,403,1613,0,A
1612,BEI,351,351,535,180,583,1613,184,B
1612,CEI,128,128,663,220,803,1613,535,C
1612,BEI,697,34,697,1000,1000,1613,0,I
1612,BEJ,817,120,817,1639,1639,1613,0,E
1612,BFJ,428,308,1125,180,1180,1613,697,J
1612,BFK,1012,704,1829,240,1879,1613,817,F
1612,BGK,756,52,1881,885,2065,1613,1125,K
1612,BGJ,1347,129,2010,1240,2043,1613,663,B
1612,CGJ,524,343,2353,765,2644,1613,1829,G
1612,CHJ,575,232,2585,745,2788,1613,2010,C
1612,DHJ,327,95,2680,9700,12344,1613,2353,H
1612,DJ,467,372,3052,4140,6928,1613,2585,D
1612,J,1289,118,3170,1165,3230,1613,1881,J
1612,K,542,542,3712,750,3980,1613,3170,K
1612,L,4536,4536,8248,1140,5120,1613,3712,L
1612,M,1582,1582,9830,1886,14230,1613,8248,M
1612,N,347,347,10177,90,14320,1613,9830,N
1612,O,507,507,10684,870,15190,1613,10177,O
1612,N,362,362,11046,10,15200,1613,10684,N
1612,O,460,460,11506,800,16000,1613,11046,O
1612,P,871,871,12377,3780,19780,1613,11506,P
1613,AE,1185,1185,1185,1555,1555,1614,0,A
1613,BE,631,631,1816,300,1855,1614,1185,B
1613,CE,840,840,2656,1045,2900,1614,1816,C
1613,DE,3657,1001,3657,6091,6091,1614,0,E
1613,DF,1659,658,4315,1140,4040,1614,2656,D
1613,F,2472,1814,6129,90,6181,1614,3657,F
1613,G,554,554,6683,1015,7196,1614,6129,G
1613,H,2914,2914,9597,3780,10976,1614,6683,H
1613,M,403,403,10000,525,11501,1614,9597,M
1613,N,246,246,10246,185,11686,1614,10000,N
1613,O,531,531,10777,525,12211,1614,10246,O
1613,P,14,14,10791,3000,15211,1614,10777,P
1614,AE,62,62,62,752,752,1615,0,A
1614,BE,135,135,197,240,992,1615,62,B
1614,CE,209,12,209,867,867,1615,0,E
1614,CF,85,73,282,295,1287,1615,197,C
1614,DF,794,721,1003,180,1047,1615,209,F
1614,DG,1013,292,1295,9700,10987,1615,282,D
1614,G,888,596,1891,1160,2207,1615,1003,G
1614,F,1112,1112,3003,785,2992,1615,1891,F
1614,G,2679,2679,5682,2985,5977,1615,3003,G
1614,H,6,6,5688,355,6332,1615,5682,H
1614,M,199,199,5887,962,11949,1615,5688,M
1614,N,855,855,6742,150,12099,1615,5887,N
1614,O,222,222,6964,180,12279,1615,6742,O
1614,N,330,330,7294,355,12634,1615,6964,N
1614,O,727,727,8021,775,13409,1615,7294,O
1614,P,527,527,8548,4230,17639,1615,8021,P
1615,A,16,16,16,1616,1616,1616,0,A
1615,B,1805,1805,1821,240,1856,1616,16,B
1615,C,823,823,2644,1045,2901,1616,1821,C
1615,D,4,4,2648,3960,6861,1616,2644,D
1615,M,838,838,3486,1386,8247,1616,2648,M
1615,N,584,584,4070,90,8337,1616,3486,N
1615,O,525,525,4595,880,9217,1616,4070,O
1615,P,2466,2466,7061,3780,12997,1616,4595,P
1616,A,359,359,359,961,961,1617,0,A
1616,B,701,701,1060,150,1111,1617,359,B
1616,C,223,223,1283,170,1281,1617,1060,C
1616,D,191,191,1474,4200,5481,1617,1283,D
1616,M,418,418,1892,1112,6593,1617,1474,M
1616,N,898,898,2790,240,6833,1617,1892,N
1616,O,518,518,3308,809,7642,1617,2790,O
1616,P,67,67,3375,3840,11482,1617,3308,P
1617,A,1652,1652,1652,2312,2312,1618,0,A
1617,B,873,873,2525,90,2402,1618,1652,B
1617,C,707,707,3232,1080,3482,1618,2525,C
1617,D,4037,4037,7269,3780,7262,1618,3232,D
1617,M,182,182,7451,1124,8386,1618,7269,M
1617,N,1062,1062,8513,180,8566,1618,7451,N
1617,O,1036,1036,9549,1055,9621,1618,8513,O
1617,N,638,638,10187,620,10241,1618,9549,N
1617,O,251,251,10438,385,10626,1618,10187,O
1617,P,1315,1315,11753,5460,16086,1618,10438,P
1618,AE,31,31,31,75,75,1619,0,E
1618,AF,133,133,164,150,225,1619,31,F
1618,AG,125,125,289,80,305,1619,164,G
1618,AH,20,20,309,2880,3185,1619,289,H
1618,A,1257,948,1257,1277,1277,1619,0,A
1618,B,112,112,1369,150,1427,1619,1257,B
1618,C,169,169,1538,155,1582,1619,1369,C
1618,B,1193,1193,2731,1215,2797,1619,1538,B
1618,C,328,328,3059,285,3082,1619,2731,C
1618,D,927,927,3986,5100,8182,1619,3059,D
1618,M,409,409,4395,1062,9244,1619,3986,M
1618,N,754,754,5149,150,9394,1619,4395,N
1618,O,138,138,5287,125,9519,1619,5149,O
1618,N,227,227,5514,230,9749,1619,5287,N
1618,O,637,637,6151,705,10454,1619,5514,O
1618,P,4447,4447,10598,4230,14684,1619,6151,P
1619,A,92,92,92,624,624,1620,0,A
1619,B,748,748,840,240,864,1620,92,B
1619,C,726,726,1566,798,1662,1620,840,C
1619,D,146,146,1712,402,2064,1620,1566,D
1619,M,2133,2133,3845,767,2831,1620,1712,M
1619,N,73,73,3918,240,3071,1620,3845,N
1619,O,1678,1678,5596,1681,4752,1620,3918,O
1619,N,2784,2784,8380,1515,6267,1620,5596,N
1619,O,490,490,8870,615,6882,1620,8380,O
1619,P,12009,12009,20879,3840,10722,1620,8870,P
1620,AE,268,268,268,700,700,1621,0,A
1620,BE,458,190,458,1036,1036,1621,0,E
1620,BF,538,348,806,150,850,1621,268,B
1620,CF,218,218,1024,185,1035,1621,806,C
1620,BF,677,111,1135,150,1186,1621,458,F
1620,BG,215,215,1350,185,1371,1621,1135,G
1620,BF,335,9,1359,355,1390,1621,1024,B
1620,CF,122,122,1481,120,1510,1621,1359,C
1620,DF,702,571,2052,725,2096,1621,1350,F
1620,DG,199,199,2251,120,2216,1621,2052,G
1620,DH,1028,258,2509,4230,5740,1621,1481,D
1620,H,649,391,2900,4230,6446,1621,2251,H
1620,M,320,320,3220,170,6616,1621,2900,M
1620,N,90,90,3310,300,6916,1621,3220,N
1620,O,353,353,3663,509,7425,1621,3310,O
1620,N,575,575,4238,401,7826,1621,3663,N
1620,O,595,595,4833,755,8581,1621,4238,O
1620,P,7589,7589,12422,1140,9721,1621,4833,P
1621,A,4764,4764,4764,6315,6315,1622,0,A
1621,B,1601,1601,6365,90,6405,1622,4764,B
1621,C,577,577,6942,1095,7500,1622,6365,C
1621,D,1943,1943,8885,3780,11280,1622,6942,D
1621,M,1682,1682,10567,2600,13880,1622,8885,M
1621,N,1187,1187,11754,300,14180,1622,10567,N
1621,O,899,899,12653,1005,15185,1622,11754,O
1621,P,45,45,12698,1200,16385,1622,12653,P
1622,AEI,58,58,58,812,812,1623,0,I
1622,AEJ,141,83,141,1008,1008,1623,0,A
1622,BEJ,677,536,677,1286,1286,1623,0,E
1622,BFJ,783,164,841,90,902,1623,58,J
1622,BFK,1052,352,1193,240,1248,1623,141,B
1622,CFK,395,43,1236,800,1702,1623,841,K
1622,CFL,638,79,1315,90,1376,1623,677,F
1622,CGL,396,396,1711,800,2176,1623,1315,G
1622,CHL,861,343,2054,995,2243,1623,1193,C
1622,DHL,1,1,2055,4680,6923,1623,2054,D
1622,HL,1000,181,2236,3780,5482,1623,1236,L
1622,H,996,471,2707,3780,5956,1623,1711,H
1622,M,2027,2027,4734,2198,9121,1623,2707,M
1622,N,212,212,4946,90,9211,1623,4734,N
1622,O,406,406,5352,820,10031,1623,4946,O
1622,N,2230,2230,7582,1815,11846,1623,5352,N
1622,O,364,364,7946,740,12586,1623,7582,O
1622,P,3967,3967,11913,3780,16366,1623,7946,P
1623,A,889,889,889,1589,1589,1624,0,A
1623,B,732,732,1621,90,1679,1624,889,B
1623,C,912,912,2533,1240,2919,1624,1621,C
1623,D,311,311,2844,3780,6699,1624,2533,D
1623,M,725,725,3569,1052,7751,1624,2844,M
1623,N,360,360,3929,90,7841,1624,3569,N
1623,O,496,496,4425,715,8556,1624,3929,O
1623,P,23,23,4448,3780,12336,1624,4425,P
1624,AE,174,174,174,1372,1372,1625,0,E
1624,AF,327,153,327,910,910,1625,0,A
1624,BF,842,842,1169,300,1210,1625,327,B
1624,CF,1390,395,1564,240,1612,1625,174,F
1624,CG,1000,605,2169,930,2140,1625,1169,C
1624,DG,838,233,2402,890,2502,1625,1564,G
1624,DH,2749,2516,4918,2760,4900,1625,2169,D
1624,H,51859,49343,54261,5160,7662,1625,2402,H
1624,M,84,84,54345,147,7809,1625,54261,M
1624,N,258,258,54603,250,8059,1625,54345,N
1624,O,913,913,55516,1170,9229,1625,54603,O
1624,N,3926,3926,59442,3700,12929,1625,55516,N
1624,O,586,586,60028,720,13649,1625,59442,O
1624,P,1148,1148,61176,400,14049,1625,60028,P
1625,AE,1540,1540,1540,4562,4562,1626,0,A
1625,BE,1759,219,1759,2306,2306,1626,0,E
1625,BF,667,667,2426,180,2486,1626,1759,F
1625,BG,2163,2163,4589,890,3376,1626,2426,G
1625,BH,3398,349,4938,420,4982,1626,1540,B
1625,CH,1169,820,5758,550,3926,1626,4589,H
1625,C,987,167,5925,985,5967,1626,4938,C
1625,D,2001,2001,7926,550,6517,1626,5925,D
1625,M,74,74,8000,191,6708,1626,7926,M
1625,N,504,504,8504,420,7128,1626,8000,N
1625,O,534,534,9038,656,7784,1626,8504,O
1625,P,696,696,9734,719,8503,1626,9038,P
1626,AE,278,278,278,267,267,1627,0,E
1626,AF,198,198,476,250,517,1627,278,F
1626,AG,612,136,612,963,963,1627,0,A
1626,BG,710,710,1322,360,1323,1627,612,B
1626,CG,1232,386,1708,1110,1627,1627,476,G
1626,CH,965,579,2287,1125,2448,1627,1322,C
1626,BH,199,199,2486,80,2528,1627,2287,B
1626,CH,130,130,2616,120,2648,1627,2486,C
1626,DH,1294,386,3002,550,2177,1627,1708,H
1626,D,4693,4307,7309,550,3198,1627,2616,D
1626,M,807,807,8116,1885,5083,1627,7309,M
1626,N,1312,1312,9428,270,5353,1627,8116,N
1626,O,775,775,10203,878,6231,1627,9428,O
1626,P,1289,1289,11492,1277,7508,1627,10203,P
1627,A,15,15,15,1558,1558,1628,0,A
1627,B,1925,1925,1940,420,1978,1628,15,B
1627,C,668,668,2608,831,2809,1628,1940,C
1627,D,402,402,3010,414,3223,1628,2608,D
1627,M,53,53,3063,485,3708,1628,3010,M
1627,N,554,554,3617,185,3893,1628,3063,N
1627,O,517,517,4134,525,4418,1628,3617,O
1627,P,103,103,4237,2880,7298,1628,4134,P
1628,A,62,62,62,267,267,1629,0,A
1628,B,431,431,493,90,357,1629,62,B
1628,C,566,566,1059,1005,1362,1629,493,C
1628,D,117,117,1176,3780,5142,1629,1059,D
1628,M,8,8,1184,48,5190,1629,1176,M
1628,N,236,236,1420,240,5430,1629,1184,N
1628,O,713,713,2133,880,6310,1629,1420,O
1628,P,1044,1044,3177,3960,10270,1629,2133,P
1629,A,2018,2018,2018,2254,2254,1630,0,A
1629,B,271,271,2289,90,2344,1630,2018,B
1629,C,414,414,2703,820,3164,1630,2289,C
1629,D,134,134,2837,3780,6944,1630,2703,D
1629,M,774,774,3611,1239,8183,1630,2837,M
1629,N,507,507,4118,90,8273,1630,3611,N
1629,O,230,230,4348,625,8898,1630,4118,O
1629,P,3168,3168,7516,3780,12678,1630,4348,P
1630,A,128,128,128,193,193,1631,0,A
1630,B,173,173,301,150,343,1631,128,B
1630,C,145,145,446,135,478,1631,301,C
1630,B,220,220,666,220,698,1631,446,B
1630,C,133,133,799,110,808,1631,666,C
1630,D,234,234,1033,4230,5038,1631,799,D
1630,M,759,759,1792,1582,6620,1631,1033,M
1630,N,844,844,2636,90,6710,1631,1792,N
1630,O,931,931,3567,1250,7960,1631,2636,O
1630,P,687,687,4254,3780,11740,1631,3567,P
1631,AEI,114,114,114,259,259,1632,0,I
1631,AEJ,265,265,379,90,349,1632,114,J
1631,AEK,721,721,1100,1005,1354,1632,379,K
1631,AEL,1,1,1101,3780,5134,1632,1100,L
1631,AE,1335,234,1335,1771,1771,1632,0,E
1631,AF,627,627,1962,240,2011,1632,1335,F
1631,AG,513,513,2475,695,2706,1632,1962,G
1631,AH,170,170,2645,3960,6666,1632,2475,H
1631,A,2762,117,2762,2800,2800,1632,0,A
1631,B,232,232,2994,240,3040,1632,2762,B
1631,C,669,669,3663,860,3900,1632,2994,C
1631,D,1906,1906,5569,3960,7860,1632,3663,D
1631,M,396,396,5965,1121,8981,1632,5569,M
1631,N,927,927,6892,240,9221,1632,5965,N
1631,O,466,466,7358,815,10036,1632,6892,O
1631,P,65,65,7423,3900,13936,1632,7358,P
1632,AEI,917,917,917,1080,1080,1633,0,E
1632,AFI,251,251,1168,90,1170,1633,917,F
1632,AGI,1453,285,1453,1679,1679,1633,0,A
1632,BGI,284,284,1737,90,1769,1633,1453,B
1632,CGI,679,110,1847,815,1985,1633,1168,G
1632,CFI,529,419,2266,860,2629,1633,1737,C
1632,BFI,345,345,2611,35,2664,1633,2266,B
1632,CFI,2900,289,2900,3389,3389,1633,0,I
1632,CFJ,495,206,3106,790,3454,1633,2611,C
1632,DFJ,1522,263,3369,1445,3430,1633,1847,F
1632,DGJ,515,46,3415,90,3479,1633,2900,J
1632,DGK,413,367,3782,790,4220,1633,3369,G
1632,DHK,296,296,4078,3780,8000,1633,3782,H
1632,DK,1164,192,4270,3780,7234,1633,3106,D
1632,K,916,61,4331,1240,4719,1633,3415,K
1632,J,724,724,5055,395,5114,1633,4331,J
1632,K,525,525,5580,800,5914,1633,5055,K
1632,L,792,792,6372,3780,9694,1633,5580,L
1632,M,247,247,6619,702,10396,1633,6372,M
1632,N,502,502,7121,90,10486,1633,6619,N
1632,O,461,461,7582,805,11291,1633,7121,O
1632,N,887,887,8469,535,11826,1633,7582,N
1632,O,878,878,9347,1285,13111,1633,8469,O
1632,P,525,525,9872,3780,16891,1633,9347,P
1633,AEI,366,366,366,849,849,1634,0,I
1633,AEJ,666,300,666,738,738,1634,0,E
1633,AFJ,252,252,918,240,978,1634,666,F
1633,AGJ,663,111,1029,240,1089,1634,366,J
1633,AGK,149,38,1067,380,1358,1634,918,G
1633,AHK,149,111,1178,380,1469,1634,1029,K
1633,AHL,1432,254,1432,2725,2725,1634,0,A
1633,BHL,1506,1252,2684,9700,11169,1634,1178,L
1633,BH,1588,336,3020,240,2965,1634,1432,B
1633,CH,3015,1062,4082,9700,11058,1634,1067,H
1633,C,1765,703,4785,700,3665,1634,3020,C
1633,D,1714,1714,6499,9700,13365,1634,4785,D
1633,M,511,511,7010,814,14179,1634,6499,M
1633,N,429,429,7439,180,14359,1634,7010,N
1633,O,236,236,7675,280,14639,1634,7439,O
1633,N,1518,1518,9193,1430,16069,1634,7675,N
1633,O,1148,1148,10341,1295,17364,1634,9193,O
1633,P,7746,7746,18087,3660,21024,1634,10341,P
1634,AEI,40,40,40,129,129,1635,0,E
1634,AFI,114,74,114,903,903,1635,0,I
1634,AFJ,253,179,293,135,264,1635,40,F
1634,AGJ,179,179,472,285,549,1635,293,G
1634,AHJ,816,458,930,90,993,1635,114,J
1634,AHK,531,73,1003,5160,5709,1635,472,H
1634,AK,307,234,1237,575,1568,1635,930,K
1634,AJ,2153,2153,3390,1875,3443,1635,1237,J
1634,AK,1170,1170,4560,1340,4783,1635,3390,K
1634,AL,3203,3203,7763,3780,8563,1635,4560,L
1634,A,10704,2941,10704,11744,11744,1635,0,A
1634,B,1070,1070,11774,90,11834,1635,10704,B
1634,C,350,350,12124,690,12524,1635,11774,C
1634,B,1700,1700,13824,1330,13854,1635,12124,B
1634,C,1256,1256,15080,1340,15194,1635,13824,C
1634,D,3187,3187,18267,3780,18974,1635,15080,D
1634,M,2049,2049,20316,2453,21427,1635,18267,M
1634,N,473,473,20789,90,21517,1635,20316,N
1634,O,1153,1153,21942,1370,22887,1635,20789,O
1634,N,774,774,22716,590,23477,1635,21942,N
1634,O,403,403,23119,755,24232,1635,22716,O
1634,P,461,461,23580,3780,28012,1635,23119,P
1635,A,40,40,40,582,582,1636,0,A
1635,B,719,719,759,240,822,1636,40,B
1635,C,128,128,887,225,1047,1636,759,C
1635,D,198,198,1085,4890,5937,1636,887,D
1635,M,12,12,1097,71,6008,1636,1085,M
1635,N,347,347,1444,240,6248,1636,1097,N
1635,O,291,291,1735,980,7228,1636,1444,O
1635,P,471,471,2206,3470,10698,1636,1735,P
1636,AEI,129,129,129,377,377,1637,0,A
1636,BEI,172,43,172,190,190,1637,0,I
1636,BEJ,114,114,286,150,340,1637,172,J
1636,BEK,178,178,464,140,480,1637,286,K
1636,BEJ,548,213,677,360,737,1637,129,B
1636,CEJ,329,329,1006,1155,1892,1637,677,C
1636,DEJ,907,365,1371,865,1345,1637,464,J
1636,DEK,546,546,1917,570,1915,1637,1371,K
1636,DEL,2003,86,2003,2054,2054,1637,0,E
1636,DFL,1406,409,2412,740,2632,1637,1006,D
1636,FL,634,139,2551,4230,6145,1637,1917,L
1636,F,949,401,2952,180,2234,1637,2003,F
1636,G,292,292,3244,880,3114,1637,2952,G
1636,H,2515,2515,5759,6660,9774,1637,3244,H
1636,M,5703,5703,11462,6077,15851,1637,5759,M
1636,N,397,397,11859,90,15941,1637,11462,N
1636,O,498,498,12357,820,16761,1637,11859,O
1636,P,154,154,12511,3780,20541,1637,12357,P
1637,AE,152,152,152,973,973,1638,0,A
1637,BE,760,608,760,772,772,1638,0,E
1637,BF,191,191,951,180,952,1638,760,F
1637,BG,945,146,1097,180,1153,1638,152,B
1637,CG,850,704,1801,930,1882,1638,951,G
1637,CH,1424,720,2521,795,1948,1638,1097,C
1637,DH,6592,5872,8393,550,2432,1638,1801,H
1637,D,8133,2261,10654,550,2498,1638,2521,D
1637,M,11061,11061,21715,11401,13899,1638,10654,M
1637,N,702,702,22417,420,14319,1638,21715,N
1637,O,955,955,23372,1160,15479,1638,22417,O
1637,P,1515,1515,24887,665,16144,1638,23372,P
1638,A,334,334,334,279,279,1639,0,A
1638,B,65,65,399,180,459,1639,334,B
1638,C,577,577,976,960,1419,1639,399,C
1638,D,1345,1345,2321,2760,4179,1639,976,D
1638,M,609,609,2930,2069,6248,1639,2321,M
1638,N,1490,1490,4420,90,6338,1639,2930,N
1638,O,2508,2508,6928,2185,8523,1639,4420,O
1638,N,2615,2615,9543,2920,11443,1639,6928,N
1638,O,873,873,10416,945,12388,1639,9543,O
1638,P,1089,1089,11505,3780,16168,1639,10416,P
1639,AE,19,19,19,283,283,1640,0,E
1639,AF,1329,1310,1329,1310,1310,1640,0,A
1639,BF,240,240,1569,300,1610,1640,1329,B
1639,CF,1704,154,1723,1500,1783,1640,19,F
1639,CG,945,791,2514,1005,2615,1640,1569,C
1639,DG,823,32,2546,1000,2783,1640,1723,G
1639,DF,510,478,3024,1200,3815,1640,2514,D
1639,F,1435,957,3981,1245,4028,1640,2546,F
1639,G,961,961,4942,1020,5048,1640,3981,G
1639,H,191,191,5133,4680,9728,1640,4942,H
1639,M,328,328,5461,714,10442,1640,5133,M
1639,N,506,506,5967,180,10622,1640,5461,N
1639,O,1157,1157,7124,1395,12017,1640,5967,O
1639,N,3021,3021,10145,2765,14782,1640,7124,N
1639,O,345,345,10490,220,15002,1640,10145,O
1639,P,4608,4608,15098,7080,22082,1640,10490,P
1640,A,261,261,261,1549,1549,1641,0,A
1640,B,1318,1318,1579,90,1639,1641,261,B
1640,C,688,688,2267,950,2589,1641,1579,C
1640,B,335,335,2602,65,2654,1641,2267,B
1640,C,1332,1332,3934,1390,4044,1641,2602,C
1640,D,539,539,4473,3780,7824,1641,3934,D
1640,M,2114,2114,6587,4429,12253,1641,4473,M
1640,N,2368,2368,8955,90,12343,1641,6587,N
1640,O,561,561,9516,1035,13378,1641,8955,O
1640,P,4346,4346,13862,3780,17158,1641,9516,P
1641,AE,1590,1590,1590,1565,1565,1642,0,A
1641,BE,232,232,1822,300,1865,1642,1590,B
1641,CE,1885,63,1885,1980,1980,1642,0,E
1641,CF,405,405,2290,355,2335,1642,1885,F
1641,CG,657,657,2947,1025,3360,1642,2290,G
1641,CH,3110,3110,6057,3000,6360,1642,2947,H
1641,C,38116,33881,39938,855,2720,1642,1822,C
1641,D,1602,1602,41540,1590,4310,1642,39938,D
1641,M,617,617,42157,3888,10248,1642,41540,M
1641,N,3283,3283,45440,90,10338,1642,42157,N
1641,O,661,661,46101,1040,11378,1642,45440,O
1641,P,867,867,46968,3780,15158,1642,46101,P
1642,A,350,350,350,415,415,1643,0,A
1642,B,330,330,680,300,715,1643,350,B
1642,C,663,663,1343,835,1550,1643,680,C
1642,D,28886,28886,30229,1140,2690,1643,1343,D
1642,M,152,152,30381,419,3109,1643,30229,M
1642,N,332,332,30713,90,3199,1643,30381,N
1642,O,1372,1372,32085,1745,4944,1643,30713,O
1642,P,43,43,32128,3780,8724,1643,32085,P
1643,A,1923,1923,1923,2209,2209,1644,0,A
1643,B,328,328,2251,90,2299,1644,1923,B
1643,C,1441,1441,3692,1935,4234,1644,2251,C
1643,D,250,250,3942,3780,8014,1644,3692,D
1643,M,184,184,4126,444,8458,1644,3942,M
1643,N,285,285,4411,90,8548,1644,4126,N
1643,O,1618,1618,6029,1780,10328,1644,4411,O
1643,N,529,529,6558,345,10673,1644,6029,N
1643,O,711,711,7269,965,11638,1644,6558,O
1643,P,1347,1347,8616,3780,15418,1644,7269,P
1644,AE,1061,1061,1061,1170,1170,1645,0,A
1644,BE,260,260,1321,180,1350,1645,1061,B
1644,CE,646,646,1967,726,2076,1645,1321,C
1644,DE,5210,3243,5210,5690,5690,1645,0,E
1644,DF,748,748,5958,300,5990,1645,5210,F
1644,DG,903,903,6861,1045,7035,1645,5958,G
1644,DH,1409,1409,8270,1140,8175,1645,6861,H
1644,D,8893,2590,10860,4080,6156,1645,1967,D
1644,M,1240,1240,12100,1507,9682,1645,10860,M
1644,N,481,481,12581,240,9922,1645,12100,N
1644,O,603,603,13184,765,10687,1645,12581,O
1644,N,380,380,13564,295,10982,1645,13184,N
1644,O,797,797,14361,1260,12242,1645,13564,O
1644,P,409,409,14770,3960,16202,1645,14361,P
1645,A,73,73,73,115,115,1646,0,A
1645,B,233,233,306,240,355,1646,73,B
1645,C,164,164,470,215,570,1646,306,C
1645,D,500,500,970,4890,5460,1646,470,D
1645,M,67,67,1037,963,6423,1646,970,M
1645,N,1114,1114,2151,240,6663,1646,1037,N
1645,O,701,701,2852,880,7543,1646,2151,O
1645,P,926,926,3778,3960,11503,1646,2852,P
1646,AE,170,170,170,308,308,1647,0,A
1646,BE,257,257,427,150,458,1647,170,B
1646,CE,160,160,587,125,583,1647,427,C
1646,BE,1458,1458,2045,1505,2088,1647,587,B
1646,CE,759,759,2804,775,2863,1647,2045,C
1646,DE,58,58,2862,4230,7093,1647,2804,D
1646,E,37213,34351,37213,37994,37994,1647,0,E
1646,F,814,814,38027,90,38084,1647,37213,F
1646,G,1171,1171,39198,1210,39294,1647,38027,G
1646,H,332,332,39530,3780,43074,1647,39198,H
1646,M,1030,1030,40560,1459,44533,1647,39530,M
1646,N,462,462,41022,90,44623,1647,40560,N
1646,O,383,383,41405,795,45418,1647,41022,O
1646,P,917,917,42322,3780,49198,1647,41405,P
1647,AEI,440,440,440,901,901,1648,0,A
1647,BEI,620,180,620,1142,1142,1648,0,I
1647,BEJ,551,371,991,150,1051,1648,440,B
1647,CEJ,99,99,1090,50,1101,1648,991,C
1647,BEJ,81,81,1171,135,1236,1648,1090,B
1647,CEJ,125,125,1296,235,1471,1648,1171,C
1647,DEJ,796,120,1416,300,1442,1648,620,J
1647,DEK,134,134,1550,285,1727,1648,1416,K
1647,DEJ,257,3,1553,5280,6751,1648,1296,D
1647,EJ,1897,344,1897,2346,2346,1648,0,E
1647,FJ,625,278,2175,505,2232,1648,1550,J
1647,FK,162,162,2337,235,2467,1648,2175,K
1647,FL,551,111,2448,150,2496,1648,1897,F
1647,GL,73,73,2521,50,2546,1648,2448,G
1647,FL,100,100,2621,135,2681,1648,2521,F
1647,GL,149,149,2770,235,2916,1648,2621,G
1647,HL,178,178,2948,5280,8196,1648,2770,H
1647,L,1891,1280,4228,5280,7747,1648,2337,L
1647,M,88,88,4316,224,8420,1648,4228,M
1647,N,224,224,4540,150,8570,1648,4316,N
1647,O,312,312,4852,155,8725,1648,4540,O
1647,N,688,688,5540,830,9555,1648,4852,N
1647,O,119,119,5659,125,9680,1648,5540,O
1647,P,290,290,5949,4230,13910,1648,5659,P
1648,A,169,169,169,484,484,1649,0,A
1648,B,496,496,665,300,784,1649,169,B
1648,C,1053,1053,1718,985,1769,1649,665,C
1648,B,637,637,2355,640,2409,1649,1718,B
1648,C,217,217,2572,390,2799,1649,2355,C
1648,D,381,381,2953,5400,8199,1649,2572,D
1648,M,61,61,3014,66,8265,1649,2953,M
1648,N,112,112,3126,150,8415,1649,3014,N
1648,O,109,109,3235,120,8535,1649,3126,O
1648,N,847,847,4082,845,9380,1649,3235,N
1648,O,142,142,4224,130,9510,1649,4082,O
1648,P,239,239,4463,4230,13740,1649,4224,P
1649,A,160,160,160,265,265,1650,0,A
1649,B,196,196,356,135,400,1650,160,B
1649,C,242,242,598,285,685,1650,356,C
1649,D,160,160,758,5160,5845,1650,598,D
1649,M,1049,1049,1807,1362,7207,1650,758,M
1649,N,348,348,2155,90,7297,1650,1807,N
1649,O,910,910,3065,1240,8537,1650,2155,O
1649,P,215,215,3280,3780,12317,1650,3065,P
1650,AE,76,76,76,770,770,1651,0,E
1650,AF,801,801,877,150,920,1651,76,F
1650,AG,134,134,1011,145,1065,1651,877,G
1650,AH,1475,464,1475,2572,2572,1651,0,A
1650,BH,554,90,1565,4200,5265,1651,1011,H
1650,B,1198,1108,2673,150,2722,1651,1475,B
1650,C,693,693,3366,730,3452,1651,2673,C
1650,D,801,801,4167,4200,7652,1651,3366,D
1650,M,521,521,4688,1126,8778,1651,4167,M
1650,N,805,805,5493,240,9018,1651,4688,N
1650,O,669,669,6162,920,9938,1651,5493,O
1650,P,5654,5654,11816,3960,13898,1651,6162,P
1651,AE,161,161,161,412,412,1652,0,E
1651,AF,451,451,612,240,652,1652,161,F
1651,AG,1235,623,1235,2748,2748,1652,0,A
1651,BG,1179,556,1791,1165,1817,1652,612,G
1651,BH,241,241,2032,550,2367,1652,1791,H
1651,B,1813,1016,3048,360,3108,1652,1235,B
1651,C,781,781,3829,700,3808,1652,3048,C
1651,D,999,999,4828,550,4358,1652,3829,D
1651,M,12528,12528,17356,13542,17900,1652,4828,M
1651,N,1147,1147,18503,180,18080,1652,17356,N
1651,O,900,900,19403,830,18910,1652,18503,O
1651,N,664,664,20067,705,19615,1652,19403,N
1651,O,564,564,20631,695,20310,1652,20067,O
1651,P,2781,2781,23412,6960,27270,1652,20631,P
1652,AE,214,214,214,228,228,1653,0,E
1652,AF,122,122,336,150,378,1653,214,F
1652,AG,556,556,892,800,1178,1653,336,G
1652,AH,75,75,967,3550,4728,1653,892,H
1652,A,1498,531,1498,1642,1642,1653,0,A
1652,B,281,281,1779,150,1792,1653,1498,B
1652,C,574,574,2353,580,2372,1653,1779,C
1652,B,356,356,2709,370,2742,1653,2353,B
1652,C,96,96,2805,125,2867,1653,2709,C
1652,D,1473,1473,4278,4230,7097,1653,2805,D
1652,M,297,297,4575,329,7426,1653,4278,M
1652,N,110,110,4685,120,7546,1653,4575,N
1652,O,134,134,4819,125,7671,1653,4685,O
1652,P,850,850,5669,2880,10551,1653,4819,P
1653,AEI,518,518,518,591,591,1654,0,A
1653,BEI,247,247,765,240,831,1654,518,B
1653,CEI,1335,570,1335,1710,1710,1654,0,E
1653,CFI,721,151,1486,845,1676,1654,765,C
1653,DFI,816,665,2151,300,2010,1654,1335,F
1653,DGI,756,756,2907,910,2920,1654,2151,G
1653,DHI,2124,703,3610,5220,6896,1654,1486,D
1653,HI,1097,394,4004,3960,6880,1654,2907,H
1653,I,5448,1444,5448,5935,5935,1654,0,I
1653,J,771,771,6219,300,6235,1654,5448,J
1653,K,671,671,6890,735,6970,1654,6219,K
1653,L,35,35,6925,1560,8530,1654,6890,L
1653,M,124,124,7049,371,8901,1654,6925,M
1653,N,445,445,7494,240,9141,1654,7049,N
1653,O,962,962,8456,995,10136,1654,7494,O
1653,N,3241,3241,11697,3130,13266,1654,8456,N
1653,O,633,633,12330,900,14166,1654,11697,O
1653,P,388,388,12718,3960,18126,1654,12330,P
1654,AE,187,187,187,408,408,1655,0,A
1654,BE,353,353,540,180,588,1655,187,B
1654,CE,602,62,602,772,772,1655,0,E
1654,CF,121,59,661,215,803,1655,540,C
1654,BF,284,225,886,150,922,1655,602,F
1654,BG,360,360,1246,315,1237,1655,886,G
1654,BF,1048,463,1709,955,1758,1655,661,B
1654,CF,137,137,1846,210,1968,1655,1709,C
1654,DF,652,52,1898,705,1942,1655,1246,F
1654,DG,200,200,2098,120,2062,1655,1898,G
1654,DH,2517,2265,4363,4140,6108,1655,1846,D
1654,H,3858,1593,5956,4230,6292,1655,2098,H
1654,M,441,441,6397,868,7160,1655,5956,M
1654,N,625,625,7022,240,7400,1655,6397,N
1654,O,160,160,7182,400,7800,1655,7022,O
1654,N,479,479,7661,235,8035,1655,7182,N
1654,O,722,722,8383,965,9000,1655,7661,O
1654,P,4336,4336,12719,3960,12960,1655,8383,P
1655,A,1215,1215,1215,1695,1695,1656,0,A
1655,B,721,721,1936,300,1995,1656,1215,B
1655,C,932,932,2868,1050,3045,1656,1936,C
1655,D,87,87,2955,1140,4185,1656,2868,D
1655,M,455,455,3410,843,5028,1656,2955,M
1655,N,615,615,4025,300,5328,1656,3410,N
1655,O,626,626,4651,820,6148,1656,4025,O
1655,N,374,374,5025,245,6393,1656,4651,N
1655,O,985,985,6010,1320,7713,1656,5025,O
1655,P,9143,9143,15153,6060,13773,1656,6010,P
1656,A,353,353,353,1115,1115,1657,0,A
1656,B,840,840,1193,150,1265,1657,353,B
1656,C,76,76,1269,75,1340,1657,1193,C
1656,B,215,215,1484,205,1545,1657,1269,B
1656,C,96,96,1580,75,1620,1657,1484,C
1656,D,1127,1127,2707,2880,4500,1657,1580,D
1656,M,102,102,2809,821,5321,1657,2707,M
1656,N,841,841,3650,180,5501,1657,2809,N
1656,O,158,158,3808,215,5716,1657,3650,O
1656,N,743,743,4551,665,6381,1657,3808,N
1656,O,828,828,5379,855,7236,1657,4551,O
1656,P,196,196,5575,4140,11376,1657,5379,P
1657,AEI,281,281,281,368,368,1658,0,E
1657,AFI,289,289,570,270,638,1658,281,F
1657,AGI,1128,558,1128,1105,1105,1658,0,A
1657,BGI,631,73,1201,735,1373,1658,570,G
1657,BFI,249,176,1377,300,1405,1658,1128,B
1657,CFI,1445,68,1445,1590,1590,1658,0,I
1657,CFJ,405,405,1850,300,1890,1658,1445,J
1657,CFK,603,130,1980,835,2240,1658,1377,C
1657,DFK,136,136,2116,3955,6195,1658,1980,D
1657,FK,1057,142,2258,940,2313,1658,1201,F
1657,GK,92,92,2350,265,2578,1658,2258,G
1657,HK,565,65,2415,835,2725,1658,1850,K
1657,HL,485,485,2900,2940,5665,1658,2415,L
1657,H,3322,2772,5672,5160,7738,1658,2350,H
1657,M,666,666,6338,4340,12078,1658,5672,M
1657,N,3821,3821,10159,240,12318,1658,6338,N
1657,O,1413,1413,11572,3085,15403,1658,10159,O
1657,P,1813,1813,13385,1800,17203,1658,11572,P
1658,AE,120,120,120,154,154,1659,0,E
1658,AF,153,33,153,214,214,1659,0,A
1658,BF,157,124,277,155,309,1659,120,F
1658,BG,173,49,326,150,364,1659,153,B
1658,CG,190,141,467,190,499,1659,277,G
1658,CH,601,460,927,620,984,1659,326,C
1658,DH,48,48,975,4260,5244,1659,927,D
1658,H,1159,651,1626,2850,3349,1659,467,H
1658,M,2017,2017,3643,3221,8465,1659,1626,M
1658,N,1254,1254,4897,90,8555,1659,3643,N
1658,O,647,647,5544,1135,9690,1659,4897,O
1658,P,2861,2861,8405,3780,13470,1659,5544,P
1659,A,16,16,16,1055,1055,1660,0,A
1659,B,1228,1228,1244,240,1295,1660,16,B
1659,C,798,798,2042,760,2055,1660,1244,C
1659,D,701,701,2743,7680,9735,1660,2042,D
1659,M,141,141,2884,282,10017,1660,2743,M
1659,N,350,350,3234,240,10257,1660,2884,N
1659,O,748,748,3982,765,11022,1660,3234,O
1659,N,174,174,4156,295,11317,1660,3982,N
1659,O,785,785,4941,1260,12577,1660,4156,O
1659,P,356,356,5297,3960,16537,1660,4941,P
1660,AE,469,469,469,1520,1520,1661,0,A
1660,BE,1402,933,1402,1689,1689,1661,0,E
1660,BF,1171,238,1640,180,1700,1661,469,B
1660,CF,344,106,1746,90,1779,1661,1402,F
1660,CG,372,266,2012,630,2330,1661,1640,C
1660,BG,439,173,2185,850,2629,1661,1746,G
1660,BH,742,742,2927,3780,6409,1661,2185,H
1660,B,1303,388,3315,1045,3375,1661,2012,B
1660,C,622,622,3937,925,4300,1661,3315,C
1660,D,1254,1254,5191,350,4650,1661,3937,D
1660,M,4363,4363,9554,5230,11639,1661,5191,M
1660,N,1135,1135,10689,300,11939,1661,9554,N
1660,O,683,683,11372,910,12849,1661,10689,O
1660,P,47,47,11419,3960,16809,1661,11372,P
1661,AEI,149,149,149,731,731,1662,0,E
1661,AFI,764,764,913,240,971,1662,149,F
1661,AGI,158,158,1071,195,1166,1662,913,G
1661,AHI,1581,510,1581,2365,2365,1662,0,I
1661,AHJ,967,967,2548,240,2605,1662,1581,J
1661,AHK,2888,340,2888,3757,3757,1662,0,A
1661,BHK,1181,841,3729,1030,3635,1662,2548,K
1661,BHJ,233,233,3962,485,4120,1662,3729,J
1661,BHK,1144,70,4032,300,4057,1662,2888,B
1661,CHK,525,455,4487,510,4630,1662,3962,K
1661,CHL,1037,582,5069,1050,5107,1662,4032,C
1661,BHL,259,259,5328,350,5457,1662,5069,B
1661,CHL,4314,57,5385,5220,6386,1662,1071,H
1661,CL,1302,404,5789,3960,8590,1662,4487,L
1661,C,702,241,6030,510,5967,1662,5328,C
1661,D,117,117,6147,3960,9927,1662,6030,D
1661,M,35629,35629,41776,36739,46666,1662,6147,M
1661,N,1168,1168,42944,90,46756,1662,41776,N
1661,O,1069,1069,44013,1400,48156,1662,42944,O
1661,N,1133,1133,45146,825,48981,1662,44013,N
1661,O,626,626,45772,920,49901,1662,45146,O
1661,P,380,380,46152,3780,53681,1662,45772,P
1662,AEI,185,185,185,252,252,1663,0,I
1662,AEJ,228,43,228,2555,2555,1663,0,A
1662,BEJ,245,202,430,240,492,1663,185,J
1662,BEK,180,180,610,215,707,1663,430,K
1662,BEL,695,695,1305,4890,5597,1663,610,L
1662,BE,1401,96,1401,1574,1574,1663,0,E
1662,BF,392,392,1793,240,1814,1663,1401,F
1662,BG,634,634,2427,855,2669,1663,1793,G
1662,BH,253,253,2680,3960,6629,1663,2427,H
1662,B,2578,126,2806,300,2855,1663,228,B
1662,C,797,797,3603,995,3850,1663,2806,C
1662,D,932,932,4535,3960,7810,1663,3603,D
1662,M,3262,3262,7797,4531,12341,1663,4535,M
1662,N,1585,1585,9382,90,12431,1663,7797,N
1662,O,1080,1080,10462,1430,13861,1663,9382,O
1662,P,290,290,10752,3780,17641,1663,10462,P
1663,AE,4,4,4,635,635,1664,0,E
1663,AF,213,209,213,874,874,1664,0,A
1663,BF,731,522,735,150,785,1664,4,F
1663,BG,156,156,891,155,940,1664,735,G
1663,BH,851,173,1064,240,1114,1664,213,B
1663,CH,311,311,1375,260,1374,1664,1064,C
1663,DH,1243,1243,2618,5160,6534,1664,1375,D
1663,H,5624,3897,6515,4230,5170,1664,891,H
1663,M,551,551,7066,1052,7586,1664,6515,M
1663,N,658,658,7724,150,7736,1664,7066,N
1663,O,185,185,7909,220,7956,1664,7724,O
1663,N,704,704,8613,705,8661,1664,7909,N
1663,O,692,692,9305,755,9416,1664,8613,O
1663,P,239,239,9544,4230,13646,1664,9305,P
1664,A,17,17,17,206,206,1665,0,A
1664,B,222,222,239,90,296,1665,17,B
1664,C,632,632,871,995,1291,1665,239,C
1664,D,223,223,1094,3780,5071,1665,871,D
1664,M,45,45,1139,928,5999,1665,1094,M
1664,N,1094,1094,2233,240,6239,1665,1139,N
1664,O,548,548,2781,930,7169,1665,2233,O
1664,P,9,9,2790,3780,10949,1665,2781,P
1665,AE,531,531,531,480,480,1666,0,E
1665,AF,69,69,600,180,660,1666,531,F
1665,AG,800,200,800,2320,2320,1666,0,A
1665,BG,395,195,995,960,1620,1666,600,G
1665,BH,1425,1425,2420,2760,4380,1666,995,H
1665,B,1883,263,2683,360,2680,1666,800,B
1665,C,681,681,3364,845,3525,1666,2683,C
1665,D,131,131,3495,2700,6225,1666,3364,D
1665,M,1830,1830,5325,1880,8105,1666,3495,M
1665,N,383,383,5708,300,8405,1666,5325,N
1665,O,740,740,6448,825,9230,1666,5708,O
1665,P,80,80,6528,2940,12170,1666,6448,P
1666,AEI,1182,1182,1182,1604,1604,1667,0,A
1666,BEI,523,523,1705,150,1754,1667,1182,B
1666,CEI,1752,47,1752,2625,2625,1667,0,I
1666,CEJ,1771,19,1771,2433,2433,1667,0,E
1666,CFJ,190,124,1895,130,1884,1667,1705,C
1666,BFJ,756,632,2527,150,2583,1667,1771,F
1666,BGJ,94,94,2621,95,2678,1667,2527,G
1666,BFJ,966,97,2718,150,2775,1667,1752,J
1666,BFK,1074,251,2969,1090,2974,1667,1895,B
1666,CFK,357,9,2978,340,3018,1667,2621,F
1666,CGK,774,514,3492,1030,3805,1667,2718,K
1666,CGJ,638,124,3616,690,3708,1667,2978,G
1666,CHJ,656,9,3625,690,3664,1667,2969,C
1666,DHJ,1216,1083,4708,925,4730,1667,3492,J
1666,DHK,1414,331,5039,4230,7894,1667,3625,D
1666,HK,716,385,5424,705,5435,1667,4708,K
1666,HL,4249,2441,7865,4290,7998,1667,3616,H
1666,L,2877,436,8301,4230,9665,1667,5424,L
1666,M,590,590,8891,245,9910,1667,8301,M
1666,N,206,206,9097,600,10510,1667,8891,N
1666,O,237,237,9334,420,10930,1667,9097,O
1666,N,1404,1404,10738,1215,12145,1667,9334,N
1666,O,272,272,11010,425,12570,1667,10738,O
1666,P,5426,5426,16436,3720,16290,1667,11010,P
1667,AEI,35,35,35,240,240,1668,0,E
1667,AFI,226,191,226,369,369,1668,0,I
1667,AFJ,491,300,526,90,330,1668,35,F
1667,AGJ,321,21,547,240,609,1668,226,J
1667,AGK,591,591,1138,725,1334,1668,547,K
1667,AGL,1192,54,1192,2019,2019,1668,0,A
1667,BGL,961,295,1487,1005,1335,1668,526,G
1667,BHL,27,27,1514,3780,5115,1668,1487,H
1667,BL,701,325,1839,3960,5294,1668,1138,L
1667,B,897,250,2089,90,2109,1668,1192,B
1667,C,1365,1365,3454,1595,3704,1668,2089,C
1667,D,119,119,3573,3780,7484,1668,3454,D
1667,M,55,55,3628,1164,8648,1668,3573,M
1667,N,1229,1229,4857,165,8813,1668,3628,N
1667,O,777,777,5634,1035,9848,1668,4857,O
1667,P,154,154,5788,3960,13808,1668,5634,P
1668,A,827,827,827,1143,1143,1669,0,A
1668,B,346,346,1173,90,1233,1669,827,B
1668,C,529,529,1702,820,2053,1669,1173,C
1668,B,3622,3622,5324,3275,5328,1669,1702,B
1668,C,1454,1454,6778,1390,6718,1669,5324,C
1668,D,456,456,7234,3780,10498,1669,6778,D
1668,M,35892,35892,43126,37228,47726,1669,7234,M
1668,N,1358,1358,44484,90,47816,1669,43126,N
1668,O,1122,1122,45606,1365,49181,1669,44484,O
1668,N,620,620,46226,365,49546,1669,45606,N
1668,O,775,775,47001,1080,50626,1669,46226,O
1668,P,91,91,47092,3780,54406,1669,47001,P
1669,AE,115,115,115,210,210,1670,0,A
1669,BE,128,13,128,1145,1145,1670,0,E
1669,BF,264,251,379,150,360,1670,115,B
1669,CF,103,103,482,80,440,1670,379,C
1669,DF,6,6,488,2880,3320,1670,482,D
1669,F,1131,771,1259,180,1325,1670,128,F
1669,G,722,722,1981,715,2040,1670,1259,G
1669,H,2667,2667,4648,3000,5040,1670,1981,H
1669,M,17,17,4665,5,5045,1670,4648,M
1669,N,74,74,4739,150,5195,1670,4665,N
1669,O,111,111,4850,100,5295,1670,4739,O
1669,P,560,560,5410,3315,8610,1670,4850,P
1670,AEI,123,123,123,1159,1159,1671,0,E
1670,AFI,214,91,214,757,757,1671,0,I
1670,AFJ,573,573,787,90,847,1671,214,J
1670,AFK,304,304,1091,575,1422,1671,787,K
1670,AFL,1066,98,1189,90,1249,1671,123,F
1670,AGL,1039,1039,2228,1220,2469,1671,1189,G
1670,AHL,11,11,2239,3780,6249,1671,2228,H
1670,AL,1996,848,3087,3780,5202,1671,1091,L
1670,A,3201,114,3201,4935,4935,1671,0,A
1670,B,2574,2574,5775,900,5835,1671,3201,B
1670,C,228,228,6003,330,6165,1671,5775,C
1670,B,2053,2053,8056,1900,8065,1671,6003,B
1670,C,989,989,9045,1215,9280,1671,8056,C
1670,D,152,152,9197,350,9630,1671,9045,D
1670,M,758,758,9955,1582,11212,1671,9197,M
1670,N,885,885,10840,90,11302,1671,9955,N
1670,O,236,236,11076,695,11997,1671,10840,O
1670,P,7420,7420,18496,3780,15777,1671,11076,P
1671,AEI,211,211,211,430,430,1672,0,I
1671,AEJ,369,158,369,1213,1213,1672,0,E
1671,AFJ,435,66,435,1269,1269,1672,0,A
1671,BFJ,243,19,454,90,520,1672,211,J
1671,BFK,884,799,1253,90,1303,1672,369,F
1671,BGK,895,77,1330,90,1359,1672,435,B
1671,CGK,446,446,1776,855,2214,1672,1330,C
1671,DGK,1524,202,1978,1780,2300,1672,454,K
1671,DGL,160,160,2138,3780,6080,1672,1978,L
1671,DG,962,77,2215,1240,2543,1672,1253,G
1671,DH,666,227,2442,3780,5994,1672,1776,D
1671,H,2911,2684,5126,3780,6323,1672,2215,H
1671,M,1014,1014,6140,2153,8476,1672,5126,M
1671,N,1229,1229,7369,90,8566,1672,6140,N
1671,O,183,183,7552,610,9176,1672,7369,O
1671,P,2722,2722,10274,3780,12956,1672,7552,P
1672,AE,73,73,73,149,149,1673,0,E
1672,AF,173,173,246,150,299,1673,73,F
1672,AG,103,103,349,80,379,1673,246,G
1672,AH,158,158,507,2880,3259,1673,349,H
1672,A,1290,783,1290,1347,1347,1673,0,A
1672,B,146,146,1436,150,1497,1673,1290,B
1672,C,658,658,2094,585,2082,1673,1436,C
1672,B,1717,1717,3811,1780,3862,1673,2094,B
1672,C,142,142,3953,130,3992,1673,3811,C
1672,D,4286,4286,8239,4230,8222,1673,3953,D
1672,M,149,149,8388,180,8402,1673,8239,M
1672,N,125,125,8513,150,8552,1673,8388,N
1672,O,126,126,8639,130,8682,1673,8513,O
1672,N,1558,1558,10197,1545,10227,1673,8639,N
1672,O,822,822,11019,775,11002,1673,10197,O
1672,P,348,348,11367,4230,15232,1673,11019,P
1673,AE,218,218,218,233,233,1674,0,A
1673,BE,266,48,266,298,298,1674,0,E
1673,BF,111,63,329,150,383,1674,218,B
1673,CF,127,64,393,150,448,1674,266,F
1673,CG,127,63,456,130,513,1674,329,C
1673,BG,167,104,560,125,573,1674,393,G
1673,BF,942,838,1398,930,1443,1674,456,B
1673,CF,865,27,1425,890,1463,1674,560,F
1673,CG,288,288,1713,645,2108,1674,1425,G
1673,CH,400,85,1798,645,2088,1674,1398,C
1673,DH,1674,1674,3472,4230,6318,1674,1798,D
1673,H,3488,1729,5201,4290,6398,1674,1713,H
1673,M,3104,3104,8305,4358,10756,1674,5201,M
1673,N,1288,1288,9593,90,10846,1674,8305,N
1673,O,1619,1619,11212,1875,12721,1674,9593,O
1673,N,708,708,11920,450,13171,1674,11212,N
1673,O,559,559,12479,1000,14171,1674,11920,O
1673,P,11877,11877,24356,3780,17951,1674,12479,P
1674,A,1656,1656,1656,1945,1945,1675,0,A
1674,B,829,829,2485,600,2545,1675,1656,B
1674,C,628,628,3113,575,3120,1675,2485,C
1674,D,4849,4849,7962,550,3670,1675,3113,D
1674,M,2084,2084,10046,2950,6620,1675,7962,M
1674,N,1616,1616,11662,420,7040,1675,10046,N
1674,O,1078,1078,12740,1605,8645,1675,11662,O
1674,P,1926,1926,14666,350,8995,1675,12740,P
1675,AE,10,10,10,607,607,1676,0,E
1675,AF,258,248,258,287,287,1676,0,A
1675,BF,376,376,634,420,707,1676,258,B
1675,CF,442,442,1076,790,1497,1676,634,C
1675,DF,1313,247,1323,780,1387,1676,10,F
1675,DG,435,435,1758,538,1925,1676,1323,G
1675,DH,1648,966,2724,1265,2762,1676,1076,D
1675,H,5966,5000,7724,402,2327,1676,1758,H
1675,M,904,904,8628,8981,11743,1676,7724,M
1675,N,8197,8197,16825,180,11923,1676,8628,N
1675,O,2211,2211,19036,900,12823,1676,16825,O
1675,N,351,351,19387,1650,14473,1676,19036,N
1675,O,372,372,19759,700,15173,1676,19387,O
1675,P,13245,13245,33004,6840,22013,1676,19759,P
1676,AEI,87,87,87,137,137,1677,0,I
1676,AEJ,153,153,240,150,287,1677,87,J
1676,AEK,154,154,394,130,417,1677,240,K
1676,AEJ,650,256,650,1023,1023,1677,0,A
1676,BEJ,432,432,1082,90,1113,1677,650,B
1676,CEJ,1085,3,1085,1229,1229,1677,0,E
1676,CFJ,171,171,1256,90,1319,1677,1085,F
1676,CGJ,481,481,1737,820,2139,1677,1256,G
1676,CHJ,1515,172,1909,1525,1942,1677,394,J
1676,CHK,966,139,2048,1240,2353,1677,1082,C
1676,DHK,7,7,2055,3780,6133,1677,2048,D
1676,HK,402,84,2139,3780,5919,1677,1737,H
1676,K,824,594,2733,770,2712,1677,1909,K
1676,L,279,279,3012,4230,6942,1677,2733,L
1676,M,393,393,3405,907,7849,1677,3012,M
1676,N,547,547,3952,90,7939,1677,3405,N
1676,O,510,510,4462,845,8784,1677,3952,O
1676,P,736,736,5198,3780,12564,1677,4462,P
1677,AEI,87,87,87,663,663,1678,0,I
1677,AEJ,118,31,118,2374,2374,1678,0,E
1677,AFJ,666,635,753,150,813,1678,87,J
1677,AFK,524,524,1277,500,1313,1678,753,K
1677,AFL,329,329,1606,385,1698,1678,1277,L
1677,AF,1671,65,1671,2072,2072,1678,0,A
1677,BF,431,431,2102,90,2162,1678,1671,B
1677,CF,2436,452,2554,240,2614,1678,118,F
1677,CG,966,514,3068,625,2787,1678,2102,C
1677,DG,749,235,3303,770,3384,1678,2554,G
1677,DH,446,446,3749,550,3934,1678,3303,H
1677,D,4732,4051,7800,550,3337,1678,3068,D
1677,M,576,576,8376,1262,5196,1678,7800,M
1677,N,832,832,9208,180,5376,1678,8376,N
1677,O,856,856,10064,830,6206,1678,9208,O
1677,N,1096,1096,11160,1120,7326,1678,10064,N
1677,O,1051,1051,12211,1070,8396,1678,11160,O
1677,P,404,404,12615,6900,15296,1678,12211,P
1678,AE,61,61,61,845,845,1679,0,E
1678,AF,964,964,1025,240,1085,1679,61,F
1678,AG,788,788,1813,770,1855,1679,1025,G
1678,AH,330,330,2143,550,2405,1679,1813,H
1678,A,16098,13955,16098,16209,16209,1679,0,A
1678,B,1157,1157,17255,250,16459,1679,16098,B
1678,C,955,955,18210,995,17454,1679,17255,C
1678,D,2196,2196,20406,550,18004,1679,18210,D
1678,M,964,964,21370,1647,19651,1679,20406,M
1678,N,1031,1031,22401,420,20071,1679,21370,N
1678,O,920,920,23321,1125,21196,1679,22401,O
1678,P,761,761,24082,350,21546,1679,23321,P
1679,AEI,298,298,298,680,680,1680,0,I
1679,AEJ,359,61,359,604,604,1680,0,A
1679,BEJ,396,396,755,210,814,1680,359,B
1679,CEJ,567,110,865,240,920,1680,298,J
1679,CEK,990,125,990,1999,1999,1680,0,E
1679,CFK,774,539,1529,895,1709,1680,755,C
1679,BFK,744,80,1609,810,1730,1680,865,K
1679,BFJ,216,136,1745,100,1809,1680,1529,B
1679,CFJ,179,179,1924,525,2334,1680,1745,C
1679,DFJ,1037,103,2027,90,2089,1680,990,F
1679,DGJ,327,224,2251,960,3294,1680,1924,D
1679,GJ,671,29,2280,585,2315,1680,1609,J
1679,GK,826,573,2853,1215,3304,1680,2027,G
1679,FK,917,344,3197,1230,3545,1680,2280,K
1679,FL,829,485,3682,435,3739,1680,2853,F
1679,GL,385,385,4067,755,4494,1680,3682,G
1679,HL,3005,3005,7072,3780,8274,1680,4067,H
1679,L,10094,6219,13291,3960,7505,1680,3197,L
1679,M,1464,1464,14755,1658,9932,1680,13291,M
1679,N,451,451,15206,300,10232,1680,14755,N
1679,O,1137,1137,16343,1275,11507,1680,15206,O
1679,N,84,84,16427,765,12272,1680,16343,N
1679,O,514,514,16941,810,13082,1680,16427,O
1679,P,1560,1560,18501,3960,17042,1680,16941,P
1680,AEI,42,42,42,126,126,1681,0,I
1680,AEJ,173,131,173,170,170,1681,0,A
1680,BEJ,92,92,265,135,305,1681,173,B
1680,CEJ,280,57,322,240,366,1681,42,J
1680,CEK,151,94,416,280,585,1681,265,C
1680,DEK,333,239,655,290,656,1681,322,K
1680,DEL,339,100,755,5160,5745,1681,416,D
1680,EL,1116,361,1116,1898,1898,1681,0,E
1680,FL,917,917,2033,180,2078,1681,1116,F
1680,GL,1380,2,2035,5160,5816,1681,655,L
1680,G,613,611,2646,645,2723,1681,2033,G
1680,H,315,315,2961,6960,9683,1681,2646,H
1680,M,902,902,3863,1428,11111,1681,2961,M
1680,N,572,572,4435,90,11201,1681,3863,N
1680,O,978,978,5413,1240,12441,1681,4435,O
1680,N,818,818,6231,550,12991,1681,5413,N
1680,O,742,742,6973,965,13956,1681,6231,O
1680,P,1150,1150,8123,3780,17736,1681,6973,P
1681,A,113,113,113,201,201,1682,0,A
1681,B,203,203,316,150,351,1682,113,B
1681,C,690,690,1006,620,971,1682,316,C
1681,D,168,168,1174,4200,5171,1682,1006,D
1681,M,1665,1665,2839,2628,7799,1682,1174,M
1681,N,993,993,3832,90,7889,1682,2839,N
1681,O,966,966,4798,1225,9114,1682,3832,O
1681,N,657,657,5455,400,9514,1682,4798,N
1681,O,642,642,6097,965,10479,1682,5455,O
1681,P,351,351,6448,3780,14259,1682,6097,P
1682,AEI,6,6,6,61,61,1683,0,A
1682,BEI,14,8,14,25,25,1683,0,E
1682,BFI,15,1,15,40,40,1683,0,I
1682,BFJ,102,101,116,150,175,1683,14,F
1682,BGJ,110,9,125,135,175,1683,15,J
1682,BGK,138,19,144,135,196,1683,6,B
1682,CGK,189,161,305,210,385,1683,116,G
1682,CHK,194,14,319,285,460,1683,125,K
1682,CHL,39,25,344,2880,3265,1683,305,H
1682,CL,212,12,356,285,481,1683,144,C
1682,DL,118,81,437,5160,5620,1683,319,L
1682,D,152,71,508,5160,5641,1683,356,D
1682,M,812,812,1320,1632,7273,1683,508,M
1682,N,993,993,2313,150,7423,1683,1320,N
1682,O,1326,1326,3639,1610,9033,1683,2313,O
1682,P,393,393,4032,2520,11553,1683,3639,P
1683,AEI,351,351,351,1368,1368,1684,0,A
1683,BEI,393,42,393,1349,1349,1684,0,E
1683,BFI,1409,1016,1409,1515,1515,1684,0,I
1683,BFJ,1046,30,1439,150,1499,1684,393,F
1683,BGJ,1107,19,1458,150,1518,1684,351,B
1683,CGJ,141,92,1550,120,1635,1684,1409,J
1683,CGK,245,245,1795,390,2025,1684,1550,K
1683,CGJ,754,398,2193,750,2249,1684,1439,G
1683,CFJ,887,152,2345,755,2273,1684,1458,C
1683,BFJ,1283,1131,3476,1275,3524,1684,2193,F
1683,BGJ,1159,28,3504,1275,3548,1684,2345,B
1683,CGJ,627,599,4103,685,4209,1684,3476,G
1683,CHJ,639,40,4143,705,4253,1684,3504,C
1683,DHJ,3696,1348,5491,3525,5550,1684,1795,J
1683,DHK,680,680,6171,685,6235,1684,5491,K
1683,DHL,7257,5189,11360,5760,9969,1684,4103,H
1683,DL,7250,33,11393,5820,10073,1684,4143,D
1683,L,9977,4755,16148,5760,11995,1684,6171,L
1683,M,322,322,16470,500,12495,1684,16148,M
1683,N,483,483,16953,300,12795,1684,16470,N
1683,O,676,676,17629,1845,14640,1684,16953,O
1683,P,527179,527179,544808,2940,17580,1684,17629,P
1684,A,55,55,55,1890,1890,1685,0,A
1684,B,2115,2115,2170,300,2190,1685,55,B
1684,C,568,568,2738,735,2925,1685,2170,C
1684,D,92,92,2830,1560,4485,1685,2738,D
1684,M,125,125,2955,1359,5844,1685,2830,M
1684,N,1594,1594,4549,420,6264,1685,2955,N
1684,O,443,443,4992,700,6964,1685,4549,O
1684,N,658,658,5650,375,7339,1685,4992,N
1684,O,199,199,5849,175,7514,1685,5650,O
1684,P,4075,4075,9924,6640,14154,1685,5849,P
1685,AE,93,93,93,1160,1160,1686,0,A
1685,BE,724,631,724,1221,1221,1686,0,E
1685,BF,1100,469,1193,90,1250,1686,93,B
1685,CF,680,211,1404,90,1311,1686,724,F
1685,CG,1022,811,2215,1220,2470,1686,1193,C
1685,DG,875,64,2279,1240,2551,1686,1404,G
1685,DH,89,25,2304,3780,6250,1686,2215,D
1685,H,38,13,2317,3780,6331,1686,2279,H
1685,M,475,475,2792,994,7325,1686,2317,M
1685,N,550,550,3342,90,7415,1686,2792,N
1685,O,236,236,3578,585,8000,1686,3342,O
1685,P,8720,8720,12298,3780,11780,1686,3578,P
1686,A,1616,1616,1616,2666,2666,1687,0,A
1686,B,1077,1077,2693,90,2756,1687,1616,B
1686,C,615,615,3308,915,3671,1687,2693,C
1686,B,725,725,4033,420,4091,1687,3308,B
1686,C,781,781,4814,1060,5151,1687,4033,C
1686,D,140,140,4954,3780,8931,1687,4814,D
1686,M,2655,2655,7609,2851,11782,1687,4954,M
1686,N,221,221,7830,90,11872,1687,7609,N
1686,O,679,679,8509,1105,12977,1687,7830,O
1686,P,291,291,8800,3780,16757,1687,8509,P
1687,A,1220,1220,1220,1590,1590,1688,0,A
1687,B,637,637,1857,300,1890,1688,1220,B
1687,C,1052,1052,2909,1045,2935,1688,1857,C
1687,D,1309,1309,4218,1140,4075,1688,2909,D
1687,M,4475,4475,8693,5345,9420,1688,4218,M
1687,N,1215,1215,9908,300,9720,1688,8693,N
1687,O,997,997,10905,965,10685,1688,9908,O
1687,P,6757,6757,17662,2760,13445,1688,10905,P
1688,AEI,45,45,45,354,354,1689,0,E
1688,AFI,265,220,265,384,384,1689,0,I
1688,AFJ,425,205,470,150,504,1689,45,F
1688,AGJ,297,92,562,240,624,1689,265,J
1688,AGK,137,45,607,175,679,1689,470,G
1688,AHK,42,42,649,4170,4849,1689,607,H
1688,AK,865,778,1427,995,1619,1689,562,K
1688,AL,415,415,1842,3960,5579,1689,1427,L
1688,A,4140,2298,4140,4651,4651,1689,0,A
1688,B,563,563,4703,90,4741,1689,4140,B
1688,C,1426,1426,6129,1565,6306,1689,4703,C
1688,D,2053,2053,8182,3780,10086,1689,6129,D
1688,M,626,626,8808,1184,11270,1689,8182,M
1688,N,603,603,9411,90,11360,1689,8808,N
1688,O,879,879,10290,1225,12585,1689,9411,O
1688,P,756,756,11046,3780,16365,1689,10290,P
1689,A,2649,2649,2649,3686,3686,1690,0,A
1689,B,1308,1308,3957,300,3986,1690,2649,B
1689,C,1144,1144,5101,1050,5036,1690,3957,C
1689,B,907,907,6008,980,6016,1690,5101,B
1689,C,1021,1021,7029,1560,7576,1690,6008,C
1689,D,648,648,7677,3960,11536,1690,7029,D
1689,M,83,83,7760,375,11911,1690,7677,M
1689,N,593,593,8353,180,12091,1690,7760,N
1689,O,372,372,8725,895,12986,1690,8353,O
1689,P,132,132,8857,6680,19666,1690,8725,P
1690,AE,1061,1061,1061,1582,1582,1691,0,A
1690,BE,569,569,1630,90,1672,1691,1061,B
1690,CE,884,884,2514,1250,2922,1691,1630,C
1690,DE,1751,1751,4265,3780,6702,1691,2514,D
1690,E,33955,29690,33955,36553,36553,1691,0,E
1690,F,2628,2628,36583,90,36643,1691,33955,F
1690,G,1045,1045,37628,1210,37853,1691,36583,G
1690,H,220,220,37848,3780,41633,1691,37628,H
1690,M,1285,1285,39133,3244,44877,1691,37848,M
1690,N,1991,1991,41124,90,44967,1691,39133,N
1690,O,433,433,41557,705,45672,1691,41124,O
1690,P,338,338,41895,3780,49452,1691,41557,P
1691,AEI,159,159,159,389,389,1692,0,A
1691,BEI,271,271,430,150,539,1692,159,B
1691,CEI,242,242,672,175,714,1692,430,C
1691,DEI,817,145,817,1005,1005,1692,0,I
1691,DEJ,236,91,908,1520,2234,1692,672,D
1691,EJ,302,211,1119,150,1155,1692,817,J
1691,EK,293,293,1412,320,1475,1692,1119,K
1691,EL,1730,318,1730,1994,1994,1692,0,E
1691,FL,306,306,2036,90,2084,1692,1730,F
1691,GL,1173,1173,3209,1315,3399,1692,2036,G
1691,HL,1841,44,3253,4020,5495,1692,1412,L
1691,H,45,1,3254,3780,7179,1692,3209,H
1691,M,1537,1537,4791,1813,8992,1692,3254,M
1691,N,426,426,5217,240,9232,1692,4791,N
1691,O,395,395,5612,845,10077,1692,5217,O
1691,P,462,462,6074,3720,13797,1692,5612,P
1692,A,163,163,163,1006,1006,1693,0,A
1692,B,963,963,1126,180,1186,1693,163,B
1692,C,946,946,2072,1055,2241,1693,1126,C
1692,B,1659,1659,3731,1555,3796,1693,2072,B
1692,C,716,716,4447,820,4616,1693,3731,C
1692,D,246,246,4693,5040,9656,1693,4447,D
1692,M,10407,10407,15100,19012,28668,1693,4693,M
1692,N,8631,8631,23731,90,28758,1693,15100,N
1692,O,344,344,24075,725,29483,1693,23731,O
1692,P,6840,6840,30915,3780,33263,1693,24075,P
1693,AEI,1046,1046,1046,1303,1303,1694,0,E
1693,AFI,285,285,1331,90,1393,1694,1046,F
1693,AGI,2085,754,2085,5995,5995,1694,0,A
1693,BGI,1049,295,2380,1250,2643,1694,1331,G
1693,BHI,40,40,2420,3780,6423,1694,2380,H
1693,BI,4357,1937,4357,6227,6227,1694,0,I
1693,BJ,3905,1633,5990,90,6085,1694,2085,B
1693,CJ,1865,232,6222,90,6317,1694,4357,J
1693,CK,1384,1152,7374,1655,7740,1694,5990,C
1693,DK,1441,289,7663,1655,7972,1694,6222,K
1693,DL,469,180,7843,3780,11520,1694,7374,D
1693,L,364,184,8027,3780,11752,1694,7663,L
1693,M,4015,4015,12042,4764,16516,1694,8027,M
1693,N,776,776,12818,90,16606,1694,12042,N
1693,O,527,527,13345,800,17406,1694,12818,O
1693,P,2287,2287,15632,3780,21186,1694,13345,P
1694,AEI,81,81,81,301,301,1695,0,I
1694,AEJ,106,25,106,195,195,1695,0,E
1694,AFJ,343,318,424,90,391,1695,81,J
1694,AFK,355,37,461,240,435,1695,106,F
1694,AGK,480,19,480,782,782,1695,0,A
1694,BGK,173,154,634,215,650,1695,461,G
1694,BHK,335,181,815,90,872,1695,480,B
1694,CHK,709,318,1133,1010,1401,1695,424,K
1694,CHL,591,92,1225,4890,5540,1695,634,H
1694,CL,222,130,1355,3780,5181,1695,1133,L
1694,C,966,426,1781,1335,2207,1695,815,C
1694,D,1582,1582,3363,3780,5987,1695,1781,D
1694,M,60,60,3423,801,6788,1695,3363,M
1694,N,955,955,4378,240,7028,1695,3423,N
1694,O,548,548,4926,930,7958,1695,4378,O
1694,P,142,142,5068,3780,11738,1695,4926,P
1695,AE,233,233,233,664,664,1696,0,A
1695,BE,332,99,332,908,908,1696,0,E
1695,BF,608,509,841,240,904,1696,233,B
1695,CF,148,148,989,225,1129,1696,841,C
1695,DF,703,46,1035,180,1088,1696,332,F
1695,DG,149,103,1138,4890,6019,1696,989,D
1695,G,205,102,1240,305,1393,1696,1035,G
1695,H,308,308,1548,4080,5473,1696,1240,H
1695,M,26,26,1574,140,6159,1696,1548,M
1695,N,344,344,1918,240,6399,1696,1574,N
1695,O,696,696,2614,960,7359,1696,1918,O
1695,P,64,64,2678,3960,11319,1696,2614,P
1696,AEI,831,831,831,1224,1224,1697,0,A
1696,BEI,448,448,1279,90,1314,1697,831,B
1696,CEI,855,855,2134,1230,2544,1697,1279,C
1696,DEI,137,137,2271,3780,6324,1697,2134,D
1696,EI,2857,586,2857,4060,4060,1697,0,I
1696,EJ,3262,405,3262,4404,4404,1697,0,E
1696,FJ,1262,857,4119,90,4150,1697,2857,J
1696,FK,1169,312,4431,90,4494,1697,3262,F
1696,GK,979,667,5098,1225,5375,1697,4119,K
1696,GL,17,17,5115,3780,9155,1697,5098,L
1696,G,1015,331,5446,1220,5714,1697,4431,G
1696,H,93,93,5539,3780,9494,1697,5446,H
1696,M,581,581,6120,1145,10639,1697,5539,M
1696,N,608,608,6728,90,10729,1697,6120,N
1696,O,464,464,7192,850,11579,1697,6728,O
1696,P,456,456,7648,3780,15359,1697,7192,P
1697,A,14856,14856,14856,14854,14854,1698,0,A
1697,B,272,272,15128,300,15154,1698,14856,B
1697,C,562,562,15690,735,15889,1698,15128,C
1697,D,1464,1464,17154,1560,17449,1698,15690,D
1697,M,1601,1601,18755,1787,19236,1698,17154,M
1697,N,401,401,19156,180,19416,1698,18755,N
1697,O,690,690,19846,875,20291,1698,19156,O
1697,N,690,690,20536,430,20721,1698,19846,N
1697,O,543,543,21079,900,21621,1698,20536,O
1697,P,371,371,21450,3960,25581,1698,21079,P
1698,AEI,82,82,82,49,49,1699,0,A
1698,BEI,139,57,139,801,801,1699,0,I
1698,BEJ,72,15,154,150,199,1699,82,B
1698,CEJ,264,110,264,746,746,1699,0,E
1698,CFJ,126,16,280,400,599,1699,154,C
1698,BFJ,577,561,841,150,896,1699,264,F
1698,BGJ,853,151,992,240,1041,1699,139,J
1698,BGK,168,17,1009,130,1026,1699,841,G
1698,BFK,903,174,1183,630,1229,1699,280,B
1698,CFK,323,132,1315,915,1956,1699,992,K
1698,CFL,436,304,1619,650,1879,1699,1183,C
1698,DFL,1552,942,2561,1565,2591,1699,1009,F
1698,DGL,401,401,2962,650,3241,1699,2561,G
1698,DHL,1848,201,3163,3960,5916,1699,1315,L
1698,DH,3213,3012,6175,4230,7471,1699,2962,H
1698,D,17313,12757,18932,4230,6109,1699,1619,D
1698,M,1487,1487,20419,1529,9000,1699,18932,M
1698,N,159,159,20578,150,9150,1699,20419,N
1698,O,613,613,21191,580,9730,1699,20578,O
1698,N,692,692,21883,745,10475,1699,21191,N
1698,O,101,101,21984,390,10865,1699,21883,O
1698,P,486,486,22470,3960,14825,1699,21984,P
1699,AE,56,56,56,359,359,1700,0,E
1699,AF,456,400,456,445,445,1700,0,A
1699,BF,407,7,463,120,479,1700,56,F
1699,BG,82,75,538,150,595,1700,456,B
1699,CG,90,90,628,80,675,1700,538,C
1699,DG,31,31,659,2880,3555,1700,628,D
1699,G,347,151,810,440,919,1700,463,G
1699,F,406,406,1216,360,1279,1700,810,F
1699,G,123,123,1339,285,1564,1700,1216,G
1699,H,1229,1229,2568,5100,6664,1700,1339,H
1699,M,523,523,3091,3965,10629,1700,2568,M
1699,N,3439,3439,6530,90,10719,1700,3091,N
1699,O,1095,1095,7625,1380,12099,1700,6530,O
1699,N,929,929,8554,605,12704,1700,7625,N
1699,O,1136,1136,9690,920,13624,1700,8554,O
1699,P,645,645,10335,3780,17404,1700,9690,P
1700,A,1164,1164,1164,1439,1439,1701,0,A
1700,B,420,420,1584,150,1589,1701,1164,B
1700,C,175,175,1759,280,1869,1701,1584,C
1700,D,2861,2861,4620,5160,7029,1701,1759,D
1700,M,821,821,5441,1310,8339,1701,4620,M
1700,N,630,630,6071,180,8519,1701,5441,N
1700,O,555,555,6626,885,9404,1701,6071,O
1700,N,1089,1089,7715,780,10184,1701,6626,N
1700,O,558,558,8273,680,10864,1701,7715,O
1700,P,2091,2091,10364,5460,16324,1701,8273,P
1701,AEI,340,340,340,620,620,1702,0,E
1701,AFI,500,160,500,875,875,1702,0,A
1701,BFI,525,25,525,851,851,1702,0,I
1701,BFJ,354,354,879,90,941,1702,525,J
1701,BFK,427,48,927,90,965,1702,500,B
1701,CFK,983,396,1323,745,1365,1702,340,F
1701,CGK,599,599,1922,760,2125,1702,1323,G
1701,CHK,1402,359,2281,1865,2806,1702,879,K
1701,CHL,1373,19,2300,1865,2830,1702,927,C
1701,DHL,1353,1353,3653,3780,6610,1702,2300,D
1701,HL,1587,215,3868,3780,6586,1702,2281,L
1701,H,6245,4299,8167,1140,3265,1702,1922,H
1701,M,1376,1376,9543,1942,8552,1702,8167,M
1701,N,600,600,10143,90,8642,1702,9543,N
1701,O,1485,1485,11628,1745,10387,1702,10143,O
1701,P,211,211,11839,3780,14167,1702,11628,P
1702,AEI,124,124,124,394,394,1703,0,E
1702,AFI,335,335,459,90,484,1703,124,F
1702,AGI,889,430,889,1295,1295,1703,0,I
1702,AGJ,446,446,1335,90,1385,1703,889,J
1702,AGK,1356,480,1815,1745,2229,1703,459,G
1702,AHK,119,119,1934,3780,6009,1703,1815,H
1702,AK,2076,142,2076,7657,7657,1703,0,A
1702,BK,1016,275,2351,1240,2625,1703,1335,K
1702,BL,56,56,2407,3780,6405,1703,2351,L
1702,B,5627,5296,7703,90,7747,1703,2076,B
1702,C,844,844,8547,1250,8997,1703,7703,C
1702,D,230,230,8777,3780,12777,1703,8547,D
1702,M,235,235,9012,491,13268,1703,8777,M
1702,N,307,307,9319,90,13358,1703,9012,N
1702,O,1586,1586,10905,2315,15673,1703,9319,O
1702,P,1479,1479,12384,3420,19093,1703,10905,P
1703,AEI,65,65,65,45,45,1704,0,E
1703,AFI,72,7,72,115,115,1704,0,A
1703,BFI,74,2,74,218,218,1704,0,I
1703,BFJ,189,189,263,90,308,1704,74,J
1703,BFK,227,36,299,240,355,1704,72,B
1703,CFK,205,205,504,770,1125,1704,299,C
1703,DFK,485,46,550,570,615,1704,65,F
1703,DGK,339,52,602,575,883,1704,263,K
1703,DGJ,68,16,618,80,695,1704,550,G
1703,DHJ,82,82,700,2880,3575,1704,618,H
1703,DJ,1477,1379,2079,1165,2048,1704,602,J
1703,DK,1933,358,2437,3600,4725,1704,504,D
1703,K,1509,1151,3588,1855,3903,1704,2079,K
1703,L,1306,1306,4894,3780,7683,1704,3588,L
1703,M,477,477,5371,2253,9936,1704,4894,M
1703,N,2013,2013,7384,90,10026,1704,5371,N
1703,O,477,477,7861,850,10876,1704,7384,O
1703,P,1803,1803,9664,3780,14656,1704,7861,P
1704,AEI,138,138,138,202,202,1705,0,I
1704,AEJ,138,138,276,135,337,1705,138,J
1704,AEK,178,178,454,215,552,1705,276,K
1704,AEL,1071,1071,1525,4890,5442,1705,454,L
1704,AE,3049,1524,3049,3355,3355,1705,0,A
1704,BE,3134,85,3134,4043,4043,1705,0,E
1704,BF,510,425,3559,240,3595,1705,3049,B
1704,CF,693,693,4252,920,4515,1705,3559,C
1704,DF,1162,44,4296,300,4343,1705,3134,F
1704,DG,198,154,4450,3960,8475,1705,4252,D
1704,G,1219,1065,5515,1000,5343,1705,4296,G
1704,H,732,732,6247,3960,9303,1705,5515,H
1704,M,153,153,6400,1137,10440,1705,6247,M
1704,N,1188,1188,7588,240,10680,1705,6400,N
1704,O,496,496,8084,765,11445,1705,7588,O
1704,P,38,38,8122,3960,15405,1705,8084,P
1705,AE,1910,1910,1910,2552,2552,1706,0,A
1705,BE,736,736,2646,90,2642,1706,1910,B
1705,CE,1113,1113,3759,1380,4022,1706,2646,C
1705,BE,4168,409,4168,4818,4818,1706,0,E
1705,BF,686,277,4445,475,4497,1706,3759,B
1705,CF,681,404,4849,90,4908,1706,4168,F
1705,CG,480,76,4925,860,5357,1706,4445,C
1705,DG,84,84,5009,3780,9137,1706,4925,D
1705,G,474,314,5323,850,5758,1706,4849,G
1705,H,150,150,5473,3780,9538,1706,5323,H
1705,M,1408,1408,6881,1726,11264,1706,5473,M
1705,N,392,392,7273,90,11354,1706,6881,N
1705,O,465,465,7738,870,12224,1706,7273,O
1705,N,372,372,8110,10,12234,1706,7738,N
1705,O,474,474,8584,800,13034,1706,8110,O
1705,P,847,847,9431,3780,16814,1706,8584,P
1706,A,1070,1070,1070,1105,1105,1707,0,A
1706,B,138,138,1208,150,1255,1707,1070,B
1706,C,185,185,1393,280,1535,1707,1208,C
1706,D,508,508,1901,5160,6695,1707,1393,D
1706,M,791,791,2692,1148,7843,1707,1901,M
1706,N,386,386,3078,90,7933,1707,2692,N
1706,O,967,967,4045,1240,9173,1707,3078,O
1706,P,7,7,4052,3780,12953,1707,4045,P
1707,A,772,772,772,1543,1543,1708,0,A
1707,B,796,796,1568,90,1633,1708,772,B
1707,C,882,882,2450,1250,2883,1708,1568,C
1707,D,1653,1653,4103,3780,6663,1708,2450,D
1707,M,726,726,4829,1346,8009,1708,4103,M
1707,N,661,661,5490,90,8099,1708,4829,N
1707,O,994,994,6484,1285,9384,1708,5490,O
1707,P,1981,1981,8465,3780,13164,1708,6484,P
1708,AEI,175,175,175,2314,2314,1709,0,I
1708,AEJ,606,431,606,387,387,1709,0,A
1708,BEJ,21,21,627,300,687,1709,606,B
1708,CEJ,682,682,1309,900,1587,1709,627,C
1708,BEJ,1524,215,1524,1760,1760,1709,0,E
1708,BFJ,451,236,1760,210,1797,1709,1309,B
1708,CFJ,267,31,1791,90,1850,1709,1524,F
1708,CGJ,633,602,2393,775,2572,1709,1760,C
1708,DGJ,109,109,2502,4080,6652,1709,2393,D
1708,GJ,2332,5,2507,240,2554,1709,175,J
1708,GK,862,146,2653,1100,2950,1709,1791,G
1708,FK,755,755,3408,510,3460,1709,2653,F
1708,GK,1029,128,3536,1030,3584,1709,2507,K
1708,GL,964,836,4372,1310,4770,1709,3408,G
1708,HL,1038,202,4574,3960,7544,1709,3536,L
1708,H,284,82,4656,3780,8550,1709,4372,H
1708,M,10913,10913,15569,13247,21797,1709,4656,M
1708,N,2530,2530,18099,240,22037,1709,15569,N
1708,O,766,766,18865,1120,23157,1709,18099,O
1708,P,10607,10607,29472,3960,27117,1709,18865,P
1709,AE,329,329,329,1363,1363,1710,0,E
1709,AF,1064,1064,1393,90,1453,1710,329,F
1709,AG,984,984,2377,1210,2663,1710,1393,G
1709,AH,3,3,2380,3780,6443,1710,2377,H
1709,A,5688,3308,5688,5985,5985,1710,0,A
1709,B,1001,1001,6689,600,6585,1710,5688,B
1709,C,1058,1058,7747,1370,7955,1710,6689,C
1709,D,1626,1626,9373,590,8545,1710,7747,D
1709,M,1194,1194,10567,1481,10026,1710,9373,M
1709,N,338,338,10905,90,10116,1710,10567,N
1709,O,447,447,11352,850,10966,1710,10905,O
1709,P,914,914,12266,3780,14746,1710,11352,P
1710,AEI,1,1,1,35,35,1711,0,A
1710,BEI,19,18,19,54,54,1711,0,E
1710,BFI,137,118,137,146,146,1711,0,I
1710,BFJ,144,8,145,150,185,1711,1,B
1710,CFJ,142,16,161,150,204,1711,19,F
1710,CGJ,107,83,244,150,296,1711,137,J
1710,CGK,108,25,269,115,319,1711,161,G
1710,CHK,9,9,278,4230,4549,1711,269,H
1710,CK,192,59,337,115,300,1711,145,C
1710,DK,7,7,344,4230,4530,1711,337,D
1710,K,164,64,408,130,426,1711,244,K
1710,J,848,848,1256,880,1306,1711,408,J
1710,K,136,136,1392,115,1421,1711,1256,K
1710,L,309,309,1701,4230,5651,1711,1392,L
1710,M,746,746,2447,725,6376,1711,1701,M
1710,N,185,185,2632,240,6616,1711,2447,N
1710,O,216,216,2848,395,7011,1711,2632,O
1710,N,393,393,3241,205,7216,1711,2848,N
1710,O,194,194,3435,435,7651,1711,3241,O
1710,P,18,18,3453,3960,11611,1711,3435,P
1711,A,1292,1292,1292,1501,1501,1712,0,A
1711,B,359,359,1651,210,1711,1712,1292,B
1711,C,538,538,2189,661,2372,1712,1651,C
1711,B,1086,1086,3275,964,3336,1712,2189,B
1711,C,1113,1113,4388,1206,4542,1712,3275,C
1711,D,3289,3289,7677,414,4956,1712,4388,D
1711,M,355,355,8032,2751,7707,1712,7677,M
1711,N,2656,2656,10688,300,8007,1712,8032,N
1711,O,648,648,11336,715,8722,1712,10688,O
1711,P,8186,8186,19522,4080,12802,1712,11336,P
1712,AE,119,119,119,1054,1054,1713,0,E
1712,AF,325,206,325,356,356,1713,0,A
1712,BF,129,129,454,150,506,1713,325,B
1712,CF,157,157,611,125,631,1713,454,C
1712,BF,1136,644,1255,240,1294,1713,119,F
1712,BG,813,169,1424,835,1466,1713,611,B
1712,CG,574,574,1998,690,2156,1713,1424,C
1712,DG,810,67,2065,930,2224,1713,1255,G
1712,DH,1051,1051,3116,6990,9214,1713,2065,H
1712,D,3317,2199,5315,4230,6386,1713,1998,D
1712,M,14746,14746,20061,14603,23817,1713,5315,M
1712,N,112,112,20173,300,24117,1713,20061,N
1712,O,876,876,21049,1005,25122,1713,20173,O
1712,P,666,666,21715,1200,26322,1713,21049,P
1713,AE,242,242,242,1404,1404,1714,0,A
1713,BE,1379,1379,1621,270,1674,1714,242,B
1713,CE,737,737,2358,830,2504,1714,1621,C
1713,DE,257,257,2615,350,2854,1714,2358,D
1713,E,3438,823,3438,3850,3850,1714,0,E
1713,F,1355,1355,4793,180,4030,1714,3438,F
1713,G,890,890,5683,915,4945,1714,4793,G
1713,H,576,576,6259,6600,11545,1714,5683,H
1713,M,2049,2049,8308,2212,13757,1714,6259,M
1713,N,223,223,8531,120,13877,1714,8308,N
1713,O,996,996,9527,1210,15087,1714,8531,O
1713,N,1292,1292,10819,1220,16307,1714,9527,N
1713,O,2562,2562,13381,2482,18789,1714,10819,O
1713,P,4181,4181,17562,428,19217,1714,13381,P
1714,AE,481,481,481,1360,1360,1715,0,A
1714,BE,1084,1084,1565,240,1600,1715,481,B
1714,CE,1930,365,1930,2968,2968,1715,0,E
1714,CF,1275,910,2840,905,2505,1715,1565,C
1714,BF,45,45,2885,410,2915,1715,2840,B
1714,CF,1543,588,3473,180,3148,1715,1930,F
1714,CG,1188,600,4073,1260,4175,1715,2885,C
1714,DG,1567,967,5040,900,4048,1715,3473,G
1714,DF,1125,158,5198,3960,8135,1715,4073,D
1714,F,336,178,5376,1260,5308,1715,5040,F
1714,G,580,580,5956,645,5953,1715,5376,G
1714,H,1653,1653,7609,6960,12913,1715,5956,H
1714,M,216,216,7825,460,13373,1715,7609,M
1714,N,355,355,8180,180,13553,1715,7825,N
1714,O,229,229,8409,205,13758,1715,8180,O
1714,P,137,137,8546,2850,16608,1715,8409,P
1715,AEI,87,87,87,485,485,1716,0,I
1715,AEJ,262,175,262,793,793,1716,0,A
1715,BEJ,573,311,573,1363,1363,1716,0,E
1715,BFJ,621,135,708,270,755,1716,87,J
1715,BFK,630,184,892,150,943,1716,262,B
1715,CFK,127,127,1019,115,1058,1716,892,C
1715,BFK,836,390,1409,90,1453,1716,573,F
1715,BGK,573,183,1592,570,1628,1716,1019,B
1715,CGK,359,176,1768,800,2253,1716,1409,G
1715,CHK,1114,54,1822,1032,1787,1716,708,K
1715,CHL,3,3,1825,333,2120,1716,1822,L
1715,CH,704,471,2296,665,2293,1716,1592,C
1715,DH,227,227,2523,4230,6523,1716,2296,D
1715,H,1708,953,3476,3780,6033,1716,1768,H
1715,M,2888,2888,6364,3038,9561,1716,3476,M
1715,N,257,257,6621,90,9651,1716,6364,N
1715,O,547,547,7168,820,10471,1716,6621,O
1715,P,950,950,8118,3780,14251,1716,7168,P
1716,AE,159,159,159,629,629,1717,0,A
1716,BE,848,848,1007,420,1049,1717,159,B
1716,CE,1658,651,1658,7813,7813,1717,0,E
1716,CF,822,171,1829,1160,2209,1717,1007,C
1716,BF,1382,1382,3211,1120,3329,1717,1829,B
1716,CF,2713,2713,5924,680,4009,1717,3211,C
1716,DF,1317,1317,7241,3140,7149,1717,5924,D
1716,F,6533,950,8191,420,8233,1717,1658,F
1716,G,1152,1152,9343,980,9213,1717,8191,G
1716,F,916,916,10259,1130,10343,1717,9343,F
1716,G,537,537,10796,495,10838,1717,10259,G
1716,H,388,388,11184,440,11278,1717,10796,H
1716,M,337,337,11521,462,11740,1717,11184,M
1716,N,155,155,11676,120,11860,1717,11521,N
1716,O,424,424,12100,465,12325,1717,11676,O
1716,N,404,404,12504,295,12620,1717,12100,N
1716,O,1386,1386,13890,602,13222,1717,12504,O
1716,P,4554,4554,18444,1263,14485,1717,13890,P
1717,AEI,36,36,36,1125,1125,1718,0,I
1717,AEJ,1072,1036,1072,1142,1142,1718,0,E
1717,AFJ,1290,254,1326,240,1365,1718,36,J
1717,AFK,430,176,1502,420,1562,1718,1072,F
1717,AGK,818,642,2144,930,2295,1718,1326,K
1717,AGL,2401,257,2401,2509,2509,1718,0,A
1717,BGL,1037,138,2539,1342,2904,1718,1502,G
1717,BHL,241,103,2642,90,2599,1718,2401,B
1717,CHL,557,557,3199,790,3389,1718,2642,C
1717,BHL,1426,1426,4625,1290,4679,1718,3199,B
1717,CHL,972,972,5597,1470,6149,1718,4625,C
1717,DHL,1012,1012,6609,3780,9929,1718,5597,D
1717,HL,5244,1174,7783,358,3262,1718,2539,H
1717,L,8208,2569,10352,6990,9285,1718,2144,L
1717,M,36175,36175,46527,36175,46104,1718,10352,M
1717,N,159,159,46686,90,46194,1718,46527,N
1717,O,1633,1633,48319,1880,48074,1718,46686,O
1717,P,282,282,48601,3780,51854,1718,48319,P
1718,AEI,22,22,22,100,100,1719,0,A
1718,BEI,241,219,241,1349,1349,1719,0,I
1718,BEJ,250,31,272,180,280,1719,22,B
1718,CEJ,195,195,467,210,490,1719,272,C
1718,DEJ,1203,977,1444,155,1504,1719,241,J
1718,DEK,1073,96,1540,2850,3340,1719,467,D
1718,EK,928,832,2372,1190,2694,1719,1444,K
1718,EJ,1575,1575,3947,1335,4029,1719,2372,J
1718,EK,4491,544,4491,4928,4928,1719,0,E
1718,FK,644,644,5135,240,5168,1719,4491,F
1718,GK,1669,481,5616,1860,5889,1719,3947,K
1718,GL,833,352,5968,970,6138,1719,5135,G
1718,FL,215,215,6183,90,6228,1719,5968,F
1718,GL,202,202,6385,360,6588,1719,6183,G
1718,HL,4418,3649,10034,375,6264,1719,5616,L
1718,H,5091,1442,11476,3960,10548,1719,6385,H
1718,M,75,75,11551,420,10968,1719,11476,M
1718,N,455,455,12006,170,11138,1719,11551,N
1718,O,624,624,12630,650,11788,1719,12006,O
1718,P,3588,3588,16218,385,12173,1719,12630,P
1719,A,2755,2755,2755,2775,2775,1720,0,A
1719,B,284,284,3039,300,3075,1720,2755,B
1719,C,627,627,3666,820,3895,1720,3039,C
1719,B,319,319,3985,135,4030,1720,3666,B
1719,C,377,377,4362,570,4600,1720,3985,C
1719,D,6807,6807,11169,1410,6010,1720,4362,D
1719,M,394,394,11563,624,6634,1720,11169,M
1719,N,260,260,11823,90,6724,1720,11563,N
1719,O,1242,1242,13065,1510,8234,1720,11823,O
1719,P,179,179,13244,3780,12014,1720,13065,P
1720,A,212,212,212,447,447,1721,0,A
1720,B,266,266,478,90,537,1721,212,B
1720,C,1532,1532,2010,1780,2317,1721,478,C
1720,D,36,36,2046,3780,6097,1721,2010,D
1720,M,4253,4253,6299,4475,10572,1721,2046,M
1720,N,254,254,6553,90,10662,1721,6299,N
1720,O,558,558,7111,805,11467,1721,6553,O
1720,P,1980,1980,9091,3780,15247,1721,7111,P
1721,A,220,220,220,1145,1145,1722,0,A
1721,B,1213,1213,1433,300,1445,1722,220,B
1721,C,753,753,2186,850,2295,1722,1433,C
1721,D,2463,2463,4649,1560,3855,1722,2186,D
1721,M,1221,1221,5870,3140,6995,1722,4649,M
1721,N,2172,2172,8042,300,7295,1722,5870,N
1721,O,606,606,8648,740,8035,1722,8042,O
1721,P,71,71,8719,1560,9595,1722,8648,P
1722,AEI,119,119,119,851,851,1723,0,A
1722,AEI,119,0,119,221,221,1723,0,E
1722,BFI,194,194,313,150,371,1723,119,F
1722,BGI,613,613,926,620,991,1723,313,G
1722,BHI,922,115,1041,240,1091,1723,119,B
1722,CHI,429,314,1355,4200,5191,1723,926,H
1722,CI,806,492,1847,1015,2106,1723,1041,C
1722,DI,3370,1523,3370,3626,3626,1723,0,I
1722,DJ,462,462,3832,240,3866,1723,3370,J
1722,DK,2483,498,4330,3960,6066,1723,1847,D
1722,K,750,252,4582,920,4786,1723,3832,K
1722,L,121,121,4703,3960,8746,1723,4582,L
1722,M,39,39,4742,84,8830,1723,4703,M
1722,N,260,260,5002,240,9070,1723,4742,N
1722,O,484,484,5486,765,9835,1723,5002,O
1722,P,262,262,5748,3960,13795,1723,5486,P
1723,A,1363,1363,1363,1443,1443,1724,0,A
1723,B,284,284,1647,240,1683,1724,1363,B
1723,C,941,941,2588,850,2533,1724,1647,C
1723,B,364,364,2952,460,2993,1724,2588,B
1723,C,733,733,3685,390,3383,1724,2952,C
1723,D,3338,3338,7023,3960,7343,1724,3685,D
1723,M,179,179,7202,210,7553,1724,7023,M
1723,N,92,92,7294,120,7673,1724,7202,N
1723,O,166,166,7460,125,7798,1724,7294,O
1723,P,2272,2272,9732,2880,10678,1724,7460,P
1724,AE,186,186,186,1765,1765,1725,0,E
1724,AF,773,587,773,1049,1049,1725,0,A
1724,BF,302,302,1075,90,1139,1725,773,B
1724,CF,1659,770,1845,90,1855,1725,186,F
1724,CG,901,131,1976,1240,2379,1725,1075,C
1724,DG,14,14,1990,3780,6159,1725,1976,D
1724,G,1047,902,2892,1365,3220,1725,1845,G
1724,H,621,621,3513,3780,7000,1725,2892,H
1724,M,506,506,4019,834,7834,1725,3513,M
1724,N,360,360,4379,90,7924,1725,4019,N
1724,O,1395,1395,5774,1865,9789,1725,4379,O
1724,P,1293,1293,7067,3780,13569,1725,5774,P
1725,A,1131,1131,1131,1506,1506,1726,0,A
1725,B,406,406,1537,90,1596,1726,1131,B
1725,C,467,467,2004,805,2401,1726,1537,C
1725,B,939,939,2943,435,2836,1726,2004,B
1725,C,1251,1251,4194,1810,4646,1726,2943,C
1725,D,3047,3047,7241,3780,8426,1726,4194,D
1725,M,1057,1057,8298,1005,9431,1726,7241,M
1725,N,202,202,8500,300,9731,1726,8298,N
1725,O,939,939,9439,1005,10736,1726,8500,O
1725,P,622,622,10061,1200,11936,1726,9439,P
1726,AE,29,29,29,1101,1101,1727,0,E
1726,AF,142,113,142,179,179,1727,0,A
1726,BF,225,225,367,240,419,1727,142,B
1726,CF,1253,915,1282,240,1341,1727,29,F
1726,CG,766,766,2048,995,2336,1727,1282,G
1726,CH,248,248,2296,4680,7016,1727,2048,H
1726,C,2811,882,3178,3630,4049,1727,367,C
1726,B,1150,1150,4328,250,4299,1727,3178,B
1726,C,687,687,5015,930,5229,1727,4328,C
1726,D,211,211,5226,3960,9189,1727,5015,D
1726,M,624,624,5850,830,10019,1727,5226,M
1726,N,330,330,6180,180,10199,1727,5850,N
1726,O,1688,1688,7868,930,11129,1727,6180,O
1726,P,198,198,8066,550,11679,1727,7868,P
1727,A,3488,3488,3488,4003,4003,1728,0,A
1727,B,544,544,4032,90,4093,1728,3488,B
1727,C,429,429,4461,820,4913,1728,4032,C
1727,B,5283,5283,9744,4880,9793,1728,4461,B
1727,C,1129,1129,10873,1625,11418,1728,9744,C
1727,D,1710,1710,12583,3780,15198,1728,10873,D
1727,M,1073,1073,13656,1183,16381,1728,12583,M
1727,N,309,309,13965,240,16621,1728,13656,N
1727,O,728,728,14693,915,17536,1728,13965,O
1727,N,810,810,15503,555,18091,1728,14693,N
1727,O,1015,1015,16518,810,18901,1728,15503,O
1727,P,5692,5692,22210,3960,22861,1728,16518,P
1728,A,1335,1335,1335,1403,1403,1729,0,A
1728,B,153,153,1488,150,1553,1729,1335,B
1728,C,179,179,1667,130,1683,1729,1488,C
1728,B,1176,1176,2843,1185,2868,1729,1667,B
1728,C,626,626,3469,690,3558,1729,2843,C
1728,D,1779,1779,5248,4230,7788,1729,3469,D
1728,M,2768,2768,8016,3051,10839,1729,5248,M
1728,N,379,379,8395,90,10929,1729,8016,N
1728,O,1196,1196,9591,1540,12469,1729,8395,O
1728,P,6,6,9597,3780,16249,1729,9591,P
1729,AEI,135,135,135,290,290,1730,0,I
1729,AEJ,279,279,414,180,470,1730,135,J
1729,AEK,601,187,601,904,904,1730,0,E
1729,AFK,293,106,707,815,1285,1730,414,K
1729,AFJ,483,377,1084,240,1144,1730,601,F
1729,AGJ,736,359,1443,195,1480,1730,707,J
1729,AGK,214,214,1657,385,1865,1730,1443,K
1729,AGL,762,189,1846,900,2044,1730,1084,G
1729,AFL,2650,804,2650,2231,2231,1730,0,A
1729,BFL,334,334,2984,780,3011,1730,2650,B
1729,CFL,1348,21,3005,4020,5885,1730,1657,L
1729,CF,1560,1539,4544,1411,4422,1730,2984,C
1729,DF,3299,601,5145,3150,5194,1730,1846,F
1729,DG,2000,1399,6544,604,5026,1730,4544,D
1729,G,1896,497,7041,1411,6605,1730,5145,G
1729,H,1135,1135,8176,504,7109,1730,7041,H
1729,M,1554,1554,9730,2244,9353,1730,8176,M
1729,N,1170,1170,10900,540,9893,1730,9730,N
1729,O,1153,1153,12053,855,10748,1730,10900,O
1729,P,1203,1203,13256,550,11298,1730,12053,P
1730,AE,3159,3159,3159,4589,4589,1731,0,E
1730,AF,1471,1471,4630,90,4679,1731,3159,F
1730,AG,783,783,5413,1045,5724,1731,4630,G
1730,AH,5616,203,5616,5787,5787,1731,0,A
1730,BH,544,544,6160,420,6207,1731,5616,B
1730,CH,1047,300,6460,3780,9504,1731,5413,H
1730,C,813,513,6973,945,7152,1731,6160,C
1730,B,534,534,7507,400,7552,1731,6973,B
1730,C,127,127,7634,200,7752,1731,7507,C
1730,D,1218,1218,8852,5220,12972,1731,7634,D
1730,M,10596,10596,19448,11438,24410,1731,8852,M
1730,N,874,874,20322,90,24500,1731,19448,N
1730,O,1223,1223,21545,1430,25930,1731,20322,O
1730,P,254,254,21799,3780,29710,1731,21545,P
1731,AE,38,38,38,116,116,1732,0,E
1731,AF,177,177,215,150,266,1732,38,F
1731,AG,263,48,263,375,375,1732,0,A
1731,BG,227,227,490,180,555,1732,263,B
1731,CG,192,192,682,140,695,1732,490,C
1731,DG,72,72,754,2880,3575,1732,682,D
1731,G,621,82,836,110,376,1732,215,G
1731,H,112,112,948,4230,4606,1732,836,H
1731,M,27,27,975,80,4686,1732,948,M
1731,N,141,141,1116,150,4836,1732,975,N
1731,O,14,14,1130,105,4941,1732,1116,O
1731,N,671,671,1801,575,5516,1732,1130,N
1731,O,258,258,2059,380,5896,1732,1801,O
1731,P,47,47,2106,5460,11356,1732,2059,P
1732,AE,54,54,54,184,184,1733,0,A
1732,BE,362,362,416,240,424,1733,54,B
1732,CE,436,20,436,1116,1116,1733,0,E
1732,CF,823,823,1259,180,1296,1733,436,F
1732,CG,873,30,1289,1200,1624,1733,416,C
1732,DG,249,219,1508,270,1566,1733,1259,G
1732,DF,258,39,1547,3960,5584,1733,1289,D
1732,F,3563,3524,5071,3520,5086,1733,1508,F
1732,G,928,928,5999,1050,6136,1733,5071,G
1732,H,1546,1546,7545,4140,10276,1733,5999,H
1732,M,1600,1600,9145,1633,11909,1733,7545,M
1732,N,290,290,9435,300,12209,1733,9145,N
1732,O,1295,1295,10730,1275,13484,1733,9435,O
1732,N,840,840,11570,1065,14549,1733,10730,N
1732,O,482,482,12052,510,15059,1733,11570,O
1732,P,181,181,12233,3960,19019,1733,12052,P
1733,AEI,86,86,86,440,440,1734,0,E
1733,AFI,145,59,145,222,222,1734,0,I
1733,AFJ,167,22,167,354,354,1734,0,A
1733,BFJ,196,174,341,180,402,1734,145,J
1733,BFK,292,118,459,165,519,1734,167,B
1733,CFK,912,539,998,615,1055,1734,86,F
1733,CGK,701,44,1042,850,1252,1734,341,K
1733,CGJ,610,27,1069,550,1069,1734,459,C
1733,BGJ,159,88,1157,185,1240,1734,998,G
1733,BHJ,427,312,1469,270,1522,1734,1042,J
1733,BHK,122,122,1591,190,1712,1734,1469,K
1733,BHL,806,806,2397,5340,7052,1734,1591,L
1733,BH,1458,218,2615,4170,5410,1734,1157,H
1733,B,1988,442,3057,2010,3079,1734,1069,B
1733,C,141,141,3198,195,3274,1734,3057,C
1733,D,852,852,4050,5220,8494,1734,3198,D
1733,M,1942,1942,5992,2880,11374,1734,4050,M
1733,N,964,964,6956,90,11464,1734,5992,N
1733,O,1320,1320,8276,1430,12894,1734,6956,O
1733,N,274,274,8550,160,13054,1734,8276,N
1733,O,464,464,9014,800,13854,1734,8550,O
1733,P,2940,2940,11954,3780,17634,1734,9014,P
1734,A,133,133,133,1040,1040,1735,0,A
1734,B,1357,1357,1490,180,1220,1735,133,B
1734,C,2999,2999,4489,665,1885,1735,1490,C
1734,D,767,767,5256,6960,8845,1735,4489,D
1734,M,731,731,5987,1585,10430,1735,5256,M
1734,N,913,913,6900,90,10520,1735,5987,N
1734,O,909,909,7809,1250,11770,1735,6900,O
1734,P,1270,1270,9079,3780,15550,1735,7809,P
1735,AE,40,40,40,142,142,1736,0,A
1735,BE,68,28,68,400,400,1736,0,E
1735,BF,195,167,235,135,277,1736,40,B
1735,CF,167,167,402,295,572,1736,235,C
1735,DF,406,72,474,135,535,1736,68,F
1735,DG,117,45,519,5100,5672,1736,402,D
1735,G,185,140,659,295,830,1736,474,G
1735,H,120,120,779,5100,5930,1736,659,H
1735,M,24534,24534,25313,25906,31836,1736,779,M
1735,N,1466,1466,26779,90,31926,1736,25313,N
1735,O,1077,1077,27856,1380,33306,1736,26779,O
1735,N,334,334,28190,85,33391,1736,27856,N
1735,O,385,385,28575,795,34186,1736,28190,O
1735,P,458,458,29033,3780,37966,1736,28575,P
1736,AEI,50,50,50,748,748,1737,0,I
1736,AEJ,954,904,954,1235,1235,1737,0,A
1736,BEJ,912,8,962,240,988,1737,50,J
1736,BEK,1101,139,1101,1177,1177,1737,0,E
1736,BFK,197,197,1298,180,1357,1737,1101,F
1736,BGK,492,156,1454,750,1738,1737,962,K
1736,BGL,195,39,1493,335,1692,1737,1298,G
1736,BFL,542,3,1496,300,1535,1737,954,B
1736,CFL,602,602,2098,740,2275,1737,1496,C
1736,DFL,1225,620,2718,1065,2757,1737,1493,F
1736,DGL,705,85,2803,3960,6235,1737,2098,D
1736,GL,651,566,3369,610,3367,1737,2718,G
1736,HL,2280,365,3734,3960,5698,1737,1454,L
1736,H,15268,14903,18637,5100,8467,1737,3369,H
1736,M,5,5,18642,297,8764,1737,18637,M
1736,N,518,518,19160,240,9004,1737,18642,N
1736,O,729,729,19889,695,9699,1737,19160,O
1736,N,589,589,20478,640,10339,1737,19889,N
1736,O,575,575,21053,810,11149,1737,20478,O
1736,P,316,316,21369,3960,15109,1737,21053,P
1737,AEI,495,495,495,1401,1401,1738,0,A
1737,BEI,531,36,531,574,574,1738,0,I
1737,BEJ,127,127,658,90,664,1738,531,J
1737,BEK,530,530,1188,860,1524,1738,658,K
1737,BEJ,936,243,1431,90,1491,1738,495,B
1737,CEJ,1033,790,2221,730,2254,1738,1188,J
1737,CEK,978,188,2409,1200,2691,1738,1431,C
1737,BEK,769,581,2990,1060,3314,1738,2221,K
1737,BEL,688,107,3097,465,3156,1738,2409,B
1737,CEL,778,778,3875,1060,4216,1738,3097,C
1737,DEL,1128,243,4118,3780,7094,1738,2990,L
1737,DE,856,613,4731,3780,7996,1738,3875,D
1737,E,35940,31209,35940,37069,37069,1738,0,E
1737,F,1285,1285,37225,90,37159,1738,35940,F
1737,G,978,978,38203,1395,38554,1738,37225,G
1737,F,755,755,38958,430,38984,1738,38203,F
1737,G,729,729,39687,1060,40044,1738,38958,G
1737,H,172,172,39859,3780,43824,1738,39687,H
1737,M,1715,1715,41574,2753,46577,1738,39859,M
1737,N,1076,1076,42650,90,46667,1738,41574,N
1737,O,807,807,43457,1105,47772,1738,42650,O
1737,P,63,63,43520,3780,51552,1738,43457,P
1738,A,4237,4237,4237,4361,4361,1739,0,A
1738,B,161,161,4398,90,4451,1739,4237,B
1738,C,755,755,5153,1130,5581,1739,4398,C
1738,D,487,487,5640,3840,9421,1739,5153,D
1738,M,1440,1440,7080,2498,11919,1739,5640,M
1738,N,1106,1106,8186,90,12009,1739,7080,N
1738,O,759,759,8945,925,12934,1739,8186,O
1738,P,3836,3836,12781,3780,16714,1739,8945,P
1739,AEI,61,61,61,390,390,1740,0,E
1739,AFI,371,371,432,90,480,1740,61,F
1739,AGI,552,120,552,1329,1329,1740,0,A
1739,BGI,1135,583,1135,1364,1364,1740,0,I
1739,BGJ,804,221,1356,90,1419,1740,552,B
1739,CGJ,1146,222,1578,1465,1945,1740,432,G
1739,CHJ,1,1,1579,3780,5725,1740,1578,H
1739,CJ,690,246,1825,90,1454,1740,1135,J
1739,CK,1185,716,2541,1405,2824,1740,1356,C
1739,DK,113,113,2654,3780,6604,1740,2541,D
1739,K,881,52,2706,1240,2694,1740,1825,K
1739,L,140,140,2846,3780,6474,1740,2706,L
1739,M,114,114,2960,787,7391,1740,2846,M
1739,N,703,703,3663,90,7481,1740,2960,N
1739,O,187,187,3850,585,8066,1740,3663,O
1739,P,3236,3236,7086,3780,11846,1740,3850,P
1740,A,1457,1457,1457,1602,1602,1741,0,A
1740,B,188,188,1645,90,1692,1741,1457,B
1740,C,704,704,2349,1135,2827,1741,1645,C
1740,D,122,122,2471,3780,6607,1741,2349,D
1740,M,400,400,2871,739,7346,1741,2471,M
1740,N,368,368,3239,90,7436,1741,2871,N
1740,O,534,534,3773,850,8286,1741,3239,O
1740,P,380,380,4153,3780,12066,1741,3773,P
1741,AE,236,236,236,660,660,1742,0,E
1741,AF,562,562,798,180,840,1742,236,F
1741,AG,924,126,924,1281,1281,1742,0,A
1741,BG,257,131,1055,450,1290,1742,798,G
1741,BF,333,333,1388,145,1435,1742,1055,F
1741,BG,600,136,1524,240,1521,1742,924,B
1741,CG,218,82,1606,2970,4405,1742,1388,G
1741,CH,633,551,2157,980,2501,1742,1524,C
1741,DH,175,175,2332,3960,6461,1742,2157,D
1741,H,8024,7298,9630,1440,5845,1742,1606,H
1741,M,771,771,10401,1521,7982,1742,9630,M
1741,N,1440,1440,11841,750,8732,1742,10401,N
1741,O,923,923,12764,855,9587,1742,11841,O
1741,P,307,307,13071,550,10137,1742,12764,P
1742,AEI,379,379,379,571,571,1743,0,E
1742,AFI,385,385,764,240,811,1743,379,F
1742,AGI,722,722,1486,725,1536,1743,764,G
1742,AHI,102,102,1588,3960,5496,1743,1486,H
1742,AI,1706,118,1706,2616,2616,1743,0,A
1742,BI,1186,1186,2892,300,2916,1743,1706,B
1742,CI,986,986,3878,970,3886,1743,2892,C
1742,DI,774,774,4652,3960,7846,1743,3878,D
1742,I,4674,22,4674,4811,4811,1743,0,I
1742,J,363,363,5037,240,5051,1743,4674,J
1742,K,787,787,5824,995,6046,1743,5037,K
1742,L,726,726,6550,3960,10006,1743,5824,L
1742,M,56,56,6606,693,10699,1743,6550,M
1742,N,842,842,7448,240,10939,1743,6606,N
1742,O,653,653,8101,790,11729,1743,7448,O
1742,P,9604,9604,17705,3960,15689,1743,8101,P
1743,AE,273,273,273,957,957,1744,0,A
1743,BE,784,784,1057,150,1107,1744,273,B
1743,CE,167,167,1224,160,1267,1744,1057,C
1743,BE,2171,947,2171,3391,3391,1744,0,E
1743,BF,1546,599,2770,1530,2797,1744,1224,B
1743,CF,1447,848,3618,270,3661,1744,2171,F
1743,CG,1152,304,3922,1245,4042,1744,2770,C
1743,DG,210,210,4132,3670,7712,1744,3922,D
1743,G,810,296,4428,1271,4932,1744,3618,G
1743,H,813,813,5241,594,5526,1744,4428,H
1743,M,449,449,5690,659,8371,1744,5241,M
1743,N,409,409,6099,240,8611,1744,5690,N
1743,O,822,822,6921,970,9581,1744,6099,O
1743,N,425,425,7346,350,9931,1744,6921,N
1743,O,858,858,8204,1260,11191,1744,7346,O
1743,P,1651,1651,9855,3960,15151,1744,8204,P
1744,A,434,434,434,1150,1150,1745,0,A
1744,B,904,904,1338,240,1390,1745,434,B
1744,C,830,830,2168,1030,2420,1745,1338,C
1744,D,1602,1602,3770,3960,6380,1745,2168,D
1744,M,70,70,3840,120,6500,1745,3770,M
1744,N,246,246,4086,240,6740,1745,3840,N
1744,O,500,500,4586,780,7520,1745,4086,O
1744,P,219,219,4805,3960,11480,1745,4586,P
1745,AEI,103,103,103,1111,1111,1746,0,I
1745,AEJ,109,6,109,1031,1031,1746,0,E
1745,AFJ,351,242,351,729,729,1746,0,A
1745,BFJ,516,516,867,150,879,1746,351,B
1745,CFJ,220,220,1087,140,1019,1746,867,C
1745,BFJ,1109,131,1218,240,1271,1746,109,F
1745,BGJ,1185,70,1288,240,1351,1746,103,J
1745,BGK,369,168,1456,470,1489,1746,1087,B
1745,CGK,766,598,2054,995,2346,1746,1288,K
1745,CGL,701,103,2157,720,2209,1746,1456,C
1745,DGL,1064,125,2282,1020,2291,1746,1218,G
1745,DHL,24,24,2306,4680,6971,1746,2282,H
1745,DL,1158,1009,3315,4170,6379,1746,2157,D
1745,L,3005,1744,5059,4680,7026,1746,2054,L
1745,M,735,735,5794,855,7881,1746,5059,M
1745,N,194,194,5988,90,7971,1746,5794,N
1745,O,602,602,6590,790,8761,1746,5988,O
1745,N,207,207,6797,70,8831,1746,6590,N
1745,O,517,517,7314,815,9646,1746,6797,O
1745,P,18060,18060,25374,3780,13426,1746,7314,P
1746,AEI,539,539,539,796,796,1747,0,E
1746,AFI,280,280,819,90,886,1747,539,F
1746,AGI,905,86,905,1718,1718,1747,0,A
1746,BGI,445,359,1264,880,1766,1747,819,G
1746,BHI,880,521,1785,90,1808,1747,905,B
1746,CHI,772,251,2036,3780,5546,1747,1264,H
1746,CI,573,322,2358,820,2628,1747,1785,C
1746,DI,71,71,2429,3780,6408,1747,2358,D
1746,I,2702,273,2702,2807,2807,1747,0,I
1746,J,134,134,2836,90,2897,1747,2702,J
1746,K,542,542,3378,820,3717,1747,2836,K
1746,L,210,210,3588,3780,7497,1747,3378,L
1746,M,716,716,4304,1286,8783,1747,3588,M
1746,N,595,595,4899,90,8873,1747,4304,N
1746,O,564,564,5463,930,9803,1747,4899,O
1746,P,8035,8035,13498,3780,13583,1747,5463,P
1747,AE,96,96,96,1138,1138,1748,0,E
1747,AF,1244,1244,1340,240,1378,1748,96,F
1747,AG,908,908,2248,1020,2398,1748,1340,G
1747,AH,3,3,2251,4680,7078,1748,2248,H
1747,A,2286,35,2286,2759,2759,1748,0,A
1747,B,516,516,2802,90,2849,1748,2286,B
1747,C,381,381,3183,795,3644,1748,2802,C
1747,D,893,893,4076,3780,7424,1748,3183,D
1747,M,25,25,4101,95,7519,1748,4076,M
1747,N,440,440,4541,420,7939,1748,4101,N
1747,O,930,930,5471,1125,9064,1748,4541,O
1747,P,470,470,5941,3960,13024,1748,5471,P
1748,AEI,421,421,421,1042,1042,1749,0,E
1748,AFI,458,37,458,1401,1401,1749,0,I
1748,AFJ,760,723,1181,150,1192,1749,421,F
1748,AGJ,71,71,1252,50,1242,1749,1181,G
1748,AFJ,65,65,1317,135,1377,1749,1252,F
1748,AGJ,141,141,1458,235,1612,1749,1317,G
1748,AHJ,1451,451,1909,540,1941,1749,458,J
1748,AHK,740,740,2649,975,2916,1749,1909,K
1748,AHJ,1333,142,2791,5280,6892,1749,1458,H
1748,AJ,2843,52,2843,2928,2928,1749,0,A
1748,BJ,280,280,3123,240,3168,1749,2843,B
1748,CJ,1113,639,3762,915,3831,1749,2649,J
1748,CK,927,288,4050,725,3893,1749,3123,C
1748,BK,1294,1006,5056,1476,5307,1749,3762,K
1748,BL,1300,294,5350,1520,5413,1749,4050,B
1748,CL,2921,2921,8271,2880,8293,1749,5350,C
1748,DL,1229,1229,9500,3960,12253,1749,8271,D
1748,L,11735,7291,16791,474,5781,1749,5056,L
1748,M,121,121,16912,1471,13724,1749,16791,M
1748,N,1437,1437,18349,150,13874,1749,16912,N
1748,O,143,143,18492,160,14034,1749,18349,O
1748,N,364,364,18856,335,14369,1749,18492,N
1748,O,111,111,18967,125,14494,1749,18856,O
1748,P,686,686,19653,4230,18724,1749,18967,P
1749,AE,964,964,964,1291,1291,1750,0,E
1749,AF,583,583,1547,300,1591,1750,964,F
1749,AG,206,206,1753,390,1981,1750,1547,G
1749,AH,2366,613,2366,3465,3465,1750,0,A
1749,BH,1130,1130,3496,90,3555,1750,2366,B
1749,CH,443,443,3939,805,4360,1750,3496,C
1749,BH,2338,152,4091,4080,6061,1750,1753,H
1749,B,1594,1442,5533,1230,5590,1750,3939,B
1749,C,381,381,5914,800,6390,1750,5533,C
1749,D,710,710,6624,3780,10170,1750,5914,D
1749,M,468,468,7092,615,10785,1750,6624,M
1749,N,345,345,7437,180,10965,1750,7092,N
1749,O,897,897,8334,765,11730,1750,7437,O
1749,P,6340,6340,14674,550,12280,1750,8334,P
1750,AEI,80,80,80,247,247,1751,0,I
1750,AEJ,303,303,383,180,427,1751,80,J
1750,AEK,1345,1345,1728,680,1107,1751,383,K
1750,AEJ,2925,1197,2925,5823,5823,1751,0,A
1750,BEJ,1516,319,3244,2075,3182,1751,1728,J
1750,BEK,3357,113,3357,3459,3459,1751,0,E
1750,BFK,373,373,3730,300,3759,1751,3357,F
1750,BGK,491,5,3735,900,4082,1751,3244,K
1750,BGL,469,469,4204,3960,8042,1751,3735,L
1750,BG,929,455,4659,1110,4869,1751,3730,G
1750,BF,678,678,5337,485,5354,1751,4659,F
1750,BG,454,454,5791,900,6254,1751,5337,G
1750,BH,3233,367,6158,480,6303,1751,2925,B
1750,CH,500,133,6291,3960,10214,1751,5791,H
1750,C,971,838,7129,1285,7588,1751,6158,C
1750,B,1621,1621,8750,1265,8853,1751,7129,B
1750,C,542,542,9292,565,9418,1751,8750,C
1750,D,392,392,9684,400,9818,1751,9292,D
1750,M,454,454,10138,3762,13976,1751,9684,M
1750,N,4148,4148,14286,900,14876,1751,10138,N
1750,O,412,412,14698,630,15506,1751,14286,O
1750,N,1123,1123,15821,900,16406,1751,14698,N
1750,O,1159,1159,16980,1259,17665,1751,15821,O
1750,P,1309,1309,18289,351,18016,1751,16980,P
1751,AE,2711,2711,2711,3124,3124,1752,0,A
1751,BE,443,443,3154,90,3214,1752,2711,B
1751,CE,1708,1708,4862,1940,5154,1752,3154,C
1751,DE,135,135,4997,3780,8934,1752,4862,D
1751,E,7800,2803,7800,8489,8489,1752,0,E
1751,F,716,716,8516,90,8579,1752,7800,F
1751,G,862,862,9378,1240,9819,1752,8516,G
1751,H,79,79,9457,3780,13599,1752,9378,H
1751,M,781,781,10238,1351,14950,1752,9457,M
1751,N,617,617,10855,90,15040,1752,10238,N
1751,O,936,936,11791,1285,16325,1752,10855,O
1751,P,416,416,12207,3780,20105,1752,11791,P
1752,AE,572,572,572,969,969,1753,0,E
1752,AF,757,757,1329,420,1389,1753,572,F
1752,AG,1614,285,1614,2560,2560,1753,0,A
1752,BG,631,346,1960,740,2129,1753,1329,G
1752,BF,972,626,2586,90,2650,1753,1614,B
1752,CF,658,32,2618,505,2634,1753,1960,F
1752,CG,269,269,2887,535,3169,1753,2618,G
1752,CH,515,214,3101,880,3530,1753,2586,C
1752,BH,427,427,3528,50,3580,1753,3101,B
1752,CH,745,745,4273,1210,4790,1753,3528,C
1752,DH,4934,4934,9207,3840,8630,1753,4273,D
1752,H,6896,576,9783,2880,6049,1753,2887,H
1752,M,1455,1455,11238,1435,10065,1753,9783,M
1752,N,160,160,11398,240,10305,1753,11238,N
1752,O,436,436,11834,185,10490,1753,11398,O
1752,N,1389,1389,13223,1760,12250,1753,11834,N
1752,O,493,493,13716,485,12735,1753,13223,O
1752,P,3043,3043,16759,840,13575,1753,13716,P
1753,AE,836,836,836,1201,1201,1754,0,E
1753,AF,1204,368,1204,2652,2652,1754,0,A
1753,BF,394,26,1230,90,1291,1754,836,F
1753,BG,255,255,1485,625,1916,1754,1230,G
1753,BH,1479,1198,2683,90,2742,1754,1204,B
1753,CH,615,615,3298,910,3652,1754,2683,C
1753,BH,647,647,3945,355,4007,1754,3298,B
1753,CH,279,279,4224,625,4632,1754,3945,C
1753,DH,6428,6428,10652,3780,8412,1754,4224,D
1753,H,11736,2569,13221,3780,5696,1754,1485,H
1753,M,4576,4576,17797,6262,14674,1754,13221,M
1753,N,1675,1675,19472,90,14764,1754,17797,N
1753,O,304,304,19776,715,15479,1754,19472,O
1753,P,1663,1663,21439,3780,19259,1754,19776,P
1754,A,1065,1065,1065,1191,1191,1755,0,A
1754,B,218,218,1283,150,1341,1755,1065,B
1754,C,42,42,1325,155,1496,1755,1283,C
1754,B,1014,1014,2339,905,2401,1755,1325,B
1754,C,146,146,2485,285,2686,1755,2339,C
1754,D,133,133,2618,5100,7786,1755,2485,D
1754,M,54,54,2672,1251,9037,1755,2618,M
1754,N,1247,1247,3919,165,9202,1755,2672,N
1754,O,618,618,4537,825,10027,1755,3919,O
1754,P,284,284,4821,3960,13987,1755,4537,P
1755,AEI,28,28,28,378,378,1756,0,I
1755,AEJ,79,51,79,73,73,1756,0,A
1755,BEJ,170,170,249,240,313,1756,79,B
1755,CEJ,233,233,482,245,558,1756,249,C
1755,DEJ,677,195,677,1273,1273,1756,0,E
1755,DFJ,710,61,738,420,798,1756,28,J
1755,DFK,537,281,1019,5250,5808,1756,482,D
1755,FK,716,374,1393,180,1453,1756,677,F
1755,GK,921,266,1659,890,1688,1756,738,K
1755,GL,69,69,1728,550,2238,1756,1659,L
1755,G,792,457,2185,795,2248,1756,1393,G
1755,H,1693,1693,3878,550,2798,1756,2185,H
1755,M,607,607,4485,874,6682,1756,3878,M
1755,N,542,542,5027,300,6982,1756,4485,N
1755,O,611,611,5638,795,7777,1756,5027,O
1755,P,2448,2448,8086,3960,11737,1756,5638,P
1756,AEI,35,35,35,34,34,1757,0,I
1756,AEJ,96,96,131,150,184,1757,35,J
1756,AEK,236,105,236,1886,1886,1757,0,A
1756,BEK,109,4,240,125,309,1757,131,K
1756,BEJ,1121,1121,1361,1085,1394,1757,240,J
1756,BEK,1381,20,1381,1396,1396,1757,0,E
1756,BFK,119,119,1500,150,1546,1757,1381,F
1756,BGK,198,198,1698,140,1686,1757,1500,G
1756,BFK,350,13,1711,650,2044,1757,1361,K
1756,BFL,1830,355,2066,240,2126,1757,236,B
1756,CFL,1325,957,3023,1375,3061,1757,1698,F
1756,CGL,288,288,3311,645,3706,1757,3023,G
1756,CHL,1707,107,3418,4230,6274,1757,1711,L
1756,CH,1956,604,4022,2130,4256,1757,2066,C
1756,BH,839,839,4861,665,4921,1757,4022,B
1756,CH,830,830,5691,926,5847,1757,4861,C
1756,DH,2052,2052,7743,414,6261,1757,5691,D
1756,H,7748,3316,11059,4290,7996,1757,3311,H
1756,M,1704,1704,12763,1704,9700,1757,11059,M
1756,N,590,590,13353,650,10350,1757,12763,N
1756,O,839,839,14192,825,11175,1757,13353,O
1756,P,1919,1919,16111,550,11725,1757,14192,P
1757,A,1219,1219,1219,2241,2241,1758,0,A
1757,B,1272,1272,2491,300,2541,1758,1219,B
1757,C,720,720,3211,825,3366,1758,2491,C
1757,B,1184,1184,4395,835,4201,1758,3211,B
1757,C,149,149,4544,334,4535,1758,4395,C
1757,D,3202,3202,7746,6060,10595,1758,4544,D
1757,M,938,938,8684,1482,12077,1758,7746,M
1757,N,755,755,9439,270,12347,1758,8684,N
1757,O,548,548,9987,735,13082,1758,9439,O
1757,N,1420,1420,11407,1235,14317,1758,9987,N
1757,O,244,244,11651,695,15012,1758,11407,O
1757,P,1176,1176,12827,5100,20112,1758,11651,P
1758,AEI,55,55,55,391,391,1759,0,E
1758,AFI,107,52,107,1009,1009,1759,0,A
1758,BFI,136,29,136,307,307,1759,0,I
1758,BFJ,321,321,457,210,517,1759,136,J
1758,BFK,108,108,565,255,772,1759,457,K
1758,BFJ,589,79,644,240,631,1759,55,F
1758,BGJ,539,539,1183,840,1471,1759,644,G
1758,BHJ,1102,26,1209,240,1249,1759,107,B
1758,CHJ,955,311,1520,795,1567,1759,565,J
1758,CHK,488,177,1697,760,2009,1759,1209,C
1758,DHK,470,293,1990,760,2327,1759,1520,K
1758,DHL,928,121,2111,4020,5491,1759,1183,H
1758,DL,964,843,2954,3540,5867,1759,1990,L
1758,D,2365,1108,4062,3540,5549,1759,1697,D
1758,M,604,604,4666,1163,7030,1759,4062,M
1758,N,589,589,5255,90,7120,1759,4666,N
1758,O,476,476,5731,820,7940,1759,5255,O
1758,N,1782,1782,7513,1405,9345,1759,5731,N
1758,O,2135,2135,9648,1245,10590,1759,7513,O
1758,P,14791,14791,24439,3780,14370,1759,9648,P
1759,A,1068,1068,1068,1594,1594,1760,0,A
1759,B,553,553,1621,90,1684,1760,1068,B
1759,C,951,951,2572,1250,2934,1760,1621,C
1759,D,9,9,2581,3780,6714,1760,2572,D
1759,M,1770,1770,4351,2352,9066,1760,2581,M
1759,N,1332,1332,5683,90,9156,1760,4351,N
1759,O,266,266,5949,630,9786,1760,5683,O
1759,P,22844,22844,28793,3780,13566,1760,5949,P
1760,A,137,137,137,1083,1083,1761,0,A
1760,B,1121,1121,1258,240,1323,1761,137,B
1760,C,840,840,2098,995,2318,1761,1258,C
1760,D,209,209,2307,4680,6998,1761,2098,D
1760,M,2115,2115,4422,2487,9485,1761,2307,M
1760,N,395,395,4817,90,9575,1761,4422,N
1760,O,692,692,5509,795,10370,1761,4817,O
1760,N,243,243,5752,125,10495,1761,5509,N
1760,O,442,442,6194,735,11230,1761,5752,O
1760,P,8292,8292,14486,3840,15070,1761,6194,P
1761,A,183,183,183,208,208,1762,0,A
1761,B,122,122,305,150,358,1762,183,B
1761,C,772,772,1077,895,1253,1762,305,C
1761,D,1454,1454,2531,3490,4743,1762,1077,D
1761,M,468,468,2999,748,5491,1762,2531,M
1761,N,695,695,3694,481,5972,1762,2999,N
1761,O,107,107,3801,90,6062,1762,3694,O
1761,P,265,265,4066,2880,8942,1762,3801,P
1762,AE,37,37,37,226,226,1763,0,A
1762,BE,327,327,364,180,406,1763,37,B
1762,CE,207,207,571,749,1155,1763,364,C
1762,DE,965,965,1536,3670,4825,1763,571,D
1762,E,3288,1752,3288,3287,3287,1763,0,E
1762,F,249,249,3537,300,3587,1763,3288,F
1762,G,972,972,4509,1145,4732,1763,3537,G
1762,F,3026,3026,7535,2905,7637,1763,4509,F
1762,G,2785,2785,10320,2826,10463,1763,7535,G
1762,H,4,4,10324,384,10847,1763,10320,H
1762,M,1231,1231,11555,1420,12267,1763,10324,M
1762,N,306,306,11861,180,12447,1763,11555,N
1762,O,188,188,12049,335,12782,1763,11861,O
1762,N,2345,2345,14394,2180,14962,1763,12049,N
1762,O,162,162,14556,390,15352,1763,14394,O
1762,P,1599,1599,16155,5400,20752,1763,14556,P
1763,A,1548,1548,1548,2279,2279,1764,0,A
1763,B,976,976,2524,240,2519,1764,1548,B
1763,C,998,998,3522,975,3494,1764,2524,C
1763,D,1806,1806,5328,385,3879,1764,3522,D
1763,M,42290,42290,47618,42826,46705,1764,5328,M
1763,N,754,754,48372,270,46975,1764,47618,N
1763,O,786,786,49158,878,47853,1764,48372,O
1763,P,1147,1147,50305,1217,49070,1764,49158,P
1764,AE,539,539,539,1327,1327,1765,0,A
1764,BE,842,842,1381,90,1417,1765,539,B
1764,CE,501,501,1882,855,2272,1765,1381,C
1764,DE,918,918,2800,3780,6052,1765,1882,D
1764,E,26262,23462,26262,27062,27062,1765,0,E
1764,F,830,830,27092,90,27152,1765,26262,F
1764,G,878,878,27970,1240,28392,1765,27092,G
1764,H,142,142,28112,3780,32172,1765,27970,H
1764,M,202,202,28314,530,32702,1765,28112,M
1764,N,357,357,28671,90,32792,1765,28314,N
1764,O,541,541,29212,880,33672,1765,28671,O
1764,P,288,288,29500,3780,37452,1765,29212,P
1765,AEI,68,68,68,138,138,1766,0,A
1765,BEI,85,17,85,85,85,1766,0,E
1765,BFI,126,126,211,180,265,1766,85,F
1765,BGI,147,4,215,135,273,1766,68,B
1765,CGI,155,151,366,215,480,1766,211,G
1765,CHI,220,69,435,215,488,1766,215,C
1765,DHI,561,561,996,4890,5378,1766,435,D
1765,HI,1117,487,1483,4140,4620,1766,366,H
1765,I,3765,2282,3765,3980,3980,1766,0,I
1765,J,425,425,4190,240,4220,1766,3765,J
1765,K,662,662,4852,850,5070,1766,4190,K
1765,L,326,326,5178,3960,9030,1766,4852,L
1765,M,652,652,5830,1526,10556,1766,5178,M
1765,N,1067,1067,6897,240,10796,1766,5830,N
1765,O,698,698,7595,970,11766,1766,6897,O
1765,P,1266,1266,8861,3960,15726,1766,7595,P
1766,AEI,367,367,367,987,987,1767,0,A
1766,BEI,899,899,1266,300,1287,1767,367,B
1766,CEI,1363,97,1363,2401,2401,1767,0,I
1766,CEJ,1747,384,1747,4108,4108,1767,0,E
1766,CFJ,918,437,2184,1125,2412,1767,1266,C
1766,DFJ,1225,404,2588,240,2641,1767,1363,J
1766,DFK,452,48,2636,4080,6492,1767,2184,D
1766,FK,912,864,3500,1020,3661,1767,2588,K
1766,FL,2405,652,4152,90,4198,1767,1747,F
1766,GL,330,330,4482,800,4998,1767,4152,G
1766,HL,1792,1792,6274,3780,8778,1767,4482,H
1766,L,5907,3133,9407,4680,8341,1767,3500,L
1766,M,2012,2012,11419,2184,10962,1767,9407,M
1766,N,213,213,11632,90,11052,1767,11419,N
1766,O,406,406,12038,820,11872,1767,11632,O
1766,P,167,167,12205,3780,15652,1767,12038,P
1767,A,229,229,229,863,863,1768,0,A
1767,B,735,735,964,150,1013,1768,229,B
1767,C,230,230,1194,425,1438,1768,964,C
1767,D,474,474,1668,3960,5398,1768,1194,D
1767,M,20,20,1688,1155,6553,1768,1668,M
1767,N,1337,1337,3025,240,6793,1768,1688,N
1767,O,582,582,3607,875,7668,1768,3025,O
1767,P,1503,1503,5110,3960,11628,1768,3607,P
1768,A,2086,2086,2086,2223,2223,1769,0,A
1768,B,170,170,2256,90,2313,1769,2086,B
1768,C,579,579,2835,820,3133,1769,2256,C
1768,D,51,51,2886,3780,6913,1769,2835,D
1768,M,177,177,3063,955,7868,1769,2886,M
1768,N,833,833,3896,90,7958,1769,3063,N
1768,O,530,530,4426,845,8803,1769,3896,O
1768,P,411,411,4837,3780,12583,1769,4426,P
1769,AEI,376,376,376,1398,1398,1770,0,E
1769,AFI,712,336,712,1068,1068,1770,0,I
1769,AFJ,384,384,1096,90,1158,1770,712,J
1769,AFK,1052,332,1428,90,1488,1770,376,F
1769,AGK,924,592,2020,1240,2398,1770,1096,K
1769,AGL,42,42,2062,3780,6178,1770,2020,L
1769,AG,1043,409,2471,1220,2708,1770,1428,G
1769,AH,606,606,3077,3780,6488,1770,2471,H
1769,A,23622,20545,23622,27526,27526,1770,0,A
1769,B,3934,3934,27556,90,27616,1770,23622,B
1769,C,906,906,28462,1210,28826,1770,27556,C
1769,D,63,63,28525,3780,32606,1770,28462,D
1769,M,756,756,29281,1186,33792,1770,28525,M
1769,N,459,459,29740,90,33882,1770,29281,N
1769,O,376,376,30116,795,34677,1770,29740,O
1769,P,1748,1748,31864,3780,38457,1770,30116,P
1770,AE,659,659,659,4164,4164,1771,0,A
1770,BE,1845,1186,1845,3098,3098,1771,0,E
1770,BF,1357,1357,3202,90,3188,1771,1845,F
1770,BG,887,887,4089,1135,4323,1771,3202,G
1770,BH,4319,889,4978,90,4254,1771,659,B
1770,CH,2106,2106,7084,1140,5394,1771,4978,C
1770,DH,933,933,8017,3780,9174,1771,7084,D
1770,H,20023,16095,24112,3780,8103,1771,4089,H
1770,M,1689,1689,25801,2409,11583,1771,24112,M
1770,N,1920,1920,27721,1260,12843,1771,25801,N
1770,O,987,987,28708,400,13243,1771,27721,O
1770,P,10962,10962,39670,425,13668,1771,28708,P
1771,AEI,82,82,82,1032,1032,1772,0,A
1771,BEI,361,279,361,1378,1378,1772,0,I
1771,BEJ,594,233,594,1421,1421,1772,0,E
1771,BFJ,1135,623,1217,240,1272,1772,82,B
1771,CFJ,863,240,1457,90,1511,1772,594,F
1771,CGJ,1200,104,1561,240,1618,1772,361,J
1771,CGK,810,466,2027,930,2202,1772,1217,C
1771,DGK,819,353,2380,930,2548,1772,1561,K
1771,DGL,1128,205,2585,1585,3096,1772,1457,G
1771,DHL,3141,2936,5521,6990,9538,1772,2380,L
1771,DH,3373,437,5958,3780,6876,1772,2585,H
1771,D,4191,260,6218,6990,9192,1772,2027,D
1771,M,1483,1483,7701,7533,17071,1772,6218,M
1771,N,6080,6080,13781,90,17161,1772,7701,N
1771,O,1354,1354,15135,1510,18671,1772,13781,O
1771,P,14071,14071,29206,3780,22451,1772,15135,P
1772,AEI,309,309,309,479,479,1773,0,E
1772,AFI,412,103,412,750,750,1773,0,I
1772,AFJ,203,100,512,90,569,1773,309,F
1772,AGJ,364,264,776,90,840,1773,412,J
1772,AGK,465,201,977,850,1419,1773,512,G
1772,AHK,549,348,1325,845,1685,1773,776,K
1772,AHL,1510,185,1510,2411,2411,1773,0,A
1772,BHL,919,386,1896,3780,5199,1773,977,H
1772,BL,784,213,2109,3780,5465,1773,1325,L
1772,B,935,336,2445,90,2501,1773,1510,B
1772,C,504,504,2949,850,3351,1773,2445,C
1772,D,7279,7279,10228,3780,7131,1773,2949,D
1772,M,1587,1587,11815,2395,9526,1773,10228,M
1772,N,925,925,12740,150,9676,1773,11815,N
1772,O,711,711,13451,640,10316,1773,12740,O
1772,N,1016,1016,14467,1100,11416,1773,13451,N
1772,O,136,136,14603,105,11521,1773,14467,O
1772,P,4352,4352,18955,4230,15751,1773,14603,P
1773,AEI,180,180,180,849,849,1774,0,A
1773,BEI,345,165,345,2001,2001,1774,0,E
1773,BFI,851,686,1031,240,1089,1774,180,B
1773,CFI,1794,763,1794,3849,3849,1774,0,I
1773,CFJ,814,51,1845,1015,2104,1774,1031,C
1773,BFJ,535,535,2380,485,2589,1774,1845,B
1773,CFJ,2196,161,2541,600,2601,1774,345,F
1773,CGJ,400,239,2780,510,3099,1774,2380,C
1773,DGJ,78,78,2858,3960,7059,1774,2780,D
1773,GJ,568,251,3109,845,3446,1774,2541,G
1773,FJ,2102,787,3896,90,3939,1774,1794,J
1773,FK,1377,590,4486,1105,4551,1774,3109,F
1773,GK,936,346,4832,1045,4984,1774,3896,K
1773,GL,583,237,5069,677,5228,1774,4486,G
1773,HL,660,423,5492,3780,8764,1774,4832,L
1773,H,562,139,5631,343,5571,1774,5069,H
1773,M,1773,1773,7404,2034,10798,1774,5631,M
1773,N,336,336,7740,180,10978,1774,7404,N
1773,O,667,667,8407,860,11838,1774,7740,O
1773,N,705,705,9112,445,12283,1774,8407,N
1773,O,938,938,10050,1030,13313,1774,9112,O
1773,P,1170,1170,11220,6900,20213,1774,10050,P
1774,AEI,1514,1514,1514,1945,1945,1775,0,E
1774,AFI,1546,32,1546,1684,1684,1775,0,I
1774,AFJ,375,375,1921,270,1954,1775,1546,J
1774,AFK,674,267,2188,300,2245,1775,1514,F
1774,AGK,816,549,2737,810,2764,1775,1921,K
1774,AGL,991,442,3179,895,3140,1775,2188,G
1774,AHL,862,862,4041,550,3690,1775,3179,H
1774,AL,3732,2428,6469,550,3314,1775,2737,L
1774,A,8686,2217,8686,9076,9076,1775,0,A
1774,B,795,795,9481,420,9496,1775,8686,B
1774,C,998,998,10479,970,10466,1775,9481,C
1774,D,1956,1956,12435,550,11016,1775,10479,D
1774,M,1113,1113,13548,1056,12072,1775,12435,M
1774,N,315,315,13863,420,12492,1775,13548,N
1774,O,1127,1127,14990,1259,13751,1775,13863,O
1774,P,822,822,15812,351,14102,1775,14990,P
1775,A,1601,1601,1601,1752,1752,1776,0,A
1775,B,776,776,2377,600,2352,1776,1601,B
1775,C,924,924,3301,955,3307,1776,2377,C
1775,B,364,364,3665,395,3702,1776,3301,B
1775,C,1221,1221,4886,1171,4873,1776,3665,C
1775,D,295,295,5181,399,5272,1776,4886,D
1775,M,540,540,5721,1488,6760,1776,5181,M
1775,N,1193,1193,6914,300,7060,1776,5721,N
1775,O,744,744,7658,970,8030,1776,6914,O
1775,N,517,517,8175,350,8380,1776,7658,N
1775,O,198,198,8373,390,8770,1776,8175,O
1775,P,149,149,8522,3960,12730,1776,8373,P
1776,AE,935,935,935,1585,1585,1777,0,A
1776,BE,676,676,1611,90,1675,1777,935,B
1776,CE,848,848,2459,1250,2925,1777,1611,C
1776,DE,2878,419,2878,2989,2989,1777,0,E
1776,DF,580,161,3039,3780,6705,1777,2459,D
1776,F,163,2,3041,90,3079,1777,2878,F
1776,G,685,685,3726,1130,4209,1777,3041,G
1776,H,202,202,3928,3780,7989,1777,3726,H
1776,M,280,280,4208,2261,10250,1777,3928,M
1776,N,2041,2041,6249,90,10340,1777,4208,N
1776,O,1571,1571,7820,1865,12205,1777,6249,O
1776,P,801,801,8621,3780,15985,1777,7820,P
1777,A,103,103,103,200,200,1778,0,A
1777,B,276,276,379,240,440,1778,103,B
1777,C,183,183,562,215,655,1778,379,C
1777,D,731,731,1293,4890,5545,1778,562,D
1777,M,1589,1589,2882,2643,8188,1778,1293,M
1777,N,1099,1099,3981,90,8278,1778,2882,N
1777,O,1019,1019,5000,1225,9503,1778,3981,O
1777,N,387,387,5387,185,9688,1778,5000,N
1777,O,251,251,5638,695,10383,1778,5387,O
1777,P,4060,4060,9698,3780,14163,1778,5638,P
1778,A,1180,1180,1180,1361,1361,1779,0,A
1778,B,542,542,1722,420,1781,1779,1180,B
1778,C,808,808,2530,955,2736,1779,1722,C
1778,B,464,464,2994,325,3061,1779,2530,B
1778,C,217,217,3211,265,3326,1779,2994,C
1778,D,1597,1597,4808,5160,8486,1779,3211,D
1778,M,630,630,5438,661,9147,1779,4808,M
1778,N,141,141,5579,170,9317,1779,5438,N
1778,O,543,543,6122,495,9812,1779,5579,O
1778,P,1474,1474,7596,385,10197,1779,6122,P
1779,AEI,586,586,586,1508,1508,1780,0,E
1779,AFI,1042,1042,1628,180,1688,1780,586,F
1779,AGI,1947,319,1947,3081,3081,1780,0,A
1779,BGI,781,462,2409,700,2388,1780,1628,G
1779,BHI,1549,1087,3496,600,3681,1780,1947,B
1779,CHI,1397,310,3806,550,2938,1780,2409,H
1779,CI,1365,1055,4861,1345,5026,1780,3496,C
1779,DI,979,979,5840,385,5411,1780,4861,D
1779,I,6014,174,6014,7974,7974,1780,0,I
1779,J,1988,1988,8002,90,8064,1780,6014,J
1779,K,501,501,8503,730,8794,1780,8002,K
1779,J,3095,3095,11598,2845,11639,1780,8503,J
1779,K,821,821,12419,1245,12884,1780,11598,K
1779,L,3345,3345,15764,3780,16664,1780,12419,L
1779,M,17109,17109,32873,17437,34101,1780,15764,M
1779,N,466,466,33339,180,34281,1780,32873,N
1779,O,696,696,34035,830,35111,1780,33339,O
1779,P,14521,14521,48556,6680,41791,1780,34035,P
1780,AE,126,126,126,538,538,1781,0,A
1780,BE,722,596,722,2756,2756,1781,0,E
1780,BF,619,23,745,240,778,1781,126,B
1780,CF,688,688,1433,960,1738,1781,745,C
1780,DF,251,251,1684,3960,5698,1781,1433,D
1780,F,2394,1432,3116,420,3176,1781,722,F
1780,G,983,983,4099,1282,4458,1781,3116,G
1780,H,4740,4740,8839,358,4816,1781,4099,H
1780,M,10054,10054,18893,11869,17567,1781,8839,M
1780,N,3292,3292,22185,90,17657,1781,18893,N
1780,O,816,816,23001,1120,18777,1781,22185,O
1780,P,925,925,23926,3780,22557,1781,23001,P
1781,AEI,443,443,443,1375,1375,1782,0,I
1781,AEJ,1183,1183,1626,300,1675,1782,443,J
1781,AEK,1865,239,1865,2103,2103,1782,0,E
1781,AFK,688,449,2314,805,2480,1782,1626,K
1781,AFL,607,158,2472,420,2523,1782,1865,F
1781,AGL,303,145,2617,4020,6500,1782,2314,L
1781,AG,148,3,2620,100,2623,1782,2472,G
1781,AF,1331,1331,3951,1375,3998,1782,2620,F
1781,AG,108,108,4059,265,4263,1782,3951,G
1781,AH,2064,2064,6123,5160,9423,1782,4059,H
1781,A,8473,2350,8473,8690,8690,1782,0,A
1781,B,492,492,8965,300,8990,1782,8473,B
1781,C,532,532,9497,835,9825,1782,8965,C
1781,D,462,462,9959,2940,12765,1782,9497,D
1781,M,457,457,10416,767,13532,1782,9959,M
1781,N,436,436,10852,240,13772,1782,10416,N
1781,O,384,384,11236,750,14522,1782,10852,O
1781,P,3360,3360,14596,3840,18362,1782,11236,P
1782,A,74,74,74,2540,2540,1783,0,A
1782,B,2722,2722,2796,300,2840,1783,74,B
1782,C,737,737,3533,895,3735,1783,2796,C
1782,D,267,267,3800,2700,6435,1783,3533,D
1782,M,330,330,4130,1721,8156,1783,3800,M
1782,N,1736,1736,5866,375,8531,1783,4130,N
1782,O,842,842,6708,790,9321,1783,5866,O
1782,P,3109,3109,9817,550,9871,1783,6708,P
1783,AEI,7,7,7,42,42,1784,0,A
1783,BEI,155,155,162,180,222,1784,7,B
1783,CEI,210,48,210,817,817,1784,0,E
1783,CFI,253,43,253,837,837,1784,0,I
1783,CFJ,326,235,488,325,547,1784,162,C
1783,DFJ,827,549,1037,240,1057,1784,210,F
1783,DGJ,830,46,1083,300,1137,1784,253,J
1783,DGK,159,113,1196,240,1297,1784,1037,G
1783,DHK,664,551,1747,920,2057,1784,1083,K
1783,DHJ,228,228,1975,65,2122,1784,1747,J
1783,DHK,2351,864,2839,940,1487,1784,488,D
1783,HK,1026,162,3001,1260,3382,1784,1975,K
1783,HL,1416,1416,4417,3960,7342,1784,3001,L
1783,H,8927,5706,10123,5100,6397,1784,1196,H
1783,M,434,434,10557,800,8142,1784,10123,M
1783,N,486,486,11043,180,8322,1784,10557,N
1783,O,795,795,11838,700,9022,1784,11043,O
1783,N,4271,4271,16109,4355,13377,1784,11838,N
1783,O,876,876,16985,1020,14397,1784,16109,O
1783,P,2043,2043,19028,4680,19077,1784,16985,P
1784,AE,91,91,91,394,394,1785,0,A
1784,BE,259,168,259,1250,1250,1785,0,E
1784,BF,522,354,613,270,664,1785,91,B
1784,CF,1241,887,1500,300,1550,1785,259,F
1784,CG,1248,361,1861,1100,1764,1785,613,C
1784,DG,961,600,2461,905,2455,1785,1500,G
1784,DH,2423,1823,4284,335,2099,1785,1861,D
1784,H,2635,812,5096,2760,5215,1785,2461,H
1784,M,1122,1122,6218,2197,7412,1785,5096,M
1784,N,1107,1107,7325,90,7502,1785,6218,N
1784,O,622,622,7947,935,8437,1785,7325,O
1784,N,2431,2431,10378,2100,10537,1785,7947,N
1784,O,745,745,11123,1195,11732,1785,10378,O
1784,P,70,70,11193,3780,15512,1785,11123,P
1785,AEI,12,12,12,992,992,1786,0,E
1785,AFI,1055,1055,1067,135,1127,1786,12,F
1785,AGI,769,769,1836,995,2122,1786,1067,G
1785,AHI,2145,309,2145,3604,3604,1786,0,A
1785,BHI,1509,1200,3345,4680,6802,1786,1836,H
1785,BI,1426,226,3571,90,3694,1786,2145,B
1785,CI,3638,67,3638,4270,4270,1786,0,I
1785,CJ,319,252,3890,755,4449,1786,3571,C
1785,DJ,624,372,4262,90,4360,1786,3638,J
1785,DK,383,383,4645,800,5160,1786,4262,K
1785,DL,879,879,5524,3780,8940,1786,4645,L
1785,D,1720,86,5610,3780,8229,1786,3890,D
1785,M,1629,1629,7239,1739,10679,1786,5610,M
1785,N,223,223,7462,90,10769,1786,7239,N
1785,O,463,463,7925,820,11589,1786,7462,O
1785,N,767,767,8692,500,12089,1786,7925,N
1785,O,232,232,8924,695,12784,1786,8692,O
1785,P,11402,11402,20326,3780,16564,1786,8924,P
1786,AEI,104,104,104,68,68,1787,0,E
1786,AFI,70,70,174,150,218,1787,104,F
1786,AGI,170,170,344,125,343,1787,174,G
1786,AFI,1466,1466,1810,1505,1848,1787,344,F
1786,AGI,828,828,2638,775,2623,1787,1810,G
1786,AHI,94,94,2732,4230,6853,1787,2638,H
1786,AI,8671,5939,8671,13087,13087,1787,0,A
1786,BI,5204,5204,13875,90,13177,1787,8671,B
1786,CI,1666,1666,15541,1865,15042,1787,13875,C
1786,DI,44,44,15585,3780,18822,1787,15541,D
1786,I,37466,21881,37466,37813,37813,1787,0,I
1786,J,652,652,38118,90,37903,1787,37466,J
1786,K,1206,1206,39324,1385,39288,1787,38118,K
1786,L,204,204,39528,3780,43068,1787,39324,L
1786,M,759,759,40287,1356,44424,1787,39528,M
1786,N,642,642,40929,90,44514,1787,40287,N
1786,O,245,245,41174,695,45209,1787,40929,O
1786,P,1597,1597,42771,3780,48989,1787,41174,P
1787,AEI,107,107,107,265,265,1788,0,I
1787,AEJ,297,190,297,505,505,1788,0,E
1787,AFJ,389,389,686,245,750,1788,297,F
1787,AGJ,668,89,775,570,835,1788,107,J
1787,AGK,822,47,822,2119,2119,1788,0,A
1787,BGK,55,8,830,80,915,1788,775,K
1787,BGL,544,400,1230,525,1275,1788,686,G
1787,BHL,53,53,1283,2880,4155,1788,1230,H
1787,BL,1432,971,2254,180,2299,1788,822,B
1787,CL,746,746,3000,865,3164,1788,2254,C
1787,BL,483,483,3483,370,3534,1788,3000,B
1787,CL,148,148,3631,290,3824,1788,3483,C
1787,DL,944,944,4575,5100,8924,1788,3631,D
1787,L,6114,2369,6944,2880,3795,1788,830,L
1787,M,4076,4076,11020,4957,13881,1788,6944,M
1787,N,911,911,11931,90,13971,1788,11020,N
1787,O,4704,4704,16635,1360,15331,1788,11931,O
1787,P,100,100,16735,3780,19111,1788,16635,P
1788,A,1382,1382,1382,1382,1382,1789,0,A
1788,B,300,300,1682,360,1742,1789,1382,B
1788,C,699,699,2381,695,2437,1789,1682,C
1788,D,484,484,2865,550,2987,1789,2381,D
1788,M,580,580,3445,1096,4083,1789,2865,M
1788,N,634,634,4079,150,4233,1789,3445,N
1788,O,149,149,4228,115,4348,1789,4079,O
1788,N,482,482,4710,525,4873,1789,4228,N
1788,O,669,669,5379,590,5463,1789,4710,O
1788,P,38002,38002,43381,4230,9693,1789,5379,P
1789,A,81,81,81,122,122,1790,0,A
1789,B,222,222,303,240,362,1790,81,B
1789,C,203,203,506,290,652,1790,303,C
1789,D,987,987,1493,5160,5812,1790,506,D
1789,M,947,947,2440,1254,7066,1790,1493,M
1789,N,440,440,2880,180,7246,1790,2440,N
1789,O,828,828,3708,885,8131,1790,2880,O
1789,N,420,420,4128,345,8476,1790,3708,N
1789,O,468,468,4596,565,9041,1790,4128,O
1789,P,2599,2599,7195,6960,16001,1790,4596,P
1790,AE,135,135,135,499,499,1791,0,A
1790,BE,1204,1204,1339,900,1399,1791,135,B
1790,CE,450,450,1789,630,2029,1791,1339,C
1790,BE,1233,1233,3022,1055,3084,1791,1789,B
1790,CE,1056,1056,4078,1206,4290,1791,3022,C
1790,DE,4092,14,4092,4409,4409,1791,0,E
1790,DF,221,207,4299,414,4704,1791,4078,D
1790,F,512,305,4604,240,4649,1791,4092,F
1790,G,616,616,5220,875,5524,1791,4604,G
1790,H,1412,1412,6632,3960,9484,1791,5220,H
1790,M,86,86,6718,4166,13650,1791,6632,M
1790,N,3927,3927,10645,180,13830,1791,6718,N
1790,O,890,890,11535,570,14400,1791,10645,O
1790,N,1475,1475,13010,1535,15935,1791,11535,N
1790,O,195,195,13205,268,16203,1791,13010,O
1790,P,12247,12247,25452,807,17010,1791,13205,P
1791,AEI,969,969,969,1279,1279,1792,0,A
1791,BEI,338,338,1307,90,1369,1792,969,B
1791,CEI,621,621,1928,820,2189,1792,1307,C
1791,BEI,767,767,2695,560,2749,1792,1928,B
1791,CEI,2989,294,2989,3947,3947,1792,0,I
1791,CEJ,1128,834,3823,1625,4374,1792,2695,C
1791,DEJ,3830,7,3830,4369,4369,1792,0,E
1791,DFJ,1205,364,4194,300,4247,1792,2989,J
1791,DFK,591,227,4421,90,4459,1792,3830,F
1791,DGK,681,454,4875,815,5062,1792,4194,K
1791,DGJ,613,159,5034,1095,5554,1792,4421,G
1791,DHJ,1121,962,5996,975,6037,1792,4875,J
1791,DHK,341,341,6337,492,6529,1792,5996,K
1791,DHL,1703,400,6737,3780,9334,1792,5034,H
1791,DL,4132,1218,7955,3780,8154,1792,3823,D
1791,L,1885,267,8222,5280,11809,1792,6337,L
1791,M,116,116,8338,454,12263,1792,8222,M
1791,N,511,511,8849,240,12503,1792,8338,N
1791,O,974,974,9823,985,13488,1792,8849,O
1791,N,626,626,10449,605,14093,1792,9823,N
1791,O,221,221,10670,260,14353,1792,10449,O
1791,P,183,183,10853,5160,19513,1792,10670,P
1792,AE,1977,1977,1977,2822,2822,1793,0,A
1792,BE,2623,646,2623,3674,3674,1793,0,E
1792,BF,947,301,2924,150,2972,1793,1977,B
1792,CF,750,750,3674,1030,4002,1793,2924,C
1792,DF,1322,271,3945,300,3974,1793,2623,F
1792,DG,1091,820,4765,3960,7962,1793,3674,D
1792,G,1144,324,5089,1050,5024,1793,3945,G
1792,H,538,538,5627,3960,8984,1793,5089,H
1792,M,18,18,5645,875,9859,1793,5627,M
1792,N,1053,1053,6698,240,10099,1793,5645,N
1792,O,573,573,7271,785,10884,1793,6698,O
1792,P,344,344,7615,3960,14844,1793,7271,P
1793,A,1767,1767,1767,1969,1969,1794,0,A
1793,B,224,224,1991,90,2059,1794,1767,B
1793,C,475,475,2466,880,2939,1794,1991,C
1793,D,387,387,2853,3780,6719,1794,2466,D
1793,M,341,341,3194,972,7691,1794,2853,M
1793,N,683,683,3877,90,7781,1794,3194,N
1793,O,137,137,4014,535,8316,1794,3877,O
1793,P,1351,1351,5365,3780,12096,1794,4014,P
1794,AE,84,84,84,181,181,1795,0,A
1794,BE,208,208,292,150,331,1795,84,B
1794,CE,321,29,321,1021,1021,1795,0,E
1794,CF,505,476,797,145,476,1795,292,C
1794,DF,100,100,897,4200,4676,1795,797,D
1794,F,927,351,1248,240,1261,1795,321,F
1794,G,928,928,2176,1015,2276,1795,1248,G
1794,H,1413,1413,3589,3960,6236,1795,2176,H
1794,M,9,9,3598,783,7019,1795,3589,M
1794,N,1243,1243,4841,240,7259,1795,3598,N
1794,O,497,497,5338,785,8044,1795,4841,O
1794,P,2336,2336,7674,3960,12004,1795,5338,P
1795,AEI,110,110,110,230,230,1796,0,E
1795,AFI,389,279,389,573,573,1796,0,A
1795,BFI,379,379,768,240,813,1796,389,B
1795,CFI,683,25,793,605,835,1796,110,F
1795,CGI,386,386,1179,310,1145,1796,793,G
1795,CFI,693,282,1461,845,1658,1796,768,C
1795,DFI,434,152,1613,505,1650,1796,1179,F
1795,DGI,827,827,2440,840,2490,1796,1613,G
1795,DHI,30,30,2470,1560,4050,1796,2440,H
1795,DI,4767,2297,4767,5945,5945,1796,0,I
1795,DJ,1531,1531,6298,300,6245,1796,4767,J
1795,DK,659,659,6957,910,7155,1796,6298,K
1795,DL,1622,1622,8579,3960,11115,1796,6957,L
1795,D,9180,2062,10641,5220,6878,1796,1461,D
1795,M,1595,1595,12236,1770,12885,1796,10641,M
1795,N,467,467,12703,300,13185,1796,12236,N
1795,O,896,896,13599,1015,14200,1796,12703,O
1795,N,1987,1987,15586,1920,16120,1796,13599,N
1795,O,714,714,16300,900,17020,1796,15586,O
1795,P,3186,3186,19486,1620,18640,1796,16300,P
1796,A,181,181,181,728,728,1797,0,A
1796,B,645,645,826,150,878,1797,181,B
1796,C,194,194,1020,155,1033,1797,826,C
1796,D,395,395,1415,4200,5233,1797,1020,D
1796,M,14188,14188,15603,14312,19545,1797,1415,M
1796,N,328,328,15931,240,19785,1797,15603,N
1796,O,613,613,16544,825,20610,1797,15931,O
1796,P,185,185,16729,3960,24570,1797,16544,P
1797,AEI,270,270,270,825,825,1798,0,E
1797,AFI,485,215,485,655,655,1798,0,A
1797,BFI,541,56,541,1641,1641,1798,0,I
1797,BFJ,290,234,775,150,805,1798,485,B
1797,CFJ,652,147,922,150,975,1798,270,F
1797,CGJ,207,60,982,390,1195,1798,775,C
1797,DGJ,41,41,1023,3960,5155,1798,982,D
1797,GJ,234,133,1156,170,1145,1798,922,G
1797,HJ,433,433,1589,4200,5345,1798,1156,H
1797,J,1208,160,1749,150,1791,1798,541,J
1797,K,749,749,2498,730,2521,1798,1749,K
1797,L,900,900,3398,4200,6721,1798,2498,L
1797,M,1400,1400,4798,2203,8924,1798,3398,M
1797,N,1009,1009,5807,240,9164,1798,4798,N
1797,O,652,652,6459,880,10044,1798,5807,O
1797,P,7066,7066,13525,3960,14004,1798,6459,P
1798,AE,1967,1967,1967,2445,2445,1799,0,A
1798,BE,516,516,2483,90,2535,1799,1967,B
1798,CE,955,955,3438,1240,3775,1799,2483,C
1798,DE,64,64,3502,3780,7555,1799,3438,D
1798,E,3987,485,3987,4090,4090,1799,0,E
1798,F,130,130,4117,90,4180,1799,3987,F
1798,G,775,775,4892,1105,5285,1799,4117,G
1798,H,1229,1229,6121,3780,9065,1799,4892,H
1798,M,384,384,6505,1722,10787,1799,6121,M
1798,N,1369,1369,7874,90,10877,1799,6505,N
1798,O,559,559,8433,805,11682,1799,7874,O
1798,P,660,660,9093,3780,15462,1799,8433,P
1799,A,51,51,51,182,182,1800,0,A
1799,B,223,223,274,135,317,1800,51,B
1799,C,297,297,571,290,607,1800,274,C
1799,D,221,221,792,5160,5767,1800,571,D
1799,M,768,768,1560,1071,6838,1800,792,M
1799,N,439,439,1999,180,7018,1800,1560,N
1799,O,715,715,2714,885,7903,1800,1999,O
1799,P,744,744,3458,6680,14583,1800,2714,P
1800,AEI,2073,2073,2073,1936,1936,1801,0,I
1800,AEJ,103,103,2176,300,2236,1801,2073,J
1800,AEK,410,410,2586,780,3016,1801,2176,K
1800,AEJ,966,966,3552,605,3621,1801,2586,J
1800,AEK,4380,828,4380,4475,4475,1801,0,A
1800,BEK,1134,306,4686,945,4566,1801,3552,K
1800,BEJ,351,45,4731,300,4775,1801,4380,B
1800,CEJ,400,355,5086,580,5146,1801,4686,J
1800,CEK,628,273,5359,810,5585,1801,4731,C
1800,DEK,511,511,5870,1560,7145,1801,5359,D
1800,EK,1026,242,6112,1206,6352,1801,5086,K
1800,EL,1469,1469,7581,324,6676,1801,6112,L
1800,E,8589,1008,8589,8680,8680,1801,0,E
1800,F,343,343,8932,300,8980,1801,8589,F
1800,G,813,813,9745,810,9790,1801,8932,G
1800,H,448,448,10193,1560,11350,1801,9745,H
1800,M,14069,14069,24262,14435,25785,1801,10193,M
1800,N,765,765,25027,300,26085,1801,24262,N
1800,O,581,581,25608,760,26845,1801,25027,O
1800,P,170,170,25778,1560,28405,1801,25608,P
1801,A,1826,1826,1826,1980,1980,1802,0,A
1801,B,173,173,1999,90,2070,1802,1826,B
1801,C,456,456,2455,800,2870,1802,1999,C
1801,B,992,992,3447,630,3500,1802,2455,B
1801,C,1510,1510,4957,1885,5385,1802,3447,C
1801,D,1358,1358,6315,3780,9165,1802,4957,D
1801,M,85,85,6400,130,9295,1802,6315,M
1801,N,296,296,6696,300,9595,1802,6400,N
1801,O,688,688,7384,780,10375,1802,6696,O
1801,P,730,730,8114,1140,11515,1802,7384,P
1802,AEI,507,507,507,658,658,1803,0,A
1802,BEI,833,326,833,2644,2644,1803,0,E
1802,BFI,337,11,844,90,748,1803,507,B
1802,CFI,396,385,1229,90,2734,1803,833,F
1802,CGI,1386,157,1386,1515,1515,1803,0,I
1802,CGJ,715,173,1559,1035,1783,1803,844,C
1802,DGJ,161,161,1720,3780,5563,1803,1559,D
1802,GJ,378,44,1764,90,1605,1803,1386,J
1802,GK,971,436,2200,1240,3974,1803,1229,G
1802,HK,43,43,2243,3780,7754,1803,2200,H
1802,K,918,439,2682,1240,2845,1803,1764,K
1802,L,103,103,2785,3780,6625,1803,2682,L
1802,M,531,531,3316,989,8743,1803,2785,M
1802,N,501,501,3817,90,8833,1803,3316,N
1802,O,205,205,4022,625,9458,1803,3817,O
1802,P,4872,4872,8894,3780,13238,1803,4022,P
1803,AEI,53,53,53,25,25,1804,0,E
1803,AFI,85,32,85,1075,1075,1804,0,A
1803,BFI,237,205,290,300,325,1804,53,F
1803,BGI,856,856,1146,1005,1330,1804,290,G
1803,BHI,1189,128,1274,240,1315,1804,85,B
1803,CHI,624,496,1770,1200,2530,1804,1146,H
1803,CI,861,365,2135,1020,2335,1804,1274,C
1803,DI,315,315,2450,4680,7015,1804,2135,D
1803,I,3426,976,3426,4243,4243,1804,0,I
1803,J,871,871,4297,90,4333,1804,3426,J
1803,K,328,328,4625,800,5133,1804,4297,K
1803,L,892,892,5517,3780,8913,1804,4625,L
1803,M,1475,1475,6992,1576,10489,1804,5517,M
1803,N,130,130,7122,90,10579,1804,6992,N
1803,O,542,542,7664,820,11399,1804,7122,O
1803,N,660,660,8324,370,11769,1804,7664,N
1803,O,235,235,8559,695,12464,1804,8324,O
1803,P,10251,10251,18810,3780,16244,1804,8559,P
1804,AE,90,90,90,90,90,1805,0,A
1804,BE,46,46,136,90,180,1805,90,B
1804,CE,416,280,416,1497,1497,1805,0,E
1804,CF,575,295,711,1010,1190,1805,136,C
1804,DF,424,424,1135,3780,4970,1805,711,D
1804,F,1326,607,1742,300,1797,1805,416,F
1804,G,1115,1115,2857,1275,3072,1805,1742,G
1804,H,714,714,3571,3960,7032,1805,2857,H
1804,M,13472,13472,17043,14252,21284,1805,3571,M
1804,N,993,993,18036,240,21524,1805,17043,N
1804,O,760,760,18796,1045,22569,1805,18036,O
1804,P,1994,1994,20790,3960,26529,1805,18796,P
1805,A,1521,1521,1521,2372,2372,1806,0,A
1805,B,1038,1038,2559,240,2612,1806,1521,B
1805,C,935,935,3494,1040,3652,1806,2559,C
1805,B,2623,2623,6117,2610,6262,1806,3494,B
1805,C,1015,1015,7132,1620,7882,1806,6117,C
1805,D,243,243,7375,3960,11842,1806,7132,D
1805,M,86,86,7461,106,11948,1806,7375,M
1805,N,135,135,7596,180,12128,1806,7461,N
1805,O,146,146,7742,265,12393,1806,7596,O
1805,N,695,695,8437,570,12963,1806,7742,N
1805,O,211,211,8648,290,13253,1806,8437,O
1805,P,90,90,8738,5220,18473,1806,8648,P
1806,A,37161,37161,37161,37993,37993,1807,0,A
1806,B,879,879,38040,90,38083,1807,37161,B
1806,C,1104,1104,39144,1210,39293,1807,38040,C
1806,B,1742,1742,40886,1645,40938,1807,39144,B
1806,C,281,281,41167,585,41523,1807,40886,C
1806,D,9463,9463,50630,3780,45303,1807,41167,D
1806,M,3,3,50633,143,45446,1807,50630,M
1806,N,494,494,51127,390,45836,1807,50633,N
1806,O,1059,1059,52186,1140,46976,1807,51127,O
1806,N,442,442,52628,385,47361,1807,52186,N
1806,O,329,329,52957,630,47991,1807,52628,O
1806,N,1519,1519,54476,1215,49206,1807,52957,N
1806,O,1005,1005,55481,2280,51486,1807,54476,O
1806,P,1300,1300,56781,1665,53151,1807,55481,P
1807,AEI,1135,1135,1135,1840,1840,1808,0,E
1807,AFI,1602,467,1602,2524,2524,1808,0,A
1807,BFI,1613,11,1613,2759,2759,1808,0,I
1807,BFJ,971,493,2106,300,2140,1808,1135,F
1807,BGJ,1021,517,2623,150,2674,1808,1602,B
1807,CGJ,1248,238,2861,150,2909,1808,1613,J
1807,CGK,842,87,2948,1220,3360,1808,2106,G
1807,CFK,776,451,3399,1030,3704,1808,2623,C
1807,BFK,554,103,3502,175,3535,1808,2948,F
1807,BGK,725,84,3586,730,3639,1808,2861,K
1807,BGJ,380,296,3882,535,4070,1808,3502,G
1807,BFJ,214,214,4096,35,4105,1808,3882,F
1807,BGJ,240,240,4336,1110,5215,1808,4096,G
1807,BHJ,1026,276,4612,1005,4644,1808,3586,J
1807,BHK,1219,6,4618,925,4629,1808,3399,B
1807,CHK,611,611,5229,705,5334,1808,4618,C
1807,DHK,651,34,5263,705,5349,1808,4612,K
1807,DHL,2854,2820,8083,4230,9564,1808,5229,D
1807,HL,3983,1163,9246,4230,9579,1808,5263,L
1807,H,6654,1744,10990,3330,8545,1808,4336,H
1807,M,835,835,11825,415,9994,1808,10990,M
1807,N,164,164,11989,640,10634,1808,11825,N
1807,O,308,308,12297,415,11049,1808,11989,O
1807,N,1655,1655,13952,1545,12594,1808,12297,N
1807,O,3874,3874,17826,1180,13774,1808,13952,O
1807,P,3119,3119,20945,3060,16834,1808,17826,P
1808,AE,164,164,164,160,160,1809,0,A
1808,BE,146,146,310,210,370,1809,164,B
1808,CE,142,142,452,255,625,1809,310,C
1808,BE,741,741,1193,620,1245,1809,452,B
1808,CE,1452,259,1452,1756,1756,1809,0,E
1808,CF,570,311,1763,470,1715,1809,1193,C
1808,DF,394,83,1846,150,1906,1809,1452,F
1808,DG,402,402,2248,420,2326,1809,1846,G
1808,DF,249,249,2497,230,2556,1809,2248,F
1808,DG,570,570,3067,470,3026,1809,2497,G
1808,DH,2136,2136,5203,5760,8786,1809,3067,H
1808,D,5146,1706,6909,5760,7475,1809,1763,D
1808,M,692,692,7601,900,9686,1809,6909,M
1808,N,397,397,7998,240,9926,1809,7601,N
1808,O,1599,1599,9597,585,10511,1809,7998,O
1808,P,704,704,10301,3960,14471,1809,9597,P
1809,AE,1393,1393,1393,1557,1557,1810,0,E
1809,AF,1522,129,1522,1459,1459,1810,0,A
1809,BF,125,125,1647,240,1699,1810,1522,B
1809,CF,265,11,1658,150,1707,1810,1393,F
1809,CG,693,693,2351,730,2437,1810,1658,G
1809,CF,1136,432,2783,1590,3289,1810,1647,C
1809,BF,1211,779,3562,1005,3442,1810,2351,F
1809,BG,538,538,4100,705,4147,1810,3562,G
1809,BH,1318,1,4101,800,4089,1810,2783,B
1809,CH,648,648,4749,975,5064,1810,4101,C
1809,DH,1633,984,5733,4230,8377,1810,4100,H
1809,D,1436,452,6185,3960,9024,1810,4749,D
1809,M,705,705,6890,710,9734,1810,6185,M
1809,N,258,258,7148,300,10034,1810,6890,N
1809,O,279,279,7427,835,10869,1810,7148,O
1809,N,1285,1285,8712,715,11584,1810,7427,N
1809,O,953,953,9665,1180,12764,1810,8712,O
1809,P,20,20,9685,3060,15824,1810,9665,P
1810,AE,864,864,864,1427,1427,1811,0,A
1810,BE,598,598,1462,90,1517,1811,864,B
1810,CE,206,206,1668,575,2092,1811,1462,C
1810,BE,1741,73,1741,3839,3839,1811,0,E
1810,BF,894,821,2562,505,2597,1811,1668,B
1810,CF,2275,1454,4016,90,3929,1811,1741,F
1810,CG,818,818,4834,1040,4969,1811,4016,G
1810,CH,2483,211,5045,1390,3987,1811,2562,C
1810,DH,310,99,5144,3780,8749,1811,4834,H
1810,D,758,659,5803,3780,7767,1811,5045,D
1810,M,33483,33483,39286,34792,43541,1811,5803,M
1810,N,1380,1380,40666,90,43631,1811,39286,N
1810,O,1256,1256,41922,1365,44996,1811,40666,O
1810,P,50,50,41972,3780,48776,1811,41922,P
1811,AEI,1,1,1,185,185,1812,0,I
1811,AEJ,315,314,315,734,734,1812,0,A
1811,BEJ,416,102,417,240,425,1812,1,J
1811,BEK,608,506,923,240,974,1812,315,B
1811,CEK,578,72,995,780,1205,1812,417,K
1811,CEL,132,60,1055,385,1359,1812,923,C
1811,BEL,70,10,1065,3960,5165,1812,995,L
1811,BE,1189,124,1189,1280,1280,1812,0,E
1811,BF,324,190,1379,65,1424,1812,1055,B
1811,CF,293,103,1482,240,1520,1812,1189,F
1811,CG,470,367,1849,785,2209,1812,1379,C
1811,DG,1019,652,2501,1195,2715,1812,1482,G
1811,DH,1047,395,2896,3960,6169,1812,1849,D
1811,H,499,104,3000,3960,6675,1812,2501,H
1811,M,1421,1421,4421,1760,8435,1812,3000,M
1811,N,913,913,5334,610,9045,1812,4421,N
1811,O,275,275,5609,455,9500,1812,5334,O
1811,N,399,399,6008,230,9730,1812,5609,N
1811,O,193,193,6201,1165,10895,1812,6008,O
1811,P,6776,6776,12977,3060,13955,1812,6201,P
1812,A,280,280,280,743,743,1813,0,A
1812,B,741,741,1021,330,1073,1813,280,B
1812,C,879,879,1900,1000,2073,1813,1021,C
1812,B,1496,1496,3396,1380,3453,1813,1900,B
1812,C,721,721,4117,845,4298,1813,3396,C
1812,D,1930,1930,6047,5220,9518,1813,4117,D
1812,M,409,409,6456,616,10134,1813,6047,M
1812,N,428,428,6884,240,10374,1813,6456,N
1812,O,1300,1300,8184,995,11369,1813,6884,O
1812,N,2805,2805,10989,3160,14529,1813,8184,N
1812,O,1081,1081,12070,1260,15789,1813,10989,O
1812,P,1515,1515,13585,3960,19749,1813,12070,P
1813,A,978,978,978,1589,1589,1814,0,A
1813,B,643,643,1621,90,1679,1814,978,B
1813,C,895,895,2516,1240,2919,1814,1621,C
1813,D,551,551,3067,3780,6699,1814,2516,D
1813,M,132,132,3199,470,7169,1814,3067,M
1813,N,371,371,3570,90,7259,1814,3199,N
1813,O,448,448,4018,880,8139,1814,3570,O
1813,P,359,359,4377,3780,11919,1814,4018,P
1814,AE,411,411,411,1357,1357,1815,0,A
1814,BE,1027,616,1027,1626,1626,1815,0,E
1814,BF,976,360,1387,90,1447,1815,411,B
1814,CF,627,267,1654,90,1716,1815,1027,F
1814,CG,815,548,2202,1200,2647,1815,1387,C
1814,DG,241,241,2443,3780,6427,1815,2202,D
1814,G,891,102,2545,1240,2956,1815,1654,G
1814,H,1529,1529,4074,3780,6736,1815,2545,H
1814,M,565,565,4639,1269,8005,1815,4074,M
1814,N,843,843,5482,90,8095,1815,4639,N
1814,O,233,233,5715,695,8790,1815,5482,O
1814,P,11464,11464,17179,3780,12570,1815,5715,P
1815,A,9777,9777,9777,10317,10317,1816,0,A
1815,B,692,692,10469,180,10497,1816,9777,B
1815,C,761,761,11230,945,11442,1816,10469,C
1815,B,870,870,12100,705,12147,1816,11230,B
1815,C,752,752,12852,695,12842,1816,12100,C
1815,D,1025,1025,13877,6960,19802,1816,12852,D
1815,M,311,311,14188,164,19966,1816,13877,M
1815,N,249,249,14437,390,20356,1816,14188,N
1815,O,1081,1081,15518,1175,21531,1816,14437,O
1815,N,967,967,16485,920,22451,1816,15518,N
1815,O,831,831,17316,1162,23613,1816,16485,O
1815,P,72,72,17388,473,24086,1816,17316,P
1816,AEI,70,70,70,1516,1516,1817,0,I
1816,AEJ,1113,1043,1113,2733,2733,1817,0,A
1816,BEJ,1552,509,1622,180,1696,1817,70,J
1816,BEK,786,786,2408,950,2646,1817,1622,K
1816,BEJ,2762,354,2762,3736,3736,1817,0,E
1816,BFJ,1710,61,2823,180,2913,1817,1113,B
1816,CFJ,517,102,2925,330,2976,1817,2408,J
1816,CFK,444,444,3369,585,3561,1817,2925,K
1816,CFL,1234,627,3996,300,4036,1817,2762,F
1816,CGL,1766,593,4589,830,3743,1817,2823,C
1816,BGL,419,419,5008,1325,5068,1817,4589,B
1816,CGL,1080,68,5076,1050,5086,1817,3996,G
1816,CFL,555,487,5563,585,5653,1817,5008,C
1816,DFL,605,118,5681,720,5806,1817,5076,F
1816,DGL,530,412,6093,6960,12613,1817,5563,D
1816,GL,580,168,6261,780,6586,1817,5681,G
1816,HL,4144,1252,7513,6960,10521,1817,3369,L
1816,H,1794,542,8055,3960,10546,1817,6261,H
1816,M,226,226,8281,1347,13960,1817,8055,M
1816,N,1491,1491,9772,420,14380,1817,8281,N
1816,O,732,732,10504,840,15220,1817,9772,O
1816,P,342,342,10846,350,15570,1817,10504,P
1817,A,898,898,898,954,954,1818,0,A
1817,B,176,176,1074,150,1104,1818,898,B
1817,C,59,59,1133,50,1154,1818,1074,C
1817,B,99,99,1232,135,1289,1818,1133,B
1817,C,137,137,1369,235,1524,1818,1232,C
1817,D,167,167,1536,5280,6804,1818,1369,D
1817,M,1222,1222,2758,1566,8370,1818,1536,M
1817,N,447,447,3205,150,8520,1818,2758,N
1817,O,155,155,3360,165,8685,1818,3205,O
1817,N,834,834,4194,830,9515,1818,3360,N
1817,O,123,123,4317,130,9645,1818,4194,O
1817,P,50,50,4367,4230,13875,1818,4317,P
1818,A,1975,1975,1975,4293,4293,1819,0,A
1818,B,2350,2350,4325,90,4383,1819,1975,B
1818,C,1078,1078,5403,1250,5633,1819,4325,C
1818,D,1907,1907,7310,3840,9473,1819,5403,D
1818,M,3653,3653,10963,4439,13912,1819,7310,M
1818,N,833,833,11796,90,14002,1819,10963,N
1818,O,170,170,11966,610,14612,1819,11796,O
1818,P,4281,4281,16247,3780,18392,1819,11966,P
1819,A,169,169,169,1144,1144,1820,0,A
1819,B,1005,1005,1174,90,1234,1820,169,B
1819,C,981,981,2155,1220,2454,1820,1174,C
1819,D,27,27,2182,3780,6234,1820,2155,D
1819,M,5043,5043,7225,5637,11871,1820,2182,M
1819,N,945,945,8170,90,11961,1820,7225,N
1819,O,295,295,8465,915,12876,1820,8170,O
1819,P,2496,2496,10961,3780,16656,1820,8465,P
1820,AEI,17,17,17,269,269,1821,0,E
1820,AFI,57,40,57,1042,1042,1821,0,I
1820,AFJ,448,408,465,240,509,1821,17,F
1820,AGJ,731,731,1196,845,1354,1821,465,G
1820,AHJ,1175,36,1232,240,1282,1821,57,J
1820,AHK,119,83,1315,9700,11054,1821,1196,H
1820,AK,899,816,2131,1020,2302,1821,1232,K
1820,AL,45,45,2176,4680,6982,1821,2131,L
1820,A,6060,3884,6060,6477,6477,1821,0,A
1820,B,615,615,6675,240,6717,1821,6060,B
1820,C,167,167,6842,390,7107,1821,6675,C
1820,B,508,508,7350,280,7387,1821,6842,B
1820,C,794,794,8144,935,8322,1821,7350,C
1820,D,61955,61955,70099,3960,12282,1821,8144,D
1820,M,2058,2058,72157,2357,14639,1821,70099,M
1820,N,491,491,72648,90,14729,1821,72157,N
1820,O,447,447,73095,815,15544,1821,72648,O
1820,N,1361,1361,74456,1140,16684,1821,73095,N
1820,O,649,649,75105,1125,17809,1821,74456,O
1820,P,1203,1203,76308,3780,21589,1821,75105,P
1821,AEI,335,335,335,537,537,1822,0,E
1821,AFI,312,312,647,150,687,1822,335,F
1821,AGI,386,386,1033,315,1002,1822,647,G
1821,AHI,10,10,1043,4020,5022,1822,1033,H
1821,AI,4521,3478,4521,4797,4797,1822,0,A
1821,BI,338,338,4859,90,4887,1822,4521,B
1821,CI,5363,504,5363,5660,5660,1822,0,I
1821,CJ,331,331,5694,90,5750,1822,5363,J
1821,CK,1031,196,5890,1285,6172,1822,4859,C
1821,DK,1161,965,6855,1315,7065,1822,5694,K
1821,DL,68,68,6923,3780,10845,1822,6855,L
1821,D,2935,1902,8825,3780,9952,1822,5890,D
1821,M,118,118,8943,638,11483,1822,8825,M
1821,N,646,646,9589,240,11723,1822,8943,N
1821,O,384,384,9973,750,12473,1822,9589,O
1821,P,1816,1816,11789,3840,16313,1822,9973,P
1822,AEI,924,924,924,1790,1790,1823,0,E
1822,AFI,1351,427,1351,1521,1521,1823,0,A
1822,BFI,239,239,1590,90,1611,1823,1351,B
1822,CFI,898,232,1822,90,1880,1823,924,F
1822,CGI,498,266,2088,860,2471,1823,1590,C
1822,DGI,956,690,2778,1240,3120,1823,1822,G
1822,DHI,177,177,2955,3780,6900,1823,2778,H
1822,DI,1355,488,3443,3780,6251,1823,2088,D
1822,I,4135,692,4135,4276,4276,1823,0,I
1822,J,176,176,4311,90,4366,1823,4135,J
1822,K,538,538,4849,820,5186,1823,4311,K
1822,L,70,70,4919,3780,8966,1823,4849,L
1822,M,4,4,4923,73,9039,1823,4919,M
1822,N,97,97,5020,90,9129,1823,4923,N
1822,O,207,207,5227,625,9754,1823,5020,O
1822,P,1295,1295,6522,3780,13534,1823,5227,P
1823,AEI,6,6,6,910,910,1824,0,I
1823,AEJ,506,500,506,2571,2571,1824,0,A
1823,BEJ,1116,616,1122,240,1150,1824,6,J
1823,BEK,526,526,1648,785,1935,1824,1122,K
1823,BEL,99,99,1747,3960,5895,1824,1648,L
1823,BE,2264,1023,2770,240,2811,1824,506,B
1823,CE,552,552,3322,785,3596,1824,2770,C
1823,DE,129,129,3451,3960,7556,1824,3322,D
1823,E,15840,12389,15840,16225,16225,1824,0,E
1823,F,587,587,16427,240,16465,1824,15840,F
1823,G,511,511,16938,780,17245,1824,16427,G
1823,H,781,781,17719,3960,21205,1824,16938,H
1823,M,2713,2713,20432,2758,23963,1824,17719,M
1823,N,288,288,20720,240,24203,1824,20432,N
1823,O,579,579,21299,740,24943,1824,20720,O
1823,N,293,293,21592,185,25128,1824,21299,N
1823,O,256,256,21848,430,25558,1824,21592,O
1823,P,7911,7911,29759,3960,29518,1824,21848,P
1824,AE,1,1,1,3066,3066,1825,0,A
1824,BE,768,767,768,1306,1306,1825,0,E
1824,BF,568,568,1336,90,1396,1825,768,F
1824,BG,595,595,1931,820,2216,1825,1336,G
1824,BF,3182,1252,3183,180,3246,1825,1,B
1824,CF,779,779,3962,835,4081,1825,3183,C
1824,BF,439,439,4401,370,4451,1825,3962,B
1824,CF,234,234,4635,290,4741,1825,4401,C
1824,DF,3578,874,5509,1450,3666,1825,1931,F
1824,DG,1382,508,6017,5100,9841,1825,4635,D
1824,G,2074,1566,7583,1865,5531,1825,5509,G
1824,H,1483,1483,9066,3780,9311,1825,7583,H
1824,M,4539,4539,13605,6712,16553,1825,9066,M
1824,N,2657,2657,16262,90,16643,1825,13605,N
1824,O,1148,1148,17410,1360,18003,1825,16262,O
1824,P,31,31,17441,3780,21783,1825,17410,P
1825,AE,8,8,8,136,136,1826,0,A
1825,BE,66,58,66,72,72,1826,0,E
1825,BF,232,232,298,240,312,1826,66,F
1825,BG,310,20,318,240,376,1826,8,B
1825,CG,179,159,477,285,597,1826,298,G
1825,CH,338,179,656,285,661,1826,318,C
1825,DH,2289,2110,2766,5160,5757,1826,477,H
1825,D,4266,2156,4922,5160,5821,1826,656,D
1825,M,565,565,5487,728,6549,1826,4922,M
1825,N,220,220,5707,90,6639,1826,5487,N
1825,O,880,880,6587,1250,7889,1826,5707,O
1825,N,827,827,7414,455,8344,1826,6587,N
1825,O,411,411,7825,790,9134,1826,7414,O
1825,P,1275,1275,9100,3780,12914,1826,7825,P
1826,AEI,121,121,121,723,723,1827,0,I
1826,AEJ,224,103,224,462,462,1827,0,E
1826,AFJ,400,176,400,610,610,1827,0,A
1826,BFJ,248,72,472,120,582,1827,224,F
1826,BGJ,68,68,540,90,672,1827,472,G
1826,BFJ,330,190,730,180,790,1827,400,B
1826,CFJ,790,181,911,240,963,1827,121,J
1826,CFK,258,77,988,660,1450,1827,730,C
1826,BFK,291,214,1202,380,1343,1827,911,K
1826,BFL,677,15,1217,595,1267,1827,540,F
1826,BGL,33,18,1235,5460,6803,1827,1202,L
1826,BG,226,208,1443,380,1647,1827,1217,G
1826,BH,110,110,1553,5460,7107,1827,1443,H
1826,B,965,400,1953,465,1915,1827,988,B
1826,C,756,756,2709,805,2720,1827,1953,C
1826,D,1201,1201,3910,1140,3860,1827,2709,D
1826,M,122,122,4032,15,7122,1827,3910,M
1826,N,253,253,4285,420,7542,1827,4032,N
1826,O,180,180,4465,320,7862,1827,4285,O
1826,N,676,676,5141,535,8397,1827,4465,N
1826,O,413,413,5554,470,8867,1827,5141,O
1826,P,5281,5281,10835,5760,14627,1827,5554,P
1827,A,109,109,109,125,125,1828,0,A
1827,B,127,127,236,150,275,1828,109,B
1827,C,128,128,364,165,440,1828,236,C
1827,D,824,824,1188,4200,4640,1828,364,D
1827,M,1801,1801,2989,2799,7439,1828,1188,M
1827,N,1031,1031,4020,90,7529,1828,2989,N
1827,O,840,840,4860,1230,8759,1828,4020,O
1827,N,782,782,5642,385,9144,1828,4860,N
1827,O,615,615,6257,945,10089,1828,5642,O
1827,P,56333,56333,62590,3780,13869,1828,6257,P
1828,A,57,57,57,1064,1064,1829,0,A
1828,B,1190,1190,1247,240,1304,1829,57,B
1828,C,863,863,2110,1020,2324,1829,1247,C
1828,D,365,365,2475,4680,7004,1829,2110,D
1828,M,4088,4088,6563,4220,11224,1829,2475,M
1828,N,190,190,6753,90,11314,1829,6563,N
1828,O,407,407,7160,800,12114,1829,6753,O
1828,N,909,909,8069,545,12659,1829,7160,N
1828,O,601,601,8670,915,13574,1829,8069,O
1828,P,997,997,9667,3780,17354,1829,8670,P
1829,AE,43,43,43,69,69,1830,0,A
1829,BE,141,98,141,195,195,1830,0,E
1829,BF,103,5,146,135,204,1830,43,B
1829,CF,156,156,302,290,494,1830,146,C
1829,DF,133,133,435,5160,5654,1830,302,D
1829,F,319,25,460,300,495,1830,141,F
1829,G,683,683,1143,800,1295,1830,460,G
1829,H,1493,1493,2636,1140,2435,1830,1143,H
1829,M,930,930,3566,2018,7672,1830,2636,M
1829,N,1222,1222,4788,150,7822,1830,3566,N
1829,O,1424,1424,6212,1685,9507,1830,4788,O
1829,P,53,53,6265,2520,12027,1830,6212,P
1830,AE,611,611,611,1707,1707,1831,0,E
1830,AF,1535,924,1535,2368,2368,1831,0,A
1830,BF,1269,345,1880,240,1947,1831,611,F
1830,BG,176,176,2056,295,2242,1831,1880,G
1830,BF,1041,520,2576,240,2608,1831,1535,B
1830,CF,646,126,2702,515,2757,1831,2056,F
1830,CG,265,265,2967,290,3047,1831,2702,G
1830,CH,761,370,3337,1040,3648,1831,2576,C
1830,BH,742,372,3709,5160,8207,1831,2967,H
1830,B,905,533,4242,690,4338,1831,3337,B
1830,C,767,767,5009,1141,5479,1831,4242,C
1830,D,748,748,5757,3960,9439,1831,5009,D
1830,M,1059,1059,6816,1247,10686,1831,5757,M
1830,N,219,219,7035,90,10776,1831,6816,N
1830,O,973,973,8008,1250,12026,1831,7035,O
1830,P,5,5,8013,3780,15806,1831,8008,P
1831,AEI,38,38,38,98,98,1832,0,A
1831,BEI,362,324,362,836,836,1832,0,E
1831,BFI,940,616,978,750,848,1832,38,B
1831,CFI,761,145,1123,360,1196,1832,362,F
1831,CGI,1144,999,2122,855,1703,1832,978,C
1831,DGI,1029,30,2152,990,2186,1832,1123,G
1831,DHI,1726,1696,3848,550,2253,1832,2122,D
1831,HI,4568,720,4568,4737,4737,1832,0,I
1831,HJ,2707,291,4859,550,2736,1832,2152,H
1831,J,386,95,4954,240,4977,1832,4568,J
1831,K,957,957,5911,995,5972,1832,4954,K
1831,J,463,463,6374,410,6382,1832,5911,J
1831,K,652,652,7026,810,7192,1832,6374,K
1831,L,1170,1170,8196,3960,11152,1832,7026,L
1831,M,399,399,8595,2887,14039,1832,8196,M
1831,N,2538,2538,11133,90,14129,1832,8595,N
1831,O,1042,1042,12175,1340,15469,1832,11133,O
1831,P,526,526,12701,3780,19249,1832,12175,P
1832,A,161,161,161,2537,2537,1833,0,A
1832,B,2561,2561,2722,240,2777,1833,161,B
1832,C,820,820,3542,995,3772,1833,2722,C
1832,D,8764,8764,12306,4680,8452,1833,3542,D
1832,M,2326,2326,14632,2508,10960,1833,12306,M
1832,N,242,242,14874,90,11050,1833,14632,N
1832,O,565,565,15439,795,11845,1833,14874,O
1832,N,1074,1074,16513,865,12710,1833,15439,N
1832,O,439,439,16952,790,13500,1833,16513,O
1832,P,928,928,17880,3780,17280,1833,16952,P
1833,AEI,367,367,367,1200,1200,1834,0,A
1833,BEI,634,267,634,4784,4784,1834,0,I
1833,BEJ,1097,830,1464,300,1500,1834,367,B
1833,CEJ,803,803,2267,910,2410,1834,1464,C
1833,DEJ,238,238,2505,2040,4450,1834,2267,D
1833,EJ,4175,2304,4809,90,4874,1834,634,J
1833,EK,791,791,5600,1295,6169,1834,4809,K
1833,EL,6425,6425,12025,3780,9949,1834,5600,L
1833,E,22092,10067,22092,24514,24514,1834,0,E
1833,F,2448,2448,24540,90,24604,1834,22092,F
1833,G,833,833,25373,1345,25949,1834,24540,G
1833,H,34322,34322,59695,3780,29729,1834,25373,H
1833,M,172,172,59867,2595,32324,1834,59695,M
1833,N,2781,2781,62648,300,32624,1834,59867,N
1833,O,657,657,63305,805,33429,1834,62648,O
1833,P,5954,5954,69259,4020,37449,1834,63305,P
1834,AE,1693,1693,1693,2247,2247,1835,0,A
1834,BE,2459,766,2459,2806,2806,1835,0,E
1834,BF,628,628,3087,240,3046,1835,2459,F
1834,BG,1476,82,3169,960,3207,1835,1693,B
1834,CG,489,407,3576,740,3786,1835,3087,G
1834,CF,703,296,3872,955,4162,1835,3169,C
1834,BF,504,208,4080,380,4166,1835,3576,F
1834,BG,1108,1108,5188,1340,5506,1835,4080,G
1834,BH,147,147,5335,3960,9466,1835,5188,H
1834,B,1494,31,5366,1275,5437,1835,3872,B
1834,C,886,886,6252,927,6364,1835,5366,C
1834,D,1584,1584,7836,393,6757,1835,6252,D
1834,M,526,526,8362,655,10121,1835,7836,M
1834,N,179,179,8541,150,10271,1835,8362,N
1834,O,640,640,9181,780,11051,1835,8541,O
1834,N,184,184,9365,5,11056,1835,9181,N
1834,O,553,553,9918,785,11841,1835,9365,O
1834,P,1528,1528,11446,3960,15801,1835,9918,P
1835,AEI,38,38,38,220,220,1836,0,A
1835,BEI,151,113,151,206,206,1836,0,E
1835,BFI,255,255,406,270,476,1836,151,F
1835,BGI,692,324,730,570,790,1836,38,B
1835,CGI,92,92,822,80,870,1836,730,C
1835,DGI,505,89,911,735,1211,1836,406,G
1835,DFI,101,12,923,2880,3750,1836,822,D
1835,FI,925,2,925,1371,1371,1836,0,I
1835,FJ,474,474,1399,90,1461,1836,925,J
1835,FK,1157,669,2068,915,2126,1836,911,F
1835,GK,131,131,2199,285,2411,1836,2068,G
1835,HK,942,142,2341,1240,2701,1836,1399,K
1835,HL,1439,1297,3638,5100,7511,1836,2199,H
1835,L,2764,1467,5105,3780,6481,1836,2341,L
1835,M,130,130,5235,183,7694,1836,5105,M
1835,N,263,263,5498,270,7964,1836,5235,N
1835,O,142,142,5640,640,8604,1836,5498,O
1835,P,3465,3465,9105,3690,12294,1836,5640,P
1836,AEI,87,87,87,285,285,1837,0,E
1836,AFI,178,91,178,264,264,1837,0,A
1836,BFI,351,173,351,1525,1525,1837,0,I
1836,BFJ,180,7,358,150,414,1837,178,B
1836,CFJ,303,32,390,155,440,1837,87,F
1836,CGJ,129,97,487,120,534,1837,358,C
1836,DGJ,132,35,522,470,910,1837,390,G
1836,DFJ,602,602,1124,275,1185,1837,522,F
1836,DGJ,642,5,1129,4230,4764,1837,487,D
1836,GJ,76,71,1200,50,1235,1837,1124,G
1836,HJ,1675,826,2026,540,2065,1837,351,J
1836,HK,803,803,2829,1065,3130,1837,2026,K
1836,HJ,3165,1536,4365,3000,4235,1837,1200,H
1836,J,3915,2379,6744,3675,6805,1837,2829,J
1836,K,2758,2758,9502,2628,9433,1837,6744,K
1836,L,1833,1833,11335,402,9835,1837,9502,L
1836,M,117,117,11452,170,10005,1837,11335,M
1836,N,115,115,11567,120,10125,1837,11452,N
1836,O,155,155,11722,125,10250,1837,11567,O
1836,P,5496,5496,17218,2880,13130,1837,11722,P
1837,A,303,303,303,1083,1083,1838,0,A
1837,B,976,976,1279,240,1323,1838,303,B
1837,C,457,457,1736,760,2083,1838,1279,C
1837,D,2453,2453,4189,3540,5623,1838,1736,D
1837,M,1467,1467,5656,1764,7387,1838,4189,M
1837,N,330,330,5986,90,7477,1838,5656,N
1837,O,526,526,6512,820,8297,1838,5986,O
1837,N,855,855,7367,545,8842,1838,6512,N
1837,O,1096,1096,8463,1300,10142,1838,7367,O
1837,P,2521,2521,10984,3780,13922,1838,8463,P
1838,AE,613,613,613,785,785,1839,0,E
1838,AF,200,200,813,90,875,1839,613,F
1838,AG,1022,209,1022,1653,1653,1839,0,A
1838,BG,585,376,1398,905,1780,1839,813,G
1838,BH,277,277,1675,3780,5560,1839,1398,H
1838,B,866,213,1888,90,1743,1839,1022,B
1838,C,947,947,2835,1250,2993,1839,1888,C
1838,D,135,135,2970,3840,6833,1839,2835,D
1838,M,498,498,3468,794,7627,1839,2970,M
1838,N,377,377,3845,90,7717,1839,3468,N
1838,O,1346,1346,5191,1865,9582,1839,3845,O
1838,P,1392,1392,6583,3780,13362,1839,5191,P
1839,AE,268,268,268,728,728,1840,0,E
1839,AF,898,630,898,3670,3670,1840,0,A
1839,BF,1265,635,1533,900,1628,1840,268,F
1839,BG,1488,1488,3021,2202,3830,1840,1533,G
1839,BH,2832,709,3730,180,3850,1840,898,B
1839,CH,761,761,4491,300,4150,1840,3730,C
1839,BH,411,411,4902,805,4955,1840,4491,B
1839,CH,1367,1367,6269,1315,6270,1840,4902,C
1839,DH,1464,1464,7733,350,6620,1840,6269,D
1839,H,7521,2809,10542,353,4183,1840,3021,H
1839,M,1900,1900,12442,2380,9000,1840,10542,M
1839,N,755,755,13197,300,9300,1840,12442,N
1839,O,822,822,14019,910,10210,1840,13197,O
1839,N,745,745,14764,660,10870,1840,14019,N
1839,O,162,162,14926,385,11255,1840,14764,O
1839,P,329,329,15255,3960,15215,1840,14926,P
1840,AEI,1226,1226,1226,1767,1767,1841,0,A
1840,BEI,1666,440,1666,1927,1927,1841,0,I
1840,BEJ,1890,224,1890,1825,1825,1841,0,E
1840,BFJ,272,48,1938,90,2017,1841,1666,J
1840,BFK,721,9,1947,240,2007,1841,1226,B
1840,CFK,949,940,2887,1315,3332,1841,1938,K
1840,CFL,109,109,2996,3780,7112,1841,2887,L
1840,CF,1874,825,3821,2130,4137,1841,1947,C
1840,BF,1034,1034,4855,745,4882,1841,3821,B
1840,CF,3010,45,4900,90,1915,1841,1890,F
1840,CG,797,752,5652,950,5832,1841,4855,C
1840,DG,220,220,5872,350,6182,1841,5652,D
1840,G,1642,670,6542,1570,3485,1841,4900,G
1840,H,345,345,6887,3780,7265,1841,6542,H
1840,M,216,216,7103,443,7708,1841,6887,M
1840,N,256,256,7359,90,7798,1841,7103,N
1840,O,402,402,7761,795,8593,1841,7359,O
1840,P,1890,1890,9651,3780,12373,1841,7761,P
1841,AE,15,15,15,153,153,1842,0,E
1841,AF,211,196,211,315,315,1842,0,A
1841,BF,256,60,271,150,303,1842,15,F
1841,BG,229,229,500,740,1043,1842,271,G
1841,BH,364,75,575,300,615,1842,211,B
1841,CH,520,520,1095,735,1350,1842,575,C
1841,DH,1853,1258,2353,3600,4643,1842,500,H
1841,D,3963,2705,5058,4020,5370,1842,1095,D
1841,M,238,238,5296,2046,7416,1842,5058,M
1841,N,1814,1814,7110,90,7506,1842,5296,N
1841,O,1184,1184,8294,1365,8871,1842,7110,O
1841,P,2147,2147,10441,3780,12651,1842,8294,P
1842,AE,179,179,179,475,475,1843,0,A
1842,BE,687,687,866,480,955,1843,179,B
1842,CE,729,729,1595,720,1675,1843,866,C
1842,DE,1656,61,1656,1880,1880,1843,0,E
1842,DF,380,319,1975,550,2225,1843,1595,D
1842,F,344,25,2000,180,2060,1843,1656,F
1842,G,738,738,2738,855,2915,1843,2000,G
1842,F,1034,1034,3772,905,3820,1843,2738,F
1842,G,239,239,4011,250,4070,1843,3772,G
1842,H,9114,9114,13125,5250,9320,1843,4011,H
1842,M,34329,34329,47454,34962,44282,1843,13125,M
1842,N,983,983,48437,420,44702,1843,47454,N
1842,O,449,449,48886,790,45492,1843,48437,O
1842,P,1731,1731,50617,1315,46807,1843,48886,P
1843,A,113,113,113,501,501,1844,0,A
1843,B,587,587,700,240,741,1844,113,B
1843,C,645,645,1345,960,1701,1844,700,C
1843,D,363,363,1708,3960,5661,1844,1345,D
1843,M,25793,25793,27501,26110,31771,1844,1708,M
1843,N,359,359,27860,90,31861,1844,27501,N
1843,O,1111,1111,28971,1540,33401,1844,27860,O
1843,P,29,29,29000,3780,37181,1844,28971,P
1844,AE,169,169,169,852,852,1845,0,A
1844,BE,869,869,1038,240,1092,1845,169,B
1844,CE,1291,1291,2329,1015,2107,1845,1038,C
1844,DE,1284,1284,3613,4020,6127,1845,2329,D
1844,E,6304,2691,6304,6505,6505,1845,0,E
1844,F,408,408,6712,240,6745,1845,6304,F
1844,G,747,747,7459,920,7665,1845,6712,G
1844,H,32,32,7491,3960,11625,1845,7459,H
1844,M,17,17,7508,209,11834,1845,7491,M
1844,N,412,412,7920,240,12074,1845,7508,N
1844,O,551,551,8471,780,12854,1845,7920,O
1844,P,709,709,9180,3960,16814,1845,8471,P
1845,AEI,16,16,16,218,218,1846,0,I
1845,AEJ,81,65,81,217,217,1846,0,E
1845,AFJ,109,28,109,193,193,1846,0,A
1845,BFJ,161,161,270,135,328,1846,109,B
1845,CFJ,214,25,295,135,352,1846,81,F
1845,CGJ,280,1,296,135,353,1846,16,J
1845,CGK,173,147,443,285,613,1846,270,C
1845,DGK,191,44,487,280,633,1846,296,K
1845,DGL,221,29,516,285,637,1846,295,G
1845,DHL,133,60,576,5160,5773,1846,443,D
1845,HL,149,60,636,5160,5793,1846,487,L
1845,H,268,148,784,5160,5797,1846,516,H
1845,M,560,560,1344,1232,7029,1846,784,M
1845,N,731,731,2075,90,7119,1846,1344,N
1845,O,930,930,3005,1250,8369,1846,2075,O
1845,P,4,4,3009,3780,12149,1846,3005,P
1846,AE,14,14,14,450,450,1847,0,A
1846,BE,215,201,215,264,264,1847,0,E
1846,BF,349,349,564,300,564,1847,215,F
1846,BG,568,18,582,180,630,1847,14,B
1846,CG,434,434,1016,565,1195,1847,582,C
1846,BG,607,155,1171,870,1434,1847,564,G
1846,BH,158,158,1329,1620,3054,1847,1171,H
1846,B,450,137,1466,295,1490,1847,1016,B
1846,C,602,602,2068,765,2255,1847,1466,C
1846,D,57,57,2125,1680,3935,1847,2068,D
1846,M,1820,1820,3945,1810,5745,1847,2125,M
1846,N,250,250,4195,300,6045,1847,3945,N
1846,O,715,715,4910,820,6865,1847,4195,O
1846,P,7700,7700,12610,1560,8425,1847,4910,P
1847,A,390,390,390,1534,1534,1848,0,A
1847,B,1164,1164,1554,90,1624,1848,390,B
1847,C,922,922,2476,1255,2879,1848,1554,C
1847,D,290,290,2766,3780,6659,1848,2476,D
1847,M,462,462,3228,1511,8170,1848,2766,M
1847,N,1525,1525,4753,555,8725,1848,3228,N
1847,O,1299,1299,6052,1235,9960,1848,4753,O
1847,P,2454,2454,8506,550,10510,1848,6052,P
1848,AE,156,156,156,240,240,1849,0,A
1848,BE,273,273,429,240,480,1849,156,B
1848,CE,137,137,566,215,695,1849,429,C
1848,DE,20,20,586,4890,5585,1849,566,D
1848,E,2681,2095,2681,2792,2792,1849,0,E
1848,F,458,458,3139,240,3032,1849,2681,F
1848,G,676,676,3815,910,3942,1849,3139,G
1848,H,1209,1209,5024,3900,7842,1849,3815,H
1848,M,13,13,5037,131,7973,1849,5024,M
1848,N,215,215,5252,150,8123,1849,5037,N
1848,O,281,281,5533,140,8263,1849,5252,O
1848,P,89,89,5622,4230,12493,1849,5533,P
1849,A,29,29,29,442,442,1850,0,A
1849,B,801,801,830,420,862,1850,29,B
1849,C,683,683,1513,850,1712,1850,830,C
1849,D,8886,8886,10399,300,2012,1850,1513,D
1849,M,1,1,10400,129,2141,1850,10399,M
1849,N,187,187,10587,120,2261,1850,10400,N
1849,O,626,626,11213,945,3206,1850,10587,O
1849,P,157,157,11370,720,3926,1850,11213,P
1850,AE,16,16,16,1255,1255,1851,0,E
1850,AF,57,41,57,224,224,1851,0,A
1850,BF,358,358,415,240,464,1851,57,B
1850,CF,621,621,1036,630,1094,1851,415,C
1850,DF,1426,406,1442,240,1495,1851,16,F
1850,DG,631,225,1667,6300,7394,1851,1036,D
1850,G,576,351,2018,620,2115,1851,1442,G
1850,H,814,814,2832,6300,8415,1851,2018,H
1850,M,65,65,2897,432,8847,1851,2832,M
1850,N,580,580,3477,270,9117,1851,2897,N
1850,O,636,636,4113,735,9852,1851,3477,O
1850,N,1015,1015,5128,910,10762,1851,4113,N
1850,O,229,229,5357,290,11052,1851,5128,O
1850,P,468,468,5825,5160,16212,1851,5357,P
1851,AEI,99,99,99,1379,1379,1852,0,E
1851,AFI,153,54,153,158,158,1852,0,I
1851,AFJ,208,55,208,585,585,1852,0,A
1851,BFJ,109,54,262,150,308,1852,153,J
1851,BFK,202,202,464,115,423,1852,262,K
1851,BFL,638,382,846,180,765,1852,208,B
1851,CFL,546,164,1010,4230,4653,1852,464,L
1851,CF,171,7,1017,145,910,1852,846,C
1851,DF,31,31,1048,2880,3790,1852,1017,D
1851,F,1875,926,1974,715,2094,1852,99,F
1851,G,1637,1637,3611,1275,3369,1852,1974,G
1851,F,271,271,3882,555,3924,1852,3611,F
1851,G,154,154,4036,188,4112,1852,3882,G
1851,H,2449,2449,6485,432,4544,1852,4036,H
1851,M,561,561,7046,897,5550,1852,6485,M
1851,N,524,524,7570,240,5790,1852,7046,N
1851,O,237,237,7807,395,6185,1852,7570,O
1851,N,2114,2114,9921,1935,8120,1852,7807,N
1851,O,596,596,10517,875,8995,1852,9921,O
1851,P,11226,11226,21743,3960,12955,1852,10517,P
1852,AE,1372,1372,1372,1902,1902,1853,0,E
1852,AF,554,554,1926,90,1992,1853,1372,F
1852,AG,1930,4,1930,2898,2898,1853,0,A
1852,BG,990,990,2920,90,2988,1853,1930,B
1852,CG,513,513,3433,880,3868,1853,2920,C
1852,BG,1524,17,3450,2315,4307,1853,1926,G
1852,BH,253,253,3703,3420,7727,1853,3450,H
1852,B,482,212,3915,110,3978,1853,3433,B
1852,C,1521,1521,5436,2315,6293,1853,3915,C
1852,D,5819,5819,11255,3420,9713,1853,5436,D
1852,M,486,486,11741,1573,11286,1853,11255,M
1852,N,1207,1207,12948,180,11466,1853,11741,N
1852,O,5300,5300,18248,935,12401,1853,12948,O
1852,P,733,733,18981,660,13061,1853,18248,P
1853,AE,88,88,88,1124,1124,1854,0,E
1853,AF,175,87,175,265,265,1854,0,A
1853,BF,453,453,628,300,565,1854,175,B
1853,CF,1231,691,1319,240,1364,1854,88,F
1853,CG,709,18,1337,750,1315,1854,628,C
1853,BG,338,338,1675,405,1720,1854,1337,B
1853,CG,752,396,2071,780,2144,1854,1319,G
1853,CH,760,364,2435,450,2170,1854,1675,C
1853,DH,320,320,2755,1140,3310,1854,2435,D
1853,H,2401,1717,4472,7680,9824,1854,2071,H
1853,M,400,400,4872,2006,11830,1854,4472,M
1853,N,2076,2076,6948,540,12370,1854,4872,N
1853,O,548,548,7496,845,13215,1854,6948,O
1853,N,1542,1542,9038,1315,14530,1854,7496,N
1853,O,1684,1684,10722,1818,16348,1854,9038,O
1853,P,574,574,11296,417,16765,1854,10722,P
1854,A,1059,1059,1059,1419,1419,1855,0,A
1854,B,596,596,1655,300,1719,1855,1059,B
1854,C,730,730,2385,820,2539,1855,1655,C
1854,B,1149,1149,3534,1115,3654,1855,2385,B
1854,C,397,397,3931,630,4284,1855,3534,C
1854,D,15437,15437,19368,6060,10344,1855,3931,D
1854,M,3412,3412,22780,3292,13636,1855,19368,M
1854,N,19,19,22799,180,13816,1855,22780,N
1854,O,696,696,23495,830,14646,1855,22799,O
1854,N,880,880,24375,765,15411,1855,23495,N
1854,O,610,610,24985,710,16121,1855,24375,O
1854,P,2629,2629,27614,6960,23081,1855,24985,P
1855,AEI,37,37,37,804,804,1856,0,A
1855,BEI,712,675,712,791,791,1856,0,E
1855,BFI,877,165,877,1028,1028,1856,0,I
1855,BFJ,262,97,974,180,971,1856,712,F
1855,BGJ,943,6,980,240,1044,1856,37,B
1855,CGJ,66,60,1040,665,1636,1856,974,G
1855,CHJ,554,494,1534,740,1784,1856,980,C
1855,DHJ,1051,394,1928,180,1208,1856,877,J
1855,DHK,304,304,2232,665,1873,1856,1928,K
1855,DHL,9384,8686,10918,5100,6884,1856,1534,D
1855,HL,88353,78475,89393,6900,8536,1856,1040,H
1855,L,123349,36188,125581,6900,8773,1856,2232,L
1855,M,2226,2226,127807,3726,12499,1856,125581,M
1855,N,1540,1540,129347,90,12589,1856,127807,N
1855,O,657,657,130004,805,13394,1856,129347,O
1855,N,662,662,130666,525,13919,1856,130004,N
1855,O,1205,1205,131871,965,14884,1856,130666,O
1855,P,581,581,132452,3780,18664,1856,131871,P
1856,AE,365,365,365,1305,1305,1857,0,A
1856,BE,1060,1060,1425,180,1485,1857,365,B
1856,CE,1680,255,1680,2462,2462,1857,0,E
1856,CF,1032,777,2457,1055,2540,1857,1425,C
1856,BF,1063,286,2743,300,2762,1857,1680,F
1856,BG,667,381,3124,630,3170,1857,2457,B
1856,CG,154,154,3278,205,3375,1857,3124,C
1856,DG,181,181,3459,5220,8595,1857,3278,D
1856,G,945,229,3688,1050,3812,1857,2743,G
1856,F,360,360,4048,350,4162,1857,3688,F
1856,G,507,507,4555,510,4672,1857,4048,G
1856,H,1385,1385,5940,3960,8632,1857,4555,H
1856,M,5818,5818,11758,6635,15267,1857,5940,M
1856,N,832,832,12590,90,15357,1857,11758,N
1856,O,1263,1263,13853,1385,16742,1857,12590,O
1856,N,1312,1312,15165,1175,17917,1857,13853,N
1856,O,144,144,15309,585,18502,1857,15165,O
1856,P,219,219,15528,3780,22282,1857,15309,P
1857,A,1076,1076,1076,1250,1250,1858,0,A
1857,B,473,473,1549,120,1370,1858,1076,B
1857,C,1247,1247,2796,990,2360,1858,1549,C
1857,D,265,265,3061,550,2910,1858,2796,D
1857,M,286,286,3347,597,3507,1858,3061,M
1857,N,460,460,3807,180,3687,1858,3347,N
1857,O,1065,1065,4872,830,4517,1858,3807,O
1857,P,326,326,5198,6680,11197,1858,4872,P
1858,AEI,108,108,108,280,280,1859,0,I
1858,AEJ,292,184,292,1207,1207,1859,0,A
1858,BEJ,302,118,410,150,430,1859,108,J
1858,BEK,597,187,597,530,530,1859,0,E
1858,BFK,283,96,693,255,685,1859,410,K
1858,BFL,113,17,710,240,770,1859,597,F
1858,BGL,1035,617,1327,180,1387,1859,292,B
1858,CGL,879,245,1572,2880,3565,1859,693,L
1858,CG,923,61,1633,1020,1790,1859,710,G
1858,CF,344,344,1977,210,2000,1859,1633,F
1858,CG,897,247,2224,1050,2437,1859,1327,C
1858,BG,876,629,2853,755,2755,1859,1977,G
1858,BH,781,152,3005,625,3062,1859,2224,B
1858,CH,241,241,3246,380,3442,1859,3005,C
1858,DH,1247,1247,4493,5460,8902,1859,3246,D
1858,H,2837,1197,5690,1140,3895,1859,2853,H
1858,M,2136,2136,7826,2332,11234,1859,5690,M
1858,N,449,449,8275,300,11534,1859,7826,N
1858,O,1027,1027,9302,775,12309,1859,8275,O
1858,P,49,49,9351,4080,16389,1859,9302,P
1859,AEI,161,161,161,1475,1475,1860,0,I
1859,AEJ,875,714,875,1676,1676,1860,0,A
1859,BEJ,1344,630,1505,90,1565,1860,161,J
1859,BEK,828,198,1703,90,1766,1860,875,B
1859,CEK,1027,829,2532,1225,2790,1860,1505,K
1859,CEL,9,9,2541,3780,6570,1860,2532,L
1859,CE,875,37,2578,1250,3016,1860,1703,C
1859,DE,13,13,2591,3780,6796,1860,2578,D
1859,E,6178,3587,6178,7199,7199,1860,0,E
1859,F,1050,1050,7228,90,7289,1860,6178,F
1859,G,1383,1383,8611,1635,8924,1860,7228,G
1859,H,647,647,9258,3780,12704,1860,8611,H
1859,M,3131,3131,12389,4449,17153,1860,9258,M
1859,N,1348,1348,13737,90,17243,1860,12389,N
1859,O,441,441,14178,860,18103,1860,13737,O
1859,P,585,585,14763,3780,21883,1860,14178,P
1860,AEI,70,70,70,133,133,1861,0,I
1860,AEJ,205,135,205,490,490,1861,0,A
1860,BEJ,141,6,211,135,268,1861,70,J
1860,BEK,236,25,236,254,254,1861,0,E
1860,BFK,187,162,398,285,553,1861,211,K
1860,BFL,210,48,446,240,494,1861,236,F
1860,BGL,136,88,534,5160,5713,1861,398,L
1860,BG,548,219,753,300,790,1861,205,B
1860,CG,644,337,1090,770,1264,1861,446,G
1860,CF,488,151,1241,640,1430,1861,753,C
1860,DF,223,72,1313,100,1364,1861,1090,F
1860,DG,104,104,1417,390,1754,1861,1313,G
1860,DH,411,411,1828,3960,5714,1861,1417,H
1860,D,2875,2288,4116,1620,3050,1861,1241,D
1860,M,866,866,4982,1214,6928,1861,4116,M
1860,N,398,398,5380,90,7018,1861,4982,N
1860,O,887,887,6267,1250,8268,1861,5380,O
1860,P,168,168,6435,3780,12048,1861,6267,P
1861,AE,7576,7576,7576,8543,8543,1862,0,A
1861,BE,8512,936,8512,8657,8657,1862,0,E
1861,BF,1007,71,8583,90,8633,1862,7576,B
1861,CF,166,95,8678,90,8747,1862,8512,F
1861,CG,742,742,9420,1105,9852,1862,8678,G
1861,CH,938,101,9521,1240,9873,1862,8583,C
1861,DH,466,365,9886,3780,13632,1862,9420,H
1861,D,1808,1443,11329,3780,13653,1862,9521,D
1861,M,1469,1469,12798,1986,15639,1862,11329,M
1861,N,562,562,13360,90,15729,1862,12798,N
1861,O,900,900,14260,1240,16969,1862,13360,O
1861,P,54,54,14314,3780,20749,1862,14260,P
1862,AE,20,20,20,618,618,1863,0,E
1862,AF,115,95,115,369,369,1863,0,A
1862,BF,486,486,601,240,609,1863,115,B
1862,CF,709,128,729,150,768,1863,20,F
1862,CG,147,19,748,215,824,1863,601,C
1862,DG,153,134,882,195,963,1863,729,G
1862,DH,231,231,1113,4170,5133,1863,882,H
1862,D,1080,715,1828,4890,5714,1863,748,D
1862,M,31,31,1859,115,5829,1863,1828,M
1862,N,296,296,2155,240,6069,1863,1859,N
1862,O,671,671,2826,960,7029,1863,2155,O
1862,P,132,132,2958,3960,10989,1863,2826,P
1863,A,191,191,191,176,176,1864,0,A
1863,B,74,74,265,150,326,1864,191,B
1863,C,169,169,434,130,456,1864,265,C
1863,B,914,914,1348,930,1386,1864,434,B
1863,C,329,329,1677,645,2031,1864,1348,C
1863,D,4665,4665,6342,4230,6261,1864,1677,D
1863,M,2719,2719,9061,3129,9390,1864,6342,M
1863,N,440,440,9501,90,9480,1864,9061,N
1863,O,1739,1739,11240,1940,11420,1864,9501,O
1863,P,105,105,11345,3780,15200,1864,11240,P
1864,AE,57,57,57,125,125,1865,0,E
1864,AF,269,269,326,240,365,1865,57,F
1864,AG,681,681,1007,960,1325,1865,326,G
1864,AH,217,217,1224,3960,5285,1865,1007,H
1864,A,1501,277,1501,3212,3212,1865,0,A
1864,B,1664,1664,3165,90,3302,1865,1501,B
1864,C,1200,1200,4365,1365,4667,1865,3165,C
1864,B,1487,1487,5852,1225,5892,1865,4365,B
1864,C,480,480,6332,880,6772,1865,5852,C
1864,D,3428,3428,9760,3780,10552,1865,6332,D
1864,M,55,55,9815,926,11478,1865,9760,M
1864,N,991,991,10806,180,11658,1865,9815,N
1864,O,998,998,11804,1050,12708,1865,10806,O
1864,N,684,684,12488,625,13333,1865,11804,N
1864,O,275,275,12763,380,13713,1865,12488,O
1864,P,1377,1377,14140,5460,19173,1865,12763,P
1865,A,852,852,852,1187,1187,1866,0,A
1865,B,360,360,1212,90,1277,1866,852,B
1865,C,566,566,1778,815,2092,1866,1212,C
1865,B,1527,1527,3305,1075,3167,1866,1778,B
1865,C,1272,1272,4577,1790,4957,1866,3305,C
1865,D,869,869,5446,3780,8737,1866,4577,D
1865,M,8778,8778,14224,8670,17407,1866,5446,M
1865,N,326,326,14550,300,17707,1866,14224,N
1865,O,855,855,15405,1005,18712,1866,14550,O
1865,P,525,525,15930,1200,19912,1866,15405,P
1866,AE,25,25,25,15,15,1867,0,A
1866,BE,370,370,395,480,495,1867,25,B
1866,CE,696,696,1091,720,1215,1867,395,C
1866,DE,3282,3282,4373,550,1765,1867,1091,D
1866,E,8693,4320,8693,9081,9081,1867,0,E
1866,F,793,793,9486,420,9501,1867,8693,F
1866,G,998,998,10484,970,10471,1867,9486,G
1866,H,1955,1955,12439,550,11021,1867,10484,H
1866,M,595,595,13034,2874,13895,1867,12439,M
1866,N,2300,2300,15334,90,13985,1867,13034,N
1866,O,1005,1005,16339,1195,15180,1867,15334,O
1866,N,757,757,17096,560,15740,1867,16339,N
1866,O,698,698,17794,890,16630,1867,17096,O
1866,P,1174,1174,18968,3780,20410,1867,17794,P
1867,AEI,147,147,147,719,719,1868,0,I
1867,AEJ,246,99,246,482,482,1868,0,E
1867,AFJ,559,313,559,1430,1430,1868,0,A
1867,BFJ,414,101,660,240,722,1868,246,F
1867,BGJ,728,215,875,240,959,1868,147,J
1867,BGK,598,383,1258,695,1417,1868,660,G
1867,BFK,447,64,1322,390,1349,1868,875,K
1867,BFJ,274,210,1532,145,1562,1868,1258,F
1867,BGJ,1116,143,1675,300,1730,1868,559,B
1867,CGJ,522,169,1844,555,1904,1868,1322,J
1867,CGK,667,355,2199,785,2347,1868,1532,G
1867,CHK,647,292,2491,1080,2984,1868,1844,K
1867,CHL,932,116,2607,760,2490,1868,1675,C
1867,DHL,2993,2585,5192,3960,6307,1868,2199,H
1867,DL,3552,851,6043,290,3274,1868,2491,L
1867,D,8078,4642,10685,1140,3630,1868,2607,D
1867,M,155,155,10840,293,6600,1868,10685,M
1867,N,391,391,11231,300,6900,1868,10840,N
1867,O,693,693,11924,775,7675,1868,11231,O
1867,N,1160,1160,13084,1085,8760,1868,11924,N
1867,O,509,509,13593,740,9500,1868,13084,O
1867,P,12298,12298,25891,5100,14600,1868,13593,P
1868,AEI,42,42,42,232,232,1869,0,I
1868,AEJ,46,4,46,59,59,1869,0,A
1868,BEJ,94,48,94,175,175,1869,0,E
1868,BFJ,102,54,148,150,209,1869,46,B
1868,CFJ,150,150,298,130,339,1869,148,C
1868,DFJ,241,37,335,150,325,1869,94,F
1868,DGJ,377,84,419,240,472,1869,42,J
1868,DGK,260,176,595,450,775,1869,335,G
1868,DFK,196,20,615,260,732,1869,419,K
1868,DFL,318,1,616,2850,3189,1869,298,D
1868,FL,170,149,765,50,825,1869,595,F
1868,GL,119,119,884,135,960,1869,765,G
1868,HL,407,407,1291,2850,3810,1869,884,H
1868,L,1036,360,1651,5160,5892,1869,615,L
1868,M,387,387,2038,841,6733,1869,1651,M
1868,N,564,564,2602,150,6883,1869,2038,N
1868,O,244,244,2846,165,7048,1869,2602,O
1868,N,126,126,2972,215,7263,1869,2846,N
1868,O,564,564,3536,545,7808,1869,2972,O
1868,P,2629,2629,6165,4230,12038,1869,3536,P
1869,AE,26,26,26,1095,1095,1870,0,E
1869,AF,59,33,59,1124,1124,1870,0,A
1869,BF,1261,1228,1287,240,1335,1870,26,F
1869,BG,1250,22,1309,240,1364,1870,59,B
1869,CG,723,723,2032,760,2124,1870,1309,C
1869,DG,800,55,2087,760,2095,1870,1287,G
1869,DH,785,730,2817,7680,9804,1870,2032,D
1869,H,1186,456,3273,7680,9775,1870,2087,H
1869,M,276,276,3549,305,10109,1870,3273,M
1869,N,305,305,3854,300,10409,1870,3549,N
1869,O,493,493,4347,665,11074,1870,3854,O
1869,P,299,299,4646,4020,15094,1870,4347,P
1870,AEI,289,289,289,289,289,1871,0,I
1870,AEJ,187,187,476,240,529,1871,289,J
1870,AEK,587,111,587,840,840,1871,0,E
1870,AFK,199,88,675,240,769,1871,476,K
1870,AFL,282,194,869,90,930,1871,587,F
1870,AGL,532,338,1207,5250,6019,1871,675,L
1870,AG,816,478,1685,1240,2170,1871,869,G
1870,AH,1696,11,1696,2238,2238,1871,0,A
1870,BH,672,672,2368,180,2418,1871,1696,B
1870,CH,732,732,3100,670,3088,1871,2368,C
1870,DH,1623,208,3308,3780,5950,1871,1685,H
1870,D,3333,3125,6433,550,3638,1871,3100,D
1870,M,2807,2807,9240,2956,8975,1871,6433,M
1870,N,1114,1114,10354,780,9755,1871,9240,N
1870,O,733,733,11087,1382,11137,1871,10354,O
1870,P,851,851,11938,713,11850,1871,11087,P
1871,AE,68,68,68,160,160,1872,0,E
1871,AF,275,275,343,240,400,1872,68,F
1871,AG,250,250,593,215,615,1872,343,G
1871,AH,630,630,1223,4890,5505,1872,593,H
1871,A,5550,4327,5550,6831,6831,1872,0,A
1871,B,1311,1311,6861,90,6921,1872,5550,B
1871,C,950,950,7811,1095,8016,1872,6861,C
1871,D,159,159,7970,3780,11796,1872,7811,D
1871,M,133,133,8103,770,12566,1872,7970,M
1871,N,761,761,8864,180,12746,1872,8103,N
1871,O,195,195,9059,265,13011,1872,8864,O
1871,N,287,287,9346,215,13226,1872,9059,N
1871,O,209,209,9555,225,13451,1872,9346,O
1871,P,1357,1357,10912,4740,18191,1872,9555,P
1872,A,730,730,730,1183,1183,1873,0,A
1872,B,516,516,1246,90,1273,1873,730,B
1872,C,998,998,2244,1250,2523,1873,1246,C
1872,D,2020,2020,4264,3780,6303,1873,2244,D
1872,M,3546,3546,7810,4247,10550,1873,4264,M
1872,N,733,733,8543,90,10640,1873,7810,N
1872,O,103,103,8646,585,11225,1873,8543,O
1872,P,11542,11542,20188,3780,15005,1873,8646,P
1873,A,38,38,38,2141,2141,1874,0,A
1873,B,2131,2131,2169,90,2231,1874,38,B
1873,C,468,468,2637,825,3056,1874,2169,C
1873,B,416,416,3053,50,3106,1874,2637,B
1873,C,959,959,4012,1425,4531,1874,3053,C
1873,D,1261,1261,5273,3780,8311,1874,4012,D
1873,M,138,138,5411,325,8636,1874,5273,M
1873,N,422,422,5833,300,8936,1874,5411,N
1873,O,725,725,6558,985,9921,1874,5833,O
1873,N,910,910,7468,635,10556,1874,6558,N
1873,O,25,25,7493,415,10971,1874,7468,O
1873,P,10410,10410,17903,6060,17031,1874,7493,P
1874,AEI,188,188,188,240,240,1875,0,E
1874,AFI,251,251,439,240,480,1875,188,F
1874,AGI,540,101,540,1689,1689,1875,0,I
1874,AGJ,708,607,1147,970,1450,1875,439,G
1874,AHJ,1440,293,1440,1790,1790,1875,0,A
1874,BHJ,370,370,1810,90,1880,1875,1440,B
1874,CHJ,1347,77,1887,240,1929,1875,540,J
1874,CHK,985,245,2132,3960,5410,1875,1147,H
1874,CK,708,463,2595,970,2899,1875,1887,K
1874,CL,1145,360,2955,1540,3420,1875,1810,C
1874,DL,371,371,3326,3780,7200,1875,2955,D
1874,L,973,242,3568,3960,6859,1875,2595,L
1874,M,612,612,4180,3179,10379,1875,3568,M
1874,N,2599,2599,6779,90,10469,1875,4180,N
1874,O,368,368,7147,700,11169,1875,6779,O
1874,N,1110,1110,8257,755,11924,1875,7147,N
1874,O,466,466,8723,945,12869,1875,8257,O
1874,P,600,600,9323,3780,16649,1875,8723,P
1875,AEI,280,280,280,1270,1270,1876,0,A
1875,BEI,1020,1020,1300,90,1360,1876,280,B
1875,CEI,1425,125,1425,1840,1840,1876,0,E
1875,CFI,446,446,1871,90,1930,1876,1425,F
1875,CGI,973,402,2273,1210,2570,1876,1300,C
1875,DGI,15,15,2288,3780,6350,1876,2273,D
1875,GI,1467,1050,3338,1745,3675,1876,1871,G
1875,HI,76,76,3414,3780,7455,1876,3338,H
1875,I,25665,22251,25665,26096,26096,1876,0,I
1875,J,473,473,26138,90,26186,1876,25665,J
1875,K,1675,1675,27813,1880,28066,1876,26138,K
1875,L,343,343,28156,3780,31846,1876,27813,L
1875,M,696,696,28852,1098,32944,1876,28156,M
1875,N,433,433,29285,90,33034,1876,28852,N
1875,O,257,257,29542,625,33659,1876,29285,O
1875,P,2007,2007,31549,3780,37439,1876,29542,P
1876,AEI,75,75,75,129,129,1877,0,A
1876,BEI,160,85,160,275,275,1877,0,E
1876,BFI,144,59,219,150,279,1877,75,B
1876,CFI,125,66,285,120,395,1877,160,F
1876,CGI,92,26,311,110,389,1877,219,C
1876,BGI,267,241,552,390,785,1877,285,G
1876,BFI,393,152,704,375,764,1877,311,B
1876,CFI,460,460,1164,465,1229,1877,704,C
1876,DFI,629,17,1181,450,1235,1877,552,F
1876,DGI,1444,263,1444,2527,2527,1877,0,I
1876,DGJ,417,137,1581,5760,6989,1877,1164,D
1876,GJ,592,192,1773,470,1705,1877,1181,G
1876,HJ,1143,814,2587,180,2707,1877,1444,J
1876,HK,147,147,2734,130,2837,1877,2587,K
1876,HJ,557,557,3291,500,3337,1877,2734,J
1876,HK,408,408,3699,465,3802,1877,3291,K
1876,HL,3584,1658,5357,5760,7465,1877,1773,H
1876,L,1877,219,5576,5760,9562,1877,3699,L
1876,M,782,782,6358,909,10471,1877,5576,M
1876,N,326,326,6684,240,10711,1877,6358,N
1876,O,1578,1578,8262,585,11296,1877,6684,O
1876,N,313,313,8575,1300,12596,1877,8262,N
1876,O,1109,1109,9684,1295,13891,1877,8575,O
1876,P,1983,1983,11667,3660,17551,1877,9684,P
1877,AEI,57,57,57,115,115,1878,0,I
1877,AEJ,66,9,66,788,788,1878,0,E
1877,AFJ,83,17,83,297,297,1878,0,A
1877,BFJ,167,141,224,135,250,1878,57,J
1877,BFK,176,176,400,295,545,1878,224,K
1877,BFL,418,101,501,240,537,1878,83,B
1877,CFL,111,10,511,5100,5645,1878,400,L
1877,CF,275,265,776,295,832,1878,501,C
1877,DF,30,30,806,5220,6052,1878,776,D
1877,F,800,60,866,135,923,1878,66,F
1877,G,182,182,1048,300,1223,1878,866,G
1877,H,54,54,1102,5100,6323,1878,1048,H
1877,M,673,673,1775,1213,7536,1878,1102,M
1877,N,690,690,2465,180,7716,1878,1775,N
1877,O,822,822,3287,895,8611,1878,2465,O
1877,N,339,339,3626,285,8896,1878,3287,N
1877,O,331,331,3957,315,9211,1878,3626,O
1877,P,10091,10091,14048,6900,16111,1878,3957,P
1878,AE,1179,1179,1179,1664,1664,1879,0,E
1878,AF,1303,124,1303,1438,1438,1879,0,A
1878,BF,333,333,1636,240,1678,1879,1303,B
1878,CF,643,186,1822,180,1844,1879,1179,F
1878,CG,878,692,2514,915,2593,1879,1636,C
1878,BG,798,106,2620,831,2675,1879,1822,G
1878,BH,513,407,3027,555,3148,1879,2514,B
1878,CH,546,139,3166,4080,6755,1879,2620,H
1878,C,637,498,3664,810,3958,1879,3027,C
1878,D,4911,4911,8575,3960,7918,1879,3664,D
1878,M,162,162,8737,703,8621,1879,8575,M
1878,N,1390,1390,10127,420,9041,1879,8737,N
1878,O,1198,1198,11325,1410,10451,1879,10127,O
1878,P,2729,2729,14054,320,10771,1879,11325,P
1879,A,200,200,200,159,159,1880,0,A
1879,B,34,34,234,300,459,1880,200,B
1879,C,1047,1047,1281,690,1149,1880,234,C
1879,B,228,228,1509,390,1539,1880,1281,B
1879,C,591,591,2100,750,2289,1880,1509,C
1879,D,362,362,2462,3960,6249,1880,2100,D
1879,M,487,487,2949,1035,7284,1880,2462,M
1879,N,924,924,3873,420,7704,1880,2949,N
1879,O,781,781,4654,942,8646,1880,3873,O
1879,P,173,173,4827,318,8964,1880,4654,P
1880,AEI,1,1,1,324,324,1881,0,E
1880,AFI,65,64,65,1843,1843,1881,0,A
1880,BFI,467,403,468,180,504,1881,1,F
1880,BGI,664,196,664,1304,1304,1881,0,I
1880,BGJ,899,703,1367,1160,1664,1881,468,G
1880,BHJ,841,138,1505,120,1424,1881,664,J
1880,BHK,2030,590,2095,300,2143,1881,65,B
1880,CHK,737,9,2104,960,2624,1881,1367,H
1880,CK,978,379,2483,920,2344,1881,1505,K
1880,CL,921,533,3016,895,3038,1881,2095,C
1880,DL,630,630,3646,550,3588,1881,3016,D
1880,L,1810,647,4293,385,2729,1881,2483,L
1880,M,17787,17787,22080,17944,21532,1881,4293,M
1880,N,377,377,22457,150,21682,1881,22080,N
1880,O,1178,1178,23635,380,22062,1881,22457,O
1880,P,649,649,24284,660,22722,1881,23635,P
1881,AEI,35,35,35,436,436,1882,0,A
1881,BEI,46,11,46,131,131,1882,0,E
1881,BFI,157,157,203,135,266,1882,46,F
1881,BGI,225,22,225,323,323,1882,0,I
1881,BGJ,203,181,406,215,481,1882,203,G
1881,BHJ,8,8,414,4890,5371,1882,406,H
1881,BJ,200,11,425,150,473,1882,225,J
1881,BK,169,169,594,155,628,1882,425,K
1881,BL,598,39,633,240,676,1882,35,B
1881,CL,628,628,1261,845,1521,1882,633,C
1881,DL,987,320,1581,4200,4828,1882,594,L
1881,D,4346,4026,5607,3960,5481,1882,1261,D
1881,M,1089,1089,6696,1893,7374,1882,5607,M
1881,N,944,944,7640,90,7464,1882,6696,N
1881,O,1259,1259,8899,1415,8879,1882,7640,O
1881,N,677,677,9576,595,9474,1882,8899,N
1881,O,582,582,10158,940,10414,1882,9576,O
1881,P,866,866,11024,3780,14194,1882,10158,P
1882,A,199,199,199,907,907,1883,0,A
1882,B,742,742,941,90,997,1883,199,B
1882,C,402,402,1343,795,1792,1883,941,C
1882,D,1325,1325,2668,3780,5572,1883,1343,D
1882,M,2153,2153,4821,2358,7930,1883,2668,M
1882,N,260,260,5081,90,8020,1883,4821,N
1882,O,499,499,5580,795,8815,1883,5081,O
1882,N,1032,1032,6612,735,9550,1883,5580,N
1882,O,507,507,7119,735,10285,1883,6612,O
1882,P,5817,5817,12936,3780,14065,1883,7119,P
1883,AEI,8,8,8,850,850,1884,0,A
1883,BEI,1124,1124,1132,240,1090,1884,8,B
1883,CEI,745,745,1877,1040,2130,1884,1132,C
1883,DEI,2212,335,2212,1931,1931,1884,0,E
1883,DFI,2,2,2214,240,2171,1884,2212,F
1883,DGI,2772,558,2772,2730,2730,1884,0,I
1883,DGJ,1037,142,2914,3960,6090,1884,1877,D
1883,GJ,236,94,3008,300,3030,1884,2772,J
1883,GK,1115,321,3329,995,3166,1884,2214,G
1883,HK,815,494,3823,970,4000,1884,3008,K
1883,HL,621,127,3950,3960,7126,1884,3329,H
1883,L,843,716,4666,4020,8020,1884,3823,L
1883,M,13325,13325,17991,14281,22301,1884,4666,M
1883,N,1071,1071,19062,90,22391,1884,17991,N
1883,O,384,384,19446,865,23256,1884,19062,O
1883,P,133,133,19579,3780,27036,1884,19446,P
1884,AE,147,147,147,164,164,1885,0,E
1884,AF,119,119,266,150,314,1885,147,F
1884,AG,146,146,412,135,449,1885,266,G
1884,AH,6,6,418,4230,4679,1885,412,H
1884,A,1200,782,1200,1329,1329,1885,0,A
1884,B,319,319,1519,240,1569,1885,1200,B
1884,C,173,173,1692,260,1829,1885,1519,C
1884,D,818,818,2510,5160,6989,1885,1692,D
1884,M,208,208,2718,841,7830,1885,2510,M
1884,N,734,734,3452,150,7980,1885,2718,N
1884,O,230,230,3682,425,8405,1885,3452,O
1884,N,266,266,3948,65,8470,1885,3682,N
1884,O,652,652,4600,735,9205,1885,3948,O
1884,P,18912,18912,23512,4230,13435,1885,4600,P
1885,A,1007,1007,1007,1366,1366,1886,0,A
1885,B,451,451,1458,150,1516,1886,1007,B
1885,C,205,205,1663,280,1796,1886,1458,C
1885,D,924,924,2587,5160,6956,1886,1663,D
1885,M,3200,3200,5787,6352,13308,1886,2587,M
1885,N,3182,3182,8969,90,13398,1886,5787,N
1885,O,1468,1468,10437,1630,15028,1886,8969,O
1885,P,1690,1690,12127,3780,18808,1886,10437,P
1886,A,40,40,40,805,805,1887,0,A
1886,B,857,857,897,150,955,1887,40,B
1886,C,164,164,1061,150,1105,1887,897,C
1886,D,187,187,1248,4200,5305,1887,1061,D
1886,M,9131,9131,10379,10279,15584,1887,1248,M
1886,N,1273,1273,11652,90,15674,1887,10379,N
1886,O,1133,1133,12785,1590,17264,1887,11652,O
1886,N,903,903,13688,505,17769,1887,12785,N
1886,O,81,81,13769,585,18354,1887,13688,O
1886,P,209,209,13978,3780,22134,1887,13769,P
1887,AEI,439,439,439,677,677,1888,0,E
1887,AFI,354,354,793,150,827,1888,439,F
1887,AGI,1317,524,1317,1940,1940,1888,0,I
1887,AGJ,827,303,1620,870,1697,1888,793,G
1887,AHJ,328,328,1948,4200,5897,1888,1620,H
1887,AJ,700,69,2017,90,2030,1888,1317,J
1887,AK,2600,583,2600,2847,2847,1888,0,A
1887,BK,962,379,2979,1310,3340,1888,2017,K
1887,BL,389,10,2989,180,3027,1888,2600,B
1887,CL,642,642,3631,675,3702,1888,2989,C
1887,DL,364,364,3995,4140,7842,1888,3631,D
1887,L,4516,3500,7495,3780,7120,1888,2979,L
1887,M,1030,1030,8525,1283,9125,1888,7495,M
1887,N,461,461,8986,240,9365,1888,8525,N
1887,O,628,628,9614,920,10285,1888,8986,O
1887,P,6119,6119,15733,3960,14245,1888,9614,P
1888,A,121,121,121,123,123,1889,0,A
1888,B,95,95,216,150,273,1889,121,B
1888,C,296,296,512,495,768,1889,216,C
1888,D,205,205,717,1200,1968,1889,512,D
1888,M,496,496,1213,723,2691,1889,717,M
1888,N,432,432,1645,240,2931,1889,1213,N
1888,O,340,340,1985,845,3776,1889,1645,O
1888,P,469,469,2454,3720,7496,1889,1985,P
1889,A,2132,2132,2132,3189,3189,1890,0,A
1889,B,1217,1217,3349,180,3369,1890,2132,B
1889,C,560,560,3909,885,4254,1890,3349,C
1889,B,309,309,4218,20,4274,1890,3909,B
1889,C,769,769,4987,810,5084,1890,4218,C
1889,D,2948,2948,7935,6600,11684,1890,4987,D
1889,M,5,5,7940,267,11951,1890,7935,M
1889,N,336,336,8276,120,12071,1890,7940,N
1889,O,725,725,9001,760,12831,1890,8276,O
1889,P,570,570,9571,385,13216,1890,9001,P
1890,A,1422,1422,1422,3637,3637,1891,0,A
1890,B,2264,2264,3686,90,3727,1891,1422,B
1890,C,690,690,4376,1040,4767,1891,3686,C
1890,D,706,706,5082,3780,8547,1891,4376,D
1890,M,5096,5096,10178,7348,15895,1891,5082,M
1890,N,2283,2283,12461,90,15985,1891,10178,N
1890,O,533,533,12994,1035,17020,1891,12461,O
1890,P,11573,11573,24567,3780,20800,1891,12994,P
1891,AEI,162,162,162,2643,2643,1892,0,E
1891,AFI,816,654,816,1301,1301,1892,0,I
1891,AFJ,534,534,1350,90,1391,1892,816,J
1891,AFK,207,207,1557,625,2016,1892,1350,K
1891,AFL,1609,52,1609,2318,2318,1892,0,A
1891,BFL,484,432,2041,3780,5796,1892,1557,L
1891,BF,734,302,2343,90,2408,1892,1609,B
1891,CF,216,216,2559,625,3033,1892,2343,C
1891,DF,2509,112,2671,90,2733,1892,162,F
1891,DG,1072,1072,3743,1220,3953,1892,2671,G
1891,DF,462,462,4205,275,4228,1892,3743,F
1891,DG,228,228,4433,625,4853,1892,4205,G
1891,DH,3996,3996,8429,3780,8633,1892,4433,H
1891,D,6439,569,8998,3780,6813,1892,2559,D
1891,M,2725,2725,11723,4027,12660,1892,8998,M
1891,N,1345,1345,13068,90,12750,1892,11723,N
1891,O,277,277,13345,625,13375,1892,13068,O
1891,N,526,526,13871,165,13540,1892,13345,N
1891,O,630,630,14501,890,14430,1892,13871,O
1891,P,104,104,14605,3780,18210,1892,14501,P
1892,A,624,624,624,840,840,1893,0,A
1892,B,730,730,1354,360,1200,1893,624,B
1892,C,740,740,2094,870,2070,1893,1354,C
1892,D,21,21,2115,3450,5520,1893,2094,D
1892,M,66,66,2181,215,5735,1893,2115,M
1892,N,406,406,2587,300,6035,1893,2181,N
1892,O,805,805,3392,795,6830,1893,2587,O
1892,P,1205,1205,4597,1140,7970,1893,3392,P
1893,AEI,144,144,144,1815,1815,1894,0,A
1893,BEI,165,21,165,320,320,1894,0,E
1893,BFI,277,277,442,180,500,1894,165,F
1893,BGI,1003,1003,1445,935,1435,1894,442,G
1893,BHI,1498,53,1498,1834,1834,1894,0,I
1893,BHJ,1848,494,1992,240,2055,1894,144,B
1893,CHJ,504,10,2002,230,2064,1894,1498,J
1893,CHK,602,602,2604,575,2639,1894,2002,K
1893,CHL,1142,530,3134,1140,3195,1894,1992,C
1893,DHL,173,173,3307,550,3745,1894,3134,D
1893,HL,1344,641,3948,385,3024,1894,2604,L
1893,H,2833,330,4278,385,1820,1894,1445,H
1893,M,1407,1407,5685,7177,10922,1894,4278,M
1893,N,5837,5837,11522,90,11012,1894,5685,N
1893,O,875,875,12397,1195,12207,1894,11522,O
1893,N,348,348,12745,50,12257,1894,12397,N
1893,O,271,271,13016,585,12842,1894,12745,O
1893,P,5204,5204,18220,3780,16622,1894,13016,P
1894,AE,165,165,165,218,218,1895,0,E
1894,AF,141,141,306,150,368,1895,165,F
1894,AG,1049,1049,1355,620,988,1895,306,G
1894,AH,1358,3,1358,1441,1441,1895,0,A
1894,BH,150,147,1505,4200,5188,1895,1355,H
1894,B,306,159,1664,240,1681,1895,1358,B
1894,C,886,886,2550,850,2531,1895,1664,C
1894,D,7298,7298,9848,3960,6491,1895,2550,D
1894,M,520,520,10368,1746,8237,1895,9848,M
1894,N,1242,1242,11610,90,8327,1895,10368,N
1894,O,1364,1364,12974,1415,9742,1895,11610,O
1894,P,860,860,13834,3840,13582,1895,12974,P
1895,A,245,245,245,782,782,1896,0,A
1895,B,637,637,882,150,932,1896,245,B
1895,C,202,202,1084,115,1047,1896,882,C
1895,B,720,720,1804,795,1842,1896,1084,B
1895,C,738,738,2542,705,2547,1896,1804,C
1895,D,1019,1019,3561,4230,6777,1896,2542,D
1895,M,14698,14698,18259,15192,21969,1896,3561,M
1895,N,543,543,18802,90,22059,1896,18259,N
1895,O,432,432,19234,700,22759,1896,18802,O
1895,N,423,423,19657,140,22899,1896,19234,N
1895,O,551,551,20208,940,23839,1896,19657,O
1895,P,1080,1080,21288,3780,27619,1896,20208,P
1896,AEI,51,51,51,1185,1185,1897,0,E
1896,AFI,53,2,53,597,597,1897,0,I
1896,AFJ,308,255,308,397,397,1897,0,A
1896,BFJ,243,243,551,150,547,1897,308,B
1896,CFJ,681,183,734,180,777,1897,53,J
1896,CFK,544,361,1095,635,1182,1897,551,C
1896,DFK,1184,140,1235,165,1350,1897,51,F
1896,DGK,230,90,1325,4230,5412,1897,1095,D
1896,GK,1027,436,1761,830,1607,1897,734,K
1896,GJ,606,80,1841,825,2175,1897,1235,G
1896,HJ,216,136,1977,430,2037,1897,1761,J
1896,HK,349,213,2190,3960,6135,1897,1841,H
1896,K,590,377,2567,760,2797,1897,1977,K
1896,L,1546,1546,4113,1140,3937,1897,2567,L
1896,M,4115,4115,8228,4031,10166,1897,4113,M
1896,N,186,186,8414,330,10496,1897,8228,N
1896,O,767,767,9181,730,11226,1897,8414,O
1896,P,1077,1077,10258,550,11776,1897,9181,P
1897,AEI,21,21,21,66,66,1898,0,E
1897,AFI,78,57,78,162,162,1898,0,A
1897,BFI,137,59,137,234,234,1898,0,I
1897,BFJ,127,11,148,135,201,1898,21,F
1897,BGJ,173,103,251,135,297,1898,78,B
1897,CGJ,162,59,310,295,496,1898,148,G
1897,CHJ,208,35,345,135,369,1898,137,J
1897,CHK,234,140,485,290,587,1898,251,C
1897,DHK,77,77,562,5160,5747,1898,485,D
1897,HK,254,37,599,285,654,1898,345,K
1897,HL,357,68,667,5160,5656,1898,310,H
1897,L,121,53,720,5160,5814,1898,599,L
1897,M,782,782,1502,1411,7225,1898,720,M
1897,N,819,819,2321,180,7405,1898,1502,N
1897,O,130,130,2451,205,7610,1898,2321,O
1897,N,1368,1368,3819,1360,8970,1898,2451,N
1897,O,105,105,3924,215,9185,1898,3819,O
1897,P,1121,1121,5045,4140,13325,1898,3924,P
1898,A,102,102,102,210,210,1899,0,A
1898,B,379,379,481,300,510,1899,102,B
1898,C,476,476,957,695,1205,1899,481,C
1898,D,1624,1624,2581,3960,5165,1899,957,D
1898,M,1002,1002,3583,1523,6688,1899,2581,M
1898,N,569,569,4152,90,6778,1899,3583,N
1898,O,884,884,5036,1250,8028,1899,4152,O
1898,N,1017,1017,6053,670,8698,1899,5036,N
1898,O,508,508,6561,790,9488,1899,6053,O
1898,P,1106,1106,7667,3780,13268,1899,6561,P
1899,AEI,133,133,133,689,689,1900,0,I
1899,AEJ,201,68,201,630,630,1900,0,A
1899,BEJ,541,541,742,180,810,1900,201,B
1899,CEJ,735,126,868,240,929,1900,133,J
1899,CEK,243,117,985,205,1015,1900,742,C
1899,DEK,165,48,1033,260,1189,1900,868,K
1899,DEL,120,72,1105,2850,3865,1900,985,D
1899,EL,325,253,1358,5160,6349,1900,1033,L
1899,E,4466,3108,4466,4930,4930,1900,0,E
1899,F,671,671,5137,240,5170,1900,4466,F
1899,G,833,833,5970,970,6140,1900,5137,G
1899,F,215,215,6185,90,6230,1900,5970,F
1899,G,202,202,6387,360,6590,1900,6185,G
1899,H,5091,5091,11478,3960,10550,1900,6387,H
1899,M,73,73,11551,1268,11818,1900,11478,M
1899,N,1382,1382,12933,240,12058,1900,11551,N
1899,O,193,193,13126,325,12383,1900,12933,O
1899,N,1079,1079,14205,940,13323,1900,13126,N
1899,O,799,799,15004,930,14253,1900,14205,O
1899,P,35748,35748,50752,6990,21243,1900,15004,P
1900,AE,252,252,252,1917,1917,1901,0,A
1900,BE,1392,1140,1392,1535,1535,1901,0,E
1900,BF,343,343,1735,240,1775,1901,1392,F
1900,BG,1888,405,2140,240,2157,1901,252,B
1900,CG,1131,726,2866,1319,3094,1901,1735,G
1900,CF,804,78,2944,970,3127,1901,2140,C
1900,BF,860,860,3804,780,3907,1901,2944,B
1900,CF,1180,242,4046,1056,4150,1901,2866,F
1900,CG,413,171,4217,510,4417,1901,3804,C
1900,DG,60,60,4277,3960,8377,1901,4217,D
1900,G,374,143,4420,510,4660,1901,4046,G
1900,H,81,81,4501,3960,8620,1901,4420,H
1900,M,263,263,4764,691,9311,1901,4501,M
1900,N,579,579,5343,210,9521,1901,4764,N
1900,O,149,149,5492,255,9776,1901,5343,O
1900,N,2890,2890,8382,2765,12541,1901,5492,N
1900,O,703,703,9085,910,13451,1901,8382,O
1900,P,8030,8030,17115,5160,18611,1901,9085,P
1901,AEI,201,201,201,189,189,1902,0,E
1901,AFI,428,227,428,463,463,1902,0,I
1901,AFJ,228,1,429,300,489,1902,201,F
1901,AGJ,280,279,708,300,763,1902,428,J
1901,AGK,927,219,927,1195,1195,1902,0,A
1901,BGK,630,132,1059,690,1179,1902,429,G
1901,BFK,439,307,1366,180,1375,1902,927,B
1901,CFK,476,169,1535,390,1569,1902,1059,F
1901,CGK,1028,201,1736,935,1698,1902,708,K
1901,CGL,758,557,2293,720,2289,1902,1535,G
1901,CHL,941,14,2307,930,2305,1902,1366,C
1901,DHL,720,149,2456,550,2248,1902,1736,L
1901,DH,4991,4828,7284,3960,6249,1902,2293,H
1901,D,5098,121,7405,550,2855,1902,2307,D
1901,M,7668,7668,15073,10088,16337,1902,7405,M
1901,N,2487,2487,17560,90,16427,1902,15073,N
1901,O,898,898,18458,1195,17622,1902,17560,O
1901,N,828,828,19286,560,18182,1902,18458,N
1901,O,627,627,19913,890,19072,1902,19286,O
1901,P,60,60,19973,3780,22852,1902,19913,P
1902,AEI,72,72,72,505,505,1903,0,E
1902,AFI,484,412,484,1537,1537,1903,0,I
1902,AFJ,883,471,955,510,1015,1903,72,F
1902,AGJ,1520,565,1520,1674,1674,1903,0,A
1902,BGJ,1077,41,1561,90,1627,1903,484,J
1902,BGK,183,142,1703,90,1764,1903,1520,B
1902,CGK,880,132,1835,1258,2273,1903,955,G
1902,CHK,740,466,2301,1115,2742,1903,1561,K
1902,CHJ,816,218,2519,1105,2869,1903,1703,C
1902,BHJ,797,579,3098,420,3162,1903,2301,J
1902,BHK,407,407,3505,755,3917,1903,3098,K
1902,BHL,2438,1452,4957,2150,5019,1903,2519,B
1902,CHL,418,418,5375,765,5784,1903,4957,C
1902,DHL,2690,820,6195,3780,7697,1903,3505,L
1902,DH,5784,1424,7619,867,3140,1903,1835,H
1902,D,2329,85,7704,3780,9564,1903,5375,D
1902,M,1294,1294,8998,1366,10930,1903,7704,M
1902,N,324,324,9322,300,11230,1903,8998,N
1902,O,1572,1572,10894,1320,12550,1903,9322,O
1902,N,612,612,11506,755,13305,1903,10894,N
1902,O,587,587,12093,810,14115,1903,11506,O
1902,P,491,491,12584,3960,18075,1903,12093,P
1903,AEI,75,75,75,1076,1076,1904,0,I
1903,AEJ,161,86,161,1370,1370,1904,0,A
1903,BEJ,775,614,775,1000,1000,1904,0,E
1903,BFJ,1201,501,1276,240,1316,1904,75,J
1903,BFK,540,39,1315,360,1360,1904,775,F
1903,BGK,1392,238,1553,240,1610,1904,161,B
1903,CGK,521,283,1836,760,2120,1904,1315,G
1903,CHK,743,183,2019,760,2076,1904,1276,K
1903,CHL,37,37,2056,7680,9756,1904,2019,L
1903,CH,745,242,2298,780,2390,1904,1553,C
1903,DH,3109,2647,4945,1140,3260,1904,1836,H
1903,D,3778,1131,6076,7740,10130,1904,2298,D
1903,M,481,481,6557,65,10195,1904,6076,M
1903,N,1139,1139,7696,1620,11815,1904,6557,N
1903,O,655,655,8351,560,12375,1904,7696,O
1903,P,1672,1672,10023,3675,16050,1904,8351,P
1904,AEI,328,328,328,4550,4550,1905,0,I
1904,AEJ,237,237,565,260,4810,1905,328,J
1904,AEK,983,983,1548,1165,5975,1905,565,K
1904,AEL,1626,78,1626,1892,1892,1905,0,A
1904,BEL,299,299,1925,90,1982,1905,1626,B
1904,CEL,1127,1127,3052,1315,3297,1905,1925,C
1904,DEL,73,73,3125,3780,7077,1905,3052,D
1904,EL,2015,438,3563,600,6575,1905,1548,L
1904,E,11391,7828,11391,10033,10033,1905,0,E
1904,F,325,325,11716,180,10213,1905,11391,F
1904,G,743,743,12459,1290,11503,1905,11716,G
1904,H,380,380,12839,1800,13303,1905,12459,H
1904,M,13288,13288,26127,14167,27470,1905,12839,M
1904,N,919,919,27046,90,27560,1905,26127,N
1904,O,1001,1001,28047,1240,28800,1905,27046,O
1904,N,840,840,28887,605,29405,1905,28047,N
1904,O,725,725,29612,935,30340,1905,28887,O
1904,P,824,824,30436,3780,34120,1905,29612,P
1905,AEI,175,175,175,789,789,1906,0,A
1905,BEI,485,310,485,653,653,1906,0,E
1905,BFI,198,198,683,90,743,1906,485,F
1905,BGI,773,90,773,1204,1204,1906,0,I
1905,BGJ,715,117,890,150,939,1906,175,B
1905,CGJ,144,144,1034,120,1059,1906,890,C
1905,BGJ,469,208,1242,90,1294,1906,773,J
1905,BGK,594,35,1277,820,1563,1906,683,G
1905,BHK,71,71,1348,3780,5343,1906,1277,H
1905,BK,729,415,1763,745,1804,1906,1034,B
1905,CK,1176,655,2418,1250,2544,1906,1242,K
1905,CL,828,173,2591,775,2579,1906,1763,C
1905,DL,95,95,2686,4230,6809,1906,2591,D
1905,L,416,148,2834,3780,6324,1906,2418,L
1905,M,703,703,3537,1342,8151,1906,2834,M
1905,N,671,671,4208,90,8241,1906,3537,N
1905,O,146,146,4354,535,8776,1906,4208,O
1905,P,7187,7187,11541,3780,12556,1906,4354,P
1906,A,15737,15737,15737,16031,16031,1907,0,A
1906,B,311,311,16048,90,16121,1907,15737,B
1906,C,1220,1220,17268,1540,17661,1907,16048,C
1906,D,80,80,17348,3780,21441,1907,17268,D
1906,M,26190,26190,43538,26801,48242,1907,17348,M
1906,N,634,634,44172,90,48332,1907,43538,N
1906,O,481,481,44653,700,49032,1907,44172,O
1906,N,1933,1933,46586,1690,50722,1907,44653,N
1906,O,566,566,47152,950,51672,1907,46586,O
1906,P,1087,1087,48239,3780,55452,1907,47152,P
1907,A,11283,11283,11283,11564,11564,1908,0,A
1907,B,478,478,11761,240,11804,1908,11283,B
1907,C,684,684,12445,1045,12849,1908,11761,C
1907,D,634,634,13079,3960,16809,1908,12445,D
1907,M,410,410,13489,550,17359,1908,13079,M
1907,N,201,201,13690,90,17449,1908,13489,N
1907,O,389,389,14079,690,18139,1908,13690,O
1907,N,1412,1412,15491,1125,19264,1908,14079,N
1907,O,479,479,15970,880,20144,1908,15491,O
1907,P,1901,1901,17871,3780,23924,1908,15970,P
1908,AE,292,292,292,1292,1292,1909,0,A
1908,BE,467,175,467,1483,1483,1909,0,E
1908,BF,1047,872,1339,90,1382,1909,292,B
1908,CF,1046,174,1513,90,1573,1909,467,F
1908,CG,1091,917,2430,1210,2592,1909,1339,C
1908,DG,1002,85,2515,1210,2783,1909,1513,G
1908,DH,392,307,2822,3780,6372,1909,2430,D
1908,H,755,448,3270,3780,6563,1909,2515,H
1908,M,3058,3058,6328,4722,11285,1909,3270,M
1908,N,1693,1693,8021,90,11375,1909,6328,N
1908,O,505,505,8526,905,12280,1909,8021,O
1908,P,3431,3431,11957,3840,16120,1909,8526,P
1909,AEI,41,41,41,1800,1800,1910,0,I
1909,AEJ,50,9,50,1292,1292,1910,0,E
1909,AFJ,52,2,52,1277,1277,1910,0,A
1909,BFJ,1292,1290,1342,165,1457,1910,50,F
1909,BGJ,1295,5,1347,165,1442,1910,52,B
1909,CGJ,564,564,1911,825,2267,1910,1347,C
1909,DGJ,618,49,1960,825,2282,1910,1342,G
1909,DHJ,1926,7,1967,165,1965,1910,41,J
1909,DHK,366,310,2277,3960,6227,1910,1911,D
1909,HK,659,349,2626,910,2875,1910,1967,K
1909,HL,125,125,2751,3960,6835,1910,2626,L
1909,H,1884,1093,3844,3960,6242,1910,1960,H
1909,M,3263,3263,7107,3314,10149,1910,3844,M
1909,N,219,219,7326,240,10389,1910,7107,N
1909,O,1110,1110,8436,1065,11454,1910,7326,O
1909,P,5194,5194,13630,550,12004,1910,8436,P
1910,AEI,16,16,16,73,73,1911,0,I
1910,AEJ,53,37,53,241,241,1911,0,E
1910,AFJ,240,203,256,240,313,1911,16,J
1910,AFK,276,73,329,135,376,1911,53,F
1910,AGK,190,117,446,285,598,1911,256,K
1910,AGL,249,132,578,290,666,1911,329,G
1910,AHL,307,307,885,5160,5826,1911,578,H
1910,AL,799,360,1245,5160,5758,1911,446,L
1910,A,1655,410,1655,3010,3010,1911,0,A
1910,B,1636,1636,3291,300,3310,1911,1655,B
1910,C,691,691,3982,780,4090,1911,3291,C
1910,D,1200,1200,5182,1620,5710,1911,3982,D
1910,M,364,364,5546,490,6316,1911,5182,M
1910,N,247,247,5793,180,6496,1911,5546,N
1910,O,164,164,5957,140,6636,1911,5793,O
1910,P,83,83,6040,2880,9516,1911,5957,P
1911,AE,66,66,66,80,80,1912,0,A
1911,BE,103,103,169,150,230,1912,66,B
1911,CE,313,144,313,234,234,1912,0,E
1911,CF,169,25,338,160,390,1912,169,C
1911,DF,108,83,421,240,474,1912,313,F
1911,DG,196,196,617,405,879,1912,421,G
1911,DH,736,736,1353,3960,4839,1912,617,H
1911,D,1088,73,1426,4200,4590,1912,338,D
1911,M,415,415,1841,405,5244,1912,1426,M
1911,N,115,115,1956,180,5424,1912,1841,N
1911,O,220,220,2176,260,5684,1912,1956,O
1911,N,938,938,3114,895,6579,1912,2176,N
1911,O,191,191,3305,225,6804,1912,3114,O
1911,P,1355,1355,4660,4740,11544,1912,3305,P
1912,AEI,1490,1490,1490,1475,1475,1913,0,E
1912,AFI,287,287,1777,300,1775,1913,1490,F
1912,AGI,680,680,2457,855,2630,1913,1777,G
1912,AHI,3426,969,3426,3758,3758,1913,0,A
1912,BHI,3691,265,3691,3822,3822,1913,0,I
1912,BHJ,161,161,3852,90,3912,1913,3691,J
1912,BHK,1528,133,3985,1590,4220,1913,2457,H
1912,BK,705,146,4131,90,3848,1913,3426,B
1912,CK,444,165,4296,795,4707,1913,3852,K
1912,CJ,524,359,4655,815,4663,1913,4131,C
1912,BJ,1230,871,5526,425,5132,1913,4296,J
1912,BK,1341,1341,6867,1885,7017,1913,5526,K
1912,BL,853,853,7720,3780,10797,1913,6867,L
1912,B,3647,582,8302,3695,8358,1913,4655,B
1912,C,1346,1346,9648,1840,10198,1913,8302,C
1912,D,1544,1544,11192,3780,13978,1913,9648,D
1912,M,288,288,11480,675,14653,1913,11192,M
1912,N,676,676,12156,300,14953,1913,11480,N
1912,O,401,401,12557,405,15358,1913,12156,O
1912,N,146,146,12703,165,15523,1913,12557,N
1912,O,516,516,13219,2045,17568,1913,12703,O
1912,P,3004,3004,16223,2745,20313,1913,13219,P
1913,A,130,130,130,833,833,1914,0,A
1913,B,833,833,963,180,1013,1914,130,B
1913,C,162,162,1125,225,1238,1914,963,C
1913,D,400,400,1525,4140,5378,1914,1125,D
1913,M,56,56,1581,1342,6720,1914,1525,M
1913,N,1321,1321,2902,90,6810,1914,1581,N
1913,O,1013,1013,3915,1225,8035,1914,2902,O
1913,P,21,21,3936,3780,11815,1914,3915,P
1914,AEI,148,148,148,548,548,1915,0,A
1914,BEI,402,254,402,1375,1375,1915,0,E
1914,BFI,410,156,558,120,668,1915,148,B
1914,CFI,98,98,656,90,758,1915,558,C
1914,BFI,648,648,1304,595,1353,1915,656,B
1914,CFI,1330,26,1330,1481,1481,1915,0,I
1914,CFJ,246,220,1550,380,1733,1915,1304,C
1914,DFJ,1232,84,1634,300,1675,1915,402,F
1914,DGJ,328,24,1658,240,1721,1915,1330,J
1914,DGK,129,21,1679,5460,7193,1915,1550,D
1914,GK,718,697,2376,745,2466,1915,1658,K
1914,GJ,748,6,2382,805,2480,1915,1634,G
1914,HJ,1859,1853,4235,1795,4261,1915,2376,J
1914,HK,194,194,4429,380,4641,1915,4235,K
1914,HL,996,996,5425,5460,10101,1915,4429,L
1914,H,4423,1380,6805,1140,3620,1915,2382,H
1914,M,882,882,7687,1857,11958,1915,6805,M
1914,N,1079,1079,8766,150,12108,1915,7687,N
1914,O,188,188,8954,185,12293,1915,8766,O
1914,N,734,734,9688,720,13013,1915,8954,N
1914,O,116,116,9804,125,13138,1915,9688,O
1914,P,1810,1810,11614,4230,17368,1915,9804,P
1915,A,1388,1388,1388,1787,1787,1916,0,A
1915,B,596,596,1984,240,2027,1916,1388,B
1915,C,826,826,2810,920,2947,1916,1984,C
1915,D,104,104,2914,3960,6907,1916,2810,D
1915,M,106,106,3020,759,7666,1916,2914,M
1915,N,850,850,3870,240,7906,1916,3020,N
1915,O,685,685,4555,895,8801,1916,3870,O
1915,P,59,59,4614,3960,12761,1916,4555,P
1916,AEI,354,354,354,545,545,1917,0,I
1916,AEJ,249,249,603,90,635,1917,354,J
1916,AEK,624,21,624,1296,1296,1917,0,A
1916,BEK,557,536,1160,860,1495,1917,603,K
1916,BEL,710,174,1334,90,1386,1917,624,B
1916,CEL,1839,505,1839,2963,2963,1917,0,E
1916,CFL,727,48,1887,3780,5275,1917,1160,L
1916,CF,952,399,2286,1250,2636,1917,1334,C
1916,DF,3,3,2289,3780,6416,1917,2286,D
1916,F,1164,714,3003,90,3053,1917,1839,F
1916,G,1015,1015,4018,1220,4273,1917,3003,G
1916,H,3,3,4021,3780,8053,1917,4018,H
1916,M,241,241,4262,748,8801,1917,4021,M
1916,N,807,807,5069,360,9161,1917,4262,N
1916,O,1017,1017,6086,990,10151,1917,5069,O
1916,P,1494,1494,7580,550,10701,1917,6086,P
1917,AEI,1424,1424,1424,1220,1220,1918,0,E
1917,AFI,76,76,1500,300,1520,1918,1424,F
1917,AGI,1056,1056,2556,895,2415,1918,1500,G
1917,AHI,637,637,3193,2220,4635,1918,2556,H
1917,AI,3229,36,3229,3571,3571,1918,0,A
1917,BI,371,371,3600,90,3661,1918,3229,B
1917,CI,654,654,4254,795,4456,1918,3600,C
1917,BI,649,649,4903,460,4916,1918,4254,B
1917,CI,1625,1625,6528,1885,6801,1918,4903,C
1917,DI,909,909,7437,3780,10581,1918,6528,D
1917,I,12571,5134,12571,12725,12725,1918,0,I
1917,J,486,486,13057,360,13085,1918,12571,J
1917,K,705,705,13762,845,13930,1918,13057,K
1917,L,118,118,13880,1590,15520,1918,13762,L
1917,M,123,123,14003,191,15711,1918,13880,M
1917,N,164,164,14167,150,15861,1918,14003,N
1917,O,630,630,14797,620,16481,1918,14167,O
1917,P,619,619,15416,4200,20681,1918,14797,P
1918,AE,14,14,14,204,204,1919,0,A
1918,BE,29,15,29,630,630,1919,0,E
1918,BF,223,208,237,90,294,1919,14,B
1918,CF,799,591,828,240,870,1919,29,F
1918,CG,707,116,944,995,1289,1919,237,C
1918,DG,143,27,971,215,1085,1919,828,G
1918,DH,355,355,1326,4890,5975,1919,971,H
1918,D,1685,1303,2629,3780,5069,1919,944,D
1918,M,152,152,2781,1038,7013,1919,2629,M
1918,N,1094,1094,3875,240,7253,1919,2781,N
1918,O,585,585,4460,930,8183,1919,3875,O
1918,P,30,30,4490,3780,11963,1919,4460,P
1919,AE,476,476,476,708,708,1920,0,E
1919,AF,412,412,888,240,948,1920,476,F
1919,AG,1458,570,1458,1798,1798,1920,0,A
1919,BG,631,61,1519,655,1603,1920,888,G
1919,BH,458,397,1916,180,1978,1920,1458,B
1919,CH,791,791,2707,970,2948,1920,1916,C
1919,BH,272,272,2979,80,3028,1920,2707,B
1919,CH,460,460,3439,610,3638,1920,2979,C
1919,DH,3434,3434,6873,6960,10598,1920,3439,D
1919,H,8484,3130,10003,385,1988,1920,1519,H
1919,M,548,548,10551,1005,11603,1920,10003,M
1919,N,601,601,11152,180,11783,1920,10551,N
1919,O,638,638,11790,615,12398,1920,11152,O
1919,P,684,684,12474,4140,16538,1920,11790,P
1920,AEI,46,46,46,99,99,1921,0,E
1920,AFI,71,25,71,511,511,1921,0,A
1920,BFI,161,136,207,150,249,1921,46,F
1920,BGI,315,108,315,822,822,1921,0,I
1920,BGJ,160,52,367,130,379,1921,207,G
1920,BFJ,656,360,727,240,751,1921,71,B
1920,CFJ,609,197,924,150,972,1921,315,J
1920,CFK,198,198,1122,400,1372,1921,924,K
1920,CFJ,237,237,1359,20,1392,1921,1122,J
1920,CFK,652,20,1379,895,1646,1921,727,C
1920,DFK,656,636,2015,625,2017,1921,1359,K
1920,DFL,993,357,2372,3960,5606,1921,1379,D
1920,FL,2801,796,3168,2835,3214,1921,367,F
1920,GL,674,674,3842,625,3839,1921,3168,G
1920,HL,2733,906,4748,4230,6247,1921,2015,L
1920,H,5669,4763,9511,4230,8069,1921,3842,H
1920,M,1427,1427,10938,1380,9449,1921,9511,M
1920,N,225,225,11163,300,9749,1921,10938,N
1920,O,793,793,11956,965,10714,1921,11163,O
1920,P,950,950,12906,4080,14794,1921,11956,P
1921,AE,30,30,30,405,405,1922,0,A
1921,BE,164,134,164,1105,1105,1922,0,E
1921,BF,1014,880,1044,695,1100,1922,30,B
1921,CF,1061,181,1225,180,1285,1922,164,F
1921,CG,324,143,1368,255,1355,1922,1044,C
1921,DG,171,171,1539,2880,4235,1922,1368,D
1921,G,989,675,2214,1050,2335,1922,1225,G
1921,F,689,689,2903,625,2960,1922,2214,F
1921,G,209,209,3112,380,3340,1922,2903,G
1921,H,291,291,3403,5460,8800,1922,3112,H
1921,M,135,135,3538,1046,9846,1922,3403,M
1921,N,1151,1151,4689,300,10146,1922,3538,N
1921,O,200,200,4889,315,10461,1922,4689,O
1921,N,2041,2041,6930,1910,12371,1922,4889,N
1921,O,884,884,7814,945,13316,1922,6930,O
1921,P,796,796,8610,5160,18476,1922,7814,P
1922,AE,1923,1923,1923,2496,2496,1923,0,E
1922,AF,720,720,2643,180,2676,1923,1923,F
1922,AG,3169,526,3169,4267,4267,1923,0,A
1922,BG,590,64,3233,400,3076,1923,2643,G
1922,BH,1313,1249,4482,240,4507,1923,3169,B
1922,CH,1510,261,4743,4080,7156,1923,3233,H
1922,C,1285,1024,5767,1040,5547,1923,4482,C
1922,D,404,404,6171,3960,9507,1923,5767,D
1922,M,50,50,6221,22,9529,1923,6171,M
1922,N,92,92,6313,180,9709,1923,6221,N
1922,O,122,122,6435,265,9974,1923,6313,O
1922,N,582,582,7017,410,10384,1923,6435,N
1922,O,215,215,7232,265,10649,1923,7017,O
1922,P,137,137,7369,5100,15749,1923,7232,P
1923,AE,159,159,159,1043,1043,1924,0,E
1923,AF,917,917,1076,90,1133,1924,159,F
1923,AG,405,405,1481,700,1833,1924,1076,G
1923,AH,84,84,1565,3780,5613,1924,1481,H
1923,A,1699,134,1699,1871,1871,1924,0,A
1923,B,250,250,1949,90,1961,1924,1699,B
1923,C,529,529,2478,860,2821,1924,1949,C
1923,D,209,209,2687,3780,6601,1924,2478,D
1923,M,460,460,3147,1143,7744,1924,2687,M
1923,N,711,711,3858,90,7834,1924,3147,N
1923,O,207,207,4065,625,8459,1924,3858,O
1923,P,4705,4705,8770,3780,12239,1924,4065,P
1924,AE,172,172,172,389,389,1925,0,E
1924,AF,337,337,509,180,569,1925,172,F
1924,AG,999,490,999,2806,2806,1925,0,A
1924,BG,729,239,1238,840,1409,1925,509,G
1924,BH,166,166,1404,6740,8149,1925,1238,H
1924,B,1927,1522,2926,180,2986,1925,999,B
1924,C,868,868,3794,860,3846,1925,2926,C
1924,D,12282,12282,16076,6680,10526,1925,3794,D
1924,M,186,186,16262,940,11466,1925,16076,M
1924,N,895,895,17157,180,11646,1925,16262,N
1924,O,458,458,17615,610,12256,1925,17157,O
1924,P,5079,5079,22694,6960,19216,1925,17615,P
1925,AEI,638,638,638,1364,1364,1926,0,A
1925,BEI,743,105,743,2915,2915,1926,0,E
1925,BFI,756,13,756,1363,1363,1926,0,I
1925,BFJ,1006,888,1644,330,1694,1926,638,B
1925,CFJ,907,19,1663,330,1693,1926,756,J
1925,CFK,811,811,2474,2174,3867,1926,1663,K
1925,CFL,996,166,2640,5001,6695,1926,1644,C
1925,DFL,475,309,2949,896,4763,1926,2474,L
1925,DF,2619,413,3362,420,3335,1926,743,F
1925,DG,792,792,4154,2049,5384,1926,3362,G
1925,DH,1709,195,4349,2074,8769,1926,2640,D
1925,H,831,636,4985,3227,8611,1926,4154,H
1925,M,1194,1194,6179,1247,10016,1926,4985,M
1925,N,897,897,7076,780,10796,1926,6179,N
1925,O,1238,1238,8314,1350,12146,1926,7076,O
1925,P,14785,14785,23099,550,12696,1926,8314,P
1926,A,75,75,75,1068,1068,1927,0,A
1926,B,1178,1178,1253,240,1308,1927,75,B
1926,C,800,800,2053,930,2238,1927,1253,C
1926,D,14422,14422,16475,6990,9228,1927,2053,D
1926,M,72,72,16547,475,9703,1927,16475,M
1926,N,433,433,16980,90,9793,1927,16547,N
1926,O,2064,2064,19044,1850,11643,1927,16980,O
1926,P,773,773,19817,3780,15423,1927,19044,P
1927,AE,60,60,60,95,95,1928,0,A
1927,BE,170,170,230,180,275,1928,60,B
1927,CE,115,115,345,260,535,1928,230,C
1927,BE,581,581,926,435,970,1928,345,B
1927,CE,112,112,1038,200,1170,1928,926,C
1927,DE,82,82,1120,9915,11085,1928,1038,D
1927,E,5887,4767,5887,6334,6334,1928,0,E
1927,F,825,825,6712,420,6754,1928,5887,F
1927,G,1193,1193,7905,1250,8004,1928,6712,G
1927,F,825,825,8730,830,8834,1928,7905,F
1927,G,530,530,9260,565,9399,1928,8730,G
1927,H,480,480,9740,400,9799,1928,9260,H
1927,M,204,204,9944,276,11361,1928,9740,M
1927,N,192,192,10136,180,11541,1928,9944,N
1927,O,432,432,10568,600,12141,1928,10136,O
1927,N,891,891,11459,685,12826,1928,10568,N
1927,O,1018,1018,12477,1162,13988,1928,11459,O
1927,P,442,442,12919,473,14461,1928,12477,P
1928,AEI,31,31,31,60,60,1929,0,E
1928,AFI,163,132,163,293,293,1929,0,A
1928,BFI,179,16,179,145,145,1929,0,I
1928,BFJ,149,1,180,180,240,1929,31,F
1928,BGJ,80,79,259,180,325,1929,179,J
1928,BGK,147,68,327,165,405,1929,180,G
1928,BHK,9,9,336,2880,3285,1929,327,H
1928,BK,116,39,375,135,460,1929,259,K
1928,BL,25,25,400,3950,4410,1929,375,L
1928,B,342,105,505,270,563,1929,163,B
1928,C,489,489,994,735,1298,1929,505,C
1928,B,2592,2592,3586,2345,3643,1929,994,B
1928,C,325,325,3911,255,3898,1929,3586,C
1928,D,1196,1196,5107,5160,9058,1929,3911,D
1928,M,267,267,5374,360,9418,1929,5107,M
1928,N,183,183,5557,150,9568,1929,5374,N
1928,O,682,682,6239,630,10198,1929,5557,O
1928,N,768,768,7007,810,11008,1929,6239,N
1928,O,694,694,7701,655,11663,1929,7007,O
1928,P,1176,1176,8877,2880,14543,1929,7701,P
1929,AE,117,117,117,452,452,1930,0,E
1929,AF,607,490,607,1109,1109,1930,0,A
1929,BF,508,18,625,240,692,1930,117,F
1929,BG,684,666,1291,240,1349,1930,607,B
1929,CG,161,161,1452,350,1699,1930,1291,C
1929,DG,954,127,1579,985,1677,1930,625,G
1929,DF,675,675,2254,625,2302,1930,1579,F
1929,DG,138,138,2392,290,2592,1930,2254,G
1929,DH,991,51,2443,4020,5719,1930,1452,D
1929,H,69,18,2461,5100,7692,1930,2392,H
1929,M,417,417,2878,1305,8997,1930,2461,M
1929,N,925,925,3803,90,9087,1930,2878,N
1929,O,1013,1013,4816,1200,10287,1930,3803,O
1929,N,1361,1361,6177,1165,11452,1930,4816,N
1929,O,782,782,6959,1060,12512,1930,6177,O
1929,P,132,132,7091,3780,16292,1930,6959,P
1930,AEI,152,152,152,1383,1383,1931,0,A
1930,BEI,1068,916,1068,1384,1384,1931,0,I
1930,BEJ,506,506,1574,240,1624,1931,1068,J
1930,BEK,1454,32,1606,240,1623,1931,152,B
1930,CEK,110,78,1684,380,2004,1931,1574,K
1930,CEJ,1908,224,1908,2128,2128,1931,0,E
1930,CFJ,342,342,2250,180,2308,1931,1908,F
1930,CGJ,674,30,2280,760,2383,1931,1606,C
1930,DGJ,1003,407,2687,730,2734,1931,1684,J
1930,DGK,491,54,2741,565,2873,1931,2250,G
1930,DFK,481,481,3222,400,3273,1931,2741,F
1930,DGK,802,267,3489,810,3544,1931,2687,K
1930,DGL,811,544,4033,780,4053,1931,3222,G
1930,DHL,2543,790,4823,7740,10123,1931,2280,D
1930,HL,1230,440,5263,7680,11733,1931,4033,H
1930,L,3020,1246,6509,3960,7504,1931,3489,L
1930,M,282,282,6791,294,12027,1931,6509,M
1930,N,246,246,7037,300,12327,1931,6791,N
1930,O,684,684,7721,820,13147,1931,7037,O
1930,N,2638,2638,10359,2490,15637,1931,7721,N
1930,O,218,218,10577,390,16027,1931,10359,O
1930,P,349,349,10926,5400,21427,1931,10577,P
1931,AEI,72,72,72,928,928,1932,0,A
1931,BEI,77,5,77,673,673,1932,0,I
1931,BEJ,775,775,852,240,913,1932,77,J
1931,BEK,245,245,1097,300,1213,1932,852,K
1931,BEL,1075,50,1147,240,1168,1932,72,B
1931,CEL,878,828,1975,5100,6313,1932,1097,L
1931,CE,1540,712,2687,1040,2208,1932,1147,C
1931,BE,421,421,3108,930,3138,1932,2687,B
1931,CE,1059,1059,4167,1560,4698,1932,3108,C
1931,DE,159,159,4326,3960,8658,1932,4167,D
1931,E,5613,1287,5613,5720,5720,1932,0,E
1931,F,365,365,5978,300,6020,1932,5613,F
1931,G,704,704,6682,695,6715,1932,5978,G
1931,F,153,153,6835,600,7315,1932,6682,F
1931,G,643,643,7478,720,8035,1932,6835,G
1931,H,1101,1101,8579,1140,9175,1932,7478,H
1931,M,640,640,9219,1125,10300,1932,8579,M
1931,N,589,589,9808,150,10450,1932,9219,N
1931,O,185,185,9993,120,10570,1932,9808,O
1931,N,601,601,10594,665,11235,1932,9993,N
1931,O,486,486,11080,465,11700,1932,10594,O
1931,P,2889,2889,13969,5760,17460,1932,11080,P
1932,A,801,801,801,1173,1173,1933,0,A
1932,B,431,431,1232,90,1263,1933,801,B
1932,C,966,966,2198,1240,2503,1933,1232,C
1932,D,7,7,2205,3780,6283,1933,2198,D
1932,M,835,835,3040,1412,7695,1933,2205,M
1932,N,639,639,3679,90,7785,1933,3040,N
1932,O,212,212,3891,695,8480,1933,3679,O
1932,P,8679,8679,12570,3780,12260,1933,3891,P
1933,A,111,111,111,1035,1035,1934,0,A
1933,B,1118,1118,1229,240,1275,1934,111,B
1933,C,865,865,2094,1020,2295,1934,1229,C
1933,D,4459,4459,6553,4680,6975,1934,2094,D
1933,M,1972,1972,8525,2181,9156,1934,6553,M
1933,N,266,266,8791,90,9246,1934,8525,N
1933,O,492,492,9283,820,10066,1934,8791,O
1933,N,577,577,9860,260,10326,1934,9283,N
1933,O,544,544,10404,805,11131,1934,9860,O
1933,P,29340,29340,39744,3780,14911,1934,10404,P
1934,A,20,20,20,90,90,1935,0,A
1934,B,163,163,183,150,240,1935,20,B
1934,C,196,196,379,130,370,1935,183,C
1934,D,104,104,483,2850,3220,1935,379,D
1934,M,191,191,674,150,3370,1935,483,M
1934,N,59,59,733,155,3525,1935,674,N
1934,O,175,175,908,100,3625,1935,733,O
1934,P,7,7,915,2880,6505,1935,908,P
1935,AE,141,141,141,380,380,1936,0,A
1935,BE,807,666,807,905,905,1936,0,E
1935,BF,734,68,875,540,920,1936,141,B
1935,CF,171,171,1046,395,1315,1936,875,C
1935,DF,413,174,1220,360,1265,1936,807,F
1935,DG,204,30,1250,1590,2905,1936,1046,D
1935,G,776,746,1996,845,2110,1936,1220,G
1935,H,174,174,2170,1590,3700,1936,1996,H
1935,M,230,230,2400,1310,5010,1936,2170,M
1935,N,1336,1336,3736,300,5310,1936,2400,N
1935,O,642,642,4378,805,6115,1936,3736,O
1935,P,327,327,4705,2940,9055,1936,4378,P
1936,A,516,516,516,1126,1126,1937,0,A
1936,B,641,641,1157,90,1216,1937,516,B
1936,C,232,232,1389,625,1841,1937,1157,C
1936,D,4707,4707,6096,3780,5621,1937,1389,D
1936,M,211,211,6307,517,6138,1937,6096,M
1936,N,397,397,6704,180,6318,1937,6307,N
1936,O,1397,1397,8101,1280,7598,1937,6704,O
1936,N,410,410,8511,475,8073,1937,8101,N
1936,O,758,758,9269,920,8993,1937,8511,O
1936,P,1473,1473,10742,1175,10168,1937,9269,P
1937,AE,7,7,7,149,149,1938,0,E
1937,AF,346,346,353,240,389,1938,7,F
1937,AG,420,67,420,1249,1249,1938,0,A
1937,BG,793,726,1146,1040,1429,1938,353,G
1937,BH,28,28,1174,3960,5389,1938,1146,H
1937,B,907,153,1327,90,1339,1938,420,B
1937,C,459,459,1786,855,2194,1938,1327,C
1937,D,389,389,2175,3780,5974,1938,1786,D
1937,M,2752,2752,4927,4342,10316,1938,2175,M
1937,N,1678,1678,6605,90,10406,1938,4927,N
1937,O,671,671,7276,1080,11486,1938,6605,O
1937,P,10363,10363,17639,3780,15266,1938,7276,P
1938,AE,92,92,92,119,119,1939,0,A
1938,BE,115,23,115,310,310,1939,0,E
1938,BF,169,146,261,180,299,1939,92,B
1938,CF,91,91,352,205,504,1939,261,C
1938,DF,283,46,398,570,880,1939,115,F
1938,DG,194,148,546,4140,4644,1939,352,D
1938,G,353,205,751,120,1000,1939,398,G
1938,H,318,318,1069,3960,4960,1939,751,H
1938,M,1005,1005,2074,1808,6768,1939,1069,M
1938,N,943,943,3017,90,6858,1939,2074,N
1938,O,1273,1273,4290,1415,8273,1939,3017,O
1938,N,663,663,4953,595,8868,1939,4290,N
1938,O,582,582,5535,940,9808,1939,4953,O
1938,P,866,866,6401,3780,13588,1939,5535,P
1939,A,222,222,222,454,454,1940,0,A
1939,B,332,332,554,150,604,1940,222,B
1939,C,106,106,660,125,729,1940,554,C
1939,B,987,987,1647,955,1684,1940,660,B
1939,C,611,611,2258,690,2374,1940,1647,C
1939,D,1281,1281,3539,4230,6604,1940,2258,D
1939,M,635,635,4174,295,6899,1940,3539,M
1939,N,211,211,4385,600,7499,1940,4174,N
1939,O,243,243,4628,420,7919,1940,4385,O
1939,N,1339,1339,5967,1170,9089,1940,4628,N
1939,O,300,300,6267,1620,10709,1940,5967,O
1939,P,4347,4347,10614,2740,13449,1940,6267,P
1940,AE,1,1,1,71,71,1941,0,E
1940,AF,53,52,53,153,153,1941,0,A
1940,BF,135,83,136,90,161,1941,1,F
1940,BG,310,227,363,240,393,1941,53,B
1940,CG,153,153,516,215,608,1941,363,C
1940,DG,671,291,807,815,976,1941,136,G
1940,DH,367,76,883,4890,5498,1941,516,D
1940,H,1403,1327,2210,3960,4936,1941,807,H
1940,M,423,423,2633,1490,6988,1941,2210,M
1940,N,1263,1263,3896,240,7228,1941,2633,N
1940,O,781,781,4677,1035,8263,1941,3896,O
1940,P,1103,1103,5780,3960,12223,1941,4677,P
1941,AEI,88,88,88,1698,1698,1942,0,A
1941,BEI,301,213,301,1719,1719,1942,0,I
1941,BEJ,982,681,982,1201,1201,1942,0,E
1941,BFJ,399,399,1381,240,1441,1942,982,F
1941,BGJ,1802,509,1890,240,1938,1942,88,B
1941,CGJ,1595,6,1896,240,1959,1942,301,J
1941,CGK,534,19,1915,630,2071,1942,1381,G
1941,CHK,536,511,2426,630,2568,1942,1890,C
1941,DHK,642,112,2538,630,2589,1942,1896,K
1941,DHL,727,104,2642,6300,8371,1942,1915,H
1941,DL,672,456,3098,6360,8928,1942,2426,D
1941,L,4133,3573,6671,6300,8889,1942,2538,L
1941,M,302,302,6973,1070,9998,1942,6671,M
1941,N,1027,1027,8000,300,10298,1942,6973,N
1941,O,208,208,8208,315,10613,1942,8000,O
1941,N,535,535,8743,400,11013,1942,8208,N
1941,O,931,931,9674,2250,13263,1942,8743,O
1941,P,1032,1032,10706,2595,15858,1942,9674,P
1942,AEI,14,14,14,1081,1081,1943,0,E
1942,AFI,206,192,206,420,420,1943,0,I
1942,AFJ,355,149,355,425,425,1943,0,A
1942,BFJ,334,185,540,180,600,1943,206,J
1942,BFK,57,57,597,420,1020,1943,540,K
1942,BFJ,323,81,678,300,725,1943,355,B
1942,CFJ,1269,605,1283,240,1321,1943,14,F
1942,CGJ,716,111,1394,1025,1750,1943,678,C
1942,BGJ,806,9,1403,425,1445,1943,597,J
1942,BGK,367,358,1761,60,1810,1943,1394,B
1942,CGK,655,297,2058,760,2205,1943,1403,K
1942,CGL,782,7,2065,760,2081,1943,1283,G
1942,CHL,243,236,2301,7740,9945,1943,2058,L
1942,CH,562,22,2323,375,2185,1943,1761,C
1942,DH,1072,814,3137,7680,9761,1943,2065,H
1942,D,5007,4193,7330,1140,3325,1943,2323,D
1942,M,240,240,7570,450,10395,1943,7330,M
1942,N,406,406,7976,245,10640,1943,7570,N
1942,O,606,606,8582,525,11165,1943,7976,O
1942,P,210,210,8792,2880,14045,1943,8582,P
1943,AE,260,260,260,349,349,1944,0,A
1943,BE,279,19,279,1214,1214,1944,0,E
1943,BF,203,184,463,90,439,1944,260,B
1943,CF,408,408,871,850,1289,1944,463,C
1943,DF,1030,438,1309,150,1364,1944,279,F
1943,DG,120,120,1429,100,1464,1944,1309,G
1943,DF,1198,640,2069,3780,5069,1944,871,D
1943,F,642,2,2071,595,2059,1944,1429,F
1943,G,682,682,2753,590,2649,1944,2071,G
1943,H,3388,3388,6141,4230,6879,1944,2753,H
1943,M,4444,4444,10585,4997,11876,1944,6141,M
1943,N,663,663,11248,180,12056,1944,10585,N
1943,O,1008,1008,12256,1015,13071,1944,11248,O
1943,P,1744,1744,14000,550,13621,1944,12256,P
1944,AEI,33,33,33,143,143,1945,0,I
1944,AEJ,80,47,80,122,122,1945,0,E
1944,AFJ,183,103,183,655,655,1945,0,A
1944,BFJ,149,46,229,150,272,1945,80,F
1944,BGJ,286,90,319,240,383,1945,33,J
1944,BGK,133,43,362,410,682,1945,229,G
1944,BFK,195,152,514,285,668,1945,319,K
1944,BFL,670,339,853,240,895,1945,183,B
1944,CFL,193,193,1046,285,1180,1945,853,C
1944,DFL,743,59,1105,475,1157,1945,362,F
1944,DGL,799,208,1313,5160,5828,1945,514,L
1944,DG,216,8,1321,165,1322,1945,1105,G
1944,DH,2932,2657,3978,5160,6340,1945,1046,D
1944,H,8608,5951,9929,4230,5552,1945,1321,H
1944,M,1902,1902,11831,2418,8758,1945,9929,M
1944,N,756,756,12587,300,9058,1945,11831,N
1944,O,239,239,12826,285,9343,1945,12587,O
1944,N,1422,1422,14248,1360,10703,1945,12826,N
1944,O,678,678,14926,740,11443,1945,14248,O
1944,P,7901,7901,22827,5100,16543,1945,14926,P
1945,AE,15,15,15,770,770,1946,0,A
1945,BE,936,936,951,240,1010,1946,15,B
1945,CE,289,289,1240,300,1310,1946,951,C
1945,DE,70,70,1310,5100,6410,1946,1240,D
1945,E,4366,3056,4366,4493,4493,1946,0,E
1945,F,1587,1587,5953,1500,5993,1946,4366,F
1945,G,810,810,6763,995,6988,1946,5953,G
1945,F,1082,1082,7845,910,7898,1946,6763,F
1945,G,189,189,8034,300,8198,1946,7845,G
1945,H,965,965,8999,5100,13298,1946,8034,H
1945,M,35082,35082,44081,37184,50482,1946,8999,M
1945,N,2211,2211,46292,90,50572,1946,44081,N
1945,O,1065,1065,47357,1365,51937,1946,46292,O
1945,N,363,363,47720,142,52079,1946,47357,N
1945,O,366,366,48086,786,52865,1946,47720,O
1945,P,410,410,48496,3780,56645,1946,48086,P
1946,AE,368,368,368,1516,1516,1947,0,E
1946,AF,646,278,646,665,665,1947,0,A
1946,BF,129,129,775,170,835,1947,646,B
1946,CF,490,490,1265,465,1300,1947,775,C
1946,BF,1390,493,1758,270,1786,1947,368,F
1946,BG,1216,723,2481,1210,2510,1947,1265,B
1946,CG,859,136,2617,878,2664,1947,1758,G
1946,CH,773,637,3254,920,3430,1947,2481,C
1946,DH,1001,364,3618,1217,3881,1947,2617,H
1946,D,1158,794,4412,1175,4605,1947,3254,D
1946,M,1216,1216,5628,2036,6641,1947,4412,M
1946,N,2020,2020,7648,1260,7901,1947,5628,N
1946,O,422,422,8070,400,8301,1947,7648,O
1946,P,8599,8599,16669,425,8726,1947,8070,P
1947,A,4421,4421,4421,4557,4557,1948,0,A
1947,B,308,308,4729,90,4647,1948,4421,B
1947,C,1027,1027,5756,1395,6042,1948,4729,C
1947,D,1076,1076,6832,3780,9822,1948,5756,D
1947,M,408,408,7240,1680,11502,1948,6832,M
1947,N,2389,2389,9629,90,11592,1948,7240,N
1947,O,1137,1137,10766,1375,12967,1948,9629,O
1947,N,314,314,11080,1155,14122,1948,10766,N
1947,O,590,590,11670,935,15057,1948,11080,O
1947,P,120,120,11790,3780,18837,1948,11670,P
1948,AE,1040,1040,1040,1595,1595,1949,0,A
1948,BE,1808,768,1808,2056,2056,1949,0,E
1948,BF,1135,367,2175,640,2235,1949,1040,B
1948,CF,716,349,2524,540,2596,1949,1808,F
1948,CG,832,483,3007,1100,3335,1949,2175,C
1948,BG,566,83,3090,845,3441,1949,2524,G
1948,BF,1796,1796,4886,1530,4971,1949,3090,F
1948,BG,1993,114,5000,1545,4880,1949,3007,B
1948,CG,1500,1500,6500,1940,6820,1949,5000,C
1948,DG,1659,45,6545,1940,6911,1949,4886,G
1948,DH,1805,1760,8305,1390,8210,1949,6500,D
1948,H,9055,7295,15600,340,7251,1949,6545,H
1948,M,1596,1596,17196,342,8552,1949,15600,M
1948,N,277,277,17473,240,8792,1949,17196,N
1948,O,5133,5133,22606,1621,10413,1949,17473,O
1948,N,1410,1410,24016,4780,15193,1949,22606,N
1948,O,613,613,24629,800,15993,1949,24016,O
1948,P,1612,1612,26241,840,16833,1949,24629,P
1949,A,57,57,57,222,222,1950,0,A
1949,B,354,354,411,240,462,1950,57,B
1949,C,703,703,1114,850,1312,1950,411,C
1949,D,408,408,1522,5220,6532,1950,1114,D
1949,M,1982,1982,3504,1915,8447,1950,1522,M
1949,N,230,230,3734,300,8747,1950,3504,N
1949,O,935,935,4669,840,9587,1950,3734,O
1949,N,313,313,4982,465,10052,1950,4669,N
1949,O,1147,1147,6129,1260,11312,1950,4982,O
1949,P,14853,14853,20982,4020,15332,1950,6129,P
1950,AEI,84,84,84,3022,3022,1951,0,I
1950,AEJ,135,51,135,485,485,1951,0,A
1950,BEJ,146,11,146,191,191,1951,0,E
1950,BFJ,345,345,491,360,551,1951,146,F
1950,BGJ,729,373,864,420,905,1951,135,B
1950,CGJ,707,334,1198,695,1246,1951,491,G
1950,CHJ,313,313,1511,550,1796,1951,1198,H
1950,CJ,907,260,1771,890,1795,1951,864,C
1950,DJ,284,284,2055,550,2345,1951,1771,D
1950,J,3137,1166,3221,250,3272,1951,84,J
1950,K,1131,1131,4352,1110,4382,1951,3221,K
1950,L,277,277,4629,550,4932,1951,4352,L
1950,M,203,203,4832,431,5363,1951,4629,M
1950,N,448,448,5280,270,5633,1951,4832,N
1950,O,1161,1161,6441,1120,6753,1951,5280,O
1950,P,4066,4066,10507,335,7088,1951,6441,P
1951,AEI,40,40,40,1061,1061,1952,0,E
1951,AFI,259,219,259,1597,1597,1952,0,I
1951,AFJ,645,386,645,680,680,1952,0,A
1951,BFJ,149,149,794,150,830,1952,645,B
1951,CFJ,1224,470,1264,240,1301,1952,40,F
1951,CGJ,563,93,1357,721,1551,1952,794,C
1951,BGJ,1458,360,1717,180,1777,1952,259,J
1951,BGK,795,342,2059,930,2231,1952,1264,G
1951,BHK,467,125,2184,630,2407,1952,1717,K
1951,BHJ,298,173,2357,7050,9281,1952,2059,H
1951,BJ,1657,657,3014,1510,3061,1952,1357,B
1951,CJ,888,58,3072,710,3117,1952,2184,J
1951,CK,802,744,3816,930,3991,1952,3014,C
1951,DK,1039,295,4111,1307,4424,1952,3072,K
1951,DL,3293,2998,7109,6990,10981,1952,3816,D
1951,L,3682,684,7793,413,4837,1952,4111,L
1951,M,62,62,7855,303,11284,1952,7793,M
1951,N,416,416,8271,240,11524,1952,7855,N
1951,O,827,827,9098,975,12499,1952,8271,O
1951,N,1275,1275,10373,1100,13599,1952,9098,N
1951,O,187,187,10560,225,13824,1952,10373,O
1951,P,1739,1739,12299,4740,18564,1952,10560,P
1952,AEI,77,77,77,1022,1022,1953,0,A
1952,BEI,107,30,107,474,474,1953,0,E
1952,BFI,240,133,240,2475,2475,1953,0,I
1952,BFJ,362,229,469,90,564,1953,107,F
1952,BGJ,695,695,1164,1170,1734,1953,469,G
1952,BFJ,1128,41,1205,240,1262,1953,77,B
1952,CFJ,868,868,2073,890,2152,1953,1205,C
1952,DFJ,2487,654,2727,300,2775,1953,240,J
1952,DFK,2079,516,3243,960,2694,1953,1164,F
1952,DGK,901,385,3628,905,3680,1953,2727,K
1952,DGL,714,329,3957,990,3684,1953,3243,G
1952,DHL,1146,1146,5103,3960,7644,1953,3957,H
1952,DL,6647,5172,10275,2760,6440,1953,3628,L
1952,D,11830,3628,13903,5220,7372,1953,2073,D
1952,M,512,512,14415,493,8137,1953,13903,M
1952,N,149,149,14564,220,8357,1953,14415,N
1952,O,1082,1082,15646,1080,9437,1953,14564,O
1952,N,757,757,16403,795,10232,1953,15646,N
1952,O,651,651,17054,606,10838,1953,16403,O
1952,P,193,193,17247,414,11252,1953,17054,P
1953,AEI,73,73,73,832,832,1954,0,A
1953,BEI,447,374,447,1215,1215,1954,0,E
1953,BFI,753,306,753,832,832,1954,0,I
1953,BFJ,262,262,1015,180,1012,1954,753,J
1953,BFK,947,5,1020,240,1072,1954,73,B
1953,CFK,66,61,1081,665,1677,1954,1015,K
1953,CFL,957,323,1404,240,1455,1954,447,F
1953,CGL,554,170,1574,740,1812,1954,1020,C
1953,DGL,577,407,1981,740,2195,1954,1404,G
1953,DHL,8929,8929,10910,5100,7295,1954,1981,H
1953,DL,9378,42,10952,5100,6912,1954,1574,D
1953,L,88351,78480,89432,6900,8577,1954,1081,L
1953,M,1053,1053,90485,2244,10821,1954,89432,M
1953,N,1215,1215,91700,90,10911,1954,90485,N
1953,O,786,786,92486,805,11716,1954,91700,O
1953,N,6003,6003,98489,5580,17296,1954,92486,N
1953,O,1870,1870,100359,1830,19126,1954,98489,O
1953,P,510,510,100869,3780,22906,1954,100359,P
1954,AE,68,68,68,102,102,1955,0,A
1954,BE,176,108,176,200,200,1955,0,E
1954,BF,139,31,207,150,252,1955,68,B
1954,CF,123,92,299,150,350,1955,176,F
1954,CG,110,110,409,160,510,1955,299,G
1954,CH,211,9,418,455,707,1955,207,C
1954,DH,72,63,481,4200,4710,1955,409,H
1954,D,1071,1008,1489,3900,4607,1955,418,D
1954,M,153,153,1642,1539,6249,1955,1489,M
1954,N,1424,1424,3066,90,6339,1955,1642,N
1954,O,980,980,4046,1230,7569,1955,3066,O
1954,P,146,146,4192,3780,11349,1955,4046,P
1955,AEI,123,123,123,156,156,1956,0,I
1955,AEJ,126,126,249,150,306,1956,123,J
1955,AEK,138,138,387,400,706,1956,249,K
1955,AEL,1166,1166,1553,3960,4666,1956,387,L
1955,AE,2698,1145,2698,2856,2856,1956,0,A
1955,BE,358,358,3056,240,3096,1956,2698,B
1955,CE,831,831,3887,855,3951,1956,3056,C
1955,DE,356,356,4243,3960,7911,1956,3887,D
1955,E,5979,1736,5979,6426,6426,1956,0,E
1955,F,643,643,6622,240,6666,1956,5979,F
1955,G,691,691,7313,920,7586,1956,6622,G
1955,H,154,154,7467,3960,11546,1956,7313,H
1955,M,24,24,7491,140,11686,1956,7467,M
1955,N,322,322,7813,240,11926,1956,7491,N
1955,O,665,665,8478,865,12791,1956,7813,O
1955,P,2673,2673,11151,3960,16751,1956,8478,P
1956,AEI,74,74,74,111,111,1957,0,I
1956,AEJ,127,127,201,150,261,1957,74,J
1956,AEK,175,175,376,490,751,1957,201,K
1956,AEL,1298,922,1298,1649,1649,1957,0,E
1956,AFL,1095,173,1471,1200,1951,1957,376,L
1956,AF,406,233,1704,135,1784,1957,1298,F
1956,AG,1802,98,1802,1665,1665,1957,0,A
1956,BG,126,126,1928,300,1965,1957,1802,B
1956,CG,646,422,2350,615,2399,1957,1704,G
1956,CH,566,144,2494,880,2845,1957,1928,C
1956,DH,142,142,2636,2940,5785,1957,2494,D
1956,H,766,480,3116,1520,3919,1957,2350,H
1956,M,225,225,3341,776,6561,1957,3116,M
1956,N,701,701,4042,240,6801,1957,3341,N
1956,O,395,395,4437,845,7646,1957,4042,O
1956,P,529,529,4966,3720,11366,1957,4437,P
1957,A,319,319,319,1486,1486,1958,0,A
1957,B,1412,1412,1731,300,1786,1958,319,B
1957,C,1115,1115,2846,1275,3061,1958,1731,C
1957,B,1154,1154,4000,1065,4126,1958,2846,B
1957,C,368,368,4368,510,4636,1958,4000,C
1957,D,63,63,4431,3960,8596,1958,4368,D
1957,M,2982,2982,7413,3293,11889,1958,4431,M
1957,N,371,371,7784,90,11979,1958,7413,N
1957,O,534,534,8318,1015,12994,1958,7784,O
1957,P,2764,2764,11082,3780,16774,1958,8318,P
1958,AEI,167,167,167,285,285,1959,0,A
1958,BEI,194,27,194,319,319,1959,0,E
1958,BFI,235,208,402,150,435,1959,167,B
1958,CFI,241,33,435,180,499,1959,194,F
1958,CGI,444,9,444,434,434,1959,0,I
1958,CGJ,93,51,495,115,550,1959,402,C
1958,DGJ,99,48,543,180,614,1959,444,J
1958,DGK,123,123,666,610,1224,1959,543,K
1958,DGL,710,479,1145,670,1169,1959,435,G
1958,DHL,90,90,1235,2880,4049,1959,1145,H
1958,DL,646,77,1312,2880,4104,1959,666,L
1958,D,3591,2774,4086,4230,4780,1959,495,D
1958,M,345,345,4431,445,5225,1959,4086,M
1958,N,156,156,4587,120,5345,1959,4431,N
1958,O,157,157,4744,125,5470,1959,4587,O
1958,P,699,699,5443,2880,8350,1959,4744,P
1959,AEI,58,58,58,121,121,1960,0,I
1959,AEJ,97,39,97,156,156,1960,0,E
1959,AFJ,154,154,251,135,291,1960,97,F
1959,AGJ,243,50,301,240,361,1960,58,J
1959,AGK,168,118,419,290,581,1960,251,G
1959,AHK,157,39,458,290,651,1960,301,K
1959,AHL,984,526,984,1157,1157,1960,0,A
1959,BHL,369,369,1353,240,1397,1960,984,B
1959,CHL,778,778,2131,915,2312,1960,1353,C
1959,BHL,229,229,2360,165,2477,1960,2131,B
1959,CHL,3038,1097,3457,5160,5741,1960,419,H
1959,CL,1368,271,3728,1260,3737,1960,2360,C
1959,DL,382,382,4110,3960,7697,1960,3728,D
1959,L,7250,3598,7708,5160,5811,1960,458,L
1959,M,1671,1671,9379,2065,9762,1960,7708,M
1959,N,418,418,9797,90,9852,1960,9379,N
1959,O,1003,1003,10800,1240,11092,1960,9797,O
1959,N,646,646,11446,405,11497,1960,10800,N
1959,O,584,584,12030,970,12467,1960,11446,O
1959,P,644,644,12674,3780,16247,1960,12030,P
1960,AEI,1259,1259,1259,2025,2025,1961,0,A
1960,BEI,946,946,2205,240,2265,1961,1259,B
1960,CEI,2913,708,2913,3134,3134,1961,0,E
1960,CFI,1059,351,3264,1375,3640,1961,2205,C
1960,DFI,490,139,3403,300,3434,1961,2913,F
1960,DGI,498,498,3901,811,4245,1961,3403,G
1960,DHI,294,294,4195,3885,8130,1961,3901,H
1960,DI,4240,45,4240,4665,4665,1961,0,I
1960,DJ,1145,169,4409,1200,4840,1961,3264,D
1960,J,693,524,4933,300,4965,1961,4240,J
1960,K,529,529,5462,680,5645,1961,4933,K
1960,L,307,307,5769,2940,8585,1961,5462,L
1960,M,1613,1613,7382,2560,11145,1961,5769,M
1960,N,977,977,8359,90,11235,1961,7382,N
1960,O,1039,1039,9398,1240,12475,1961,8359,O
1960,P,511,511,9909,3780,16255,1961,9398,P
1961,AE,284,284,284,334,334,1962,0,E
1961,AF,350,350,634,360,694,1962,284,F
1961,AG,750,750,1384,700,1394,1962,634,G
1961,AH,288,288,1672,550,1944,1962,1384,H
1961,A,2776,1104,2776,4886,4886,1962,0,A
1961,B,2471,2471,5247,420,5306,1962,2776,B
1961,C,895,895,6142,895,6201,1962,5247,C
1961,D,201,201,6343,550,6751,1962,6142,D
1961,M,543,543,6886,905,7656,1962,6343,M
1961,N,483,483,7369,150,7806,1962,6886,N
1961,O,104,104,7473,115,7921,1962,7369,O
1961,N,358,358,7831,360,8281,1962,7473,N
1961,O,762,762,8593,695,8976,1962,7831,O
1961,P,39,39,8632,4230,13206,1962,8593,P
1962,AEI,34,34,34,196,196,1963,0,A
1962,BEI,104,70,104,752,752,1963,0,I
1962,BEJ,251,181,285,135,331,1963,34,B
1962,CEJ,432,147,432,1400,1400,1963,0,E
1962,CFJ,173,26,458,290,621,1963,285,C
1962,DFJ,73,73,531,5160,5781,1963,458,D
1962,FJ,831,404,935,240,992,1963,104,J
1962,FK,180,180,1115,290,1282,1963,935,K
1962,FL,1224,541,1656,300,1700,1963,432,F
1962,GL,1125,584,2240,5160,6442,1963,1115,L
1962,G,655,71,2311,775,2475,1963,1656,G
1962,H,282,282,2593,1140,3615,1963,2311,H
1962,M,1588,1588,4181,2659,9101,1963,2593,M
1962,N,1222,1222,5403,180,9281,1963,4181,N
1962,O,1034,1034,6437,885,10166,1963,5403,O
1962,N,185,185,6622,365,10531,1963,6437,N
1962,O,547,547,7169,360,10891,1963,6622,O
1962,P,2453,2453,9622,7020,17911,1963,7169,P
1963,A,20,20,20,180,180,1964,0,A
1963,B,352,352,372,240,420,1964,20,B
1963,C,813,813,1185,1045,1465,1964,372,C
1963,D,700,700,1885,3960,5425,1964,1185,D
1963,M,2103,2103,3988,2635,8060,1964,1885,M
1963,N,565,565,4553,90,8150,1964,3988,N
1963,O,175,175,4728,585,8735,1964,4553,O
1963,P,9028,9028,13756,3780,12515,1964,4728,P
1964,AE,814,814,814,1397,1397,1965,0,E
1964,AF,1078,1078,1892,90,1487,1965,814,F
1964,AG,2923,1031,2923,3103,3103,1965,0,A
1964,BG,1113,82,3005,1430,2917,1965,1892,G
1964,BF,237,155,3160,90,3193,1965,2923,B
1964,CF,551,551,3711,800,3993,1965,3160,C
1964,BF,714,8,3719,845,3762,1965,3005,F
1964,BG,183,183,3902,690,4452,1965,3719,G
1964,BH,336,145,4047,80,4073,1965,3711,B
1964,CH,176,176,4223,690,4763,1965,4047,C
1964,DH,1802,1802,6025,3780,8543,1965,4223,D
1964,H,3158,1035,7060,3780,8232,1965,3902,H
1964,M,3445,3445,10505,4240,12783,1965,7060,M
1964,N,825,825,11330,90,12873,1965,10505,N
1964,O,352,352,11682,690,13563,1965,11330,O
1964,N,1733,1733,13415,1345,14908,1965,11682,N
1964,O,1429,1429,14844,1935,16843,1965,13415,O
1964,P,4436,4436,19280,3780,20623,1965,14844,P
1965,AEI,2,2,2,1382,1382,1966,0,I
1965,AEJ,373,373,375,540,1922,1966,2,J
1965,AEK,471,96,471,1379,1379,1966,0,A
1965,BEK,792,321,792,819,819,1966,0,E
1965,BFK,171,171,963,180,999,1966,792,F
1965,BGK,126,126,1089,212,1211,1966,963,G
1965,BHK,808,94,1183,1230,3152,1966,375,K
1965,BHJ,108,14,1197,393,1604,1966,1089,H
1965,BJ,1028,302,1499,180,1559,1966,471,B
1965,CJ,1032,1032,2531,1050,2609,1966,1499,C
1965,BJ,647,647,3178,620,3229,1966,2531,B
1965,CJ,182,182,3360,260,3489,1966,3178,C
1965,DJ,628,628,3988,5100,8589,1966,3360,D
1965,J,2989,184,4172,1140,4292,1966,1183,J
1965,K,635,635,4807,888,5180,1966,4172,K
1965,L,692,692,5499,402,5582,1966,4807,L
1965,M,593,593,6092,887,9476,1966,5499,M
1965,N,506,506,6598,240,9716,1966,6092,N
1965,O,691,691,7289,890,10606,1966,6598,O
1965,P,2652,2652,9941,1095,11701,1966,7289,P
1966,A,3306,3306,3306,3648,3648,1967,0,A
1966,B,371,371,3677,90,3738,1967,3306,B
1966,C,651,651,4328,795,4533,1967,3677,C
1966,B,652,652,4980,460,4993,1967,4328,B
1966,C,1627,1627,6607,1885,6878,1967,4980,C
1966,D,902,902,7509,3780,10658,1967,6607,D
1966,M,342,342,7851,385,11043,1967,7509,M
1966,N,294,294,8145,300,11343,1967,7851,N
1966,O,716,716,8861,880,12223,1967,8145,O
1966,P,308,308,9169,1620,13843,1967,8861,P
1967,AE,97,97,97,283,283,1968,0,A
1967,BE,373,373,470,240,523,1968,97,B
1967,CE,204,204,674,290,813,1968,470,C
1967,DE,1526,852,1526,1791,1791,1968,0,E
1967,DF,375,375,1901,150,1941,1968,1526,F
1967,DG,442,442,2343,725,2666,1968,1901,G
1967,DF,405,405,2748,135,2801,1968,2343,F
1967,DG,442,442,3190,110,2911,1968,2748,G
1967,DH,906,906,4096,4230,7141,1968,3190,H
1967,D,5027,1605,5701,5220,6033,1968,674,D
1967,M,1599,1599,7300,3426,10567,1968,5701,M
1967,N,1845,1845,9145,90,10657,1968,7300,N
1967,O,1266,1266,10411,1360,12017,1968,9145,O
1967,N,257,257,10668,150,12167,1968,10411,N
1967,O,391,391,11059,765,12932,1968,10668,O
1967,P,4645,4645,15704,3840,16772,1968,11059,P
1968,AE,88,88,88,98,98,1969,0,E
1968,AF,199,199,287,240,338,1969,88,F
1968,AG,19,19,306,260,598,1969,287,G
1968,AH,336,30,336,710,710,1969,0,A
1968,BH,641,641,977,300,1010,1969,336,B
1968,CH,253,253,1230,405,1415,1969,977,C
1968,BH,311,311,1541,165,1580,1969,1230,B
1968,CH,1387,152,1693,5160,5758,1969,306,H
1968,C,570,418,2111,785,2365,1969,1541,C
1968,D,560,560,2671,4005,6370,1969,2111,D
1968,M,128,128,2799,525,6895,1969,2671,M
1968,N,547,547,3346,240,7135,1969,2799,N
1968,O,395,395,3741,845,7980,1969,3346,O
1968,P,457,457,4198,3720,11700,1969,3741,P
1969,AE,20,20,20,201,201,1970,0,E
1969,AF,76,56,76,192,192,1970,0,A
1969,BF,273,217,293,135,336,1970,20,F
1969,BG,299,82,375,240,432,1970,76,B
1969,CG,192,110,485,290,626,1970,293,G
1969,CH,223,113,598,285,717,1970,375,C
1969,DH,137,24,622,5160,5786,1970,485,H
1969,D,1466,1442,2064,5160,5877,1970,598,D
1969,M,765,765,2829,1312,7189,1970,2064,M
1969,N,697,697,3526,180,7369,1970,2829,N
1969,O,836,836,4362,885,8254,1970,3526,O
1969,P,3199,3199,7561,6680,14934,1970,4362,P
1970,A,620,620,620,1513,1513,1971,0,A
1970,B,1186,1186,1806,300,1813,1971,620,B
1970,C,933,933,2739,970,2783,1971,1806,C
1970,B,169,169,2908,290,3073,1971,2739,B
1970,C,726,726,3634,510,3583,1971,2908,C
1970,D,58985,58985,62619,3960,7543,1971,3634,D
1970,M,1603,1603,64222,3977,11520,1971,62619,M
1970,N,2434,2434,66656,180,11700,1971,64222,N
1970,O,802,802,67458,860,12560,1971,66656,O
1970,P,19248,19248,86706,6680,19240,1971,67458,P
1971,AE,12,12,12,123,123,1972,0,A
1971,BE,228,228,240,150,273,1972,12,B
1971,CE,612,612,852,765,1038,1972,240,C
1971,DE,1195,343,1195,1390,1390,1972,0,E
1971,DF,568,225,1420,3600,4638,1972,852,D
1971,F,339,114,1534,150,1540,1972,1195,F
1971,G,580,580,2114,585,2125,1972,1534,G
1971,F,293,293,2407,335,2460,1972,2114,F
1971,G,1020,1020,3427,135,2595,1972,2407,G
1971,H,760,760,4187,4230,6825,1972,3427,H
1971,M,1616,1616,5803,2592,9417,1972,4187,M
1971,N,1074,1074,6877,150,9567,1972,5803,N
1971,O,209,209,7086,140,9707,1972,6877,O
1971,N,217,217,7303,275,9982,1972,7086,N
1971,O,630,630,7933,690,10672,1972,7303,O
1971,P,1417,1417,9350,4230,14902,1972,7933,P
1972,A,1454,1454,1454,1564,1564,1973,0,A
1972,B,134,134,1588,90,1654,1973,1454,B
1972,C,713,713,2301,1130,2784,1973,1588,C
1972,D,329,329,2630,3780,6564,1973,2301,D
1972,M,712,712,3342,993,7557,1973,2630,M
1972,N,317,317,3659,90,7647,1973,3342,N
1972,O,226,226,3885,625,8272,1973,3659,O
1972,P,7378,7378,11263,3780,12052,1973,3885,P
1973,A,106,106,106,1130,1130,1974,0,A
1973,B,1215,1215,1321,240,1370,1974,106,B
1973,C,1031,1031,2352,1020,2390,1974,1321,C
1973,D,4,4,2356,4680,7070,1974,2352,D
1973,M,487,487,2843,990,8060,1974,2356,M
1973,N,623,623,3466,180,8240,1974,2843,N
1973,O,927,927,4393,910,9150,1974,3466,O
1973,P,1508,1508,5901,550,9700,1974,4393,P
1974,AE,139,139,139,544,544,1975,0,E
1974,AF,285,146,285,373,373,1975,0,A
1974,BF,184,184,469,135,508,1975,285,B
1974,CF,415,85,554,120,664,1975,139,F
1974,CG,181,96,650,290,798,1975,469,C
1974,DG,99,3,653,90,754,1975,554,G
1974,DF,148,145,798,5160,5958,1975,650,D
1974,F,629,484,1282,585,1339,1975,653,F
1974,G,154,154,1436,290,1629,1975,1282,G
1974,H,175,175,1611,5160,6789,1975,1436,H
1974,M,18989,18989,20600,19162,25951,1975,1611,M
1974,N,313,313,20913,180,26131,1975,20600,N
1974,O,1279,1279,22192,885,27016,1975,20913,O
1974,P,2546,2546,24738,6680,33696,1975,22192,P
1975,A,5106,5106,5106,5677,5677,1976,0,A
1975,B,623,623,5729,90,5767,1976,5106,B
1975,C,956,956,6685,1310,7077,1976,5729,C
1975,D,266,266,6951,3780,10857,1976,6685,D
1975,M,11,11,6962,152,11009,1976,6951,M
1975,N,281,281,7243,150,11159,1976,6962,N
1975,O,617,617,7860,680,11839,1976,7243,O
1975,P,23,23,7883,3690,15529,1976,7860,P
1976,AEI,88,88,88,952,952,1977,0,A
1976,BEI,1053,1053,1141,240,1192,1977,88,B
1976,CEI,1667,526,1667,3212,3212,1977,0,I
1976,CEJ,841,315,1982,995,2187,1977,1141,C
1976,DEJ,1220,1220,3202,4680,6867,1977,1982,D
1976,EJ,1746,211,3413,240,3452,1977,1667,J
1976,EK,4008,595,4008,4742,4742,1977,0,E
1976,FK,803,208,4216,765,4217,1977,3413,K
1976,FJ,765,557,4773,90,4832,1977,4008,F
1976,GJ,906,349,5122,935,5152,1977,4216,J
1976,GK,401,52,5174,795,5627,1977,4773,G
1976,HK,791,739,5913,947,6099,1977,5122,K
1976,HL,1014,275,6188,3780,9407,1977,5174,H
1976,L,889,614,6802,348,6447,1977,5913,L
1976,M,3791,3791,10593,3943,13350,1977,6802,M
1976,N,308,308,10901,90,13440,1977,10593,N
1976,O,654,654,11555,795,14235,1977,10901,O
1976,N,925,925,12480,880,15115,1977,11555,N
1976,O,232,232,12712,695,15810,1977,12480,O
1976,P,1568,1568,14280,3780,19590,1977,12712,P
1977,AE,876,876,876,1196,1196,1978,0,E
1977,AF,358,358,1234,90,1286,1978,876,F
1977,AG,906,906,2140,1225,2511,1978,1234,G
1977,AF,395,395,2535,85,2596,1978,2140,F
1977,AG,291,291,2826,585,3181,1978,2535,G
1977,AH,19210,16384,19210,21865,21865,1978,0,A
1977,BH,17029,645,19855,3780,6961,1978,2826,H
1977,B,2683,2038,21893,90,21955,1978,19210,B
1977,C,1146,1146,23039,1375,23330,1978,21893,C
1977,B,579,579,23618,340,23670,1978,23039,B
1977,C,163,163,23781,585,24255,1978,23618,C
1977,D,14410,14410,38191,3780,28035,1978,23781,D
1977,M,217,217,38408,216,28251,1978,38191,M
1977,N,362,362,38770,390,28641,1978,38408,N
1977,O,1015,1015,39785,1140,29781,1978,38770,O
1977,N,552,552,40337,460,30241,1978,39785,N
1977,O,187,187,40524,385,30626,1978,40337,O
1977,P,1373,1373,41897,950,31576,1978,40524,P
1978,AEI,143,143,143,1005,1005,1979,0,A
1978,BEI,1044,901,1044,1399,1399,1979,0,I
1978,BEJ,982,81,1125,180,1185,1979,143,B
1978,CEJ,602,521,1646,300,1699,1979,1044,J
1978,CEK,966,445,2091,1055,2240,1979,1125,C
1978,BEK,648,203,2294,825,2524,1979,1646,K
1978,BEJ,1393,1393,3687,1255,3779,1979,2294,J
1978,BEK,284,284,3971,430,4209,1979,3687,K
1978,BEL,2457,577,4548,1970,4210,1979,2091,B
1978,CEL,250,250,4798,440,4650,1979,4548,C
1978,DEL,1513,686,5484,8050,12259,1979,3971,L
1978,DE,5677,193,5677,5920,5920,1979,0,E
1978,DF,663,663,6340,480,6400,1979,5677,F
1978,DG,802,802,7142,990,7390,1979,6340,G
1978,DF,1518,1518,8660,1365,8755,1979,7142,F
1978,DG,471,471,9131,485,9240,1979,8660,G
1978,DH,4410,77,9208,9900,14550,1979,4798,D
1978,H,1740,1663,10871,340,9580,1979,9131,H
1978,M,247,247,11118,487,15037,1979,10871,M
1978,N,300,300,11418,120,15157,1979,11118,N
1978,O,285,285,11703,315,15472,1979,11418,O
1978,N,392,392,12095,360,15832,1979,11703,N
1978,O,2990,2990,15085,5001,20833,1979,12095,O
1978,P,4,4,15089,2854,23687,1979,15085,P
1979,AEI,37,37,37,1191,1191,1980,0,E
1979,AFI,117,80,117,282,282,1980,0,I
1979,AFJ,213,213,330,90,372,1980,117,J
1979,AFK,333,333,663,695,1067,1980,330,K
1979,AFL,309,309,972,3780,4847,1980,663,L
1979,AF,1188,253,1225,90,1281,1980,37,F
1979,AG,960,960,2185,1210,2491,1980,1225,G
1979,AH,236,236,2421,3780,6271,1980,2185,H
1979,A,4264,1843,4264,4516,4516,1980,0,A
1979,B,322,322,4586,90,4606,1980,4264,B
1979,C,1665,1665,6251,1910,6516,1980,4586,C
1979,D,322,322,6573,3780,10296,1980,6251,D
1979,M,1801,1801,8374,2289,12585,1980,6573,M
1979,N,532,532,8906,90,12675,1980,8374,N
1979,O,746,746,9652,1135,13810,1980,8906,O
1979,P,19031,19031,28683,3780,17590,1980,9652,P
1980,AEI,83,83,83,1027,1027,1981,0,E
1980,AFI,146,63,146,1337,1337,1981,0,A
1980,BFI,679,533,679,3533,3533,1981,0,I
1980,BFJ,1123,527,1206,240,1267,1981,83,F
1980,BGJ,1374,314,1520,240,1577,1981,146,B
1980,CGJ,961,647,2167,995,2262,1981,1206,G
1980,CHJ,65,65,2232,4680,6942,1981,2167,H
1980,CJ,818,106,2338,995,2572,1981,1520,C
1980,DJ,353,353,2691,4680,7252,1981,2338,D
1980,J,2885,873,3564,90,3623,1981,679,J
1980,K,750,750,4314,805,4428,1981,3564,K
1980,J,273,273,4587,185,4613,1981,4314,J
1980,K,324,324,4911,795,5408,1981,4587,K
1980,L,527,527,5438,3780,9188,1981,4911,L
1980,M,1928,1928,7366,2034,11222,1981,5438,M
1980,N,134,134,7500,90,11312,1981,7366,N
1980,O,445,445,7945,820,12132,1981,7500,O
1980,N,754,754,8699,375,12507,1981,7945,N
1980,O,473,473,9172,740,13247,1981,8699,O
1980,P,2386,2386,11558,3780,17027,1981,9172,P
1981,A,1765,1765,1765,2318,2318,1982,0,A
1981,B,744,744,2509,240,2558,1982,1765,B
1981,C,162,162,2671,400,2958,1982,2509,C
1981,B,547,547,3218,285,3243,1982,2671,B
1981,C,593,593,3811,925,4168,1982,3218,C
1981,D,262,262,4073,3960,8128,1982,3811,D
1981,M,600,600,4673,1479,9607,1982,4073,M
1981,N,1130,1130,5803,300,9907,1982,4673,N
1981,O,885,885,6688,1000,10907,1982,5803,O
1981,N,413,413,7101,535,11442,1982,6688,N
1981,O,200,200,7301,390,11832,1982,7101,O
1981,P,3214,3214,10515,3960,15792,1982,7301,P
1982,A,33,33,33,84,84,1983,0,A
1982,B,260,260,293,240,324,1983,33,B
1982,C,258,258,551,285,609,1983,293,C
1982,D,1048,1048,1599,5160,5769,1983,551,D
1982,M,2104,2104,3703,2681,8450,1983,1599,M
1982,N,622,622,4325,90,8540,1983,3703,N
1982,O,935,935,5260,1240,9780,1983,4325,O
1982,P,20,20,5280,3780,13560,1983,5260,P
1983,AE,282,282,282,1039,1039,1984,0,A
1983,BE,853,853,1135,150,1189,1984,282,B
1983,CE,142,142,1277,100,1289,1984,1135,C
1983,BE,541,541,1818,570,1859,1984,1277,B
1983,CE,822,822,2640,660,2519,1984,1818,C
1983,DE,1386,1386,4026,4230,6749,1984,2640,D
1983,E,5797,1771,5797,5740,5740,1984,0,E
1983,F,218,218,6015,300,6040,1984,5797,F
1983,G,884,884,6899,1005,7045,1984,6015,G
1983,H,585,585,7484,1200,8245,1984,6899,H
1983,M,596,596,8080,747,8992,1984,7484,M
1983,N,296,296,8376,180,9172,1984,8080,N
1983,O,106,106,8482,665,9837,1984,8376,O
1983,P,118585,118585,127067,6900,16737,1984,8482,P
1984,A,8777,8777,8777,9145,9145,1985,0,A
1984,B,580,580,9357,240,9385,1985,8777,B
1984,C,626,626,9983,920,10305,1985,9357,C
1984,D,265,265,10248,3960,14265,1985,9983,D
1984,M,1,1,10249,1080,15345,1985,10248,M
1984,N,1281,1281,11530,240,15585,1985,10249,N
1984,O,678,678,12208,880,16465,1985,11530,O
1984,P,116,116,12324,3960,20425,1985,12208,P
1985,AEI,234,234,234,290,290,1986,0,I
1985,AEJ,365,131,365,1139,1139,1986,0,E
1985,AFJ,189,58,423,180,470,1986,234,J
1985,AFK,136,136,559,210,680,1986,423,K
1985,AFJ,954,760,1319,240,1379,1986,365,F
1985,AGJ,142,142,1461,395,1774,1986,1319,G
1985,AHJ,927,25,1486,765,1445,1986,559,J
1985,AHK,1552,66,1552,2992,2992,1986,0,A
1985,BHK,179,113,1665,265,1710,1986,1486,K
1985,BHL,1362,1362,3027,4140,5850,1986,1665,L
1985,BH,1800,325,3352,420,3412,1986,1552,B
1985,CH,884,884,4236,1150,4562,1986,3352,C
1985,BH,2848,73,4309,9700,11474,1986,1461,H
1985,B,892,819,5128,625,5187,1986,4236,B
1985,C,2689,2689,7817,2745,7932,1986,5128,C
1985,D,1599,1599,9416,385,8317,1986,7817,D
1985,M,1311,1311,10727,1399,12873,1986,9416,M
1985,N,284,284,11011,240,13113,1986,10727,N
1985,O,518,518,11529,765,13878,1986,11011,O
1985,P,274,274,11803,9700,23578,1986,11529,P
1986,A,1408,1408,1408,1747,1747,1987,0,A
1986,B,623,623,2031,260,2007,1987,1408,B
1986,C,1283,1283,3314,1175,3182,1987,2031,C
1986,D,480,480,3794,600,3782,1987,3314,D
1986,M,768,768,4562,1301,5083,1987,3794,M
1986,N,792,792,5354,300,5383,1987,4562,N
1986,O,549,549,5903,700,6083,1987,5354,O
1986,P,1193,1193,7096,4080,10163,1987,5903,P
1987,AE,651,651,651,757,757,1988,0,A
1987,BE,304,304,955,180,937,1988,651,B
1987,CE,997,997,1952,880,1817,1988,955,C
1987,DE,3567,1615,3567,3765,3765,1988,0,E
1987,DF,602,602,4169,180,3945,1988,3567,F
1987,DG,2423,206,4375,6660,8477,1988,1952,D
1987,G,3115,2909,7284,880,4825,1988,4169,G
1987,H,1709,1709,8993,6660,11485,1988,7284,H
1987,M,772,772,9765,1285,12770,1988,8993,M
1987,N,640,640,10405,90,12860,1988,9765,N
1987,O,517,517,10922,820,13680,1988,10405,O
1987,N,1466,1466,12388,1260,14940,1988,10922,N
1987,O,751,751,13139,1060,16000,1988,12388,O
1987,P,920,920,14059,3840,19840,1988,13139,P
1988,A,2405,2405,2405,2559,2559,1989,0,A
1988,B,223,223,2628,90,2649,1989,2405,B
1988,C,588,588,3216,815,3464,1989,2628,C
1988,D,1563,1563,4779,3780,7244,1989,3216,D
1988,M,5160,5160,9939,5292,12536,1989,4779,M
1988,N,185,185,10124,90,12626,1989,9939,N
1988,O,581,581,10705,850,13476,1989,10124,O
1988,P,621,621,11326,3780,17256,1989,10705,P
1989,A,295,295,295,914,914,1990,0,A
1989,B,735,735,1030,150,1064,1990,295,B
1989,C,219,219,1249,115,1179,1990,1030,C
1989,B,2041,2041,3290,2155,3334,1990,1249,B
1989,C,649,649,3939,605,3939,1990,3290,C
1989,D,3999,3999,7938,4230,8169,1990,3939,D
1989,M,1274,1274,9212,1298,9467,1990,7938,M
1989,N,260,260,9472,240,9707,1990,9212,N
1989,O,686,686,10158,915,10622,1990,9472,O
1989,N,1110,1110,11268,930,11552,1990,10158,N
1989,O,1196,1196,12464,1560,13112,1990,11268,O
1989,P,1490,1490,13954,3960,17072,1990,12464,P
1990,AE,251,251,251,427,427,1991,0,E
1990,AF,200,200,451,90,517,1991,251,F
1990,AG,1455,1004,1455,1589,1589,1991,0,A
1990,BG,174,174,1629,90,1679,1991,1455,B
1990,CG,1507,329,1958,1745,2262,1991,451,G
1990,CH,54,54,2012,3780,6042,1991,1958,H
1990,C,589,206,2218,820,2499,1991,1629,C
1990,D,45,45,2263,3780,6279,1991,2218,D
1990,M,1369,1369,3632,1733,8012,1991,2263,M
1990,N,395,395,4027,90,8102,1991,3632,N
1990,O,509,509,4536,815,8917,1991,4027,O
1990,P,25080,25080,29616,3780,12697,1991,4536,P
1991,A,288,288,288,629,629,1992,0,A
1991,B,638,638,926,360,989,1992,288,B
1991,C,405,405,1331,947,1936,1992,926,C
1991,D,1413,1413,2744,948,2884,1992,1331,D
1991,M,1439,1439,4183,2044,4928,1992,2744,M
1991,N,676,676,4859,90,5018,1992,4183,N
1991,O,521,521,5380,825,5843,1992,4859,O
1991,N,3630,3630,9010,3350,9193,1992,5380,N
1991,O,2089,2089,11099,1440,10633,1992,9010,O
1991,P,1675,1675,12774,3780,14413,1992,11099,P
1992,AE,95,95,95,958,958,1993,0,E
1992,AF,607,512,607,1234,1234,1993,0,A
1992,BF,899,387,994,90,1048,1993,95,F
1992,BG,368,368,1362,800,1848,1993,994,G
1992,BH,776,21,1383,180,1414,1993,607,B
1992,CH,792,792,2175,895,2309,1993,1383,C
1992,BH,982,169,2344,3780,5628,1993,1362,H
1992,B,799,630,2974,725,3034,1993,2175,B
1992,C,601,601,3575,730,3764,1993,2974,C
1992,D,157,157,3732,4020,7784,1993,3575,D
1992,M,1913,1913,5645,2007,9791,1993,3732,M
1992,N,119,119,5764,90,9881,1993,5645,N
1992,O,631,631,6395,820,10701,1993,5764,O
1992,N,547,547,6942,355,11056,1993,6395,N
1992,O,683,683,7625,1070,12126,1993,6942,O
1992,P,33,33,7658,3780,15906,1993,7625,P
1993,AEI,115,115,115,375,375,1994,0,I
1993,AEJ,300,185,300,590,590,1994,0,E
1993,AFJ,380,195,495,180,555,1994,115,J
1993,AFK,410,215,710,180,770,1994,300,F
1993,AGK,298,83,793,660,1215,1994,495,K
1993,AGJ,264,181,974,645,1415,1994,710,G
1993,AFJ,1781,807,1781,1900,1900,1994,0,A
1993,BFJ,1061,73,1854,690,1905,1994,793,J
1993,BFK,1129,249,2103,690,2105,1994,974,F
1993,BGK,376,54,2157,300,2200,1994,1781,B
1993,CGK,796,493,2650,885,2790,1994,1854,K
1993,CGL,4,4,2654,2940,5730,1994,2650,L
1993,CG,800,249,2903,885,2990,1994,2103,G
1993,CH,756,10,2913,830,3030,1994,2157,C
1993,DH,28,28,2941,2940,5970,1994,2913,D
1993,H,72,34,2975,2940,5930,1994,2903,H
1993,M,1451,1451,4426,1605,7575,1994,2975,M
1993,N,424,424,4850,310,7885,1994,4426,N
1993,O,597,597,5447,770,8655,1994,4850,O
1993,N,768,768,6215,550,9205,1994,5447,N
1993,O,591,591,6806,755,9960,1994,6215,O
1993,P,394,394,7200,1140,11100,1994,6806,P
1994,AE,1,1,1,131,131,1995,0,A
1994,BE,231,231,232,150,281,1995,1,B
1994,CE,1191,959,1191,1201,1201,1995,0,E
1994,CF,205,205,1396,240,1441,1995,1191,F
1994,CG,1217,53,1449,180,461,1995,232,C
1994,DG,393,393,1842,4200,4661,1995,1449,D
1994,G,937,491,2333,860,2301,1995,1396,G
1994,H,235,235,2568,3960,6261,1995,2333,H
1994,M,433,433,3001,1116,7377,1995,2568,M
1994,N,878,878,3879,240,7617,1995,3001,N
1994,O,543,543,4422,815,8432,1995,3879,O
1994,P,187,187,4609,3840,12272,1995,4422,P
1995,A,1519,1519,1519,1743,1743,1996,0,A
1995,B,644,644,2163,480,2223,1996,1519,B
1995,C,711,711,2874,990,3213,1996,2163,C
1995,B,1015,1015,3889,600,3813,1996,2874,B
1995,C,2473,2473,6362,2628,6441,1996,3889,C
1995,D,574,574,6936,402,6843,1996,6362,D
1995,M,71,71,7007,121,6964,1996,6936,M
1995,N,146,146,7153,150,7114,1996,7007,N
1995,O,127,127,7280,125,7239,1996,7153,O
1995,N,907,907,8187,890,8129,1996,7280,N
1995,O,384,384,8571,645,8774,1996,8187,O
1995,P,10545,10545,19116,4230,13004,1996,8571,P
1996,AE,68,68,68,60,60,1997,0,A
1996,BE,67,67,135,135,195,1997,68,B
1996,CE,239,104,239,214,214,1997,0,E
1996,CF,188,84,323,280,475,1997,135,C
1996,DF,162,78,401,240,454,1997,239,F
1996,DG,232,154,555,5160,5635,1997,323,D
1996,G,184,30,585,285,739,1997,401,G
1996,H,1781,1781,2366,5160,5899,1997,585,H
1996,M,161,161,2527,423,6322,1997,2366,M
1996,N,413,413,2940,180,6502,1997,2527,N
1996,O,516,516,3456,885,7387,1997,2940,O
1996,P,73,73,3529,6680,14067,1997,3456,P
1997,A,57,57,57,989,989,1998,0,A
1997,B,1120,1120,1177,240,1229,1998,57,B
1997,C,850,850,2027,1020,2249,1998,1177,C
1997,D,448,448,2475,4680,6929,1998,2027,D
1997,M,910,910,3385,1166,8095,1998,2475,M
1997,N,416,416,3801,180,8275,1998,3385,N
1997,O,850,850,4651,930,9205,1998,3801,O
1997,P,2167,2167,6818,550,9755,1998,4651,P
1998,AEI,74,74,74,1388,1388,1999,0,A
1998,BEI,219,145,219,1752,1752,1999,0,E
1998,BFI,484,265,484,1510,1510,1999,0,I
1998,BFJ,1338,928,1412,90,1478,1999,74,B
1998,CFJ,1056,128,1540,90,1600,1999,484,J
1998,CFK,1561,240,1780,90,1842,1999,219,F
1998,CGK,980,740,2520,1210,2810,1999,1540,K
1998,CGL,7,7,2527,3780,6590,1999,2520,L
1998,CG,1518,403,2930,1780,3258,1999,1412,C
1998,DG,150,150,3080,3780,7038,1999,2930,D
1998,G,1433,133,3213,1745,3587,1999,1780,G
1998,H,150,150,3363,3780,7367,1999,3213,H
1998,M,635,635,3998,1059,8426,1999,3363,M
1998,N,449,449,4447,90,8516,1999,3998,N
1998,O,197,197,4644,625,9141,1999,4447,O
1998,P,338,338,4982,3780,12921,1999,4644,P
1999,A,1555,1555,1555,1720,1720,2000,0,A
1999,B,285,285,1840,180,1900,2000,1555,B
1999,C,344,344,2184,660,2560,2000,1840,C
1999,B,1014,1014,3198,580,3140,2000,2184,B
1999,C,719,719,3917,840,3980,2000,3198,C
1999,D,143,143,4060,1560,5540,2000,3917,D
1999,M,55,55,4115,596,6136,2000,4060,M
1999,N,1991,1991,6106,1500,7636,2000,4115,N
1999,O,791,791,6897,995,8631,2000,6106,O
1999,N,1107,1107,8004,910,9541,2000,6897,N
1999,O,183,183,8187,300,9841,2000,8004,O
1999,P,648,648,8835,5100,14941,2000,8187,P
2000,AEI,395,395,395,1014,1014,2001,0,I
2000,AEJ,631,236,631,1372,1372,2001,0,E
2000,AFJ,803,172,803,1291,1291,2001,0,A
2000,BFJ,735,327,1130,150,1164,2001,395,J
2000,BFK,196,196,1326,115,1279,2001,1130,K
2000,BFJ,770,75,1401,90,1462,2001,631,F
2000,BGJ,634,36,1437,180,1471,2001,803,B
2000,CGJ,434,323,1760,525,1804,2001,1326,J
2000,CGK,486,127,1887,845,2307,2001,1401,G
2000,CHK,679,229,2116,885,2356,2001,1437,C
2000,BHK,646,290,2406,590,2394,2001,1760,K
2000,BHL,975,685,3091,795,3151,2001,2116,B
2000,CHL,1729,525,3616,3780,6087,2001,1887,H
2000,CL,554,29,3645,665,3816,2001,3091,C
2000,DL,3571,3571,7216,5460,9276,2001,3645,D
2000,L,31961,27151,34367,4230,6624,2001,2406,L
2000,M,205,205,34572,896,10172,2001,34367,M
2000,N,974,974,35546,300,10472,2001,34572,N
2000,O,958,958,36504,910,11382,2001,35546,O
2000,N,755,755,37259,885,12267,2001,36504,N
2000,O,895,895,38154,1141,13408,2001,37259,O
2000,P,845,845,38999,3960,17368,2001,38154,P
2001,A,42,42,42,121,121,2002,0,A
2001,B,266,266,308,240,361,2002,42,B
2001,C,584,584,892,925,1286,2002,308,C
2001,D,228,228,1120,3960,5246,2002,892,D
2001,M,1593,1593,2713,2428,7674,2002,1120,M
2001,N,896,896,3609,90,7764,2002,2713,N
2001,O,449,449,4058,855,8619,2002,3609,O
2001,N,1059,1059,5117,675,9294,2002,4058,N
2001,O,475,475,5592,790,10084,2002,5117,O
2001,P,889,889,6481,3780,13864,2002,5592,P
2002,A,266,266,266,1215,1215,2003,0,A
2002,B,979,979,1245,90,1305,2003,266,B
2002,C,902,902,2147,1240,2545,2003,1245,C
2002,B,1509,1509,3656,1150,3695,2003,2147,B
2002,C,179,179,3835,690,4385,2003,3656,C
2002,D,6060,6060,9895,3780,8165,2003,3835,D
2002,M,3305,3305,13200,4210,12375,2003,9895,M
2002,N,947,947,14147,90,12465,2003,13200,N
2002,O,352,352,14499,685,13150,2003,14147,O
2002,N,1705,1705,16204,1380,14530,2003,14499,N
2002,O,1138,1138,17342,1340,15870,2003,16204,O
2002,P,3053,3053,20395,3780,19650,2003,17342,P
2003,AE,433,433,433,1685,1685,2004,0,A
2003,BE,1398,965,1398,1462,1462,2004,0,E
2003,BF,1362,397,1795,180,1865,2004,433,B
2003,CF,423,26,1821,420,1882,2004,1398,F
2003,CG,560,534,2355,560,2425,2004,1795,C
2003,DG,190,190,2545,2850,5275,2004,2355,D
2003,G,788,64,2609,955,2837,2004,1821,G
2003,F,489,489,3098,325,3162,2004,2609,F
2003,G,561,561,3659,265,3427,2004,3098,G
2003,H,7942,7942,11601,5160,8587,2004,3659,H
2003,M,518,518,12119,1148,9735,2004,11601,M
2003,N,810,810,12929,240,9975,2004,12119,N
2003,O,290,290,13219,325,10300,2004,12929,O
2003,N,1352,1352,14571,1300,11600,2004,13219,N
2003,O,721,721,15292,610,12210,2004,14571,O
2003,P,1363,1363,16655,5100,17310,2004,15292,P
2004,AE,5180,5180,5180,4580,4580,2005,0,E
2004,AF,126,126,5306,780,5360,2005,5180,F
2004,AG,275,275,5581,395,5755,2005,5306,G
2004,AH,404,404,5985,1590,7345,2005,5581,H
2004,A,13568,7583,13568,13719,13719,2005,0,A
2004,B,483,483,14051,360,14079,2005,13568,B
2004,C,682,682,14733,860,14939,2005,14051,C
2004,D,186,186,14919,1590,16529,2005,14733,D
2004,M,1942,1942,16861,2985,19514,2005,14919,M
2004,N,1421,1421,18282,300,19814,2005,16861,N
2004,O,724,724,19006,780,20594,2005,18282,O
2004,P,1171,1171,20177,1140,21734,2005,19006,P
2005,AE,42,42,42,805,805,2006,0,A
2005,BE,80,38,80,150,150,2006,0,E
2005,BF,253,253,333,240,390,2006,80,F
2005,BG,125,125,458,215,605,2006,333,G
2005,BH,861,445,903,150,955,2006,42,B
2005,CH,160,160,1063,155,1110,2006,903,C
2005,DH,655,50,1113,4890,5495,2006,458,H
2005,D,1553,1503,2616,4200,5310,2006,1063,D
2005,M,446,446,3062,2346,7841,2006,2616,M
2005,N,2114,2114,5176,240,8081,2006,3062,N
2005,O,647,647,5823,1015,9096,2006,5176,O
2005,P,1542,1542,7365,3960,13056,2006,5823,P
2006,AEI,659,659,659,1241,1241,2007,0,I
2006,AEJ,618,618,1277,90,1331,2007,659,J
2006,AEK,1971,694,1971,2873,2873,2007,0,A
2006,BEK,970,276,2247,1225,2556,2007,1277,K
2006,BEJ,2664,417,2664,3838,3838,2007,0,E
2006,BFJ,929,236,2900,90,2963,2007,1971,B
2006,CFJ,691,38,2938,440,2996,2007,2247,J
2006,CFK,744,706,3644,905,3868,2007,2900,C
2006,BFK,826,120,3764,1080,4076,2007,2938,K
2006,BFL,1219,119,3883,90,3928,2007,2664,F
2006,BGL,634,395,4278,465,4333,2007,3644,B
2006,CGL,820,306,4584,3780,7856,2007,3764,L
2006,CG,723,22,4606,1060,4988,2007,3883,G
2006,CH,231,231,4837,3780,8768,2007,4606,H
2006,C,764,205,5042,1080,5413,2007,4278,C
2006,D,215,215,5257,3780,9193,2007,5042,D
2006,M,376,376,5633,659,9852,2007,5257,M
2006,N,308,308,5941,90,9942,2007,5633,N
2006,O,793,793,6734,1105,11047,2007,5941,O
2006,P,608,608,7342,3780,14827,2007,6734,P
2007,A,82,82,82,237,237,2008,0,A
2007,B,357,357,439,240,477,2008,82,B
2007,C,764,764,1203,785,1262,2008,439,C
2007,D,4024,4024,5227,3900,5162,2008,1203,D
2007,M,1531,1531,6758,2618,7780,2008,5227,M
2007,N,1111,1111,7869,90,7870,2008,6758,N
2007,O,852,852,8721,1225,9095,2008,7869,O
2007,N,782,782,9503,400,9495,2008,8721,N
2007,O,941,941,10444,965,10460,2008,9503,O
2007,P,139,139,10583,3780,14240,2008,10444,P
2008,AE,3171,3171,3171,3568,3568,2009,0,A
2008,BE,604,604,3775,130,3698,2009,3171,B
2008,CE,4411,636,4411,4447,4447,2009,0,E
2008,CF,173,173,4584,180,4627,2009,4411,F
2008,CG,913,104,4688,925,4623,2009,3775,C
2008,DG,981,877,5565,965,5592,2009,4584,G
2008,DH,799,799,6364,385,5977,2009,5565,H
2008,D,5527,3851,10215,385,5008,2009,4688,D
2008,M,546,546,10761,1124,7101,2009,10215,M
2008,N,1318,1318,12079,780,7881,2009,10761,N
2008,O,942,942,13021,1159,9040,2009,12079,O
2008,P,788,788,13809,341,9381,2009,13021,P
2009,A,70,70,70,277,277,2010,0,A
2009,B,421,421,491,240,517,2010,70,B
2009,C,520,520,1011,845,1362,2010,491,C
2009,D,4923,4923,5934,3960,5322,2010,1011,D
2009,M,1595,1595,7529,2421,7743,2010,5934,M
2009,N,875,875,8404,90,7833,2010,7529,N
2009,O,466,466,8870,805,8638,2010,8404,O
2009,N,1114,1114,9984,755,9393,2010,8870,N
2009,O,968,968,10952,1470,10863,2010,9984,O
2009,P,1088,1088,12040,3780,14643,2010,10952,P
2010,A,1607,1607,1607,2450,2450,2011,0,A
2010,B,1094,1094,2701,300,2750,2011,1607,B
2010,C,890,890,3591,905,3655,2011,2701,C
2010,D,5654,5654,9245,2820,6475,2011,3591,D
2010,M,156,156,9401,1152,7627,2011,9245,M
2010,N,1116,1116,10517,180,7807,2011,9401,N
2010,O,940,940,11457,1055,8862,2011,10517,O
2010,N,874,874,12331,830,9692,2011,11457,N
2010,O,300,300,12631,300,9992,2011,12331,O
2010,P,249,249,12880,5100,15092,2011,12631,P
2011,AE,40,40,40,1133,1133,2012,0,A
2011,BE,555,515,555,900,900,2012,0,E
2011,BF,533,533,1088,240,1140,2012,555,F
2011,BG,1123,75,1163,90,1223,2012,40,B
2011,CG,135,60,1223,370,1510,2012,1088,G
2011,CF,787,787,2010,530,2040,2012,1223,F
2011,CG,930,83,2093,1220,2443,2012,1163,C
2011,DG,8,8,2101,3780,6223,2012,2093,D
2011,G,810,719,2820,1045,3085,2012,2010,G
2011,H,2502,2502,5322,3960,7045,2012,2820,H
2011,M,515,515,5837,1017,8062,2012,5322,M
2011,N,544,544,6381,90,8152,2012,5837,N
2011,O,358,358,6739,705,8857,2012,6381,O
2011,P,2581,2581,9320,3780,12637,2012,6739,P
2012,A,2452,2452,2452,3565,3565,2013,0,A
2012,B,1143,1143,3595,90,3655,2013,2452,B
2012,C,545,545,4140,805,4460,2013,3595,C
2012,B,1499,1499,5639,1230,5690,2013,4140,B
2012,C,372,372,6011,800,6490,2013,5639,C
2012,D,739,739,6750,3780,10270,2013,6011,D
2012,M,1571,1571,8321,2381,12651,2013,6750,M
2012,N,946,946,9267,180,12831,2013,8321,N
2012,O,849,849,10116,890,13721,2013,9267,O
2012,P,1957,1957,12073,550,14271,2013,10116,P
2013,AEI,382,382,382,665,665,2014,0,A
2013,BEI,201,201,583,240,905,2014,382,B
2013,CEI,1453,870,1453,2841,2841,2014,0,I
2013,CEJ,1010,140,1593,1470,2375,2014,583,C
2013,BEJ,792,792,2385,89,2464,2014,1593,B
2013,CEJ,1513,581,2966,180,3021,2014,1453,J
2013,CEK,782,201,3167,901,3365,2014,2385,C
2013,BEK,426,225,3392,510,3531,2014,2966,K
2013,BEJ,3655,263,3655,4360,4360,2014,0,E
2013,BFJ,1065,802,4457,970,4501,2014,3392,J
2013,BFK,964,162,4619,300,4660,2014,3655,F
2013,BGK,1475,23,4642,1330,4695,2014,3167,B
2013,CGK,803,803,5445,930,5625,2014,4642,C
2013,DGK,1093,105,5550,1317,5818,2014,4457,K
2013,DGL,1677,746,6296,1220,5880,2014,4619,G
2013,DHL,649,649,6945,1140,7020,2014,6296,H
2013,DL,3943,2548,9493,383,6201,2014,5550,L
2013,D,4638,590,10083,6990,12615,2014,5445,D
2013,M,516,516,10599,701,13316,2014,10083,M
2013,N,605,605,11204,480,13796,2014,10599,N
2013,O,831,831,12035,720,14516,2014,11204,O
2013,P,3185,3185,15220,550,15066,2014,12035,P
2014,A,685,685,685,1459,1459,2015,0,A
2014,B,795,795,1480,90,1549,2015,685,B
2014,C,587,587,2067,905,2454,2015,1480,C
2014,B,416,416,2483,90,2544,2015,2067,B
2014,C,2904,2904,5387,2320,4864,2015,2483,C
2014,D,4108,4108,9495,3420,8284,2015,5387,D
2014,M,1394,1394,10889,3028,11312,2015,9495,M
2014,N,1664,1664,12553,90,11402,2015,10889,N
2014,O,1636,1636,14189,1875,13277,2015,12553,O
2014,N,312,312,14501,60,13337,2015,14189,N
2014,O,193,193,14694,610,13947,2015,14501,O
2014,P,3943,3943,18637,3780,17727,2015,14694,P
2015,A,746,746,746,1362,1362,2016,0,A
2015,B,651,651,1397,90,1452,2016,746,B
2015,C,988,988,2385,1250,2702,2016,1397,C
2015,D,38,38,2423,3780,6482,2016,2385,D
2015,M,442,442,2865,1043,7525,2016,2423,M
2015,N,629,629,3494,90,7615,2016,2865,N
2015,O,490,490,3984,845,8460,2016,3494,O
2015,P,423,423,4407,3780,12240,2016,3984,P
2016,AE,288,288,288,1490,1490,2017,0,E
2016,AF,481,193,481,1015,1015,2017,0,A
2016,BF,629,629,1110,150,1165,2017,481,B
2016,CF,23,23,1133,100,1265,2017,1110,C
2016,BF,314,314,1447,235,1500,2017,1133,B
2016,CF,25,25,1472,255,1755,2017,1447,C
2016,DF,1472,288,1760,300,1790,2017,288,F
2016,DG,736,736,2496,795,2585,2017,1760,G
2016,DF,184,184,2680,155,2740,2017,2496,F
2016,DG,2602,2602,5282,1020,3760,2017,2680,G
2016,DH,4733,923,6205,5160,6915,2017,1472,D
2016,H,1230,307,6512,2940,6700,2017,5282,H
2016,M,1579,1579,8091,3844,10759,2017,6512,M
2016,N,2555,2555,10646,240,10999,2017,8091,N
2016,O,587,587,11233,1215,12214,2017,10646,O
2016,P,5225,5225,16458,3600,15814,2017,11233,P
2017,AEI,1499,1499,1499,1767,1767,2018,0,E
2017,AFI,332,332,1831,90,1857,2018,1499,F
2017,AGI,1905,74,1905,1997,1997,2018,0,A
2017,BGI,117,117,2022,90,2087,2018,1905,B
2017,CGI,2153,131,2153,2306,2306,2018,0,I
2017,CGJ,474,152,2305,860,2717,2018,1831,G
2017,CFJ,309,157,2462,90,2396,2018,2153,J
2017,CFK,630,190,2652,820,2907,2018,2022,C
2017,BFK,594,404,3056,795,3191,2018,2462,K
2017,BFJ,571,167,3223,375,3282,2018,2652,B
2017,CFJ,180,13,3236,75,3266,2018,3056,J
2017,CFK,1028,97,3333,670,3387,2018,2305,F
2017,CGK,346,249,3582,735,4001,2018,3236,K
2017,CGL,451,92,3674,740,4022,2018,3223,C
2017,DGL,471,130,3804,735,4122,2018,3333,G
2017,DHL,899,769,4573,3780,7802,2018,3674,D
2017,HL,1039,270,4843,3780,7902,2018,3804,H
2017,L,2551,1290,6133,3780,7781,2018,3582,L
2017,M,387,387,6520,1389,9291,2018,6133,M
2017,N,1082,1082,7602,155,9446,2018,6520,N
2017,O,796,796,8398,920,10366,2018,7602,O
2017,N,2535,2535,10933,2385,12751,2018,8398,N
2017,O,765,765,11698,2342,15093,2018,10933,O
2017,P,825,825,12523,918,16011,2018,11698,P
2018,A,917,917,917,1055,1055,2019,0,A
2018,B,503,503,1420,420,1475,2019,917,B
2018,C,1073,1073,2493,1250,2725,2019,1420,C
2018,D,4,4,2497,335,3060,2019,2493,D
2018,M,599,599,3096,685,3745,2019,2497,M
2018,N,366,366,3462,180,3925,2019,3096,N
2018,O,67,67,3529,665,4590,2019,3462,O
2018,P,164623,164623,168152,6900,11490,2019,3529,P
2019,AE,137,137,137,174,174,2020,0,E
2019,AF,162,162,299,150,324,2020,137,F
2019,AG,137,137,436,180,504,2020,299,G
2019,AH,922,922,1358,385,889,2020,436,H
2019,A,4022,2664,4022,4802,4802,2020,0,A
2019,B,825,825,4847,90,4892,2020,4022,B
2019,C,483,483,5330,735,5627,2020,4847,C
2019,B,1284,1284,6614,505,6132,2020,5330,B
2019,C,1185,1185,7799,1580,7712,2020,6614,C
2019,D,1710,1710,9509,3780,11492,2020,7799,D
2019,M,906,906,10415,1642,13134,2020,9509,M
2019,N,1126,1126,11541,420,13554,2020,10415,N
2019,O,811,811,12352,2174,15728,2020,11541,O
2019,P,476,476,12828,846,16574,2020,12352,P
2020,AEI,145,145,145,220,220,2021,0,A
2020,BEI,176,176,321,150,370,2021,145,B
2020,CEI,597,276,597,832,832,2021,0,E
2020,CFI,364,364,961,180,1012,2021,597,F
2020,CGI,232,232,1193,270,1282,2021,961,G
2020,CHI,997,125,1318,620,990,2021,321,C
2020,DHI,300,300,1618,4200,5190,2021,1318,D
2020,HI,707,282,1900,4140,5422,2021,1193,H
2020,I,2609,709,2609,2834,2834,2021,0,I
2020,J,482,482,3091,240,3074,2021,2609,J
2020,K,871,871,3962,855,3929,2021,3091,K
2020,L,120,120,4082,3960,7889,2021,3962,L
2020,M,450,450,4532,1898,9787,2021,4082,M
2020,N,1478,1478,6010,90,9877,2021,4532,N
2020,O,1422,1422,7432,1635,11512,2021,6010,O
2020,P,892,892,8324,3780,15292,2021,7432,P
2021,A,1089,1089,1089,1188,1188,2022,0,A
2021,B,294,294,1383,240,1428,2022,1089,B
2021,C,668,668,2051,910,2338,2022,1383,C
2021,D,1290,1290,3341,3900,6238,2022,2051,D
2021,M,2061,2061,5402,2862,9100,2022,3341,M
2021,N,851,851,6253,90,9190,2022,5402,N
2021,O,1050,1050,7303,1230,10420,2022,6253,O
2021,N,363,363,7666,200,10620,2022,7303,N
2021,O,241,241,7907,695,11315,2022,7666,O
2021,P,2661,2661,10568,3780,15095,2022,7907,P
2022,AEI,147,147,147,265,265,2023,0,I
2022,AEJ,165,18,165,194,194,2023,0,E
2022,AFJ,154,154,319,180,374,2023,165,F
2022,AGJ,204,32,351,150,415,2023,147,J
2022,AGK,140,140,491,80,495,2023,351,K
2022,AGJ,236,64,555,210,584,2023,319,G
2022,AHJ,560,5,560,888,888,2023,0,A
2022,BHJ,32,27,587,2850,3434,2023,555,H
2022,BJ,490,463,1050,150,1038,2023,560,B
2022,CJ,579,20,1070,635,1130,2023,491,J
2022,CK,116,116,1186,135,1265,2023,1070,K
2022,CL,172,36,1222,410,1448,2023,1050,C
2022,BL,203,203,1425,25,1473,2023,1222,B
2022,CL,296,57,1482,2850,4115,2023,1186,L
2022,C,175,118,1600,150,1623,2023,1425,C
2022,D,1346,1346,2946,4230,5853,2023,1600,D
2022,M,328,328,3274,1109,6962,2023,2946,M
2022,N,875,875,4149,155,7117,2023,3274,N
2022,O,261,261,4410,215,7332,2023,4149,O
2022,P,4288,4288,8698,2850,10182,2023,4410,P
2023,A,42,42,42,1056,1056,2024,0,A
2023,B,1199,1199,1241,240,1296,2024,42,B
2023,C,801,801,2042,930,2226,2024,1241,C
2023,D,18455,18455,20497,6990,9216,2024,2042,D
2023,M,10286,10286,30783,16434,25650,2024,20497,M
2023,N,5862,5862,36645,90,25740,2024,30783,N
2023,O,2277,2277,38922,1850,27590,2024,36645,O
2023,P,84,84,39006,3780,31370,2024,38922,P
2024,AE,267,267,267,728,728,2025,0,E
2024,AF,457,190,457,602,602,2025,0,A
2024,BF,533,533,990,210,812,2025,457,B
2024,CF,373,373,1363,530,1342,2025,990,C
2024,DF,1266,170,1533,900,1628,2025,267,F
2024,DG,201,31,1564,1350,2692,2025,1363,D
2024,G,915,884,2448,1727,3355,2025,1533,G
2024,H,13562,13562,16010,338,3693,2025,2448,H
2024,M,11111,11111,27121,11274,14967,2025,16010,M
2024,N,251,251,27372,90,15057,2025,27121,N
2024,O,632,632,28004,815,15872,2025,27372,O
2024,N,839,839,28843,705,16577,2025,28004,N
2024,O,228,228,29071,625,17202,2025,28843,O
2024,P,53628,53628,82699,3780,20982,2025,29071,P
2025,AEI,90,90,90,1086,1086,2026,0,E
2025,AFI,1066,1066,1156,120,1206,2026,90,F
2025,AGI,180,180,1336,420,1626,2026,1156,G
2025,AFI,2160,2160,3496,1935,3561,2026,1336,F
2025,AGI,685,685,4181,810,4371,2026,3496,G
2025,AHI,4558,377,4558,4864,4864,2026,0,A
2025,BHI,406,29,4587,5040,9411,2026,4181,H
2025,BI,351,322,4909,120,4984,2026,4558,B
2025,CI,56,56,4965,120,5104,2026,4909,C
2025,BI,247,247,5212,165,5269,2026,4965,B
2025,CI,680,680,5892,820,6089,2026,5212,C
2025,DI,52,52,5944,5040,11129,2026,5892,D
2025,I,6166,222,6166,5938,5938,2026,0,I
2025,J,410,410,6576,90,6028,2026,6166,J
2025,K,641,641,7217,1130,7158,2026,6576,K
2025,J,2396,2396,9613,1545,8703,2026,7217,J
2025,K,654,654,10267,1135,9838,2026,9613,K
2025,L,542,542,10809,3780,13618,2026,10267,L
2025,M,2939,2939,13748,3643,17261,2026,10809,M
2025,N,1904,1904,15652,1260,18521,2026,13748,N
2025,O,436,436,16088,400,18921,2026,15652,O
2025,P,4503,4503,20591,425,19346,2026,16088,P
2026,A,33,33,33,148,148,2027,0,A
2026,B,319,319,352,240,388,2027,33,B
2026,C,782,782,1134,1045,1433,2027,352,C
2026,D,81,81,1215,3960,5393,2027,1134,D
2026,M,4122,4122,5337,4835,10228,2027,1215,M
2026,N,750,750,6087,90,10318,2027,5337,N
2026,O,161,161,6248,605,10923,2027,6087,O
2026,P,1804,1804,8052,3780,14703,2027,6248,P
2027,A,2830,2830,2830,3267,3267,2028,0,A
2027,B,677,677,3507,300,3567,2028,2830,B
2027,C,835,835,4342,1100,4667,2028,3507,C
2027,B,2027,2027,6369,1785,6452,2028,4342,B
2027,C,2879,2879,9248,2826,9278,2028,6369,C
2027,D,1,1,9249,384,9662,2028,9248,D
2027,M,206,206,9455,285,9947,2028,9249,M
2027,N,198,198,9653,180,10127,2028,9455,N
2027,O,199,199,9852,335,10462,2028,9653,O
2027,N,1170,1170,11022,1035,11497,2028,9852,N
2027,O,145,145,11167,285,11782,2028,11022,O
2027,P,1120,1120,12287,5100,16882,2028,11167,P
2028,AEI,14,14,14,92,92,2029,0,E
2028,AFI,185,185,199,150,242,2029,14,F
2028,AGI,356,157,356,880,880,2029,0,I
2028,AGJ,680,523,879,765,1007,2029,199,G
2028,AHJ,648,125,1004,180,1060,2029,356,J
2028,AHK,135,135,1139,155,1215,2029,1004,K
2028,AHL,19,19,1158,2880,4095,2029,1139,L
2028,AH,1188,30,1188,1280,1280,2029,0,A
2028,BH,315,6,1194,3600,4607,2029,879,H
2028,B,268,262,1456,240,1520,2029,1188,B
2028,C,274,274,1730,775,2295,2029,1456,C
2028,B,474,474,2204,35,2330,2029,1730,B
2028,C,162,162,2366,310,2640,2029,2204,C
2028,D,192,192,2558,4140,6780,2029,2366,D
2028,M,1195,1195,3753,2433,9213,2029,2558,M
2028,N,1336,1336,5089,150,9363,2029,3753,N
2028,O,242,242,5331,155,9518,2029,5089,O
2028,N,676,676,6007,725,10243,2029,5331,N
2028,O,813,813,6820,765,11008,2029,6007,O
2028,P,259,259,7079,4230,15238,2029,6820,P
2029,AEI,305,305,305,437,437,2030,0,I
2029,AEJ,245,245,550,150,587,2030,305,J
2029,AEK,158,158,708,130,717,2030,550,K
2029,AEJ,916,916,1624,930,1647,2030,708,J
2029,AEK,1752,128,1752,2559,2559,2030,0,E
2029,AFK,343,215,1967,645,2292,2030,1624,K
2029,AFL,832,617,2584,90,2649,2030,1752,F
2029,AGL,510,510,3094,880,3529,2030,2584,G
2029,AFL,482,482,3576,110,3639,2030,3094,F
2029,AGL,1596,1596,5172,2315,5954,2030,3576,G
2029,AHL,7894,2722,7894,8691,8691,2030,0,A
2029,BHL,6243,316,8210,4230,6522,2030,1967,L
2029,BH,834,518,8728,90,8781,2030,7894,B
2029,CH,490,490,9218,880,9661,2030,8728,C
2029,BH,4468,422,9640,3420,9374,2030,5172,H
2029,B,487,65,9705,110,9771,2030,9218,B
2029,C,1603,1603,11308,2315,12086,2030,9705,C
2029,D,7177,7177,18485,3420,15506,2030,11308,D
2029,M,2621,2621,21106,2744,18250,2030,18485,M
2029,N,217,217,21323,150,18400,2030,21106,N
2029,O,628,628,21951,585,18985,2030,21323,O
2029,N,740,740,22691,760,19745,2030,21951,N
2029,O,124,124,22815,390,20135,2030,22691,O
2029,P,5040,5040,27855,3960,24095,2030,22815,P
2030,AE,1220,1220,1220,1700,1700,2031,0,E
2030,AF,725,725,1945,300,2000,2031,1220,F
2030,AG,2026,81,2026,2009,2009,2031,0,A
2030,BG,253,253,2279,240,2249,2031,2026,B
2030,CG,334,334,2613,660,2909,2031,2279,C
2030,BG,809,141,2754,1050,3050,2031,1945,G
2030,BH,590,449,3203,345,3254,2031,2613,B
2030,CH,572,572,3775,710,3964,2031,3203,C
2030,DH,1554,1554,5329,4080,8044,2031,3775,D
2030,H,2676,101,5430,1140,4190,2031,2754,H
2030,M,407,407,5837,1230,9274,2031,5430,M
2030,N,1094,1094,6931,300,9574,2031,5837,N
2030,O,872,872,7803,905,10479,2031,6931,O
2030,P,6990,6990,14793,2760,13239,2031,7803,P
2031,AEI,131,131,131,682,682,2032,0,I
2031,AEJ,649,649,780,150,832,2032,131,J
2031,AEK,890,110,890,1137,1137,2032,0,E
2031,AFK,134,24,914,100,932,2032,780,K
2031,AFJ,537,537,1451,570,1502,2032,914,J
2031,AFK,626,65,1516,420,1557,2032,890,F
2031,AGK,720,655,2171,660,2162,2032,1451,K
2031,AGL,1031,376,2547,1240,2797,2032,1516,G
2031,AHL,12,12,2559,335,3132,2032,2547,H
2031,AL,1132,744,3303,4230,6392,2032,2171,L
2031,A,9900,6597,9900,9880,9880,2032,0,A
2031,B,254,254,10154,300,10180,2032,9900,B
2031,C,847,847,11001,1005,11185,2032,10154,C
2031,D,612,612,11613,1200,12385,2032,11001,D
2031,M,378,378,11991,879,13264,2032,11613,M
2031,N,620,620,12611,180,13444,2032,11991,N
2031,O,941,941,13552,900,14344,2032,12611,O
2031,P,4852,4852,18404,550,14894,2032,13552,P
2032,AEI,340,340,340,1179,1179,2033,0,E
2032,AFI,395,55,395,758,758,2033,0,A
2032,BFI,402,7,402,1146,1146,2033,0,I
2032,BFJ,493,486,888,150,908,2033,395,B
2032,CFJ,213,213,1101,140,1048,2033,888,C
2032,BFJ,845,146,1247,150,1296,2033,402,J
2032,BFK,956,49,1296,150,1329,2033,340,F
2032,BGK,83,34,1330,85,1381,2033,1247,K
2032,BGJ,279,50,1380,330,1378,2033,1101,B
2032,CGJ,165,115,1495,150,1531,2033,1330,J
2032,CGK,125,10,1505,245,1623,2033,1380,C
2032,DGK,109,99,1604,125,1656,2033,1495,K
2032,DGL,64,64,1668,4230,5886,2033,1604,L
2032,DG,684,312,1980,125,1454,2033,1296,G
2032,DF,159,159,2139,715,2169,2033,1980,F
2032,DG,140,140,2279,120,2289,2033,2139,G
2032,DH,1061,287,2566,4110,5733,2033,1505,D
2032,H,705,418,2984,4230,6519,2033,2279,H
2032,M,17,17,3001,108,6627,2033,2984,M
2032,N,222,222,3223,180,6807,2033,3001,N
2032,O,160,160,3383,220,7027,2033,3223,O
2032,N,1610,1610,4993,1445,8472,2033,3383,N
2032,O,607,607,5600,900,9372,2033,4993,O
2032,P,204,204,5804,3960,13332,2033,5600,P
2033,AE,350,350,350,277,277,2034,0,E
2033,AF,1140,790,1140,1345,1345,2034,0,A
2033,BF,343,343,1483,180,1525,2034,1140,B
2033,CF,677,677,2160,675,2200,2034,1483,C
2033,DF,176,176,2336,4200,6400,2034,2160,D
2033,F,2114,128,2464,980,1257,2034,350,F
2033,G,1206,1206,3670,2460,3717,2034,2464,G
2033,F,199,199,3869,160,3877,2034,3670,F
2033,G,866,866,4735,970,4847,2034,3869,G
2033,H,8720,8720,13455,3960,8807,2034,4735,H
2033,M,52,52,13507,806,9613,2034,13455,M
2033,N,953,953,14460,240,9853,2034,13507,N
2033,O,501,501,14961,660,10513,2034,14460,O
2033,P,249,249,15210,3960,14473,2034,14961,P
2034,A,13,13,13,151,151,2035,0,A
2034,B,378,378,391,300,451,2035,13,B
2034,C,187,187,578,900,1351,2035,391,C
2034,B,960,960,1538,210,1561,2035,578,B
2034,C,672,672,2210,775,2336,2035,1538,C
2034,D,78,78,2288,4080,6416,2035,2210,D
2034,M,44,44,2332,1043,7459,2035,2288,M
2034,N,1194,1194,3526,240,7699,2035,2332,N
2034,O,673,673,4199,895,8594,2035,3526,O
2034,P,1053,1053,5252,3960,12554,2035,4199,P
2035,A,2305,2305,2305,5634,5634,2036,0,A
2035,B,3449,3449,5754,180,5814,2036,2305,B
2035,C,641,641,6395,840,6654,2036,5754,C
2035,B,1605,1605,8000,1395,8049,2036,6395,B
2035,C,692,692,8692,710,8759,2036,8000,C
2035,D,2711,2711,11403,6960,15719,2036,8692,D
2035,M,374,374,11777,261,15980,2036,11403,M
2035,N,248,248,12025,390,16370,2036,11777,N
2035,O,978,978,13003,995,17365,2036,12025,O
2035,P,1150,1150,14153,550,17915,2036,13003,P
2036,AE,105,105,105,1129,1129,2037,0,A
2036,BE,216,111,216,392,392,2037,0,E
2036,BF,343,343,559,180,572,2037,216,F
2036,BG,593,593,1152,683,1255,2037,559,G
2036,BH,1144,97,1249,180,1309,2037,105,B
2036,CH,484,387,1636,4080,5335,2037,1152,H
2036,C,781,394,2030,795,2104,2037,1249,C
2036,D,1134,1134,3164,550,2654,2037,2030,D
2036,M,5269,5269,8433,5282,10617,2037,3164,M
2036,N,385,385,8818,420,11037,2037,8433,N
2036,O,1127,1127,9945,1259,12296,2037,8818,O
2036,P,2984,2984,12929,351,12647,2037,9945,P
2037,AEI,227,227,227,666,666,2038,0,E
2037,AFI,342,115,342,2062,2062,2038,0,I
2037,AFJ,624,509,851,90,756,2038,227,F
2037,AGJ,1138,287,1138,1448,1448,2038,0,A
2037,BGJ,365,365,1503,90,1538,2038,1138,B
2037,CGJ,676,24,1527,1025,1781,2038,851,G
2037,CHJ,66,66,1593,3780,5561,2038,1527,H
2037,CJ,825,735,2328,1230,2768,2038,1503,C
2037,DJ,129,129,2457,3780,6548,2038,2328,D
2037,J,4015,1900,4357,90,2152,2038,342,J
2037,K,1133,1133,5490,1360,3512,2038,4357,K
2037,L,61,61,5551,3780,7292,2038,5490,L
2037,M,450,450,6001,794,8086,2038,5551,M
2037,N,373,373,6374,90,8176,2038,6001,N
2037,O,701,701,7075,1135,9311,2038,6374,O
2037,P,18785,18785,25860,3780,13091,2038,7075,P
2038,A,1356,1356,1356,1508,1508,2039,0,A
2038,B,424,424,1780,300,1808,2039,1356,B
2038,C,1282,1282,3062,1275,3083,2039,1780,C
2038,B,767,767,3829,1065,4148,2039,3062,B
2038,C,273,273,4102,510,4658,2039,3829,C
2038,D,431,431,4533,3960,8618,2039,4102,D
2038,M,35774,35774,40307,36373,44991,2039,4533,M
2038,N,614,614,40921,90,45081,2039,40307,N
2038,O,1263,1263,42184,1385,46466,2039,40921,O
2038,N,1312,1312,43496,1175,47641,2039,42184,N
2038,O,144,144,43640,585,48226,2039,43496,O
2038,P,1465,1465,45105,3780,52006,2039,43640,P
2039,A,187,187,187,451,451,2040,0,A
2039,B,294,294,481,90,541,2040,187,B
2039,C,383,383,864,800,1341,2040,481,C
2039,D,1179,1179,2043,3840,5181,2040,864,D
2039,M,3392,3392,5435,3637,8818,2040,2043,M
2039,N,279,279,5714,90,8908,2040,5435,N
2039,O,568,568,6282,795,9703,2040,5714,O
2039,N,412,412,6694,190,9893,2040,6282,N
2039,O,325,325,7019,535,10428,2040,6694,O
2039,P,34,34,7053,3780,14208,2040,7019,P
2040,AEI,114,114,114,980,980,2041,0,I
2040,AEJ,199,85,199,209,209,2041,0,A
2040,BEJ,114,114,313,150,359,2041,199,B
2040,CEJ,550,550,863,800,1159,2041,313,C
2040,DEJ,177,177,1040,3550,4709,2041,863,D
2040,EJ,968,42,1082,150,1130,2041,114,J
2040,EK,79,79,1161,65,1195,2041,1082,K
2040,EL,44,44,1205,2880,4075,2041,1161,L
2040,E,2820,1615,2820,2889,2889,2041,0,E
2040,F,275,275,3095,240,3129,2041,2820,F
2040,G,849,849,3944,855,3984,2041,3095,G
2040,F,447,447,4391,455,4439,2041,3944,F
2040,G,579,579,4970,385,4824,2041,4391,G
2040,H,1725,1725,6695,3960,8784,2041,4970,H
2040,M,129,129,6824,199,8983,2041,6695,M
2040,N,165,165,6989,150,9133,2041,6824,N
2040,O,176,176,7165,155,9288,2041,6989,O
2040,P,1282,1282,8447,4200,13488,2041,7165,P
2041,A,9312,9312,9312,9576,9576,2042,0,A
2041,B,292,292,9604,90,9666,2042,9312,B
2041,C,753,753,10357,1105,10771,2042,9604,C
2041,D,448,448,10805,3780,14551,2042,10357,D
2041,M,571,571,11376,963,15514,2042,10805,M
2041,N,420,420,11796,90,15604,2042,11376,N
2041,O,936,936,12732,1285,16889,2042,11796,O
2041,P,1316,1316,14048,3780,20669,2042,12732,P
2042,AE,1413,1413,1413,3099,3099,2043,0,E
2042,AF,2922,1509,2922,3008,3008,2043,0,A
2042,BF,176,176,3098,150,3158,2043,2922,B
2042,CF,1881,196,3294,240,3339,2043,1413,F
2042,CG,675,675,3969,780,4119,2043,3294,G
2042,CH,2529,1658,5627,3000,6158,2043,3098,C
2042,BH,1418,1418,7045,915,7073,2043,5627,B
2042,CH,3527,451,7496,9700,13819,2043,3969,H
2042,C,975,524,8020,1250,8323,2043,7045,C
2042,D,22,22,8042,335,8658,2043,8020,D
2042,M,1760,1760,9802,1913,15732,2043,8042,M
2042,N,197,197,9999,90,15822,2043,9802,N
2042,O,543,543,10542,800,16622,2043,9999,O
2042,P,73,73,10615,3780,20402,2043,10542,P
2043,A,3720,3720,3720,4552,4552,2044,0,A
2043,B,865,865,4585,90,4642,2044,3720,B
2043,C,287,287,4872,715,5357,2044,4585,C
2043,D,72,72,4944,3780,9137,2044,4872,D
2043,M,36371,36371,41315,36923,46060,2044,4944,M
2043,N,840,840,42155,90,46150,2044,41315,N
2043,O,435,435,42590,700,46850,2044,42155,O
2043,N,214,214,42804,200,47050,2044,42590,N
2043,O,601,601,43405,880,47930,2044,42804,O
2043,P,1556,1556,44961,3780,51710,2044,43405,P
2044,AEI,108,108,108,239,239,2045,0,I
2044,AEJ,128,20,128,1145,1145,2045,0,E
2044,AFJ,165,37,165,310,310,2045,0,A
2044,BFJ,186,129,294,180,419,2045,108,J
2044,BFK,247,118,412,150,460,2045,165,B
2044,CFK,121,121,533,110,570,2045,412,C
2044,DFK,357,118,651,660,1079,2045,294,K
2044,DFL,614,496,1147,4230,4800,2045,533,D
2044,FL,1131,112,1259,180,1325,2045,128,F
2044,GL,722,722,1981,715,2040,2045,1259,G
2044,HL,3338,2008,3989,3960,5039,2045,651,L
2044,H,2667,659,4648,3000,5040,2045,1981,H
2044,M,473,473,5121,1939,6979,2045,4648,M
2044,N,1496,1496,6617,90,7069,2045,5121,N
2044,O,1233,1233,7850,1420,8489,2045,6617,O
2044,N,653,653,8503,465,8954,2045,7850,N
2044,O,238,238,8741,695,9649,2045,8503,O
2044,P,8679,8679,17420,3780,13429,2045,8741,P
2045,AE,1378,1378,1378,1593,1593,2046,0,A
2045,BE,425,425,1803,270,1863,2046,1378,B
2045,CE,591,591,2394,780,2643,2046,1803,C
2045,BE,2991,597,2991,2994,2994,2046,0,E
2045,BF,137,137,3128,150,3144,2046,2991,F
2045,BG,853,119,3247,655,3298,2046,2394,B
2045,CG,807,688,3935,730,3874,2046,3128,G
2045,CF,1014,326,4261,2034,5332,2046,3247,C
2045,DF,573,573,4834,846,6178,2046,4261,D
2045,F,1144,245,5079,1215,5089,2046,3935,F
2045,G,793,793,5872,2034,7123,2046,5079,G
2045,H,1187,1187,7059,906,8029,2046,5872,H
2045,M,1544,1544,8603,2565,10594,2046,7059,M
2045,N,1610,1610,10213,600,11194,2046,8603,N
2045,O,1792,1792,12005,1740,12934,2046,10213,O
2045,P,622,622,12627,385,13319,2046,12005,P
2046,AEI,44,44,44,718,718,2047,0,A
2046,BEI,872,872,916,240,958,2047,44,B
2046,CEI,947,31,947,2804,2804,2047,0,E
2046,CFI,722,691,1638,785,1743,2047,916,C
2046,DFI,2044,1353,2991,240,3044,2047,947,F
2046,DGI,525,525,3516,825,3869,2047,2991,G
2046,DHI,5555,2039,5555,5896,5896,2047,0,I
2046,DHJ,568,568,6123,240,6136,2047,5555,J
2046,DHK,677,677,6800,785,6921,2047,6123,K
2046,DHL,68,68,6868,3960,10881,2047,6800,L
2046,DH,9782,4552,11420,3960,5703,2047,1638,D
2046,H,11579,3675,15095,3960,7829,2047,3516,H
2046,M,150,150,15245,433,11314,2047,15095,M
2046,N,348,348,15593,90,11404,2047,15245,N
2046,O,1388,1388,16981,1745,13149,2047,15593,O
2046,N,688,688,17669,340,13489,2047,16981,N
2046,O,697,697,18366,945,14434,2047,17669,O
2046,P,404,404,18770,3780,18214,2047,18366,P
2047,AEI,274,274,274,1194,1194,2048,0,E
2047,AFI,329,55,329,485,485,2048,0,I
2047,AFJ,276,276,605,180,665,2048,329,J
2047,AFK,410,410,1015,355,1020,2048,605,K
2047,AFJ,214,214,1229,250,1270,2048,1015,J
2047,AFK,95,95,1324,160,1430,2048,1229,K
2047,AFL,1140,90,1414,180,1374,2048,274,F
2047,AGL,681,681,2095,810,2184,2048,1414,G
2047,AHL,1016,245,2340,375,1805,2048,1324,L
2047,AH,2076,1831,4171,465,2649,2048,2095,H
2047,A,6027,1856,6027,6231,6231,2048,0,A
2047,B,414,414,6441,240,6471,2048,6027,B
2047,C,928,928,7369,995,7466,2048,6441,C
2047,B,308,308,7677,280,7746,2048,7369,B
2047,C,1081,1081,8758,1260,9006,2048,7677,C
2047,D,1517,1517,10275,3960,12966,2048,8758,D
2047,M,209,209,10484,243,13209,2048,10275,M
2047,N,209,209,10693,300,13509,2048,10484,N
2047,O,395,395,11088,600,14109,2048,10693,O
2047,N,2036,2036,13124,1755,15864,2048,11088,N
2047,O,1118,1118,14242,1315,17179,2048,13124,O
2047,P,7,7,14249,570,17749,2048,14242,P
2048,A,7223,7223,7223,7599,7599,2049,0,A
2048,B,438,438,7661,90,7689,2049,7223,B
2048,C,812,812,8473,1035,8724,2049,7661,C
2048,D,65,65,8538,3780,12504,2049,8473,D
2048,M,1482,1482,10020,1632,14136,2049,8538,M
2048,N,224,224,10244,90,14226,2049,10020,N
2048,O,366,366,10610,805,15031,2049,10244,O
2048,P,2505,2505,13115,3780,18811,2049,10610,P
2049,AEI,40,40,40,1334,1334,2050,0,A
2049,BEI,105,65,105,1351,1351,2050,0,E
2049,BFI,1127,1022,1127,1413,1413,2050,0,I
2049,BFJ,1476,389,1516,240,1574,2050,40,B
2049,CFJ,1433,22,1538,240,1591,2050,105,F
2049,CGJ,485,74,1612,240,1653,2050,1127,J
2049,CGK,597,501,2113,620,2194,2050,1516,C
2049,DGK,576,1,2114,620,2211,2050,1538,G
2049,DHK,582,80,2194,620,2273,2050,1612,K
2049,DHL,642,561,2755,6300,8494,2050,2113,D
2049,HL,2281,1640,4395,6300,8511,2050,2114,H
2049,L,3990,1789,6184,6300,8573,2050,2194,L
2049,M,217,217,6401,548,9121,2050,6184,M
2049,N,543,543,6944,270,9391,2050,6401,N
2049,O,491,491,7435,735,10126,2050,6944,O
2049,N,2954,2954,10389,2705,12831,2050,7435,N
2049,O,37,37,10426,180,13011,2050,10389,O
2049,P,1355,1355,11781,5280,18291,2050,10426,P
2050,AEI,573,573,573,732,732,2051,0,E
2050,AFI,617,44,617,2035,2035,2051,0,A
2050,BFI,219,175,792,120,852,2051,573,F
2050,BGI,992,200,992,1255,1255,2051,0,I
2050,BGJ,408,408,1400,150,1405,2051,992,J
2050,BGK,73,73,1473,95,1500,2051,1400,K
2050,BGJ,987,306,1779,1210,2062,2051,792,G
2050,BFJ,1621,459,2238,240,2275,2051,617,B
2050,CFJ,1097,332,2570,1110,2610,2051,1473,J
2050,CFK,726,394,2964,825,3100,2051,2238,C
2050,BFK,1245,60,3024,1000,3062,2051,1779,F
2050,BGK,645,191,3215,710,3320,2051,2570,K
2050,BGL,327,76,3291,215,3315,2051,2964,B
2050,CGL,656,656,3947,1005,4320,2051,3291,C
2050,DGL,1088,165,4112,1431,4493,2051,3024,G
2050,DHL,1646,749,4861,4230,7550,2051,3215,L
2050,DH,1609,695,5556,3960,8280,2051,3947,D
2050,H,3225,1781,7337,604,5097,2051,4112,H
2050,M,2757,2757,10094,3051,11331,2051,7337,M
2050,N,666,666,10760,300,11631,2051,10094,N
2050,O,878,878,11638,860,12491,2051,10760,O
2050,P,242,242,11880,3960,16451,2051,11638,P
2051,AEI,49,49,49,202,202,2052,0,I
2051,AEJ,128,79,128,170,170,2052,0,A
2051,BEJ,275,147,275,2845,2845,2052,0,E
2051,BFJ,151,4,279,150,320,2052,128,B
2051,CFJ,250,20,299,150,352,2052,49,J
2051,CFK,189,189,488,185,537,2052,299,K
2051,CFL,218,9,497,150,470,2052,279,C
2051,DFL,24,24,521,4200,4670,2052,497,D
2051,FL,977,944,1465,4200,4737,2052,488,L
2051,F,2749,1559,3024,240,3085,2052,275,F
2051,G,749,749,3773,740,3825,2052,3024,G
2051,F,1192,1192,4965,1200,5025,2052,3773,F
2051,G,252,252,5217,215,5240,2052,4965,G
2051,H,270,270,5487,4890,10130,2052,5217,H
2051,M,5266,5266,10753,5853,15983,2052,5487,M
2051,N,1123,1123,11876,90,16073,2052,10753,N
2051,O,1226,1226,13102,1365,17438,2052,11876,O
2051,N,523,523,13625,890,18328,2052,13102,N
2051,O,199,199,13824,605,18933,2052,13625,O
2051,P,111,111,13935,3780,22713,2052,13824,P
2052,AEI,1581,1581,1581,1751,1751,2053,0,A
2052,BEI,1701,120,1701,2087,2087,2053,0,I
2052,BEJ,248,128,1829,90,1841,2053,1581,B
2052,CEJ,409,281,2110,90,2177,2053,1701,J
2052,CEK,528,247,2357,860,2701,2053,1829,C
2052,DEK,536,536,2893,3780,6481,2053,2357,D
2052,EK,815,32,2925,1060,3237,2053,2110,K
2052,EL,141,141,3066,3780,7017,2053,2925,L
2052,E,36962,33896,36962,37992,37992,2053,0,E
2052,F,1060,1060,38022,90,38082,2053,36962,F
2052,G,1018,1018,39040,1210,39292,2053,38022,G
2052,H,136,136,39176,3780,43072,2053,39040,H
2052,M,4240,4240,43416,5026,48098,2053,39176,M
2052,N,812,812,44228,90,48188,2053,43416,N
2052,O,769,769,44997,1195,49383,2053,44228,O
2052,P,70,70,45067,3780,53163,2053,44997,P
2053,A,271,271,271,711,711,2054,0,A
2053,B,726,726,997,360,1071,2054,271,B
2053,C,980,980,1977,990,2061,2054,997,C
2053,D,2934,2934,4911,550,2611,2054,1977,D
2053,M,1443,1443,6354,2754,5365,2054,4911,M
2053,N,1700,1700,8054,420,5785,2054,6354,N
2053,O,1205,1205,9259,2557,8342,2054,8054,O
2053,P,1093,1093,10352,4333,12675,2054,9259,P
2054,AEI,716,716,716,2473,2473,2055,0,A
2054,BEI,1402,686,1402,1513,1513,2055,0,I
2054,BEJ,140,140,1542,90,1603,2055,1402,J
2054,BEK,2021,479,2021,2191,2191,2055,0,E
2054,BFK,211,211,2232,90,2281,2055,2021,F
2054,BGK,745,55,2287,1105,2708,2055,1542,K
2054,BGL,1815,244,2531,90,2563,2055,716,B
2054,CGL,408,109,2640,820,3101,2055,2232,G
2054,CHL,147,147,2787,3780,6881,2055,2640,H
2054,CL,1027,527,3314,3780,6488,2055,2287,L
2054,C,913,130,3444,1230,3793,2055,2531,C
2054,D,295,295,3739,3780,7573,2055,3444,D
2054,M,692,692,4431,1254,8827,2055,3739,M
2054,N,587,587,5018,90,8917,2055,4431,N
2054,O,262,262,5280,625,9542,2055,5018,O
2054,P,1588,1588,6868,3780,13322,2055,5280,P
2055,AEI,48,48,48,132,132,2056,0,A
2055,BEI,184,136,184,868,868,2056,0,E
2055,BFI,175,39,223,135,267,2056,48,B
2055,CFI,146,146,369,215,482,2056,223,C
2055,DFI,5,5,374,4890,5372,2056,369,D
2055,FI,783,593,967,150,1018,2056,184,F
2055,GI,251,251,1218,240,1258,2056,967,G
2055,HI,3460,3460,4678,4230,5488,2056,1218,H
2055,I,5531,853,5531,5901,5901,2056,0,I
2055,J,582,582,6113,240,6141,2056,5531,J
2055,K,627,627,6740,920,7061,2056,6113,K
2055,L,342,342,7082,3960,11021,2056,6740,L
2055,M,3392,3392,10474,4597,15618,2056,7082,M
2055,N,1230,1230,11704,90,15708,2056,10474,N
2055,O,1250,1250,12954,1480,17188,2056,11704,O
2055,P,303,303,13257,3780,20968,2056,12954,P
2056,AEI,106,106,106,197,197,2057,0,E
2056,AFI,274,274,380,240,437,2057,106,F
2056,AGI,452,72,452,3574,3574,2057,0,A
2056,BGI,117,45,497,195,632,2057,380,G
2056,BHI,1028,531,1028,1095,1095,2057,0,I
2056,BHJ,733,202,1230,5220,5852,2057,497,H
2056,BJ,290,88,1318,240,1335,2057,1028,J
2056,BK,886,886,2204,1050,2385,2057,1318,K
2056,BJ,384,384,2588,770,3155,2057,2204,J
2056,BK,491,491,3079,150,3305,2057,2588,K
2056,BL,3247,620,3699,90,3664,2057,452,B
2056,CL,752,752,4451,1040,4704,2057,3699,C
2056,DL,411,411,4862,3780,8484,2057,4451,D
2056,L,2691,908,5770,3900,7205,2057,3079,L
2056,M,481,481,6251,4751,13235,2057,5770,M
2056,N,4292,4292,10543,90,13325,2057,6251,N
2056,O,1150,1150,11693,1420,14745,2057,10543,O
2056,N,1472,1472,13165,1195,15940,2057,11693,N
2056,O,432,432,13597,860,16800,2057,13165,O
2056,P,91,91,13688,3780,20580,2057,13597,P
2057,A,4266,4266,4266,4406,4406,2058,0,A
2057,B,175,175,4441,90,4496,2058,4266,B
2057,C,538,538,4979,820,5316,2058,4441,C
2057,B,1008,1008,5987,730,6046,2058,4979,B
2057,C,559,559,6546,805,6851,2058,5987,C
2057,D,43740,43740,50286,3780,10631,2058,6546,D
2057,M,469,469,50755,566,11197,2058,50286,M
2057,N,231,231,50986,180,11377,2058,50755,N
2057,O,627,627,51613,865,12242,2058,50986,O
2057,N,1586,1586,53199,1360,13602,2058,51613,N
2057,O,649,649,53848,665,14267,2058,53199,O
2057,P,2779,2779,56627,5430,19697,2058,53848,P
2058,AE,81,81,81,856,856,2059,0,E
2058,AF,958,958,1039,240,1096,2059,81,F
2058,AG,1424,385,1424,1565,1565,2059,0,A
2058,BG,635,250,1674,640,1736,2059,1039,G
2058,BH,261,11,1685,180,1745,2059,1424,B
2058,CH,676,676,2361,950,2695,2059,1685,C
2058,BH,445,445,2806,145,2840,2059,2361,B
2058,CH,1398,1398,4204,1050,3890,2059,2806,C
2058,DH,3173,643,4847,5370,7106,2059,1674,H
2058,D,7667,7024,11871,6960,10850,2059,4204,D
2058,M,1849,1849,13720,3212,14062,2059,11871,M
2058,N,1503,1503,15223,90,14152,2059,13720,N
2058,O,1377,1377,16600,1780,15932,2059,15223,O
2058,N,645,645,17245,345,16277,2059,16600,N
2058,O,708,708,17953,965,17242,2059,17245,O
2058,P,410,410,18363,3780,21022,2059,17953,P
2059,AEI,422,422,422,1051,1051,2060,0,A
2059,BEI,569,147,569,1605,1605,2060,0,E
2059,BFI,659,512,1081,90,1141,2060,422,B
2059,CFI,484,484,1565,845,1986,2060,1081,C
2059,DFI,1176,180,1745,180,1785,2060,569,F
2059,DGI,443,263,2008,3780,5766,2060,1565,D
2059,GI,690,427,2435,840,2625,2060,1745,G
2059,FI,555,555,2990,425,3050,2060,2435,F
2059,GI,529,529,3519,680,3730,2060,2990,G
2059,HI,566,566,4085,5460,9190,2060,3519,H
2059,I,10817,6732,10817,11561,11561,2060,0,I
2059,J,954,954,11771,240,11801,2060,10817,J
2059,K,759,759,12530,860,12661,2060,11771,K
2059,L,3534,3534,16064,3960,16621,2060,12530,L
2059,M,557,557,16621,1307,17928,2060,16064,M
2059,N,1011,1011,17632,300,18228,2060,16621,N
2059,O,1118,1118,18750,920,19148,2060,17632,O
2059,N,1406,1406,20156,1505,20653,2060,18750,N
2059,O,1011,1011,21167,1260,21913,2060,20156,O
2059,P,169,169,21336,3960,25873,2060,21167,P
2060,AE,1245,1245,1245,1410,1410,2061,0,E
2060,AF,267,267,1512,150,1560,2061,1245,F
2060,AG,2057,545,2057,2142,2142,2061,0,A
2060,BG,597,52,2109,585,2145,2061,1512,G
2060,BF,292,240,2349,180,2322,2061,2057,B
2060,CF,138,138,2487,880,3202,2061,2349,C
2060,DF,1601,1223,3710,1530,3675,2061,2109,F
2060,DG,495,495,4205,570,4245,2061,3710,G
2060,DH,3324,1606,5811,6660,9862,2061,2487,D
2060,H,3703,2097,7908,4230,8475,2061,4205,H
2060,M,2152,2152,10060,2449,12311,2061,7908,M
2060,N,327,327,10387,90,12401,2061,10060,N
2060,O,483,483,10870,820,13221,2061,10387,O
2060,N,371,371,11241,35,13256,2061,10870,N
2060,O,667,667,11908,965,14221,2061,11241,O
2060,P,1530,1530,13438,3780,18001,2061,11908,P
2061,AE,37,37,37,147,147,2062,0,E
2061,AF,109,72,109,979,979,2062,0,A
2061,BF,310,238,347,240,387,2062,37,F
2061,BG,566,566,913,715,1102,2062,347,G
2061,BH,966,162,1075,150,1129,2062,109,B
2061,CH,177,177,1252,190,1319,2062,1075,C
2061,DH,1864,1525,2777,3960,5062,2062,913,H
2061,D,2701,1176,3953,4200,5519,2062,1252,D
2061,M,2905,2905,6858,4144,9663,2062,3953,M
2061,N,1271,1271,8129,90,9753,2062,6858,N
2061,O,1019,1019,9148,1230,10983,2062,8129,O
2061,P,15,15,9163,3780,14763,2062,9148,P
2062,A,2126,2126,2126,3203,3203,2063,0,A
2062,B,1124,1124,3250,90,3293,2063,2126,B
2062,C,1402,1402,4652,1635,4928,2063,3250,C
2062,B,537,537,5189,305,5233,2063,4652,B
2062,C,163,163,5352,585,5818,2063,5189,C
2062,D,11510,11510,16862,3780,9598,2063,5352,D
2062,M,1225,1225,18087,1546,11144,2063,16862,M
2062,N,351,351,18438,90,11234,2063,18087,N
2062,O,307,307,18745,575,11809,2063,18438,O
2062,P,95,95,18840,3780,15589,2063,18745,P
2063,AEI,108,108,108,1100,1100,2064,0,I
2063,AEJ,189,81,189,1338,1338,2064,0,A
2063,BEJ,294,105,294,1360,1360,2064,0,E
2063,BFJ,1171,985,1279,240,1340,2064,108,J
2063,BFK,1341,251,1530,240,1578,2064,189,B
2063,CFK,1245,9,1539,240,1600,2064,294,F
2063,CGK,862,602,2141,780,2120,2064,1279,K
2063,CGL,754,143,2284,780,2358,2064,1530,C
2063,DGL,799,54,2338,780,2380,2064,1539,G
2063,DHL,694,497,2835,7680,9800,2064,2141,L
2063,DH,791,240,3075,7680,10038,2064,2284,D
2063,H,3640,2903,5978,7680,10060,2064,2338,H
2063,M,7454,7454,13432,8365,18425,2064,5978,M
2063,N,1165,1165,14597,300,18725,2064,13432,N
2063,O,992,992,15589,905,19630,2064,14597,O
2063,P,1133,1133,16722,2760,22390,2064,15589,P
2064,A,4135,4135,4135,4288,4288,2065,0,A
2064,B,372,372,4507,240,4528,2065,4135,B
2064,C,497,497,5004,695,5223,2065,4507,C
2064,D,481,481,5485,3960,9183,2065,5004,D
2064,M,26552,26552,32037,27944,37127,2065,5485,M
2064,N,1408,1408,33445,90,37217,2065,32037,N
2064,O,1369,1369,34814,1635,38852,2065,33445,O
2064,P,599,599,35413,3780,42632,2065,34814,P
2065,A,52,52,52,1160,1160,2066,0,A
2065,B,1296,1296,1348,240,1400,2066,52,B
2065,C,684,684,2032,780,2180,2066,1348,C
2065,D,2298,2298,4330,7680,9860,2066,2032,D
2065,M,1550,1550,5880,1695,11555,2066,4330,M
2065,N,396,396,6276,300,11855,2066,5880,N
2065,O,538,538,6814,700,12555,2066,6276,O
2065,P,474,474,7288,1140,13695,2066,6814,P
2066,A,118,118,118,463,463,2067,0,A
2066,B,396,396,514,90,553,2067,118,B
2066,C,1416,1416,1930,1745,2298,2067,514,C
2066,D,119,119,2049,3780,6078,2067,1930,D
2066,M,429,429,2478,739,6817,2067,2049,M
2066,N,349,349,2827,90,6907,2067,2478,N
2066,O,979,979,3806,1285,8192,2067,2827,O
2066,P,38,38,3844,3780,11972,2067,3806,P
2067,AEI,50,50,50,298,298,2068,0,A
2067,BEI,358,308,358,1067,1067,2068,0,I
2067,BEJ,395,87,445,165,463,2068,50,B
2067,CEJ,740,653,1098,90,1157,2068,358,J
2067,CEK,656,3,1101,910,1373,2068,445,C
2067,DEK,152,152,1253,3960,5333,2068,1101,D
2067,EK,1334,81,1334,1445,1445,2068,0,E
2067,FK,509,273,1607,850,2007,2068,1098,K
2067,FL,301,28,1635,240,1685,2068,1334,F
2067,GL,571,571,2206,905,2590,2068,1635,G
2067,HL,282,282,2488,3960,6550,2068,2206,H
2067,L,1215,334,2822,3780,5787,2068,1607,L
2067,M,1610,1610,4432,2512,9062,2068,2822,M
2067,N,1162,1162,5594,300,9362,2068,4432,N
2067,O,787,787,6381,970,10332,2068,5594,O
2067,N,636,636,7017,455,10787,2068,6381,N
2067,O,230,230,7247,385,11172,2068,7017,O
2067,P,506,506,7753,3960,15132,2068,7247,P
2068,AEI,42,42,42,994,994,2069,0,E
2068,AFI,229,187,229,761,761,2069,0,I
2068,AFJ,436,207,436,2507,2507,2069,0,A
2068,BFJ,633,426,862,150,911,2069,229,J
2068,BFK,122,122,984,125,1036,2069,862,K
2068,BFJ,1142,200,1184,240,1234,2069,42,F
2068,BGJ,569,369,1553,545,1581,2069,984,J
2068,BGK,907,538,2091,1020,2254,2069,1184,G
2068,BHK,6,6,2097,4680,6934,2069,2091,H
2068,BK,755,211,2308,720,2301,2069,1553,K
2068,BL,2162,290,2598,90,2597,2069,436,B
2068,CL,335,45,2643,4170,6471,2069,2308,L
2068,C,1138,1093,3736,1380,3977,2069,2598,C
2068,B,268,268,4004,85,4062,2069,3736,B
2068,C,362,362,4366,795,4857,2069,4004,C
2068,D,503,503,4869,3780,8637,2069,4366,D
2068,M,468,468,5337,643,9280,2069,4869,M
2068,N,205,205,5542,90,9370,2069,5337,N
2068,O,479,479,6021,820,10190,2069,5542,O
2068,N,380,380,6401,30,10220,2069,6021,N
2068,O,242,242,6643,695,10915,2069,6401,O
2068,P,1531,1531,8174,3780,14695,2069,6643,P
2069,A,2511,2511,2511,2647,2647,2070,0,A
2069,B,182,182,2693,90,2737,2070,2511,B
2069,C,739,739,3432,1130,3867,2070,2693,C
2069,D,602,602,4034,3780,7647,2070,3432,D
2069,M,1568,1568,5602,2669,10316,2070,4034,M
2069,N,1134,1134,6736,90,10406,2070,5602,N
2069,O,762,762,7498,1195,11601,2070,6736,O
2069,P,60,60,7558,3780,15381,2070,7498,P
2070,AEI,167,167,167,1151,1151,2071,0,I
2070,AEJ,1014,1014,1181,90,1241,2071,167,J
2070,AEK,1190,9,1190,1501,1501,2071,0,E
2070,AFK,528,528,1718,240,1741,2071,1190,F
2070,AGK,1037,500,2218,1220,2461,2071,1181,K
2070,AGL,215,215,2433,3780,6241,2071,2218,L
2070,AG,795,80,2513,1045,2786,2071,1718,G
2070,AH,1115,1115,3628,3960,6746,2071,2513,H
2070,A,29268,25640,29268,30364,30364,2071,0,A
2070,B,1119,1119,30387,90,30454,2071,29268,B
2070,C,533,533,30920,965,31419,2071,30387,C
2070,D,735,735,31655,3780,35199,2071,30920,D
2070,M,281,281,31936,894,36093,2071,31655,M
2070,N,643,643,32579,90,36183,2071,31936,N
2070,O,210,210,32789,625,36808,2071,32579,O
2070,P,17475,17475,50264,3780,40588,2071,32789,P
2071,A,6778,6778,6778,8413,8413,2072,0,A
2071,B,1285,1285,8063,420,8833,2072,6778,B
2071,C,914,914,8977,695,9528,2072,8063,C
2071,D,1403,1403,10380,550,10078,2072,8977,D
2071,M,126,126,10506,326,10404,2072,10380,M
2071,N,320,320,10826,180,10584,2072,10506,N
2071,O,686,686,11512,830,11414,2072,10826,O
2071,P,315,315,11827,6680,18094,2072,11512,P
2072,AE,96,96,96,725,725,2073,0,E
2072,AF,880,880,976,300,1025,2073,96,F
2072,AG,1133,157,1133,936,936,2073,0,A
2072,BG,56,56,1189,300,1236,2073,1133,B
2072,CG,667,454,1643,815,1840,2073,976,G
2072,CH,680,226,1869,825,2061,2073,1189,C
2072,DH,292,292,2161,4080,6141,2073,1869,D
2072,H,2978,2460,4621,4080,5920,2073,1643,H
2072,M,4338,4338,8959,4536,10677,2073,4621,M
2072,N,459,459,9418,300,10977,2073,8959,N
2072,O,137,137,9555,3520,14497,2073,9418,O
2072,P,1846,1846,11401,1440,15937,2073,9555,P
2073,AEI,502,502,502,490,490,2074,0,A
2073,BEI,254,254,756,300,790,2074,502,B
2073,CEI,1389,633,1389,1615,1615,2074,0,E
2073,CFI,782,149,1538,840,1630,2074,756,C
2073,BFI,503,354,1892,300,1915,2074,1389,F
2073,BGI,494,140,2032,434,2064,2074,1538,B
2073,CGI,612,472,2504,775,2690,2074,1892,G
2073,CHI,505,33,2537,2191,4255,2074,2032,C
2073,DHI,253,220,2757,4020,6710,2074,2504,H
2073,DI,2871,114,2871,3129,3129,2074,0,I
2073,DJ,514,514,3385,300,3429,2074,2871,J
2073,DK,527,527,3912,2071,5500,2074,3385,K
2073,DL,1639,1639,5551,2625,8125,2074,3912,L
2073,D,3159,145,5696,2625,6880,2074,2537,D
2073,M,30588,30588,36284,31578,39703,2074,5696,M
2073,N,1020,1020,37304,90,39793,2074,36284,N
2073,O,1021,1021,38325,1240,41033,2074,37304,O
2073,N,816,816,39141,595,41628,2074,38325,N
2073,O,615,615,39756,924,42552,2074,39141,O
2073,P,17,17,39773,3780,46332,2074,39756,P
2074,AE,446,446,446,1172,1172,2075,0,A
2074,BE,760,760,1206,90,1262,2075,446,B
2074,CE,268,268,1474,605,1867,2075,1206,C
2074,DE,2031,557,2031,3071,3071,2075,0,E
2074,DF,1325,1325,3356,90,3161,2075,2031,F
2074,DG,1379,1379,4735,1635,4796,2075,3356,G
2074,DF,409,409,5144,380,5176,2075,4735,F
2074,DG,196,196,5340,605,5781,2075,5144,G
2074,DH,4378,4378,9718,3780,9561,2075,5340,H
2074,D,27569,19325,29043,3780,5647,2075,1474,D
2074,M,4337,4337,33380,4852,14413,2075,29043,M
2074,N,540,540,33920,90,14503,2075,33380,N
2074,O,442,442,34362,600,15103,2075,33920,O
2074,N,1832,1832,36194,1575,16678,2075,34362,N
2074,O,1322,1322,37516,1840,18518,2075,36194,O
2074,P,1556,1556,39072,3780,22298,2075,37516,P
2075,AE,1056,1056,1056,7864,7864,2076,0,E
2075,AF,3371,2315,3371,4791,4791,2076,0,A
2075,BF,1802,1802,5173,420,5211,2076,3371,B
2075,CF,981,981,6154,1015,6226,2076,5173,C
2075,DF,1331,1331,7485,460,6686,2076,6154,D
2075,F,6931,502,7987,180,8044,2076,1056,F
2075,G,1450,1450,9437,695,8739,2076,7987,G
2075,F,610,610,10047,1355,10094,2076,9437,F
2075,G,521,521,10568,585,10679,2076,10047,G
2075,H,1426,1426,11994,6960,17639,2076,10568,H
2075,M,1375,1375,13369,1735,19374,2076,11994,M
2075,N,476,476,13845,150,19524,2076,13369,N
2075,O,847,847,14692,1024,20548,2076,13845,O
2075,P,10191,10191,24883,2766,23314,2076,14692,P
2076,A,2,2,2,117,117,2077,0,A
2076,B,325,325,327,240,357,2077,2,B
2076,C,734,734,1061,930,1287,2077,327,C
2076,D,111,111,1172,3960,5247,2077,1061,D
2076,M,1811,1811,2983,2046,7293,2077,1172,M
2076,N,261,261,3244,90,7383,2077,2983,N
2076,O,448,448,3692,820,8203,2077,3244,O
2076,N,505,505,4197,130,8333,2077,3692,N
2076,O,205,205,4402,625,8958,2077,4197,O
2076,P,3876,3876,8278,3780,12738,2077,4402,P
2077,AEI,146,146,146,881,881,2078,0,I
2077,AEJ,296,150,296,1273,1273,2078,0,E
2077,AFJ,835,685,981,150,1031,2078,146,J
2077,AFK,137,137,1118,370,1401,2078,981,K
2077,AFJ,1194,372,1490,240,1513,2078,296,F
2077,AGJ,284,284,1774,915,2428,2078,1490,G
2077,AHJ,1583,927,2701,1345,2746,2078,1118,J
2077,AHK,2707,6,2707,2727,2727,2078,0,A
2077,BHK,114,114,2821,150,2877,2078,2707,B
2077,CHK,104,104,2925,120,2997,2078,2821,C
2077,BHK,417,193,3118,650,3396,2078,2701,K
2077,BHL,1607,263,3381,3960,6388,2078,1774,H
2077,BL,1294,838,4219,1245,4242,2078,2925,B
2077,CL,317,317,4536,645,4887,2078,4219,C
2077,DL,1770,352,4888,4230,7626,2078,3118,L
2077,D,6149,5797,10685,4230,9117,2078,4536,D
2077,M,5543,5543,16228,9013,18130,2078,10685,M
2077,N,3600,3600,19828,180,18310,2078,16228,N
2077,O,1113,1113,20941,875,19185,2078,19828,O
2077,P,518,518,21459,660,19845,2078,20941,P
2078,A,2168,2168,2168,2267,2267,2079,0,A
2078,B,140,140,2308,90,2357,2079,2168,B
2078,C,1148,1148,3456,815,3172,2079,2308,C
2078,B,890,890,4346,1105,4277,2079,3456,B
2078,C,1313,1313,5659,1850,6127,2079,4346,C
2078,D,1011,1011,6670,3780,9907,2079,5659,D
2078,M,114,114,6784,150,10057,2079,6670,M
2078,N,309,309,7093,300,10357,2079,6784,N
2078,O,665,665,7758,880,11237,2079,7093,O
2078,P,240,240,7998,1620,12857,2079,7758,P
2079,A,232,232,232,546,546,2080,0,A
2079,B,339,339,571,90,636,2080,232,B
2079,C,969,969,1540,1285,1921,2080,571,C
2079,D,2222,2222,3762,3780,5701,2080,1540,D
2079,M,10202,10202,13964,11354,17055,2080,3762,M
2079,N,1355,1355,15319,240,17295,2080,13964,N
2079,O,382,382,15701,760,18055,2080,15319,O
2079,P,50,50,15751,3840,21895,2080,15701,P
2080,AE,149,149,149,386,386,2081,0,E
2080,AF,377,377,526,90,476,2081,149,F
2080,AG,1776,1250,1776,2372,2372,2081,0,A
2080,BG,1357,107,1883,1780,2256,2081,526,G
2080,BF,442,442,2325,130,2386,2081,1883,F
2080,BG,629,80,2405,90,2462,2081,1776,B
2080,CG,160,160,2565,535,2997,2081,2405,C
2080,DG,259,19,2584,535,2921,2081,2325,G
2080,DH,56,56,2640,3780,6701,2081,2584,H
2080,D,219,144,2784,3780,6777,2081,2565,D
2080,M,526,526,3310,448,7225,2081,2784,M
2080,N,24,24,3334,150,7375,2081,3310,N
2080,O,1066,1066,4400,965,8340,2081,3334,O
2080,P,1005,1005,5405,385,8725,2081,4400,P
2081,AEI,213,213,213,198,198,2082,0,A
2081,BEI,80,80,293,150,348,2082,213,B
2081,CEI,146,146,439,140,488,2082,293,C
2081,BEI,1084,645,1084,1137,1137,2082,0,E
2081,BFI,161,161,1245,150,1287,2082,1084,F
2081,BGI,910,104,1349,900,1388,2082,439,B
2081,CGI,348,348,1697,650,2038,2082,1349,C
2081,DGI,1110,658,2355,130,1417,2082,1245,G
2081,DFI,279,279,2634,1230,2647,2082,2355,F
2081,DGI,2675,41,2675,2500,2500,2082,0,I
2081,DGJ,57,57,2732,660,3160,2082,2675,J
2081,DGK,338,240,2972,650,3297,2082,2634,G
2081,DHK,1216,976,3948,1920,5080,2082,2732,K
2081,DHJ,3105,3105,7053,1965,7045,2082,3948,J
2081,DHK,288,288,7341,915,7960,2082,7053,K
2081,DHL,6250,606,7947,4230,6268,2082,1697,D
2081,HL,1556,950,8897,3960,11920,2082,7341,L
2081,H,6205,280,9177,4230,7527,2082,2972,H
2081,M,1728,1728,10905,1968,13888,2082,9177,M
2081,N,474,474,11379,260,14148,2082,10905,N
2081,O,2241,2241,13620,2210,16358,2082,11379,O
2081,N,3217,3217,16837,3280,19638,2082,13620,N
2081,O,2773,2773,19610,1460,21098,2082,16837,O
2081,P,6333,6333,25943,4200,25298,2082,19610,P
2082,A,976,976,976,1174,1174,2083,0,A
2082,B,229,229,1205,90,1264,2083,976,B
2082,C,919,919,2124,1240,2504,2083,1205,C
2082,D,35,35,2159,3780,6284,2083,2124,D
2082,M,675,675,2834,1314,7598,2083,2159,M
2082,N,671,671,3505,90,7688,2083,2834,N
2082,O,147,147,3652,535,8223,2083,3505,O
2082,P,1380,1380,5032,3780,12003,2083,3652,P
2083,AEI,35,35,35,888,888,2084,0,E
2083,AFI,285,250,285,921,921,2084,0,A
2083,BFI,825,825,1110,240,1161,2084,285,B
2083,CFI,1162,87,1197,300,1188,2084,35,F
2083,CGI,244,157,1354,510,1671,2084,1110,C
2083,DGI,1582,228,1582,2557,2557,2084,0,I
2083,DGJ,307,79,1661,3960,5631,2084,1354,D
2083,GJ,706,242,1903,920,2108,2084,1197,G
2083,HJ,1009,688,2591,90,2647,2084,1582,J
2083,HK,1280,592,3183,3960,6068,2084,1903,H
2083,K,977,385,3568,1190,3837,2084,2591,K
2083,L,825,825,4393,3780,7617,2084,3568,L
2083,M,72,72,4465,84,7701,2084,4393,M
2083,N,209,209,4674,240,7941,2084,4465,N
2083,O,700,700,5374,960,8901,2084,4674,O
2083,P,124,124,5498,3960,12861,2084,5374,P
2084,AEI,102,102,102,200,200,2085,0,E
2084,AFI,117,15,117,160,160,2085,0,A
2084,BFI,124,124,241,150,310,2085,117,B
2084,CFI,259,18,259,324,324,2085,0,I
2084,CFJ,213,56,315,180,380,2085,102,F
2084,CGJ,182,108,423,120,430,2085,241,C
2084,DGJ,183,19,442,180,504,2085,259,J
2084,DGK,211,84,526,210,590,2085,315,G
2084,DHK,194,110,636,205,709,2085,442,K
2084,DHL,120,10,646,3275,3865,2085,526,H
2084,DL,251,28,674,2850,3280,2085,423,D
2084,L,935,897,1571,2850,3559,2085,636,L
2084,M,203,203,1774,614,4479,2085,1571,M
2084,N,658,658,2432,240,4719,2085,1774,N
2084,O,345,345,2777,490,5209,2085,2432,O
2084,N,1397,1397,4174,1295,6504,2085,2777,N
2084,O,601,601,4775,780,7284,2085,4174,O
2084,P,8029,8029,12804,3960,11244,2085,4775,P
2085,AEI,65,65,65,141,141,2086,0,E
2085,AFI,279,279,344,240,381,2086,65,F
2085,AGI,154,154,498,190,571,2086,344,G
2085,AHI,1451,953,1451,2174,2174,2086,0,A
2085,BHI,923,923,2374,240,2414,2086,1451,B
2085,CHI,206,206,2580,400,2814,2086,2374,C
2085,DHI,183,183,2763,9700,12514,2086,2580,D
2085,HI,2772,9,2772,3743,3743,2086,0,I
2085,HJ,1231,1231,4003,300,4043,2086,2772,J
2085,HK,1080,1080,5083,1050,5093,2086,4003,K
2085,HJ,224,224,5307,350,5443,2086,5083,J
2085,HK,315,315,5622,510,5953,2086,5307,K
2085,HL,244,244,5866,3960,9913,2086,5622,L
2085,H,6315,947,6813,5220,5791,2086,498,H
2085,M,345,345,7158,3144,15658,2086,6813,M
2085,N,1321,1321,8479,240,15898,2086,7158,N
2085,O,223,223,8702,1590,17488,2086,8479,O
2085,N,8090,8090,16792,3595,21083,2086,8702,N
2085,O,599,599,17391,960,22043,2086,16792,O
2085,P,2873,2873,20264,3960,26003,2086,17391,P
2086,AEI,57,57,57,253,253,2087,0,A
2086,BEI,169,112,169,189,189,2087,0,E
2086,BFI,116,116,285,150,339,2087,169,F
2086,BGI,126,126,411,170,509,2087,285,G
2086,BHI,386,32,443,240,493,2087,57,B
2086,CHI,142,142,585,215,708,2087,443,C
2086,DHI,845,671,1256,4200,4709,2087,411,H
2086,DI,864,193,1449,4890,5598,2087,585,D
2086,I,1637,188,1637,2510,2510,2087,0,I
2086,J,1137,1137,2774,300,2810,2087,1637,J
2086,K,857,857,3631,970,3780,2087,2774,K
2086,L,877,877,4508,3960,7740,2087,3631,L
2086,M,546,546,5054,1350,9090,2087,4508,M
2086,N,850,850,5904,90,9180,2087,5054,N
2086,O,946,946,6850,1230,10410,2087,5904,O
2086,N,889,889,7739,605,11015,2087,6850,N
2086,O,636,636,8375,890,11905,2087,7739,O
2086,P,2754,2754,11129,3840,15745,2087,8375,P
2087,A,24840,24840,24840,25575,25575,2088,0,A
2087,B,941,941,25781,90,25665,2088,24840,B
2087,C,1056,1056,26837,1385,27050,2088,25781,C
2087,B,749,749,27586,600,27650,2088,26837,B
2087,C,358,358,27944,800,28450,2088,27586,C
2087,D,1451,1451,29395,3780,32230,2088,27944,D
2087,M,3048,3048,32443,3174,35404,2088,29395,M
2087,N,170,170,32613,90,35494,2088,32443,N
2087,O,569,569,33182,820,36314,2088,32613,O
2087,N,1013,1013,34195,730,37044,2088,33182,N
2087,O,514,514,34709,805,37849,2088,34195,O
2087,P,46620,46620,81329,3780,41629,2088,34709,P
2088,A,597,597,597,1459,1459,2089,0,A
2088,B,1126,1126,1723,300,1759,2089,597,B
2088,C,834,834,2557,970,2729,2089,1723,C
2088,D,1087,1087,3644,3960,6689,2089,2557,D
2088,M,206,206,3850,341,7030,2089,3644,M
2088,N,328,328,4178,240,7270,2089,3850,N
2088,O,811,811,4989,1045,8315,2089,4178,O
2088,P,637,637,5626,3960,12275,2089,4989,P
2089,AE,1585,1585,1585,1806,1806,2090,0,E
2089,AF,245,245,1830,90,1896,2090,1585,F
2089,AG,536,536,2366,880,2776,2090,1830,G
2089,AH,45,45,2411,3780,6556,2090,2366,H
2089,A,37007,34596,37007,37506,37506,2090,0,A
2089,B,800,800,37807,90,37596,2090,37007,B
2089,C,1340,1340,39147,1430,39026,2090,37807,C
2089,D,2,2,39149,3780,42806,2090,39147,D
2089,M,3675,3675,42824,4324,47130,2090,39149,M
2089,N,678,678,43502,90,47220,2090,42824,N
2089,O,849,849,44351,1240,48460,2090,43502,O
2089,P,3315,3315,47666,3840,52300,2090,44351,P
2090,AE,130,130,130,395,395,2091,0,A
2090,BE,137,7,137,75,75,2091,0,E
2090,BF,183,183,320,300,375,2091,137,F
2090,BG,567,377,697,360,755,2091,130,B
2090,CG,981,604,1301,965,1340,2091,320,G
2090,CH,165,165,1466,550,1890,2091,1301,H
2090,C,1088,319,1785,1125,1880,2091,697,C
2090,B,458,458,2243,425,2305,2091,1785,B
2090,C,166,166,2409,120,2425,2091,2243,C
2090,D,4486,4486,6895,550,2975,2091,2409,D
2090,M,1297,1297,8192,2112,5087,2091,6895,M
2090,N,838,838,9030,90,5177,2091,8192,N
2090,O,887,887,9917,1215,6392,2091,9030,O
2090,N,1448,1448,11365,1110,7502,2091,9917,N
2090,O,653,653,12018,1070,8572,2091,11365,O
2090,P,17,17,12035,3780,12352,2091,12018,P
2091,AEI,186,186,186,842,842,2092,0,I
2091,AEJ,759,759,945,150,992,2092,186,J
2091,AEK,654,654,1599,130,1122,2092,945,K
2091,AEJ,1042,1042,2641,1535,2657,2092,1599,J
2091,AEK,361,361,3002,645,3302,2092,2641,K
2091,AEL,6077,3075,6077,6908,6908,2092,0,A
2091,BEL,977,977,7054,90,6998,2092,6077,B
2091,CEL,7191,137,7191,11703,11703,2092,0,E
2091,CFL,528,391,7582,880,7878,2092,7054,C
2091,BFL,365,365,7947,110,7988,2092,7582,B
2091,CFL,1464,1464,9411,2315,10303,2092,7947,C
2091,DFL,7269,860,10271,4230,7532,2092,3002,L
2091,DF,4894,1814,12085,240,11943,2092,7191,F
2091,DG,941,941,13026,1335,13278,2092,12085,G
2091,DH,4533,918,13944,3420,13723,2092,9411,D
2091,H,3233,2315,16259,780,14058,2092,13026,H
2091,M,1309,1309,17568,1387,15445,2092,16259,M
2091,N,297,297,17865,240,15685,2092,17568,N
2091,O,893,893,18758,855,16540,2092,17865,O
2091,N,220,220,18978,340,16880,2092,18758,N
2091,O,2406,2406,21384,2820,19700,2092,18978,O
2091,P,4592,4592,25976,3960,23660,2092,21384,P
2092,AEI,22,22,22,877,877,2093,0,E
2092,AFI,955,955,977,150,1027,2093,22,F
2092,AGI,108,108,1085,110,1137,2093,977,G
2092,AHI,1149,64,1149,1539,1539,2093,0,A
2092,BHI,448,384,1533,4230,5367,2093,1085,H
2092,BI,570,186,1719,240,1779,2093,1149,B
2092,CI,706,706,2425,800,2579,2093,1719,C
2092,BI,3046,621,3046,3780,3780,2093,0,I
2092,BJ,1385,764,3810,1290,3869,2093,2425,B
2092,CJ,104,104,3914,385,4254,2093,3810,C
2092,DJ,924,56,3970,240,4020,2093,3046,J
2092,DK,261,205,4175,5400,9654,2093,3914,D
2092,K,772,567,4742,1030,5050,2093,3970,K
2092,J,1085,1085,5827,815,5865,2093,4742,J
2092,K,2684,2684,8511,2655,8520,2093,5827,K
2092,L,252,252,8763,1680,10200,2093,8511,L
2092,M,148,148,8911,158,10358,2093,8763,M
2092,N,127,127,9038,180,10538,2093,8911,N
2092,O,185,185,9223,265,10803,2093,9038,O
2092,N,1444,1444,10667,1350,12153,2093,9223,N
2092,O,799,799,11466,830,12983,2093,10667,O
2092,P,1383,1383,12849,5400,18383,2093,11466,P
2093,A,1681,1681,1681,1984,1984,2094,0,A
2093,B,337,337,2018,90,2074,2094,1681,B
2093,C,653,653,2671,885,2959,2094,2018,C
2093,D,759,759,3430,3780,6739,2094,2671,D
2093,M,1796,1796,5226,2593,9332,2094,3430,M
2093,N,827,827,6053,90,9422,2094,5226,N
2093,O,317,317,6370,705,10127,2094,6053,O
2093,P,2504,2504,8874,3780,13907,2094,6370,P
2094,AE,1477,1477,1477,1579,1579,2095,0,A
2094,BE,131,131,1608,90,1669,2095,1477,B
2094,CE,542,542,2150,820,2489,2095,1608,C
2094,DE,210,210,2360,3780,6269,2095,2150,D
2094,E,22209,19849,22209,23210,23210,2095,0,E
2094,F,1031,1031,23240,90,23300,2095,22209,F
2094,G,1031,1031,24271,1210,24510,2095,23240,G
2094,H,66,66,24337,3780,28290,2095,24271,H
2094,M,406,406,24743,655,28945,2095,24337,M
2094,N,504,504,25247,300,29245,2095,24743,N
2094,O,917,917,26164,1070,30315,2095,25247,O
2094,N,1128,1128,27292,1040,31355,2095,26164,N
2094,O,270,270,27562,390,31745,2095,27292,O
2094,P,220,220,27782,3960,35705,2095,27562,P
2095,AE,19,19,19,812,812,2096,0,A
2095,BE,364,345,364,319,319,2096,0,E
2095,BF,135,135,499,240,559,2096,364,F
2095,BG,380,380,879,660,1219,2096,499,G
2095,BF,991,131,1010,240,1052,2096,19,B
2095,CF,627,496,1506,345,1564,2096,879,F
2095,CG,654,158,1664,810,1862,2096,1010,C
2095,DG,240,240,1904,3960,5822,2096,1664,D
2095,G,556,158,2062,710,2274,2096,1506,G
2095,H,2772,2772,4834,4080,6354,2096,2062,H
2095,M,4220,4220,9054,7992,14346,2096,4834,M
2095,N,3876,3876,12930,90,14436,2096,9054,N
2095,O,1301,1301,14231,1610,16046,2096,12930,O
2095,P,18840,18840,33071,3780,19826,2096,14231,P
2096,AE,49,49,49,389,389,2097,0,A
2096,BE,537,537,586,240,629,2097,49,B
2096,CE,615,615,1201,895,1524,2097,586,C
2096,DE,5410,4209,5410,5752,5752,2097,0,E
2096,DF,538,538,5948,240,5992,2097,5410,F
2096,DG,648,648,6596,865,6857,2097,5948,G
2096,DH,11,11,6607,3960,10817,2097,6596,H
2096,D,34516,29110,35717,3960,5484,2097,1201,D
2096,M,3336,3336,39053,10186,21003,2097,35717,M
2096,N,1555,1555,40608,300,21303,2097,39053,N
2096,O,596,596,41204,705,22008,2097,40608,O
2096,P,5684,5684,46888,4080,26088,2097,41204,P
2097,AE,157,157,157,230,230,2098,0,A
2097,BE,351,351,508,300,530,2098,157,B
2097,CE,623,623,1131,805,1335,2098,508,C
2097,DE,1937,806,1937,3119,3119,2098,0,E
2097,DF,1450,644,2581,2940,4275,2098,1131,D
2097,F,1441,797,3378,300,3419,2098,1937,F
2097,G,522,522,3900,811,4230,2098,3378,G
2097,H,402,402,4302,3885,8115,2098,3900,H
2097,M,5746,5746,10048,7248,15363,2098,4302,M
2097,N,1672,1672,11720,240,15603,2098,10048,N
2097,O,975,975,12695,1275,16878,2098,11720,O
2097,P,970,970,13665,3780,20658,2098,12695,P
2098,A,201,201,201,1506,1506,2099,0,A
2098,B,1596,1596,1797,300,1806,2099,201,B
2098,C,593,593,2390,805,2611,2099,1797,C
2098,D,1350,1350,3740,8355,10966,2099,2390,D
2098,M,3220,3220,6960,3255,14221,2099,3740,M
2098,N,299,299,7259,300,14521,2099,6960,N
2098,O,669,669,7928,835,15356,2099,7259,O
2098,N,862,862,8790,720,16076,2099,7928,N
2098,O,995,995,9785,990,17066,2099,8790,O
2098,P,355,355,10140,4080,21146,2099,9785,P
2099,A,103,103,103,231,231,2100,0,A
2099,B,428,428,531,360,591,2100,103,B
2099,C,750,750,1281,695,1286,2100,531,C
2099,D,1908,1908,3189,550,1836,2100,1281,D
2099,M,652,652,3841,2519,4355,2100,3189,M
2099,N,2261,2261,6102,420,4775,2100,3841,N
2099,O,626,626,6728,626,5401,2100,6102,O
2099,P,10687,10687,17415,939,6340,2100,6728,P
2100,AEI,1297,1297,1297,1931,1931,2101,0,I
2100,AEJ,1489,192,1489,2818,2818,2101,0,A
2100,BEJ,672,480,1969,90,2021,2101,1297,J
2100,BEK,987,987,2956,1310,3331,2101,1969,K
2100,BEL,1517,50,3006,240,3058,2101,1489,B
2100,CEL,428,378,3384,3780,7111,2101,2956,L
2100,CE,885,507,3891,785,3843,2101,3006,C
2100,DE,1055,1055,4946,3900,7743,2101,3891,D
2100,E,14515,9569,14515,16117,16117,2101,0,E
2100,F,1643,1643,16158,90,16207,2101,14515,F
2100,G,829,829,16987,1120,17327,2101,16158,G
2100,H,832,832,17819,3780,21107,2101,16987,H
2100,M,44,44,17863,397,21504,2101,17819,M
2100,N,468,468,18331,165,21669,2101,17863,N
2100,O,1023,1023,19354,1275,22944,2101,18331,O
2100,P,809,809,20163,3960,26904,2101,19354,P
2101,AEI,1514,1514,1514,2367,2367,2102,0,I
2101,AEJ,1568,54,1568,2655,2655,2102,0,A
2101,BEJ,1591,23,1591,2835,2835,2102,0,E
2101,BFJ,1040,963,2554,240,2607,2102,1514,J
2101,BFK,1207,221,2775,180,2835,2102,1568,B
2101,CFK,1505,321,3096,300,3135,2102,1591,F
2101,CGK,935,393,3489,1040,3647,2102,2554,K
2101,CGJ,446,53,3542,3245,6380,2102,3096,G
2101,CHJ,1236,469,4011,1495,4330,2102,2775,C
2101,BHJ,1336,814,4825,1250,4897,2102,3489,J
2101,BHK,1447,633,5458,1175,5505,2102,4011,B
2101,CHK,567,567,6025,730,6235,2102,5458,C
2101,DHK,2369,1169,7194,2660,7557,2102,4825,K
2101,DHL,399,399,7593,3960,11517,2102,7194,L
2101,DH,4543,492,8085,1440,7820,2102,3542,H
2101,D,3100,1040,9125,2580,8815,2102,6025,D
2101,M,4368,4368,13493,4366,15883,2102,9125,M
2101,N,141,141,13634,180,16063,2102,13493,N
2101,O,182,182,13816,155,16218,2102,13634,O
2101,N,1215,1215,15031,1235,17453,2102,13816,N
2101,O,811,811,15842,2174,19627,2102,15031,O
2101,P,475,475,16317,896,20523,2102,15842,P
2102,AEI,92,92,92,120,120,2103,0,A
2102,BEI,119,119,211,150,270,2103,92,B
2102,CEI,180,180,391,125,395,2103,211,C
2102,DEI,743,743,1134,2880,3275,2103,391,D
2102,EI,1613,479,1613,1819,1819,2103,0,E
2102,FI,326,326,1939,180,1999,2103,1613,F
2102,GI,777,777,2716,885,2884,2103,1939,G
2102,HI,3298,582,3298,3967,3967,2103,0,I
2102,HJ,784,784,4082,180,4147,2103,3298,J
2102,HK,704,704,4786,810,4957,2103,4082,K
2102,HL,2856,786,5572,360,3244,2103,2716,H
2102,L,1084,298,5870,835,5792,2103,4786,L
2102,M,1602,1602,7472,3597,9389,2103,5870,M
2102,N,2122,2122,9594,180,9569,2103,7472,N
2102,O,703,703,10297,820,10389,2103,9594,O
2102,P,14380,14380,24677,6680,17069,2103,10297,P
2103,A,151,151,151,353,353,2104,0,A
2103,B,222,222,373,90,443,2104,151,B
2103,C,546,546,919,880,1323,2104,373,C
2103,D,206,206,1125,3780,5103,2104,919,D
2103,M,522,522,1647,772,5875,2104,1125,M
2103,N,303,303,1950,90,5965,2104,1647,N
2103,O,1586,1586,3536,1865,7830,2104,1950,O
2103,P,1404,1404,4940,3780,11610,2104,3536,P
2104,AEI,79,79,79,1209,1209,2105,0,A
2104,BEI,261,182,261,1127,1127,2105,0,I
2104,BEJ,915,915,1176,90,1217,2105,261,J
2104,BEK,1160,63,1239,90,1299,2105,79,B
2104,CEK,1478,239,1478,4671,4671,2105,0,E
2104,CFK,509,207,1685,855,2072,2105,1176,K
2104,CFL,327,327,2012,3780,5852,2105,1685,L
2104,CF,1021,248,2260,1210,2509,2105,1239,C
2104,DF,76,76,2336,3780,6289,2105,2260,D
2104,F,3331,2473,4809,90,4761,2105,1478,F
2104,G,1147,1147,5956,1240,6001,2105,4809,G
2104,H,10,10,5966,3780,9781,2105,5956,H
2104,M,1452,1452,7418,1750,11531,2105,5966,M
2104,N,366,366,7784,90,11621,2105,7418,N
2104,O,426,426,8210,850,12471,2105,7784,O
2104,P,748,748,8958,3780,16251,2105,8210,P
2105,A,546,546,546,772,772,2106,0,A
2105,B,282,282,828,90,862,2106,546,B
2105,C,351,351,1179,800,1662,2106,828,C
2105,D,1450,1450,2629,3780,5442,2106,1179,D
2105,M,522,522,3151,1258,6700,2106,2629,M
2105,N,895,895,4046,180,6880,2106,3151,N
2105,O,895,895,4941,900,7780,2106,4046,O
2105,P,1566,1566,6507,550,8330,2106,4941,P
2106,A,2777,2777,2777,2826,2826,2107,0,A
2106,B,287,287,3064,240,3066,2107,2777,B
2106,C,938,938,4002,855,3921,2107,3064,C
2106,B,328,328,4330,340,4261,2107,4002,B
2106,C,2155,2155,6485,2820,7081,2107,4330,C
2106,D,4851,4851,11336,3960,11041,2107,6485,D
2106,M,63,63,11399,812,11853,2107,11336,M
2106,N,852,852,12251,150,12003,2107,11399,N
2106,O,163,163,12414,125,12128,2107,12251,O
2106,N,721,721,13135,745,12873,2107,12414,N
2106,O,824,824,13959,770,13643,2107,13135,O
2106,P,280,280,14239,4230,17873,2107,13959,P
2107,AEI,179,179,179,819,819,2108,0,A
2107,BEI,193,14,193,1373,1373,2108,0,E
2107,BFI,866,852,1045,270,1089,2108,179,B
2107,CFI,1487,442,1487,1466,1466,2108,0,I
2107,CFJ,34,34,1521,120,1586,2108,1487,J
2107,CFK,1563,235,1756,420,1793,2108,193,F
2107,CGK,770,59,1815,870,1959,2108,1045,C
2107,DGK,727,668,2483,840,2633,2108,1756,G
2107,DHK,3273,2311,4794,2550,4136,2108,1521,K
2107,DHJ,3533,554,5348,525,2484,2108,1815,D
2107,HJ,3059,194,5542,350,2983,2108,2483,H
2107,J,954,206,5748,1655,5791,2108,4794,J
2107,K,1504,1504,7252,1310,7101,2108,5748,K
2107,L,1033,1033,8285,1175,8276,2108,7252,L
2107,M,752,752,9037,954,9230,2108,8285,M
2107,N,359,359,9396,120,9350,2108,9037,N
2107,O,772,772,10168,1025,10375,2108,9396,O
2107,N,1285,1285,11453,1135,11510,2108,10168,N
2107,O,2638,2638,14091,1892,13402,2108,11453,O
2107,P,284,284,14375,593,13995,2108,14091,P
2108,AE,13,13,13,156,156,2109,0,E
2108,AF,328,328,341,240,396,2109,13,F
2108,AG,121,121,462,255,651,2109,341,G
2108,AF,586,586,1048,460,1111,2109,462,F
2108,AG,1070,22,1070,1358,1358,2109,0,A
2108,BG,141,119,1189,215,1326,2109,1048,G
2108,BH,405,286,1475,150,1508,2109,1070,B
2108,CH,403,117,1592,4890,6216,2109,1189,H
2108,C,677,560,2152,760,2268,2109,1475,C
2108,D,80,80,2232,4200,6468,2109,2152,D
2108,M,16,16,2248,137,6605,2109,2232,M
2108,N,220,220,2468,150,6755,2109,2248,N
2108,O,606,606,3074,765,7520,2109,2468,O
2108,P,597,597,3671,3600,11120,2109,3074,P
2109,AE,81,81,81,127,127,2110,0,E
2109,AF,166,166,247,180,307,2110,81,F
2109,AG,1878,1631,1878,1868,1868,2110,0,A
2109,BG,1916,285,2163,750,1057,2110,247,G
2109,BH,1,1,2164,1140,2197,2110,2163,H
2109,B,342,56,2220,420,2288,2110,1878,B
2109,C,1236,1236,3456,1255,3543,2110,2220,C
2109,D,278,278,3734,420,3963,2110,3456,D
2109,M,270,270,4004,341,4304,2110,3734,M
2109,N,142,142,4146,90,4394,2110,4004,N
2109,O,447,447,4593,860,5254,2110,4146,O
2109,N,411,411,5004,35,5289,2110,4593,N
2109,O,540,540,5544,790,6079,2110,5004,O
2109,P,902,902,6446,3780,9859,2110,5544,P
2110,AE,177,177,177,1097,1097,2111,0,E
2110,AF,319,142,319,873,873,2111,0,A
2110,BF,682,682,1001,180,1053,2111,319,B
2110,CF,175,175,1176,245,1298,2111,1001,C
2110,BF,1040,41,1217,180,1277,2111,177,F
2110,BG,957,957,2174,1050,2327,2111,1217,G
2110,BF,1532,534,2708,1415,2713,2111,1176,B
2110,CF,1094,1094,3802,1245,3958,2111,2708,C
2110,DF,1645,17,3819,1555,3882,2111,2174,F
2110,DG,231,214,4033,3670,7628,2111,3802,D
2110,G,689,475,4508,810,4692,2111,3819,G
2110,H,279,279,4787,5040,9732,2111,4508,H
2110,M,4121,4121,8908,4927,14659,2111,4787,M
2110,N,2006,2006,10914,1260,15919,2111,8908,N
2110,O,399,399,11313,400,16319,2111,10914,O
2110,P,4261,4261,15574,425,16744,2111,11313,P
2111,AE,238,238,238,276,276,2112,0,E
2111,AF,315,315,553,300,576,2112,238,F
2111,AG,890,337,890,945,945,2112,0,A
2111,BG,162,162,1052,150,1095,2112,890,B
2111,CG,202,202,1254,170,1265,2112,1052,C
2111,DG,896,195,1449,1010,1586,2112,553,G
2111,DH,254,59,1508,4200,5465,2112,1254,D
2111,H,147,88,1596,3960,5546,2112,1449,H
2111,M,12,12,1608,60,5606,2112,1596,M
2111,N,288,288,1896,300,5906,2112,1608,N
2111,O,459,459,2355,840,6746,2112,1896,O
2111,N,728,728,3083,325,7071,2112,2355,N
2111,O,633,633,3716,780,7851,2112,3083,O
2111,P,1101,1101,4817,4080,11931,2112,3716,P
2112,AE,62,62,62,244,244,2113,0,E
2112,AF,236,174,236,410,410,2113,0,A
2112,BF,215,41,277,90,334,2113,62,F
2112,BG,239,198,475,90,500,2113,236,B
2112,CG,786,588,1063,1130,1464,2113,277,G
2112,CH,179,179,1242,3780,5244,2113,1063,H
2112,C,1434,667,1909,1745,2245,2113,475,C
2112,D,31,31,1940,3780,6025,2113,1909,D
2112,M,249,249,2189,1055,7080,2113,1940,M
2112,N,849,849,3038,90,7170,2113,2189,N
2112,O,148,148,3186,535,7705,2113,3038,O
2112,P,294,294,3480,3780,11485,2113,3186,P
2113,AE,117,117,117,985,985,2114,0,E
2113,AF,958,958,1075,150,1135,2114,117,F
2113,AG,88,88,1163,65,1200,2114,1075,G
2113,AH,102,102,1265,2880,4080,2114,1163,H
2113,A,4205,2940,4205,4289,4289,2114,0,A
2113,B,270,270,4475,240,4529,2114,4205,B
2113,C,756,756,5231,850,5379,2114,4475,C
2113,B,568,568,5799,460,5839,2114,5231,B
2113,C,546,546,6345,1050,6889,2114,5799,C
2113,D,795,795,7140,3300,10189,2114,6345,D
2113,M,73,73,7213,2785,12974,2114,7140,M
2113,N,4888,4888,12101,240,13214,2114,7213,N
2113,O,164,164,12265,3375,16589,2114,12101,O
2113,N,1809,1809,14074,505,17094,2114,12265,N
2113,O,671,671,14745,1070,18164,2114,14074,O
2113,P,2605,2605,17350,3960,22124,2114,14745,P
2114,A,56,56,56,631,631,2115,0,A
2114,B,782,782,838,240,871,2115,56,B
2114,C,514,514,1352,770,1641,2115,838,C
2114,D,1039,1039,2391,3960,5601,2115,1352,D
2114,M,974,974,3365,1490,7091,2115,2391,M
2114,N,728,728,4093,270,7361,2115,3365,N
2114,O,889,889,4982,735,8096,2115,4093,O
2114,N,903,903,5885,1050,9146,2115,4982,N
2114,O,460,460,6345,760,9906,2115,5885,O
2114,P,36141,36141,42486,5160,15066,2115,6345,P
2115,AEI,374,374,374,460,460,2116,0,I
2115,AEJ,176,176,550,150,610,2116,374,J
2115,AEK,702,702,1252,475,1085,2116,550,K
2115,AEL,109,109,1361,475,1560,2116,1252,L
2115,AE,2658,1297,2658,2547,2547,2116,0,E
2115,AF,269,269,2927,420,2967,2116,2658,F
2115,AG,745,745,3672,735,3702,2116,2927,G
2115,AH,2653,2653,6325,610,4312,2116,3672,H
2115,A,6533,208,6533,6622,6622,2116,0,A
2115,B,232,232,6765,240,6862,2116,6533,B
2115,C,779,779,7544,730,7592,2116,6765,C
2115,D,1244,1244,8788,550,8142,2116,7544,D
2115,M,920,920,9708,1704,9846,2116,8788,M
2115,N,1164,1164,10872,420,10266,2116,9708,N
2115,O,955,955,11827,1159,11425,2116,10872,O
2115,P,128,128,11955,341,11766,2116,11827,P
2116,AEI,40,40,40,549,549,2117,0,E
2116,AFI,336,296,336,851,851,2117,0,A
2116,BFI,550,214,550,670,670,2117,0,I
2116,BFJ,707,197,747,240,789,2117,40,F
2116,BGJ,609,198,945,150,1001,2117,336,B
2116,CGJ,475,80,1025,360,1030,2117,550,J
2116,CGK,190,110,1135,130,1131,2117,945,C
2116,BGK,451,341,1476,700,1730,2117,1025,K
2116,BGL,795,66,1542,775,1564,2117,747,G
2116,BHL,1545,1138,2680,1600,2731,2117,1135,B
2116,CHL,510,510,3190,595,3326,2117,2680,C
2116,DHL,1741,1741,4931,4140,7466,2117,3190,D
2116,HL,4225,770,5701,1140,2870,2117,1476,L
2116,H,4411,252,5953,3960,5524,2117,1542,H
2116,M,143,143,6096,130,7596,2117,5953,M
2116,N,77,77,6173,300,7896,2117,6096,N
2116,O,797,797,6970,690,8586,2117,6173,O
2116,N,468,468,7438,390,8976,2117,6970,N
2116,O,575,575,8013,720,9696,2117,7438,O
2116,P,2159,2159,10172,3960,13656,2117,8013,P
2117,AEI,346,346,346,1194,1194,2118,0,A
2117,BEI,423,77,423,612,612,2118,0,E
2117,BFI,403,403,826,260,872,2118,423,F
2117,BGI,988,508,1334,180,1374,2118,346,B
2117,CGI,802,294,1628,1525,2397,2118,826,G
2117,CHI,612,318,1946,625,1999,2118,1334,C
2117,DHI,1045,727,2673,720,3117,2118,1628,H
2117,DI,2957,284,2957,3305,3305,2118,0,I
2117,DJ,1289,278,3235,6960,8959,2118,1946,D
2117,J,608,330,3565,300,3605,2118,2957,J
2117,K,489,489,4054,1965,5570,2118,3565,K
2117,L,1413,1413,5467,2760,8330,2118,4054,L
2117,M,926,926,6393,1115,10074,2118,5467,M
2117,N,336,336,6729,180,10254,2118,6393,N
2117,O,699,699,7428,875,11129,2118,6729,O
2117,P,9424,9424,16852,6680,17809,2118,7428,P
2118,AEI,1668,1668,1668,1890,1890,2119,0,A
2118,BEI,246,246,1914,90,1980,2119,1668,B
2118,CEI,536,536,2450,880,2860,2119,1914,C
2118,DEI,194,194,2644,3780,6640,2119,2450,D
2118,EI,3142,498,3142,4049,4049,2119,0,E
2118,FI,937,937,4079,90,4139,2119,3142,F
2118,GI,1021,1021,5100,1210,5349,2119,4079,G
2118,HI,635,635,5735,3780,9129,2119,5100,H
2118,I,36746,31011,36746,37410,37410,2119,0,I
2118,J,694,694,37440,90,37500,2119,36746,J
2118,K,987,987,38427,1240,38740,2119,37440,K
2118,L,63,63,38490,3780,42520,2119,38427,L
2118,M,457,457,38947,998,43518,2119,38490,M
2118,N,578,578,39525,90,43608,2119,38947,N
2118,O,608,608,40133,955,44563,2119,39525,O
2118,P,1344,1344,41477,3780,48343,2119,40133,P
2119,AEI,3,3,3,132,132,2120,0,E
2119,AFI,59,56,59,134,134,2120,0,A
2119,BFI,114,55,114,454,454,2120,0,I
2119,BFJ,168,113,227,135,269,2120,59,B
2119,CFJ,332,108,335,240,372,2120,3,F
2119,CGJ,524,303,638,240,694,2120,114,J
2119,CGK,621,318,956,725,1097,2120,335,G
2119,CFK,855,126,1082,380,649,2120,227,C
2119,DFK,242,242,1324,9250,9899,2120,1082,D
2119,FK,1197,511,1835,1405,2099,2120,638,K
2119,FJ,1583,704,2539,1550,2647,2120,956,F
2119,GJ,992,288,2827,850,2949,2120,1835,J
2119,GK,559,559,3386,653,3602,2120,2827,K
2119,GL,1030,183,3569,1620,4267,2120,2539,G
2119,HL,407,407,3976,3960,8227,2120,3569,H
2119,L,1291,701,4677,1092,4694,2120,3386,L
2119,M,87,87,4764,106,10005,2120,4677,M
2119,N,134,134,4898,180,10185,2120,4764,N
2119,O,148,148,5046,265,10450,2120,4898,O
2119,N,550,550,5596,425,10875,2120,5046,N
2119,O,237,237,5833,280,11155,2120,5596,O
2119,P,81,81,5914,5160,16315,2120,5833,P
2120,A,211,211,211,1054,1054,2121,0,A
2120,B,864,864,1075,90,1144,2121,211,B
2120,C,966,966,2041,1250,2394,2121,1075,C
2120,D,2,2,2043,3780,6174,2121,2041,D
2120,M,2400,2400,4443,2532,8706,2121,2043,M
2120,N,167,167,4610,90,8796,2121,4443,N
2120,O,357,357,4967,705,9501,2121,4610,O
2120,P,1043,1043,6010,3780,13281,2121,4967,P
2121,AEI,98,98,98,1032,1032,2122,0,A
2121,BEI,301,203,301,418,418,2122,0,I
2121,BEJ,117,117,418,180,598,2122,301,J
2121,BEK,478,60,478,1189,1189,2122,0,E
2121,BFK,1117,737,1215,240,1272,2122,98,B
2121,CFK,906,109,1324,1200,1798,2122,418,K
2121,CFJ,913,67,1391,240,1429,2122,478,F
2121,CGJ,914,738,2129,1020,2292,2122,1215,C
2121,DGJ,889,151,2280,1020,2449,2122,1391,G
2121,DHJ,350,199,2479,4680,6972,2122,2129,D
2121,HJ,1521,366,2845,1085,2883,2122,1324,J
2121,HK,1084,1084,3929,1240,4123,2122,2845,K
2121,HL,10,10,3939,335,4458,2122,3929,L
2121,H,14589,12930,16869,4680,7129,2122,2280,H
2121,M,2355,2355,19224,2515,9644,2122,16869,M
2121,N,196,196,19420,90,9734,2122,19224,N
2121,O,673,673,20093,795,10529,2122,19420,O
2121,N,980,980,21073,860,11389,2122,20093,N
2121,O,141,141,21214,585,11974,2122,21073,O
2121,P,7203,7203,28417,3780,15754,2122,21214,P
2122,A,3453,3453,3453,5058,5058,2123,0,A
2122,B,1974,1974,5427,420,5478,2123,3453,B
2122,C,1138,1138,6565,1240,6718,2123,5427,C
2122,D,4,4,6569,335,7053,2123,6565,D
2122,M,657,657,7226,904,7957,2123,6569,M
2122,N,266,266,7492,90,8047,2123,7226,N
2122,O,524,524,8016,790,8837,2123,7492,O
2122,N,1786,1786,9802,1495,10332,2123,8016,N
2122,O,656,656,10458,1060,11392,2123,9802,O
2122,P,39,39,10497,3780,15172,2123,10458,P
2123,AE,88,88,88,1015,1015,2124,0,E
2123,AF,1110,1110,1198,240,1255,2124,88,F
2123,AG,897,897,2095,1020,2275,2124,1198,G
2123,AH,178,178,2273,4680,6955,2124,2095,H
2123,A,9471,7198,9471,10431,10431,2124,0,A
2123,B,1034,1034,10505,90,10521,2124,9471,B
2123,C,1244,1244,11749,1590,12111,2124,10505,C
2123,B,725,725,12474,425,12536,2124,11749,B
2123,C,371,371,12845,800,13336,2124,12474,C
2123,D,1011,1011,13856,3840,17176,2124,12845,D
2123,M,3170,3170,17026,3959,21135,2124,13856,M
2123,N,885,885,17911,90,21225,2124,17026,N
2123,O,956,956,18867,815,22040,2124,17911,O
2123,N,1123,1123,19990,1330,23370,2124,18867,N
2123,O,209,209,20199,605,23975,2124,19990,O
2123,P,3764,3764,23963,3780,27755,2124,20199,P
2124,AEI,150,150,150,208,208,2125,0,I
2124,AEJ,153,3,153,666,666,2125,0,A
2124,BEJ,228,75,228,646,646,2125,0,E
2124,BFJ,238,160,388,240,448,2125,150,J
2124,BFK,701,466,854,240,906,2125,153,B
2124,CFK,718,92,946,360,1006,2125,228,F
2124,CGK,600,42,988,610,1058,2125,388,K
2124,CGL,252,118,1106,255,1161,2125,854,C
2124,DGL,126,8,1114,385,1443,2125,988,L
2124,DG,1061,893,2007,1000,2006,2125,946,G
2124,DH,903,2,2009,5250,6411,2125,1106,D
2124,H,682,680,2689,550,2556,2125,2007,H
2124,M,175,175,2864,458,6869,2125,2689,M
2124,N,512,512,3376,270,7139,2125,2864,N
2124,O,788,788,4164,2049,9188,2125,3376,O
2124,P,1274,1274,5438,846,10034,2125,4164,P
2125,AE,321,321,321,900,900,2126,0,E
2125,AF,716,716,1037,180,1080,2126,321,F
2125,AG,595,595,1632,580,1660,2126,1037,G
2125,AF,1560,1560,3192,1550,3210,2126,1632,F
2125,AG,690,690,3882,865,4075,2126,3192,G
2125,AH,228,228,4110,1620,5695,2126,3882,H
2125,A,5282,1172,5282,4982,4982,2126,0,A
2125,B,449,449,5731,780,5762,2126,5282,B
2125,C,1116,1116,6847,1259,7021,2126,5731,C
2125,D,733,733,7580,351,7372,2126,6847,D
2125,M,317,317,7897,858,8230,2126,7580,M
2125,N,907,907,8804,420,8650,2126,7897,N
2125,O,981,981,9785,975,9625,2126,8804,O
2125,P,2043,2043,11828,550,10175,2126,9785,P
2126,AEI,218,218,218,204,204,2127,0,I
2126,AEJ,81,81,299,150,354,2127,218,J
2126,AEK,341,42,341,1182,1182,2127,0,E
2126,AFK,146,104,445,140,494,2127,299,K
2126,AFJ,695,250,695,973,973,2127,0,A
2126,BFJ,308,308,1003,90,1063,2127,695,B
2126,CFJ,866,204,1207,90,1272,2127,341,F
2126,CGJ,910,148,1355,900,1394,2127,445,J
2126,CGK,347,347,1702,650,2044,2127,1355,K
2126,CGL,542,47,1749,880,2152,2127,1207,G
2126,CFL,472,472,2221,110,2262,2127,1749,F
2126,CGL,1450,232,2453,2315,3378,2127,1003,C
2126,DGL,1415,1183,3636,2315,4577,2127,2221,G
2126,DHL,4840,2906,6542,4230,6274,2127,1702,L
2126,DH,4603,1697,8239,3420,7997,2127,3636,H
2126,D,7511,1725,9964,3420,6798,2127,2453,D
2126,M,155,155,10119,343,8340,2127,9964,M
2126,N,256,256,10375,90,8430,2127,10119,N
2126,O,1593,1593,11968,1875,10305,2127,10375,O
2126,N,452,452,12420,195,10500,2127,11968,N
2126,O,115,115,12535,535,11035,2127,12420,O
2126,P,918,918,13453,3780,14815,2127,12535,P
2127,AE,8597,8597,8597,8816,8816,2128,0,E
2127,AF,214,214,8811,120,8936,2128,8597,F
2127,AG,192,192,9003,390,9326,2128,8811,G
2127,AF,1491,1491,10494,1225,10551,2128,9003,F
2127,AG,700,700,11194,810,11361,2128,10494,G
2127,AH,11528,334,11528,11694,11694,2128,0,A
2127,BH,363,29,11557,5040,16401,2128,11194,H
2127,B,180,151,11708,90,11784,2128,11528,B
2127,C,3697,3697,15405,1345,13129,2128,11708,C
2127,B,1749,1749,17154,3935,17064,2128,15405,B
2127,C,711,711,17865,1130,18194,2128,17154,C
2127,D,12819,12819,30684,3780,21974,2128,17865,D
2127,M,241,241,30925,251,22225,2128,30684,M
2127,N,145,145,31070,195,22420,2128,30925,N
2127,O,699,699,31769,695,23115,2128,31070,O
2127,P,3753,3753,35522,385,23500,2128,31769,P
2128,AEI,215,215,215,912,912,2129,0,I
2128,AEJ,423,208,423,503,503,2129,0,E
2128,AFJ,335,335,758,300,803,2129,423,F
2128,AGJ,891,348,1106,240,1152,2129,215,J
2128,AGK,863,515,1621,1080,1883,2129,758,G
2128,AHK,1823,202,1823,2119,2119,2129,0,A
2128,BHK,776,59,1882,1030,2182,2129,1106,K
2128,BHL,698,437,2319,3960,5843,2129,1621,H
2128,BL,668,172,2491,300,2419,2129,1823,B
2128,CL,878,878,3369,860,3279,2129,2491,C
2128,DL,1642,155,3524,3960,6142,2129,1882,L
2128,D,685,530,4054,3960,7239,2129,3369,D
2128,M,31,31,4085,293,7532,2129,4054,M
2128,N,462,462,4547,240,7772,2129,4085,N
2128,O,727,727,5274,965,8737,2129,4547,O
2128,P,211,211,5485,3960,12697,2129,5274,P
2129,AE,174,174,174,187,187,2130,0,A
2129,BE,122,122,296,150,337,2130,174,B
2129,CE,106,106,402,165,502,2130,296,C
2129,DE,1796,1796,2198,4200,4702,2130,402,D
2129,E,3286,1088,3286,3307,3307,2130,0,E
2129,F,224,224,3510,240,3547,2130,3286,F
2129,G,827,827,4337,1055,4602,2130,3510,G
2129,H,364,364,4701,3900,8502,2130,4337,H
2129,M,94,94,4795,193,8695,2130,4701,M
2129,N,229,229,5024,180,8875,2130,4795,N
2129,O,123,123,5147,260,9135,2130,5024,O
2129,N,1025,1025,6172,895,10030,2130,5147,N
2129,O,187,187,6359,225,10255,2130,6172,O
2129,P,1583,1583,7942,4740,14995,2130,6359,P
2130,A,90,90,90,20,20,2131,0,A
2130,B,117,117,207,240,260,2131,90,B
2130,C,662,662,869,765,1025,2131,207,C
2130,D,135,135,1004,3600,4625,2131,869,D
2130,M,458,458,1462,546,5171,2131,1004,M
2130,N,176,176,1638,150,5321,2131,1462,N
2130,O,122,122,1760,145,5466,2131,1638,O
2130,N,798,798,2558,750,6216,2131,1760,N
2130,O,722,722,3280,665,6881,2131,2558,O
2130,P,6151,6151,9431,4230,11111,2131,3280,P
2131,A,23,23,23,221,221,2132,0,A
2131,B,286,286,309,135,356,2132,23,B
2131,C,172,172,481,215,571,2132,309,C
2131,D,130,130,611,4890,5461,2132,481,D
2131,M,106,106,717,860,6321,2132,611,M
2131,N,957,957,1674,240,6561,2132,717,N
2131,O,709,709,2383,880,7441,2132,1674,O
2131,P,70,70,2453,3960,11401,2132,2383,P
2132,AEI,150,150,150,859,859,2133,0,I
2132,AEJ,151,1,151,1326,1326,2133,0,A
2132,BEJ,623,472,623,401,401,2133,0,E
2132,BFJ,799,326,949,150,1009,2133,150,J
2132,BFK,153,153,1102,100,1109,2133,949,K
2132,BFJ,520,41,1143,780,1181,2133,623,F
2132,BGJ,547,506,1649,570,1679,2133,1102,J
2132,BGK,1548,50,1699,420,1746,2133,151,B
2132,CGK,959,403,2102,1777,2958,2133,1143,G
2132,CHK,716,263,2365,660,2339,2133,1649,K
2132,CHL,993,327,2692,1240,2986,2133,1699,C
2132,DHL,362,362,3054,335,3321,2133,2692,D
2132,HL,1114,425,3479,4230,6569,2133,2365,L
2132,H,14718,13341,16820,338,3296,2133,2102,H
2132,M,1970,1970,18790,2370,8939,2133,16820,M
2132,N,665,665,19455,180,9119,2133,18790,N
2132,O,113,113,19568,665,9784,2133,19455,O
2132,P,54054,54054,73622,6900,16684,2133,19568,P
2133,AE,383,383,383,708,708,2134,0,E
2133,AF,471,471,854,90,798,2134,383,F
2133,AG,1247,393,1247,1879,1879,2134,0,A
2133,BG,1168,775,2022,1590,2388,2134,854,G
2133,BH,992,217,2239,420,2299,2134,1247,B
2133,CH,986,769,3008,3780,6168,2134,2022,H
2133,C,1066,297,3305,880,3179,2134,2239,C
2133,D,6018,6018,9323,550,3729,2134,3305,D
2133,M,865,865,10188,1502,7670,2134,9323,M
2133,N,758,758,10946,150,7820,2134,10188,N
2133,O,217,217,11163,375,8195,2134,10946,O
2133,N,174,174,11337,25,8220,2134,11163,N
2133,O,723,723,12060,660,8880,2134,11337,O
2133,P,210,210,12270,4230,13110,2134,12060,P
2134,AEI,88,88,88,243,243,2135,0,I
2134,AEJ,257,257,345,150,393,2135,88,J
2134,AEK,629,629,974,620,1013,2135,345,K
2134,AEL,1404,430,1404,1628,1628,2135,0,E
2134,AFL,638,208,1612,4200,5213,2135,974,L
2134,AF,418,210,1822,240,1868,2135,1404,F
2134,AG,467,467,2289,775,2643,2135,1822,G
2134,AH,780,780,3069,3900,6543,2135,2289,H
2134,A,7257,4188,7257,7551,7551,2135,0,A
2134,B,487,487,7744,240,7791,2135,7257,B
2134,C,629,629,8373,920,8711,2135,7744,C
2134,D,97,97,8470,3960,12671,2135,8373,D
2134,M,25,25,8495,128,12799,2135,8470,M
2134,N,365,365,8860,240,13039,2135,8495,N
2134,O,452,452,9312,815,13854,2135,8860,O
2134,P,220,220,9532,3840,17694,2135,9312,P
2135,A,2992,2992,2992,4879,4879,2136,0,A
2135,B,2070,2070,5062,240,5119,2136,2992,B
2135,C,479,479,5541,725,5844,2136,5062,C
2135,D,371,371,5912,3960,9804,2136,5541,D
2135,M,2656,2656,8568,4037,13841,2136,5912,M
2135,N,1436,1436,10004,90,13931,2136,8568,N
2135,O,995,995,10999,1230,15161,2136,10004,O
2135,N,265,265,11264,25,15186,2136,10999,N
2135,O,215,215,11479,695,15881,2136,11264,O
2135,P,8692,8692,20171,3780,19661,2136,11479,P
2136,AEI,316,316,316,1259,1259,2137,0,A
2136,BEI,970,970,1286,90,1349,2137,316,B
2136,CEI,1875,589,1875,2530,2530,2137,0,E
2136,CFI,1018,429,2304,1220,2569,2137,1286,C
2136,BFI,702,273,2577,90,2620,2137,1875,F
2136,BGI,426,153,2730,215,2784,2137,2304,B
2136,CGI,186,33,2763,605,3225,2137,2577,G
2136,CHI,220,187,2950,605,3389,2137,2730,C
2136,DHI,6454,3504,6454,7064,7064,2137,0,I
2136,DHJ,1146,1146,7600,90,7154,2137,6454,J
2136,DHK,5786,949,8549,3780,7005,2137,2763,H
2136,DK,1234,285,8834,1365,8519,2137,7600,K
2136,DJ,515,515,9349,890,9409,2137,8834,J
2136,DK,200,200,9549,605,10014,2137,9349,K
2136,DL,111,111,9660,3780,13794,2137,9549,L
2136,D,6870,160,9820,3780,7169,2137,2950,D
2136,M,32,32,9852,1544,15338,2137,9820,M
2136,N,1753,1753,11605,300,15638,2137,9852,N
2136,O,897,897,12502,1075,16713,2137,11605,O
2136,N,2886,2886,15388,2750,19463,2137,12502,N
2136,O,2092,2092,17480,2346,21809,2137,15388,O
2136,P,1412,1412,18892,864,22673,2137,17480,P
2137,AE,59,59,59,983,983,2138,0,E
2137,AF,112,53,112,1178,1178,2138,0,A
2137,BF,1102,1049,1161,240,1223,2138,59,F
2137,BG,1249,200,1361,240,1418,2138,112,B
2137,CG,824,824,2185,1020,2438,2138,1361,C
2137,DG,1066,42,2227,995,2218,2138,1161,G
2137,DH,74,74,2301,4680,6898,2138,2227,H
2137,D,4934,4818,7119,4680,7118,2138,2185,D
2137,M,1685,1685,8804,1859,8977,2138,7119,M
2137,N,229,229,9033,90,9067,2138,8804,N
2137,O,470,470,9503,800,9867,2138,9033,O
2137,N,1241,1241,10744,920,10787,2138,9503,N
2137,O,717,717,11461,890,11677,2138,10744,O
2137,P,2625,2625,14086,3780,15457,2138,11461,P
2138,A,88,88,88,269,269,2139,0,A
2138,B,368,368,456,240,509,2139,88,B
2138,C,159,159,615,215,724,2139,456,C
2138,D,935,935,1550,4890,5614,2139,615,D
2138,M,37,37,1587,51,5665,2139,1550,M
2138,N,209,209,1796,240,5905,2139,1587,N
2138,O,670,670,2466,960,6865,2139,1796,O
2138,P,172,172,2638,3960,10825,2139,2466,P
2139,A,15717,15717,15717,16016,16016,2140,0,A
2139,B,316,316,16033,90,16106,2140,15717,B
2139,C,1596,1596,17629,1880,17986,2140,16033,C
2139,D,539,539,18168,3780,21766,2140,17629,D
2139,M,357,357,18525,879,22645,2140,18168,M
2139,N,551,551,19076,90,22735,2140,18525,N
2139,O,470,470,19546,860,23595,2140,19076,O
2139,P,3247,3247,22793,3780,27375,2140,19546,P
2140,A,169,169,169,876,876,2141,0,A
2140,B,802,802,971,150,1026,2141,169,B
2140,C,116,116,1087,100,1126,2141,971,C
2140,B,588,588,1675,595,1721,2141,1087,B
2140,C,784,784,2459,590,2311,2141,1675,C
2140,D,1957,1957,4416,4230,6541,2141,2459,D
2140,M,1823,1823,6239,2532,9073,2141,4416,M
2140,N,809,809,7048,150,9223,2141,6239,N
2140,O,782,782,7830,640,9863,2141,7048,O
2140,N,971,971,8801,1095,10958,2141,7830,N
2140,O,120,120,8921,110,11068,2141,8801,O
2140,P,445,445,9366,4230,15298,2141,8921,P
2141,A,45,45,45,1219,1219,2142,0,A
2141,B,1284,1284,1329,165,1384,2142,45,B
2141,C,555,555,1884,825,2209,2142,1329,C
2141,D,1929,1929,3813,3960,6169,2142,1884,D
2141,M,2513,2513,6326,2669,8838,2142,3813,M
2141,N,277,277,6603,150,8988,2142,6326,N
2141,O,1384,1384,7987,730,9718,2142,6603,O
2141,N,458,458,8445,1005,10723,2142,7987,N
2141,O,609,609,9054,705,11428,2142,8445,O
2141,P,1084,1084,10138,4230,15658,2142,9054,P
2142,AE,123,123,123,125,125,2143,0,E
2142,AF,122,122,245,180,305,2143,123,F
2142,AG,461,461,706,840,1145,2143,245,G
2142,AF,979,979,1685,575,1720,2143,706,F
2142,AG,694,694,2379,880,2600,2143,1685,G
2142,AH,101,101,2480,1620,4220,2143,2379,H
2142,A,7239,4759,7239,7445,7445,2143,0,A
2142,B,596,596,7835,300,7745,2143,7239,B
2142,C,657,657,8492,880,8625,2143,7835,C
2142,D,228,228,8720,1620,10245,2143,8492,D
2142,M,1800,1800,10520,1700,11945,2143,8720,M
2142,N,201,201,10721,300,12245,2143,10520,N
2142,O,815,815,11536,820,13065,2143,10721,O
2142,P,1803,1803,13339,1560,14625,2143,11536,P
2143,A,122,122,122,242,242,2144,0,A
2143,B,300,300,422,270,512,2144,122,B
2143,C,2272,2272,2694,2730,3242,2144,422,C
2143,B,1295,1295,3989,795,4037,2144,2694,B
2143,C,985,985,4974,1250,5287,2144,3989,C
2143,D,11,11,4985,335,5622,2144,4974,D
2143,M,1600,1600,6585,2326,7948,2144,4985,M
2143,N,860,860,7445,180,8128,2144,6585,N
2143,O,885,885,8330,930,9058,2144,7445,O
2143,P,1549,1549,9879,550,9608,2144,8330,P
2144,AEI,14,14,14,128,128,2145,0,A
2144,BEI,61,47,61,66,66,2145,0,E
2144,BFI,80,80,141,135,201,2145,61,F
2144,BGI,151,151,292,280,481,2145,141,G
2144,BHI,294,16,308,240,368,2145,14,B
2144,CHI,467,159,467,1674,1674,2145,0,I
2144,CHJ,327,168,635,285,653,2145,308,C
2144,DHJ,1380,1212,1847,240,1914,2145,467,J
2144,DHK,1642,87,1934,5160,5641,2145,292,H
2144,DK,176,89,2023,295,2209,2145,1847,K
2144,DJ,640,640,2663,515,2724,2145,2023,J
2144,DK,239,239,2902,295,3019,2145,2663,K
2144,DL,2875,608,3510,5160,5813,2145,635,D
2144,L,1929,1321,4831,5160,8179,2145,2902,L
2144,M,134,134,4965,185,8364,2145,4831,M
2144,N,157,157,5122,180,8544,2145,4965,N
2144,O,223,223,5345,535,9079,2145,5122,O
2144,P,323,323,5668,2760,11839,2145,5345,P
2145,A,1796,1796,1796,2334,2334,2146,0,A
2145,B,913,913,2709,420,2754,2146,1796,B
2145,C,962,962,3671,980,3734,2146,2709,C
2145,D,1977,1977,5648,550,4284,2146,3671,D
2145,M,178,178,5826,224,4508,2146,5648,M
2145,N,276,276,6102,270,4778,2146,5826,N
2145,O,1352,1352,7454,1160,5938,2146,6102,O
2145,P,6147,6147,13601,695,6633,2146,7454,P
2146,AEI,72,72,72,228,228,2147,0,E
2146,AFI,116,116,188,150,378,2147,72,F
2146,AGI,385,197,385,1310,1310,2147,0,A
2146,BGI,272,75,460,490,868,2147,188,G
2146,BHI,590,590,1050,720,1588,2147,460,H
2146,BI,1260,595,1645,300,1610,2147,385,B
2146,CI,737,737,2382,2065,3675,2147,1645,C
2146,DI,4700,2318,4700,4994,4994,2147,0,I
2146,DJ,323,323,5023,90,5084,2147,4700,J
2146,DK,2744,103,5126,2760,6435,2147,2382,D
2146,K,1150,1047,6173,1315,6399,2147,5023,K
2146,L,159,159,6332,3780,10179,2147,6173,L
2146,M,15994,15994,22326,16975,27154,2147,6332,M
2146,N,1021,1021,23347,90,27244,2147,22326,N
2146,O,1021,1021,24368,1240,28484,2147,23347,O
2146,N,816,816,25184,605,29089,2147,24368,N
2146,O,615,615,25799,924,30013,2147,25184,O
2146,P,41,41,25840,3780,33793,2147,25799,P
2147,AE,451,451,451,1300,1300,2148,0,A
2147,BE,980,529,980,1090,1090,2148,0,E
2147,BF,892,363,1343,90,1390,2148,451,B
2147,CF,795,432,1775,90,1180,2148,980,F
2147,CG,499,67,1842,855,2245,2148,1343,C
2147,DG,971,904,2746,1310,2490,2148,1775,G
2147,DH,76,76,2822,3780,6270,2148,2746,H
2147,D,1226,246,3068,3780,6025,2148,1842,D
2147,M,1797,1797,4865,2323,8593,2148,3068,M
2147,N,560,560,5425,90,8683,2148,4865,N
2147,O,504,504,5929,800,9483,2148,5425,O
2147,P,950,950,6879,3780,13263,2148,5929,P
2148,A,441,441,441,1404,1404,2149,0,A
2148,B,1525,1525,1966,90,1494,2149,441,B
2148,C,758,758,2724,1040,2534,2149,1966,C
2148,D,993,993,3717,3780,6314,2149,2724,D
2148,M,660,660,4377,951,7265,2149,3717,M
2148,N,388,388,4765,150,7415,2149,4377,N
2148,O,141,141,4906,75,7490,2149,4765,O
2148,N,1284,1284,6190,1335,8825,2149,4906,N
2148,O,595,595,6785,760,9585,2149,6190,O
2148,P,2680,2680,9465,5160,14745,2149,6785,P
2149,AEI,44,44,44,401,401,2150,0,E
2149,AFI,229,185,229,1124,1124,2150,0,I
2149,AFJ,497,312,541,165,566,2150,44,F
2149,AGJ,1025,713,1254,240,1364,2150,229,J
2149,AGK,1038,325,1579,1275,1841,2150,541,G
2149,AHK,934,934,2513,3960,5801,2150,1579,H
2149,AK,1814,555,3068,2820,4184,2150,1254,K
2149,AJ,1735,1735,4803,645,4829,2150,3068,J
2149,AK,581,581,5384,905,5734,2150,4803,K
2149,AL,242,242,5626,3960,9694,2150,5384,L
2149,A,8531,2905,8531,9687,9687,2150,0,A
2149,B,1188,1188,9719,90,9777,2150,8531,B
2149,C,994,994,10713,1220,10997,2150,9719,C
2149,B,809,809,11522,585,11582,2150,10713,B
2149,C,769,769,12291,860,12442,2150,11522,C
2149,D,39,39,12330,3780,16222,2150,12291,D
2149,M,1894,1894,14224,1982,18204,2150,12330,M
2149,N,184,184,14408,90,18294,2150,14224,N
2149,O,513,513,14921,870,19164,2150,14408,O
2149,N,1975,1975,16896,1680,20844,2150,14921,N
2149,O,730,730,17626,935,21779,2150,16896,O
2149,P,894,894,18520,3780,25559,2150,17626,P
2150,AEI,659,659,659,801,801,2151,0,E
2150,AFI,270,270,929,90,891,2151,659,F
2150,AGI,662,662,1591,815,1706,2151,929,G
2150,AHI,166,166,1757,3780,5486,2151,1591,H
2150,AI,2166,409,2166,2294,2294,2151,0,A
2150,BI,202,202,2368,90,2384,2151,2166,B
2150,CI,602,602,2970,790,3174,2151,2368,C
2150,DI,391,391,3361,3780,6954,2151,2970,D
2150,I,29283,25922,29283,30294,30294,2151,0,I
2150,J,1041,1041,30324,90,30384,2151,29283,J
2150,K,1009,1009,31333,1220,31604,2151,30324,K
2150,L,87,87,31420,3780,35384,2151,31333,L
2150,M,269,269,31689,1007,36391,2151,31420,M
2150,N,877,877,32566,90,36481,2151,31689,N
2150,O,3490,3490,36056,1780,38261,2151,32566,O
2150,P,1279,1279,37335,3780,42041,2151,36056,P
2151,AE,230,230,230,213,213,2152,0,E
2151,AF,73,73,303,150,363,2152,230,F
2151,AG,230,230,533,205,568,2152,303,G
2151,AH,171,171,704,1520,2088,2152,533,H
2151,A,1295,591,1295,3024,3024,2152,0,A
2151,B,1810,1810,3105,240,3264,2152,1295,B
2151,C,2036,2036,5141,1630,4894,2152,3105,C
2151,D,5987,5987,11128,5070,9964,2152,5141,D
2151,M,1249,1249,12377,3077,13041,2152,11128,M
2151,N,2034,2034,14411,240,13281,2152,12377,N
2151,O,944,944,15355,1295,14576,2152,14411,O
2151,P,992,992,16347,3780,18356,2152,15355,P
2152,A,120,120,120,3087,3087,2153,0,A
2152,B,3186,3186,3306,240,3327,2153,120,B
2152,C,904,904,4210,910,4237,2153,3306,C
2152,D,5834,5834,10044,550,4787,2153,4210,D
2152,M,946,946,10990,2718,7505,2153,10044,M
2152,N,2146,2146,13136,420,7925,2153,10990,N
2152,O,643,643,13779,676,8601,2153,13136,O
2152,P,5118,5118,18897,759,9360,2153,13779,P
2153,AEI,6,6,6,115,115,2154,0,A
2153,BEI,399,399,405,300,415,2154,6,B
2153,CEI,469,64,469,1580,1580,2154,0,I
2153,CEJ,577,513,982,750,1165,2154,405,C
2153,DEJ,83,83,1065,1560,2725,2154,982,D
2153,EJ,1497,901,1966,300,1880,2154,469,J
2153,EK,681,681,2647,840,2720,2154,1966,K
2153,EL,113,113,2760,1560,4280,2154,2647,L
2153,E,8958,6198,8958,10212,10212,2154,0,E
2153,F,1524,1524,10482,300,10512,2154,8958,F
2153,G,817,817,11299,775,11287,2154,10482,G
2153,H,1383,1383,12682,8400,19687,2154,11299,H
2153,M,3244,3244,15926,3403,23090,2154,12682,M
2153,N,370,370,16296,240,23330,2154,15926,N
2153,O,939,939,17235,995,24325,2154,16296,O
2153,N,223,223,17458,290,24615,2154,17235,N
2153,O,841,841,18299,1080,25695,2154,17458,O
2153,P,5974,5974,24273,3960,29655,2154,18299,P
2154,AE,81,81,81,156,156,2155,0,E
2154,AF,149,149,230,135,291,2155,81,F
2154,AG,237,7,237,1011,1011,2155,0,A
2154,BG,187,180,417,215,506,2155,230,G
2154,BH,1,1,418,4890,5396,2155,417,H
2154,B,1026,845,1263,300,1311,2155,237,B
2154,C,1021,1021,2284,995,2306,2155,1263,C
2154,D,867,867,3151,3960,6266,2155,2284,D
2154,M,539,539,3690,1043,7309,2155,3151,M
2154,N,695,695,4385,240,7549,2155,3690,N
2154,O,684,684,5069,785,8334,2155,4385,O
2154,P,1483,1483,6552,3960,12294,2155,5069,P
2155,A,416,416,416,1272,1272,2156,0,A
2155,B,1103,1103,1519,240,1512,2156,416,B
2155,C,887,887,2406,1040,2552,2156,1519,C
2155,D,747,747,3153,3960,6512,2156,2406,D
2155,M,7614,7614,10767,8491,15003,2156,3153,M
2155,N,1105,1105,11872,240,15243,2156,10767,N
2155,O,579,579,12451,1050,16293,2156,11872,O
2155,P,735,735,13186,3960,20253,2156,12451,P
2156,AEI,145,145,145,1230,1230,2157,0,A
2156,BEI,228,83,228,771,771,2157,0,E
2156,BFI,726,726,954,240,1011,2157,228,F
2156,BGI,991,37,991,1398,1398,2157,0,I
2156,BGJ,145,108,1099,390,1401,2157,954,G
2156,BFJ,1127,173,1272,90,1320,2157,145,B
2156,CFJ,440,159,1431,90,1488,2157,991,J
2156,CFK,747,415,1846,475,1876,2157,1099,F
2156,CGK,920,346,2192,1210,2530,2157,1272,C
2156,DGK,9,9,2201,3780,6310,2157,2192,D
2156,GK,1149,379,2580,1250,2738,2157,1431,K
2156,GL,810,76,2656,1045,2921,2157,1846,G
2156,HL,309,233,2889,3780,6518,2157,2580,L
2156,H,268,35,2924,3960,6881,2157,2656,H
2156,M,811,811,3735,1334,8215,2157,2924,M
2156,N,569,569,4304,90,8305,2157,3735,N
2156,O,410,410,4714,800,9105,2157,4304,O
2156,P,2429,2429,7143,3780,12885,2157,4714,P
2157,AEI,33,33,33,118,118,2158,0,I
2157,AEJ,187,187,220,150,268,2158,33,J
2157,AEK,287,67,287,371,371,2158,0,A
2157,BEK,271,271,558,240,611,2158,287,B
2157,CEK,1362,804,1362,1590,1590,2158,0,E
2157,CFK,940,136,1498,970,1581,2158,558,C
2157,DFK,446,310,1808,240,1830,2158,1362,F
2157,DGK,541,231,2039,3960,5541,2158,1498,D
2157,GK,842,611,2650,910,2740,2158,1808,G
2157,HK,77,77,2727,3900,6640,2158,2650,H
2157,K,3959,1452,4179,645,913,2158,220,K
2157,L,1217,1217,5396,4230,5143,2158,4179,L
2157,M,9550,9550,14946,9785,16425,2158,5396,M
2157,N,377,377,15323,180,16605,2158,14946,N
2157,O,539,539,15862,698,17303,2158,15323,O
2157,P,1448,1448,17310,4080,21383,2158,15862,P
2158,AEI,173,173,173,334,334,2159,0,I
2158,AEJ,281,281,454,180,514,2159,173,J
2158,AEK,476,22,476,580,580,2159,0,A
2158,BEK,552,76,552,865,865,2159,0,E
2158,BFK,227,151,703,180,760,2159,476,B
2158,CFK,147,147,850,140,900,2159,703,C
2158,DFK,418,22,872,660,1174,2159,454,K
2158,DFL,353,33,905,90,955,2159,552,F
2158,DGL,151,96,1001,2880,3780,2159,850,D
2158,GL,966,870,1871,1270,2225,2159,905,G
2158,HL,1395,1395,3266,3780,6005,2159,1871,H
2158,L,3183,789,4055,3960,5134,2159,872,L
2158,M,3661,3661,7716,5179,11184,2159,4055,M
2158,N,1524,1524,9240,90,11274,2159,7716,N
2158,O,1188,1188,10428,1365,12639,2159,9240,O
2158,N,2331,2331,12759,2130,14769,2159,10428,N
2158,O,424,424,13183,805,15574,2159,12759,O
2158,P,991,991,14174,3780,19354,2159,13183,P
2159,A,2964,2964,2964,3707,3707,2160,0,A
2159,B,1002,1002,3966,300,4007,2160,2964,B
2159,C,1153,1153,5119,1050,5057,2160,3966,C
2159,B,563,563,5682,720,5777,2160,5119,B
2159,C,697,697,6379,780,6557,2160,5682,C
2159,D,1737,1737,8116,3960,10517,2160,6379,D
2159,M,840,840,8956,1311,11828,2160,8116,M
2159,N,591,591,9547,180,12008,2160,8956,N
2159,O,217,217,9764,240,12248,2160,9547,O
2159,N,1158,1158,10922,1125,13373,2160,9764,N
2159,O,265,265,11187,355,13728,2160,10922,O
2159,P,33140,33140,44327,6060,19788,2160,11187,P
2160,AEI,95,95,95,5,5,2161,0,A
2160,BEI,156,156,251,300,305,2161,95,B
2160,CEI,380,380,631,395,700,2161,251,C
2160,DEI,869,869,1500,2040,2740,2161,631,D
2160,EI,1510,10,1510,1260,1260,2161,0,E
2160,FI,29,29,1539,300,1560,2161,1510,F
2160,GI,848,848,2387,895,2455,2161,1539,G
2160,HI,58,58,2445,2220,4675,2161,2387,H
2160,I,3591,1146,3591,3746,3746,2161,0,I
2160,J,245,245,3836,90,3836,2161,3591,J
2160,K,497,497,4333,815,4651,2161,3836,K
2160,J,1362,1362,5695,1105,5756,2161,4333,J
2160,K,1323,1323,7018,1850,7606,2161,5695,K
2160,L,1260,1260,8278,3780,11386,2161,7018,L
2160,M,651,651,8929,1620,13006,2161,8278,M
2160,N,1216,1216,10145,300,13306,2161,8929,N
2160,O,670,670,10815,805,14111,2161,10145,O
2160,P,324,324,11139,2940,17051,2161,10815,P
2161,AEI,566,566,566,3009,3009,2162,0,A
2161,BEI,1170,604,1170,1219,1219,2162,0,I
2161,BEJ,140,140,1310,150,1369,2162,1170,J
2161,BEK,212,212,1522,140,1509,2162,1310,K
2161,BEJ,494,494,2016,550,2059,2162,1522,J
2161,BEK,758,758,2774,775,2834,2162,2016,K
2161,BEL,2484,276,3050,90,3099,2162,566,B
2161,CEL,885,885,3935,1240,4339,2162,3050,C
2161,DEL,1352,191,4126,4230,7064,2162,2774,L
2161,DE,367,176,4302,3780,8119,2162,3935,D
2161,E,37165,32863,37165,37993,37993,2162,0,E
2161,F,859,859,38024,90,38083,2162,37165,F
2161,G,1068,1068,39092,1220,39303,2162,38024,G
2161,H,134,134,39226,3780,43083,2162,39092,H
2161,M,1864,1864,41090,2392,45475,2162,39226,M
2161,N,553,553,41643,90,45565,2162,41090,N
2161,O,1509,1509,43152,2315,47880,2162,41643,O
2161,P,24649,24649,67801,3420,51300,2162,43152,P
2162,AE,90,90,90,1727,1727,2163,0,A
2162,BE,1718,1718,1808,130,1857,2163,90,B
2162,CE,893,893,2701,910,2767,2163,1808,C
2162,DE,4492,1791,4492,4492,4492,2163,0,E
2162,DF,648,648,5140,540,5032,2163,4492,F
2162,DG,828,828,5968,795,5827,2163,5140,G
2162,DH,3664,397,6365,550,3317,2163,2701,D
2162,H,16322,15925,22290,550,6377,2163,5968,H
2162,M,1945,1945,24235,3643,10020,2163,22290,M
2162,N,2071,2071,26306,420,10440,2163,24235,N
2162,O,936,936,27242,1240,11680,2163,26306,O
2162,P,235,235,27477,335,12015,2163,27242,P
2163,AE,981,981,981,4277,4277,2164,0,E
2163,AF,3336,3336,4317,90,4367,2164,981,F
2163,AG,888,888,5205,1250,5617,2164,4317,G
2163,AH,130,130,5335,3780,9397,2164,5205,H
2163,A,30556,25221,30556,31353,31353,2164,0,A
2163,B,827,827,31383,90,31443,2164,30556,B
2163,C,890,890,32273,1240,32683,2164,31383,C
2163,D,123,123,32396,3780,36463,2164,32273,D
2163,M,2106,2106,34502,2650,39113,2164,32396,M
2163,N,598,598,35100,90,39203,2164,34502,N
2163,O,212,212,35312,625,39828,2164,35100,O
2163,P,4554,4554,39866,3780,43608,2164,35312,P
2164,AE,257,257,257,326,326,2165,0,A
2164,BE,355,98,355,522,522,2165,0,E
2164,BF,368,270,625,240,566,2165,257,B
2164,CF,312,42,667,150,672,2165,355,F
2164,CG,138,138,805,390,1062,2165,667,G
2164,CH,29,29,834,3960,5022,2165,805,H
2164,C,1732,1523,2357,725,1291,2165,625,C
2164,D,174,174,2531,3960,5251,2165,2357,D
2164,M,28,28,2559,121,5372,2165,2531,M
2164,N,216,216,2775,180,5552,2165,2559,N
2164,O,134,134,2909,260,5812,2165,2775,O
2164,N,1034,1034,3943,895,6707,2165,2909,N
2164,O,176,176,4119,225,6932,2165,3943,O
2164,P,70842,70842,74961,4740,11672,2165,4119,P
2165,A,24,24,24,225,225,2166,0,A
2165,B,397,397,421,240,465,2166,24,B
2165,C,213,213,634,285,750,2166,421,C
2165,D,3292,3292,3926,5160,5910,2166,634,D
2165,M,251,251,4177,646,6556,2166,3926,M
2165,N,455,455,4632,90,6646,2166,4177,N
2165,O,866,866,5498,1250,7896,2166,4632,O
2165,N,837,837,6335,455,8351,2166,5498,N
2165,O,465,465,6800,790,9141,2166,6335,O
2165,P,918,918,7718,3780,12921,2166,6800,P
2166,AEI,75,75,75,153,153,2167,0,A
2166,BEI,84,9,84,143,143,2167,0,E
2166,BFI,239,239,323,240,383,2167,84,F
2166,BGI,268,20,343,240,393,2167,75,B
2166,CGI,169,149,492,215,598,2167,323,G
2166,CHI,248,99,591,215,608,2167,343,C
2166,DHI,596,596,1187,4890,5498,2167,591,D
2166,HI,831,136,1323,4890,5488,2167,492,H
2166,I,8828,7505,8828,8525,8525,2167,0,I
2166,J,506,506,9334,90,8615,2167,8828,J
2166,K,855,855,10189,1330,9945,2167,9334,K
2166,L,523,523,10712,3780,13725,2167,10189,L
2166,M,1608,1608,12320,2680,16405,2167,10712,M
2166,N,1127,1127,13447,90,16495,2167,12320,N
2166,O,928,928,14375,1230,17725,2167,13447,O
2166,N,679,679,15054,385,18110,2167,14375,N
2166,O,624,624,15678,945,19055,2167,15054,O
2166,P,85526,85526,101204,3780,22835,2167,15678,P
2167,A,1418,1418,1418,1461,1461,2168,0,A
2167,B,224,224,1642,240,1701,2168,1418,B
2167,C,643,643,2285,765,2466,2168,1642,C
2167,D,241,241,2526,3960,6426,2168,2285,D
2167,M,62,62,2588,421,6847,2168,2526,M
2167,N,570,570,3158,240,7087,2168,2588,N
2167,O,519,519,3677,740,7827,2168,3158,O
2167,P,82,82,3759,4020,11847,2168,3677,P
2168,A,5193,5193,5193,6959,6959,2169,0,A
2168,B,2150,2150,7343,420,7379,2169,5193,B
2168,C,1207,1207,8550,1401,8780,2169,7343,C
2168,D,720,720,9270,504,9284,2169,8550,D
2168,M,8,8,9278,481,9765,2169,9270,M
2168,N,594,594,9872,150,9915,2169,9278,N
2168,O,620,620,10492,920,10835,2169,9872,O
2168,N,2824,2824,13316,2535,13370,2169,10492,N
2168,O,613,613,13929,780,14150,2169,13316,O
2168,P,897,897,14826,4230,18380,2169,13929,P
2169,AEI,483,483,483,707,707,2170,0,A
2169,BEI,318,318,801,150,857,2170,483,B
2169,CEI,499,499,1300,485,1342,2170,801,C
2169,DEI,1498,198,1498,2281,2281,2170,0,I
2169,DEJ,808,808,2306,90,2371,2170,1498,J
2169,DEK,2722,416,2722,2853,2853,2170,0,E
2169,DFK,1507,85,2807,4200,5542,2170,1300,D
2169,FK,519,18,2825,820,3191,2170,2306,K
2169,FJ,246,143,2968,150,3003,2170,2722,F
2169,GJ,761,761,3729,1000,4003,2170,2968,G
2169,HJ,1743,839,4568,1430,4621,2170,2825,J
2169,HK,1302,463,5031,3960,7963,2170,3729,H
2169,K,992,529,5560,1275,5896,2170,4568,K
2169,L,632,632,6192,3780,9676,2170,5560,L
2169,M,1241,1241,7433,1297,10973,2170,6192,M
2169,N,161,161,7594,150,11123,2170,7433,N
2169,O,209,209,7803,110,11233,2170,7594,O
2169,P,467,467,8270,4230,15463,2170,7803,P
2170,AEI,71,71,71,156,156,2171,0,E
2170,AFI,138,67,138,2232,2232,2171,0,I
2170,AFJ,264,197,335,240,396,2171,71,F
2170,AGJ,188,188,523,215,611,2171,335,G
2170,AHJ,1,1,524,4890,5501,2171,523,H
2170,AJ,537,13,537,1603,1603,2171,0,A
2170,BJ,1189,1189,1726,150,1753,2171,537,B
2170,CJ,691,691,2417,730,2483,2171,1726,C
2170,DJ,2296,17,2434,240,2472,2171,138,J
2170,DK,1052,1035,3469,4200,6683,2171,2417,D
2170,K,1447,412,3881,1015,3487,2171,2434,K
2170,L,479,479,4360,3960,7447,2171,3881,L
2170,M,505,505,4865,788,8235,2171,4360,M
2170,N,476,476,5341,240,8475,2171,4865,N
2170,O,666,666,6007,895,9370,2171,5341,O
2170,P,1033,1033,7040,3960,13330,2171,6007,P
2171,AEI,74,74,74,85,85,2172,0,A
2171,AEI,74,0,74,997,997,2172,0,I
2171,BEJ,161,87,161,1018,1018,2172,0,E
2171,BFJ,208,121,282,240,325,2172,74,B
2171,CFJ,705,705,987,960,1285,2172,282,C
2171,DFJ,1113,200,1187,240,1237,2172,74,J
2171,DFK,1050,24,1211,240,1258,2172,161,F
2171,DGK,457,233,1444,3960,5245,2172,987,D
2171,GK,799,542,1986,890,2127,2172,1187,K
2171,GL,795,20,2006,890,2148,2172,1211,G
2171,HL,255,235,2241,5160,7287,2172,1986,L
2171,H,4709,4474,6715,5160,7308,2172,2006,H
2171,M,160,160,6875,1671,8979,2172,6715,M
2171,N,1710,1710,8585,250,9229,2172,6875,N
2171,O,1014,1014,9599,910,10139,2172,8585,O
2171,P,581,581,10180,550,10689,2172,9599,P
2172,AE,299,299,299,428,428,2173,0,A
2172,BE,871,871,1170,780,1208,2173,299,B
2172,CE,916,916,2086,1727,2935,2173,1170,C
2172,DE,9121,9121,11207,338,3273,2173,2086,D
2172,E,35901,24694,35901,37898,37898,2173,0,E
2172,F,2090,2090,37991,90,37988,2173,35901,F
2172,G,1082,1082,39073,1385,39373,2173,37991,G
2172,F,394,394,39467,130,39503,2173,39073,F
2172,G,381,381,39848,800,40303,2173,39467,G
2172,H,1885,1885,41733,3780,44083,2173,39848,H
2172,M,3331,3331,45064,3484,47567,2173,41733,M
2172,N,193,193,45257,90,47657,2173,45064,N
2172,O,446,446,45703,800,48457,2173,45257,O
2172,N,1554,1554,47257,1220,49677,2173,45703,N
2172,O,195,195,47452,690,50367,2173,47257,O
2172,P,1609,1609,49061,3780,54147,2173,47452,P
2173,AEI,157,157,157,171,171,2174,0,E
2173,AFI,168,11,168,170,170,2174,0,I
2173,AFJ,245,77,245,195,195,2174,0,A
2173,BFJ,80,3,248,135,305,2174,168,J
2173,BFK,95,4,252,135,306,2174,157,F
2173,BGK,137,133,385,285,590,2174,248,K
2173,BGL,223,83,468,300,495,2174,245,B
2173,CGL,120,37,505,5160,5750,2174,385,L
2173,CG,286,33,538,280,586,2174,252,G
2173,CH,133,133,671,5160,5746,2174,538,H
2173,C,571,368,1039,795,1290,2174,468,C
2173,D,922,922,1961,1140,2430,2174,1039,D
2173,M,3237,3237,5198,4782,10532,2174,1961,M
2173,N,1585,1585,6783,90,10622,2174,5198,N
2173,O,823,823,7606,1240,11862,2174,6783,O
2173,N,1063,1063,8669,655,12517,2174,7606,N
2173,O,207,207,8876,605,13122,2174,8669,O
2173,P,4209,4209,13085,3780,16902,2174,8876,P
2174,AEI,302,302,302,3990,3990,2175,0,I
2174,AEJ,1387,1085,1387,2365,2365,2175,0,A
2174,BEJ,1611,224,1611,2070,2070,2175,0,E
2174,BFJ,1186,962,2573,240,2605,2175,1387,B
2174,CFJ,761,761,3334,1040,3645,2175,2573,C
2174,BFJ,1850,127,3461,1470,3540,2175,1611,F
2174,BGJ,644,644,4105,570,4110,2175,3461,G
2174,BHJ,3965,162,4267,300,4290,2175,302,J
2174,BHK,989,56,4323,670,4315,2175,3334,B
2174,CHK,626,626,4949,780,5095,2175,4323,C
2174,DHK,800,118,5067,825,5115,2175,4267,K
2174,DHL,920,920,5987,1140,6255,2175,5067,L
2174,DH,2665,783,6770,550,4660,2175,4105,H
2174,D,2656,835,7605,3960,9055,2175,4949,D
2174,M,687,687,8292,1181,10236,2175,7605,M
2174,N,1252,1252,9544,780,11016,2175,8292,N
2174,O,1783,1783,11327,1744,12760,2175,9544,O
2174,P,1156,1156,12483,1081,13841,2175,11327,P
2175,AE,33,33,33,127,127,2176,0,E
2175,AF,189,156,189,200,200,2176,0,A
2175,BF,205,49,238,135,262,2176,33,F
2175,BG,87,38,276,135,335,2176,189,B
2175,CG,168,168,444,280,615,2176,276,C
2175,DG,253,47,491,285,547,2176,238,G
2175,DH,122,122,613,5160,5707,2176,491,H
2175,D,261,92,705,5160,5775,2176,444,D
2175,M,908,908,1613,1380,7155,2176,705,M
2175,N,520,520,2133,90,7245,2176,1613,N
2175,O,906,906,3039,1250,8495,2176,2133,O
2175,P,585,585,3624,3780,12275,2176,3039,P
2176,AEI,188,188,188,1241,1241,2177,0,I
2176,AEJ,1129,941,1129,1740,1740,2177,0,A
2176,BEJ,1083,142,1271,90,1331,2177,188,J
2176,BEK,1355,84,1355,1736,1736,2177,0,E
2176,BFK,406,406,1761,90,1826,2177,1355,F
2176,BGK,645,13,1774,90,1830,2177,1129,B
2176,CGK,1049,546,2320,1240,2571,2177,1271,K
2176,CGL,874,328,2648,1240,3070,2177,1774,C
2176,DGL,590,590,3238,3780,6850,2177,2648,D
2176,GL,1548,71,3309,1780,3606,2177,1761,G
2176,HL,5,5,3314,3780,7386,2177,3309,H
2176,L,2835,1841,5155,3780,6351,2177,2320,L
2176,M,468,468,5623,991,8377,2177,5155,M
2176,N,565,565,6188,90,8467,2177,5623,N
2176,O,351,351,6539,705,9172,2177,6188,O
2176,P,3930,3930,10469,3780,12952,2177,6539,P
2177,AE,166,166,166,395,395,2178,0,E
2177,AF,491,491,657,300,695,2178,166,F
2177,AG,705,705,1362,910,1605,2178,657,G
2177,AH,1506,144,1506,1630,1630,2178,0,A
2177,BH,153,9,1515,3960,5565,2178,1362,H
2177,B,409,400,1915,300,1930,2178,1506,B
2177,C,523,523,2438,760,2690,2178,1915,C
2177,D,162,162,2600,1560,4250,2178,2438,D
2177,M,1660,1660,4260,1595,7160,2178,2600,M
2177,N,195,195,4455,300,7460,2178,4260,N
2177,O,804,804,5259,855,8315,2178,4455,O
2177,N,253,253,5512,205,8520,2178,5259,N
2177,O,211,211,5723,1290,9810,2178,5512,O
2177,P,1078,1078,6801,3120,12930,2178,5723,P
2178,A,4323,4323,4323,4972,4972,2179,0,A
2178,B,680,680,5003,90,5062,2179,4323,B
2178,C,724,724,5727,1130,6192,2179,5003,C
2178,D,163,163,5890,3780,9972,2179,5727,D
2178,M,1588,1588,7478,1773,11745,2179,5890,M
2178,N,230,230,7708,90,11835,2179,7478,N
2178,O,1192,1192,8900,1465,13300,2179,7708,O
2178,P,1859,1859,10759,3780,17080,2179,8900,P
2179,AE,201,201,201,467,467,2180,0,E
2179,AF,297,297,498,90,557,2180,201,F
2179,AG,528,528,1026,845,1402,2180,498,G
2179,AH,427,427,1453,3780,5182,2180,1026,H
2179,A,3681,2228,3681,7367,7367,2180,0,A
2179,B,3895,3895,7576,240,7607,2180,3681,B
2179,C,675,675,8251,860,8467,2180,7576,C
2179,D,618,618,8869,3960,12427,2180,8251,D
2179,M,1754,1754,10623,2477,14904,2180,8869,M
2179,N,1015,1015,11638,300,15204,2180,10623,N
2179,O,792,792,12430,910,16114,2180,11638,O
2179,N,762,762,13192,660,16774,2180,12430,N
2179,O,245,245,13437,385,17159,2180,13192,O
2179,P,1542,1542,14979,3960,21119,2180,13437,P
2180,AE,5721,5721,5721,7483,7483,2181,0,E
2180,AF,6843,1122,6843,7089,7089,2181,0,A
2180,BF,896,896,7739,780,7869,2181,6843,B
2180,CF,2412,394,8133,710,8193,2181,5721,F
2180,CG,870,870,9003,825,9018,2181,8133,G
2180,CH,1375,111,9114,1225,9094,2181,7739,C
2180,DH,844,733,9847,550,9568,2181,9003,H
2180,D,1556,823,10670,550,9644,2181,9114,D
2180,M,3479,3479,14149,4247,13891,2181,10670,M
2180,N,1125,1125,15274,420,14311,2181,14149,N
2180,O,1076,1076,16350,1206,15517,2181,15274,O
2180,P,183,183,16533,414,15931,2181,16350,P
2181,AE,42,42,42,202,202,2182,0,A
2181,BE,150,108,150,66,66,2182,0,E
2181,BF,132,132,282,240,306,2182,150,F
2181,BG,259,19,301,150,352,2182,42,B
2181,CG,616,597,898,765,1071,2182,282,G
2181,CH,397,397,1295,3600,4671,2182,898,H
2181,C,1068,74,1369,140,492,2182,301,C
2181,D,6392,6392,7761,4230,4722,2182,1369,D
2181,M,1774,1774,9535,1849,6571,2182,7761,M
2181,N,168,168,9703,150,6721,2182,9535,N
2181,O,148,148,9851,150,6871,2182,9703,O
2181,N,928,928,10779,890,7761,2182,9851,N
2181,O,292,292,11071,650,8411,2182,10779,O
2181,P,1512,1512,12583,4230,12641,2182,11071,P
2182,AE,7,7,7,116,116,2183,0,A
2182,BE,304,304,311,240,356,2183,7,B
2182,CE,831,831,1142,1045,1401,2183,311,C
2182,DE,145,145,1287,4020,5421,2183,1142,D
2182,E,2324,1037,2324,3997,3997,2183,0,E
2182,F,1707,1707,4031,90,4087,2183,2324,F
2182,G,1003,1003,5034,1250,5337,2183,4031,G
2182,H,30,30,5064,3780,9117,2183,5034,H
2182,M,4212,4212,9276,4802,13919,2183,5064,M
2182,N,620,620,9896,90,14009,2183,9276,N
2182,O,373,373,10269,739,14748,2183,9896,O
2182,P,2696,2696,12965,3780,18528,2183,10269,P
2183,AEI,43,43,43,1409,1409,2184,0,E
2183,AFI,98,55,98,1151,1151,2184,0,I
2183,AFJ,1250,1250,1348,240,1391,2184,98,J
2183,AFK,1404,56,1404,1641,1641,2184,0,A
2183,BFK,1554,193,1597,240,1649,2184,43,F
2183,BGK,424,231,1828,240,1881,2184,1404,B
2183,CGK,111,111,1939,380,2261,2184,1828,C
2183,BGK,679,88,2027,760,2151,2184,1348,K
2183,BGL,730,300,2327,780,2429,2184,1597,G
2183,BHL,933,545,2872,645,2906,2184,1939,B
2183,CHL,606,606,3478,810,3716,2184,2872,C
2183,DHL,1185,34,3512,7680,10109,2184,2327,H
2183,DL,2708,1223,4735,7680,9831,2184,2027,L
2183,D,3197,1940,6675,3960,7676,2184,3478,D
2183,M,408,408,7083,590,10699,2184,6675,M
2183,N,311,311,7394,185,10884,2184,7083,N
2183,O,506,506,7900,525,11409,2184,7394,O
2183,N,239,239,8139,220,11629,2184,7900,N
2183,O,171,171,8310,100,11729,2184,8139,O
2183,N,92,92,8402,170,11899,2184,8310,N
2183,O,3480,3480,11882,2910,14809,2184,8402,O
2183,P,402,402,12284,3450,18259,2184,11882,P
2184,A,1050,1050,1050,2201,2201,2185,0,A
2184,B,1607,1607,2657,420,2621,2185,1050,B
2184,C,1100,1100,3757,1304,3925,2185,2657,C
2184,D,1180,1180,4937,456,4381,2185,3757,D
2184,M,4771,4771,9708,5740,10121,2185,4937,M
2184,N,1167,1167,10875,240,10361,2185,9708,N
2184,O,825,825,11700,850,11211,2185,10875,O
2184,P,2995,2995,14695,550,11761,2185,11700,P
2185,A,549,549,549,634,634,2186,0,A
2185,B,329,329,878,270,904,2186,549,B
2185,C,833,833,1711,855,1759,2186,878,C
2185,D,20,20,1731,355,2114,2186,1711,D
2185,M,560,560,2291,1218,3332,2186,1731,M
2185,N,681,681,2972,90,3422,2186,2291,N
2185,O,243,243,3215,625,4047,2186,2972,O
2185,P,3594,3594,6809,3780,7827,2186,3215,P
2186,A,44,44,44,287,287,2187,0,A
2186,B,343,343,387,165,452,2187,44,B
2186,C,1054,1054,1441,1275,1727,2187,387,C
2186,D,708,708,2149,4020,5747,2187,1441,D
2186,M,1349,1349,3498,1411,7158,2187,2149,M
2186,N,317,317,3815,300,7458,2187,3498,N
2186,O,724,724,4539,970,8428,2187,3815,O
2186,N,503,503,5042,350,8778,2187,4539,N
2186,O,246,246,5288,390,9168,2187,5042,O
2186,P,1767,1767,7055,3960,13128,2187,5288,P
2187,A,1473,1473,1473,1630,1630,2188,0,A
2187,B,374,374,1847,240,1870,2188,1473,B
2187,C,734,734,2581,995,2865,2188,1847,C
2187,B,686,686,3267,410,3275,2188,2581,B
2187,C,652,652,3919,810,4085,2188,3267,C
2187,D,4101,4101,8020,3960,8045,2188,3919,D
2187,M,918,918,8938,1238,9283,2188,8020,M
2187,N,459,459,9397,150,9433,2188,8938,N
2187,O,118,118,9515,105,9538,2188,9397,O
2187,N,454,454,9969,490,10028,2188,9515,N
2187,O,911,911,10880,960,10988,2188,9969,O
2187,P,1208,1208,12088,4230,15218,2188,10880,P
2188,AE,105,105,105,851,851,2189,0,E
2188,AF,162,57,162,614,614,2189,0,A
2188,BF,500,500,662,90,704,2189,162,B
2188,CF,845,288,950,150,1001,2189,105,F
2188,CG,412,124,1074,800,1504,2189,662,C
2188,DG,174,50,1124,140,1141,2189,950,G
2188,DF,466,466,1590,500,1641,2189,1124,F
2188,DG,722,722,2312,660,2301,2189,1590,G
2188,DH,1397,159,2471,3780,5284,2189,1074,D
2188,H,1137,978,3449,4230,6531,2189,2312,H
2188,M,3404,3404,6853,3488,10019,2189,3449,M
2188,N,156,156,7009,90,10109,2189,6853,N
2188,O,696,696,7705,815,10924,2189,7009,O
2188,N,1780,1780,9485,1690,12614,2189,7705,N
2188,O,111,111,9596,585,13199,2189,9485,O
2188,P,12494,12494,22090,3780,16979,2189,9596,P
2189,AE,761,761,761,985,985,2190,0,A
2189,BE,516,516,1277,330,1315,2190,761,B
2189,CE,807,807,2084,942,2257,2190,1277,C
2189,DE,465,465,2549,348,2605,2190,2084,D
2189,E,4624,2075,4624,4581,4581,2190,0,E
2189,F,460,460,5084,300,4881,2190,4624,F
2189,G,895,895,5979,1010,5891,2190,5084,G
2189,H,374,374,6353,1200,7091,2190,5979,H
2189,M,1639,1639,7992,1748,8839,2190,6353,M
2189,N,222,222,8214,90,8929,2190,7992,N
2189,O,463,463,8677,820,9749,2190,8214,O
2189,N,1761,1761,10438,1485,11234,2190,8677,N
2189,O,520,520,10958,585,11819,2190,10438,O
2189,P,15839,15839,26797,3780,15599,2190,10958,P
2190,AEI,66,66,66,1026,1026,2191,0,I
2190,AEJ,575,509,575,1358,1358,2191,0,E
2190,AFJ,578,3,578,830,830,2191,0,A
2190,BFJ,299,299,877,90,920,2191,578,B
2190,CFJ,1162,351,1228,240,1266,2191,66,J
2190,CFK,389,38,1266,800,1720,2191,877,C
2190,DFK,812,121,1387,90,1448,2191,575,F
2190,DGK,386,386,1773,800,2248,2191,1387,G
2190,DHK,910,365,2138,1020,2286,2191,1228,K
2190,DHL,969,97,2235,3780,5500,2191,1266,D
2190,HL,301,204,2439,4680,6966,2191,2138,L
2190,H,1757,1091,3530,3780,6028,2191,1773,H
2190,M,2014,2014,5544,2182,9148,2191,3530,M
2190,N,209,209,5753,90,9238,2191,5544,N
2190,O,409,409,6162,820,10058,2191,5753,O
2190,N,673,673,6835,260,10318,2191,6162,N
2190,O,547,547,7382,805,11123,2191,6835,O
2190,P,23640,23640,31022,3780,14903,2191,7382,P
2191,AE,247,247,247,781,781,2192,0,E
2191,AF,574,574,821,90,871,2192,247,F
2191,AG,1504,1504,2325,2315,3186,2192,821,G
2191,AH,1265,1265,3590,3420,6606,2192,2325,H
2191,A,19207,15617,19207,20143,20143,2192,0,A
2191,B,971,971,20178,90,20233,2192,19207,B
2191,C,496,496,20674,880,21113,2192,20178,C
2191,B,495,495,21169,110,21223,2192,20674,B
2191,C,1428,1428,22597,2315,23538,2192,21169,C
2191,D,4267,4267,26864,3420,26958,2192,22597,D
2191,M,469,469,27333,1770,28728,2192,26864,M
2191,N,1331,1331,28664,90,28818,2192,27333,N
2191,O,1687,1687,30351,1875,30693,2192,28664,O
2191,N,1402,1402,31753,1185,31878,2192,30351,N
2191,O,407,407,32160,790,32668,2192,31753,O
2191,P,1279,1279,33439,3780,36448,2192,32160,P
2192,A,1,1,1,50,50,2193,0,A
2192,B,304,304,305,300,350,2193,1,B
2192,C,790,790,1095,830,1180,2193,305,C
2192,B,1213,1213,2308,1180,2360,2193,1095,B
2192,C,129,129,2437,240,2600,2193,2308,C
2192,D,4519,4519,6956,5100,7700,2193,2437,D
2192,M,279,279,7235,778,8478,2193,6956,M
2192,N,603,603,7838,150,8628,2193,7235,N
2192,O,115,115,7953,125,8753,2193,7838,O
2192,N,353,353,8306,345,9098,2193,7953,N
2192,O,122,122,8428,120,9218,2193,8306,O
2192,P,1100,1100,9528,4230,13448,2193,8428,P
2193,AE,80,80,80,1036,1036,2194,0,A
2193,BE,322,242,322,876,876,2194,0,E
2193,BF,660,660,982,150,1026,2194,322,F
2193,BG,175,175,1157,140,1166,2194,982,G
2193,BF,1144,67,1224,240,1276,2194,80,B
2193,CF,431,364,1588,470,1636,2194,1157,F
2193,CG,814,450,2038,995,2271,2194,1224,C
2193,DG,197,197,2235,4680,6951,2194,2038,D
2193,G,736,89,2324,660,2296,2194,1588,G
2193,H,1220,1220,3544,4230,6526,2194,2324,H
2193,M,2196,2196,5740,2301,9252,2194,3544,M
2193,N,212,212,5952,90,9342,2194,5740,N
2193,O,505,505,6457,815,10157,2194,5952,O
2193,N,865,865,7322,220,10377,2194,6457,N
2193,O,910,910,8232,1280,11657,2194,7322,O
2193,P,163,163,8395,3780,15437,2194,8232,P
2194,AEI,594,594,594,1259,1259,2195,0,E
2194,AFI,697,697,1291,90,1349,2195,594,F
2194,AGI,952,952,2243,1240,2589,2195,1291,G
2194,AHI,5,5,2248,3780,6369,2195,2243,H
2194,AI,36951,34703,36951,37993,37993,2195,0,I
2194,AJ,37086,135,37086,37994,37994,2195,0,A
2194,BJ,938,938,38024,90,38084,2195,37086,B
2194,CJ,1087,14,38038,90,38083,2195,36951,J
2194,CK,1023,1009,39047,1210,39294,2195,38024,C
2194,DK,1061,52,39099,1210,39293,2195,38038,K
2194,DL,5,5,39104,3780,43073,2195,39099,L
2194,D,634,577,39681,3780,43074,2195,39047,D
2194,M,3632,3632,43313,4765,47839,2195,39681,M
2194,N,1186,1186,44499,90,47929,2195,43313,N
2194,O,327,327,44826,720,48649,2195,44499,O
2194,P,3078,3078,47904,3780,52429,2195,44826,P
2195,AE,777,777,777,1370,1370,2196,0,A
2195,BE,835,58,835,1541,1541,2196,0,E
2195,BF,852,794,1629,300,1670,2196,777,B
2195,CF,831,37,1666,180,1721,2196,835,F
2195,CG,650,613,2279,805,2475,2196,1629,C
2195,DG,1843,1230,3509,1300,3021,2196,1666,G
2195,DH,1458,228,3737,4020,6495,2196,2279,D
2195,H,312,84,3821,1860,4881,2196,3509,H
2195,M,587,587,4408,1391,7886,2196,3821,M
2195,N,1058,1058,5466,300,8186,2196,4408,N
2195,O,533,533,5999,695,8881,2196,5466,O
2195,P,967,967,6966,4080,12961,2196,5999,P
2196,AEI,52,52,52,876,876,2197,0,I
2196,AEJ,58,6,58,819,819,2197,0,E
2196,AFJ,942,942,1000,240,1059,2197,58,F
2196,AGJ,1006,58,1058,240,1116,2197,52,J
2196,AGK,1265,207,1265,1466,1466,2197,0,A
2196,BGK,313,48,1313,540,1599,2197,1000,G
2196,BHK,384,336,1649,240,1706,2197,1265,B
2196,CHK,593,2,1651,535,1651,2197,1058,K
2196,CHL,558,556,2207,740,2446,2197,1649,C
2196,BHL,1542,1542,3749,1345,3791,2197,2207,B
2196,CHL,224,224,3973,535,4326,2197,3749,C
2196,DHL,5715,3055,7028,2880,4479,2197,1313,H
2196,DL,6782,1405,8433,2880,4531,2197,1651,L
2196,D,17380,12920,21353,2940,7266,2197,3973,D
2196,M,4,4,21357,193,7459,2197,21353,M
2196,N,309,309,21666,180,7639,2197,21357,N
2196,O,48,48,21714,545,8184,2197,21666,O
2196,N,1096,1096,22810,630,8814,2197,21714,N
2196,O,485,485,23295,300,9114,2197,22810,O
2196,P,3949,3949,27244,5100,14214,2197,23295,P
2197,A,517,517,517,912,912,2198,0,A
2197,B,448,448,965,90,1002,2198,517,B
2197,C,528,528,1493,845,1847,2198,965,C
2197,D,423,423,1916,3780,5627,2198,1493,D
2197,M,677,677,2593,1399,7026,2198,1916,M
2197,N,840,840,3433,150,7176,2198,2593,N
2197,O,637,637,4070,640,7816,2198,3433,O
2197,N,1022,1022,5092,1025,8841,2198,4070,N
2197,O,241,241,5333,105,8946,2198,5092,O
2197,P,800,800,6133,4230,13176,2198,5333,P
2198,AE,46,46,46,232,232,2199,0,A
2198,BE,72,26,72,63,63,2199,0,E
2198,BF,140,140,212,135,198,2199,72,F
2198,BG,188,188,400,285,483,2199,212,G
2198,BH,369,15,415,240,472,2199,46,B
2198,CH,165,150,565,5160,5643,2199,400,H
2198,C,222,72,637,285,757,2199,415,C
2198,D,1470,1470,2107,5160,5917,2199,637,D
2198,M,771,771,2878,2381,8298,2199,2107,M
2198,N,1744,1744,4622,180,8478,2199,2878,N
2198,O,622,622,5244,885,9363,2199,4622,O
2198,N,309,309,5553,300,9663,2199,5244,N
2198,O,631,631,6184,360,10023,2199,5553,O
2198,P,2593,2593,8777,7020,17043,2199,6184,P
2199,AEI,68,68,68,379,379,2200,0,I
2199,AEJ,86,18,86,389,389,2200,0,A
2199,BEJ,110,24,110,980,980,2200,0,E
2199,BFJ,388,364,474,180,569,2200,86,B
2199,CFJ,491,85,559,180,559,2200,68,J
2199,CFK,311,311,870,660,1219,2200,559,K
2199,CFL,446,50,920,660,1229,2200,474,C
2199,DFL,956,146,1066,150,1130,2200,110,F
2199,DGL,231,85,1151,3960,5189,2200,920,D
2199,GL,120,35,1186,130,1260,2200,1066,G
2199,HL,329,13,1199,3960,5179,2200,870,L
2199,H,389,376,1575,2880,4140,2200,1186,H
2199,M,400,400,1975,722,5911,2200,1575,M
2199,N,514,514,2489,240,6151,2200,1975,N
2199,O,174,174,2663,385,6536,2200,2489,O
2199,N,751,751,3414,510,7046,2200,2663,N
2199,O,738,738,4152,1025,8071,2200,3414,O
2199,P,1110,1110,5262,3960,12031,2200,4152,P
2200,A,52,52,52,534,534,2201,0,A
2200,B,631,631,683,165,699,2201,52,B
2200,C,630,630,1313,910,1609,2201,683,C
2200,D,105,105,1418,3960,5569,2201,1313,D
2200,M,1607,1607,3025,2467,8036,2201,1418,M
2200,N,913,913,3938,90,8126,2201,3025,N
2200,O,490,490,4428,885,9011,2201,3938,O
2200,N,1584,1584,6012,1165,10176,2201,4428,N
2200,O,513,513,6525,805,10981,2201,6012,O
2200,P,19260,19260,25785,3780,14761,2201,6525,P
2201,AE,1020,1020,1020,1806,1806,2202,0,E
2201,AF,912,912,1932,150,1956,2202,1020,F
2201,AG,647,647,2579,120,2076,2202,1932,G
2201,AH,2654,75,2654,2899,2899,2202,0,A
2201,BH,431,431,3085,240,3139,2202,2654,B
2201,CH,758,758,3843,885,4024,2202,3085,C
2201,BH,3272,2008,5851,4230,6306,2202,2579,H
2201,B,3006,998,6849,2935,6959,2202,3843,B
2201,C,2513,2513,9362,2820,9779,2202,6849,C
2201,D,5625,5625,14987,3960,13739,2202,9362,D
2201,M,209,209,15196,1014,14753,2202,14987,M
2201,N,900,900,16096,150,14903,2202,15196,N
2201,O,139,139,16235,120,15023,2202,16096,O
2201,N,345,345,16580,355,15378,2202,16235,N
2201,O,692,692,17272,775,16153,2202,16580,O
2201,P,842,842,18114,4230,20383,2202,17272,P
2202,A,197,197,197,255,255,2203,0,A
2202,B,187,187,384,180,435,2203,197,B
2202,C,145,145,529,230,665,2203,384,C
2202,B,746,746,1275,630,1295,2203,529,B
2202,C,655,655,1930,780,2075,2203,1275,C
2202,D,2020,2020,3950,4140,6215,2203,1930,D
2202,M,327,327,4277,509,6724,2203,3950,M
2202,N,202,202,4479,90,6814,2203,4277,N
2202,O,1698,1698,6177,1880,8694,2203,4479,O
2202,P,441,441,6618,3780,12474,2203,6177,P
2203,AEI,29,29,29,82,82,2204,0,A
2203,BEI,44,15,44,106,106,2204,0,I
2203,BEJ,144,129,173,135,217,2204,29,B
2203,CEJ,154,25,198,135,241,2204,44,J
2203,CEK,274,249,447,285,502,2204,173,C
2203,DEK,297,48,495,290,531,2204,198,K
2203,DEL,51,51,546,5160,5691,2204,495,L
2203,DE,550,451,997,5160,5662,2204,447,D
2203,E,1806,809,1806,2576,2576,2204,0,E
2203,F,1049,1049,2855,240,2816,2204,1806,F
2203,G,923,923,3778,1040,3856,2204,2855,G
2203,F,714,714,4492,690,4546,2204,3778,F
2203,G,690,690,5182,1141,5687,2204,4492,G
2203,H,958,958,6140,3960,9647,2204,5182,H
2203,M,3278,3278,9418,4838,14485,2204,6140,M
2203,N,1377,1377,10795,90,14575,2204,9418,N
2203,O,978,978,11773,1240,15815,2204,10795,O
2203,N,844,844,12617,365,16180,2204,11773,N
2203,O,907,907,13524,1080,17260,2204,12617,O
2203,P,427,427,13951,3780,21040,2204,13524,P
2204,AE,781,781,781,1562,1562,2205,0,E
2204,AF,1087,306,1087,1230,1230,2205,0,A
2204,BF,170,170,1257,90,1320,2205,1087,B
2204,CF,805,329,1586,90,1652,2205,781,F
2204,CG,470,141,1727,820,2140,2205,1257,C
2204,DG,413,413,2140,3780,5920,2205,1727,D
2204,G,898,344,2484,1250,2902,2205,1586,G
2204,H,429,429,2913,3780,6682,2205,2484,H
2204,M,1123,1123,4036,1720,8402,2205,2913,M
2204,N,640,640,4676,90,8492,2205,4036,N
2204,O,877,877,5553,1175,9667,2205,4676,O
2204,P,34750,34750,40303,3780,13447,2205,5553,P
2205,AE,491,491,491,5971,5971,2206,0,A
2205,BE,516,25,516,1216,1216,2206,0,E
2205,BF,265,240,756,270,6241,2206,491,B
2205,CF,880,640,1396,240,1456,2206,516,F
2205,CG,1111,1111,2507,1800,3256,2206,1396,G
2205,CF,1796,1796,4303,1095,4351,2206,2507,F
2205,CG,3719,172,4475,395,6636,2206,756,C
2205,BG,984,812,5287,1250,5601,2206,4303,G
2205,BH,12,12,5299,335,5936,2206,5287,H
2205,B,2765,1941,7240,635,7271,2206,4475,B
2205,C,1154,1154,8394,1240,8511,2206,7240,C
2205,D,3,3,8397,335,8846,2206,8394,D
2205,M,668,668,9065,1213,10059,2206,8397,M
2205,N,806,806,9871,180,10239,2206,9065,N
2205,O,967,967,10838,920,11159,2206,9871,O
2205,P,723,723,11561,550,11709,2206,10838,P
2206,AEI,203,203,203,401,401,2207,0,A
2206,BEI,246,43,246,854,854,2207,0,I
2206,BEJ,236,193,439,90,491,2207,203,B
2206,CEJ,763,324,763,1371,1371,2207,0,E
2206,CFJ,361,37,800,800,1291,2207,439,C
2206,DFJ,648,94,894,90,944,2207,246,J
2206,DFK,356,356,1250,800,1744,2207,894,K
2206,DFL,660,173,1423,90,1461,2207,763,F
2206,DGL,383,383,1806,800,2261,2207,1423,G
2206,DHL,1439,433,2239,3840,5131,2207,800,D
2206,HL,1027,38,2277,3780,5524,2207,1250,L
2206,H,1824,1353,3630,3780,6041,2207,1806,H
2206,M,600,600,4230,1080,7121,2207,3630,M
2206,N,728,728,4958,300,7421,2207,4230,N
2206,O,941,941,5899,1045,8466,2207,4958,O
2206,P,1006,1006,6905,1140,9606,2207,5899,P
2207,AEI,570,570,570,705,705,2208,0,I
2207,AEJ,464,464,1034,360,1065,2208,570,J
2207,AEK,649,649,1683,1835,2900,2208,1034,K
2207,AEL,147,147,1830,1890,4790,2208,1683,L
2207,AE,2782,952,2782,2390,2390,2208,0,E
2207,AF,1,1,2783,300,2690,2208,2782,F
2207,AG,773,773,3556,895,3585,2208,2783,G
2207,AH,799,799,4355,2040,5625,2208,3556,H
2207,A,20733,16378,20733,21559,21559,2208,0,A
2207,B,861,861,21594,90,21649,2208,20733,B
2207,C,737,737,22331,1105,22754,2208,21594,C
2207,D,37371,37371,59702,3780,26534,2208,22331,D
2207,M,64,64,59766,680,27214,2208,59702,M
2207,N,885,885,60651,300,27514,2208,59766,N
2207,O,985,985,61636,925,28439,2208,60651,O
2207,P,3844,3844,65480,2760,31199,2208,61636,P
2208,A,2007,2007,2007,2058,2058,2209,0,A
2208,B,949,949,2956,180,2238,2209,2007,B
2208,C,292,292,3248,880,3118,2209,2956,C
2208,D,2514,2514,5762,6660,9778,2209,3248,D
2208,M,2059,2059,7821,2137,11915,2209,5762,M
2208,N,277,277,8098,240,12155,2209,7821,N
2208,O,856,856,8954,810,12965,2209,8098,O
2208,N,2454,2454,11408,2480,15445,2209,8954,N
2208,O,1050,1050,12458,780,16225,2209,11408,O
2208,P,2301,2301,14759,3960,20185,2209,12458,P
2209,AE,369,369,369,1034,1034,2210,0,E
2209,AF,795,795,1164,180,1214,2210,369,F
2209,AG,164,164,1328,245,1459,2210,1164,G
2209,AF,2174,846,2174,2487,2487,2210,0,A
2209,BF,343,343,2517,90,2577,2210,2174,B
2209,CF,1512,323,2840,1420,2879,2210,1328,F
2209,CG,484,161,3001,820,3397,2210,2517,C
2209,BG,673,512,3513,780,3659,2210,2840,G
2209,BH,921,409,3922,555,3952,2210,3001,B
2209,CH,486,77,3999,4200,7859,2210,3513,H
2209,C,1124,1047,5046,1585,5537,2210,3922,C
2209,D,1264,1264,6310,3780,9317,2210,5046,D
2209,M,35974,35974,42284,36189,45506,2210,6310,M
2209,N,374,374,42658,90,45596,2210,42284,N
2209,O,1284,1284,43942,1540,47136,2210,42658,O
2209,P,24,24,43966,3780,50916,2210,43942,P
2210,A,171,171,171,481,481,2211,0,A
2210,B,485,485,656,240,721,2211,171,B
2210,C,854,854,1510,985,1706,2211,656,C
2210,B,745,745,2255,605,2311,2211,1510,B
2210,C,195,195,2450,260,2571,2211,2255,C
2210,D,186,186,2636,5160,7731,2211,2450,D
2210,M,337,337,2973,507,8238,2211,2636,M
2210,N,290,290,3263,180,8418,2211,2973,N
2210,O,677,677,3940,650,9068,2211,3263,O
2210,P,3141,3141,7081,550,9618,2211,3940,P
2211,A,1716,1716,1716,3993,3993,2212,0,A
2211,B,2327,2327,4043,90,4083,2212,1716,B
2211,C,518,518,4561,880,4963,2212,4043,C
2211,D,1515,1515,6076,3780,8743,2212,4561,D
2211,M,4516,4516,10592,4725,13468,2212,6076,M
2211,N,278,278,10870,90,13558,2212,10592,N
2211,O,270,270,11140,705,14263,2212,10870,O
2211,P,2519,2519,13659,3780,18043,2212,11140,P
2212,AE,135,135,135,390,390,2213,0,A
2212,BE,375,375,510,180,570,2213,135,B
2212,CE,297,297,807,660,1230,2213,510,C
2212,BE,969,969,1776,580,1810,2213,807,B
2212,CE,798,798,2574,840,2650,2213,1776,C
2212,DE,131,131,2705,1560,4210,2213,2574,D
2212,E,14889,12184,14889,14919,14919,2213,0,E
2212,F,293,293,15182,300,15219,2213,14889,F
2212,G,687,687,15869,740,15959,2213,15182,G
2212,H,65,65,15934,1560,17519,2213,15869,H
2212,M,13,13,15947,219,17738,2213,15934,M
2212,N,420,420,16367,240,17978,2213,15947,N
2212,O,792,792,17159,995,18973,2213,16367,O
2212,N,586,586,17745,410,19383,2213,17159,N
2212,O,711,711,18456,810,20193,2213,17745,O
2212,P,858,858,19314,3960,24153,2213,18456,P
2213,AE,41,41,41,1253,1253,2214,0,A
2213,BE,116,75,116,276,276,2214,0,E
2213,BF,320,320,436,150,426,2214,116,F
2213,BG,187,187,623,130,556,2214,436,G
2213,BF,1332,750,1373,165,1418,2214,41,B
2213,CF,1254,504,1877,1350,1906,2214,623,F
2213,CG,541,37,1914,825,2243,2214,1373,C
2213,DG,295,295,2209,3960,6203,2214,1914,D
2213,G,587,255,2464,635,2541,2214,1877,G
2213,H,250,250,2714,4290,6831,2214,2464,H
2213,M,542,542,3256,1378,8209,2214,2714,M
2213,N,902,902,4158,90,8299,2214,3256,N
2213,O,478,478,4636,855,9154,2214,4158,O
2213,N,1956,1956,6592,1610,10764,2214,4636,N
2213,O,865,865,7457,1165,11929,2214,6592,O
2213,P,8874,8874,16331,3780,15709,2214,7457,P
2214,AE,195,195,195,1320,1320,2215,0,A
2214,BE,1442,1247,1442,1694,1694,2215,0,E
2214,BF,1391,144,1586,300,1620,2215,195,B
2214,CF,556,412,1998,300,1994,2215,1442,F
2214,CG,653,241,2239,775,2395,2215,1586,C
2214,DG,77,77,2316,2940,5335,2215,2239,D
2214,G,513,195,2511,811,2805,2215,1998,G
2214,H,200,200,2711,2940,5745,2215,2511,H
2214,M,377,377,3088,710,6455,2215,2711,M
2214,N,483,483,3571,240,6695,2215,3088,N
2214,O,395,395,3966,845,7540,2215,3571,O
2214,P,2998,2998,6964,3720,11260,2215,3966,P
2215,AE,11,11,11,849,849,2216,0,E
2215,AF,268,257,268,318,318,2216,0,A
2215,BF,185,185,453,180,498,2216,268,B
2215,CF,250,250,703,320,818,2216,453,C
2215,DF,1120,428,1131,240,1089,2216,11,F
2215,DG,745,745,1876,1040,2129,2216,1131,G
2215,DF,1204,31,1907,360,1178,2216,703,D
2215,F,1664,1633,3540,1310,3439,2216,1876,F
2215,G,784,784,4324,1260,4699,2216,3540,G
2215,H,243,243,4567,3960,8659,2216,4324,H
2215,M,441,441,5008,433,9092,2216,4567,M
2215,N,101,101,5109,150,9242,2216,5008,N
2215,O,105,105,5214,130,9372,2216,5109,O
2215,N,697,697,5911,685,10057,2216,5214,N
2215,O,119,119,6030,250,10307,2216,5911,O
2215,P,317,317,6347,4110,14417,2216,6030,P
2216,AEI,33,33,33,1119,1119,2217,0,I
2216,AEJ,428,395,428,612,612,2217,0,A
2216,BEJ,231,231,659,90,702,2217,428,B
2216,CEJ,400,400,1059,795,1497,2217,659,C
2216,DEJ,1274,248,1307,240,1359,2217,33,J
2216,DEK,815,815,2122,995,2354,2217,1307,K
2216,DEL,43,43,2165,4680,7034,2217,2122,L
2216,DE,1382,276,2441,3780,5277,2217,1059,D
2216,E,5601,3160,5601,5625,5625,2217,0,E
2216,F,591,591,6192,420,6045,2217,5601,F
2216,G,1291,1291,7483,1345,7390,2217,6192,G
2216,F,132,132,7615,295,7685,2217,7483,F
2216,G,1542,1542,9157,420,8105,2217,7615,G
2216,H,1875,1875,11032,1230,9335,2217,9157,H
2216,M,2810,2810,13842,3588,12923,2217,11032,M
2216,N,874,874,14716,90,13013,2217,13842,N
2216,O,945,945,15661,815,13828,2217,14716,O
2216,N,1276,1276,16937,1475,15303,2217,15661,N
2216,O,436,436,17373,740,16043,2217,16937,O
2216,P,931,931,18304,3780,19823,2217,17373,P
2217,AEI,466,466,466,1037,1037,2218,0,E
2217,AFI,559,93,559,619,619,2218,0,A
2217,BFI,179,179,738,150,769,2218,559,B
2217,CFI,675,403,1141,150,1187,2218,466,F
2217,CGI,169,169,1310,400,1587,2218,1141,G
2217,CFI,892,320,1630,1115,1884,2218,738,C
2217,BFI,404,84,1714,100,1687,2218,1310,F
2217,BGI,464,380,2094,250,2134,2218,1630,B
2217,CGI,608,228,2322,735,2422,2218,1714,G
2217,CHI,2358,36,2358,2540,2540,2218,0,I
2217,CHJ,668,404,2762,735,2869,2218,2094,C
2217,DHJ,173,173,2935,4230,7099,2218,2762,D
2217,HJ,590,13,2948,420,2960,2218,2358,J
2217,HK,1606,980,3928,4230,6652,2218,2322,H
2217,K,1146,166,4094,1381,4341,2218,2948,K
2217,L,5173,5173,9267,504,4845,2218,4094,L
2217,M,303,303,9570,1783,8882,2218,9267,M
2217,N,1855,1855,11425,420,9302,2218,9570,N
2217,O,910,910,12335,865,10167,2218,11425,O
2217,P,8114,8114,20449,550,10717,2218,12335,P
2218,AE,859,859,859,1295,1295,2219,0,A
2218,BE,515,515,1374,120,1415,2219,859,B
2218,CE,2054,680,2054,2624,2624,2219,0,E
2218,CF,901,221,2275,900,2315,2219,1374,C
2218,DF,630,409,2684,120,2744,2219,2054,F
2218,DG,1022,1022,3706,1020,3764,2219,2684,G
2218,DH,1473,42,3748,385,2700,2219,2275,D
2218,H,1206,1164,4912,550,4314,2219,3706,H
2218,M,174,174,5086,307,4621,2219,4912,M
2218,N,357,357,5443,270,4891,2219,5086,N
2218,O,1122,1122,6565,1100,5991,2219,5443,O
2218,P,2174,2174,8739,335,6326,2219,6565,P
2219,A,168,168,168,408,408,2220,0,A
2219,B,283,283,451,90,498,2220,168,B
2219,C,915,915,1366,1285,1783,2220,451,C
2219,D,135,135,1501,3780,5563,2220,1366,D
2219,M,1204,1204,2705,1791,7354,2220,1501,M
2219,N,618,618,3323,90,7444,2220,2705,N
2219,O,941,941,4264,1250,8694,2220,3323,O
2219,N,982,982,5246,670,9364,2220,4264,N
2219,O,511,511,5757,790,10154,2220,5246,O
2219,P,797,797,6554,3780,13934,2220,5757,P
2220,AEI,31,31,31,1043,1043,2221,0,I
2220,AEJ,47,16,47,971,971,2221,0,A
2220,BEJ,1113,1113,1160,240,1211,2221,47,B
2220,CEJ,1216,87,1247,240,1283,2221,31,J
2220,CEK,489,402,1649,760,1971,2221,1160,C
2220,DEK,460,58,1707,760,2043,2221,1247,K
2220,DEL,985,927,2634,3540,5511,2221,1649,D
2220,EL,2334,1407,4041,3540,5583,2221,1707,L
2220,E,16041,12000,16041,17125,17125,2221,0,E
2220,F,1366,1366,17407,300,17425,2221,16041,F
2220,G,1293,1293,18700,1055,18480,2221,17407,G
2220,H,635,635,19335,1200,19680,2221,18700,H
2220,M,1055,1055,20390,2202,21882,2221,19335,M
2220,N,1177,1177,21567,90,21972,2221,20390,N
2220,O,597,597,22164,820,22792,2221,21567,O
2220,N,765,765,22929,495,23287,2221,22164,N
2220,O,1321,1321,24250,1865,25152,2221,22929,O
2220,P,2837,2837,27087,3780,28932,2221,24250,P
2221,A,1112,1112,1112,1238,1238,2222,0,A
2221,B,345,345,1457,240,1478,2222,1112,B
2221,C,704,704,2161,855,2333,2222,1457,C
2221,B,267,267,2428,130,2463,2222,2161,B
2221,C,108,108,2536,390,2853,2222,2428,C
2221,D,1080,1080,3616,3960,6813,2222,2536,D
2221,M,114,114,3730,859,7672,2222,3616,M
2221,N,873,873,4603,180,7852,2222,3730,N
2221,O,159,159,4762,210,8062,2222,4603,O
2221,N,525,525,5287,460,8522,2222,4762,N
2221,O,547,547,5834,725,9247,2222,5287,O
2221,P,255,255,6089,4140,13387,2222,5834,P
2222,AEI,495,495,495,450,450,2223,0,I
2222,AEJ,75,75,570,180,630,2223,495,J
2222,AEK,397,397,967,960,1590,2223,570,K
2222,AEJ,714,714,1681,140,1730,2223,967,J
2222,AEK,798,798,2479,825,2555,2223,1681,K
2222,AEL,2841,362,2841,3026,3026,2223,0,A
2222,BEL,689,689,3530,480,3506,2223,2841,B
2222,CEL,798,798,4328,890,4396,2223,3530,C
2222,DEL,3162,1313,5641,1140,3695,2223,2479,L
2222,DE,4306,2993,8634,550,4946,2223,4328,D
2222,E,11568,2934,11568,11631,11631,2223,0,E
2222,F,223,223,11791,220,11851,2223,11568,F
2222,G,946,946,12737,915,12766,2223,11791,G
2222,H,1509,1509,14246,385,13151,2223,12737,H
2222,M,989,989,15235,1716,14867,2223,14246,M
2222,N,847,847,16082,180,15047,2223,15235,N
2222,O,762,762,16844,840,15887,2223,16082,O
2222,P,4233,4233,21077,6680,22567,2223,16844,P
2223,AEI,133,133,133,877,877,2224,0,I
2223,AEJ,211,78,211,1171,1171,2224,0,E
2223,AFJ,676,465,676,1376,1376,2224,0,A
2223,BFJ,839,296,972,150,1027,2224,133,J
2223,BFK,120,120,1092,100,1127,2224,972,K
2223,BFJ,1142,261,1353,240,1411,2224,211,F
2223,BGJ,727,50,1403,90,1466,2224,676,B
2223,CGJ,584,273,1676,570,1697,2224,1092,J
2223,CGK,373,100,1776,800,2266,2224,1403,C
2223,DGK,688,588,2364,660,2357,2224,1676,K
2223,DGL,1048,37,2401,1020,2431,2224,1353,G
2223,DHL,137,100,2501,4230,6587,2224,2364,L
2223,DH,151,51,2552,4680,7111,2224,2401,H
2223,D,1669,893,3445,3780,6046,2224,1776,D
2223,M,1130,1130,4575,1835,8946,2224,3445,M
2223,N,953,953,5528,300,9246,2224,4575,N
2223,O,975,975,6503,1220,10466,2224,5528,O
2223,N,1330,1330,7833,1080,11546,2224,6503,N
2223,O,395,395,8228,555,12101,2224,7833,O
2223,N,916,916,9144,750,12851,2224,8228,N
2223,O,724,724,9868,865,13716,2224,9144,O
2223,P,42,42,9910,1620,15336,2224,9868,P
2224,A,1875,1875,1875,1810,1810,2225,0,A
2224,B,188,188,2063,300,2110,2225,1875,B
2224,C,746,746,2809,1035,3145,2225,2063,C
2224,B,286,286,3095,5,3150,2225,2809,B
2224,C,1126,1126,4221,1195,4345,2225,3095,C
2224,D,2899,2899,7120,1620,5965,2225,4221,D
2224,M,145,145,7265,845,6810,2225,7120,M
2224,N,819,819,8084,180,6990,2225,7265,N
2224,O,282,282,8366,345,7335,2225,8084,O
2224,N,374,374,8740,290,7625,2225,8366,N
2224,O,585,585,9325,700,8325,2225,8740,O
2224,P,2013,2013,11338,1140,9465,2225,9325,P
2225,AEI,286,286,286,1073,1073,2226,0,I
2225,AEJ,308,22,308,556,556,2226,0,E
2225,AFJ,537,229,537,885,885,2226,0,A
2225,BFJ,368,139,676,180,736,2226,308,F
2225,BGJ,707,568,1244,360,1245,2226,537,B
2225,CGJ,979,21,1265,240,1313,2226,286,J
2225,CGK,760,171,1436,765,1501,2226,676,G
2225,CHK,530,530,1966,550,2051,2226,1436,H
2225,CK,966,244,2210,1125,2370,2226,1244,C
2225,BK,198,198,2408,80,2450,2226,2210,B
2225,CK,100,100,2508,120,2570,2226,2408,C
2225,DK,1495,252,2760,1040,2353,2226,1265,K
2225,DJ,88,88,2848,670,3023,2226,2760,J
2225,DK,651,651,3499,780,3803,2226,2848,K
2225,DL,2210,2210,5709,3960,7763,2226,3499,L
2225,D,4796,1595,7304,550,3120,2226,2508,D
2225,M,1225,1225,8529,1367,9130,2226,7304,M
2225,N,592,592,9121,510,9640,2226,8529,N
2225,O,331,331,9452,925,10565,2226,9121,O
2225,P,8838,8838,18290,350,10915,2226,9452,P
2226,A,82,82,82,108,108,2227,0,A
2226,B,106,106,188,135,243,2227,82,B
2226,C,125,125,313,290,533,2227,188,C
2226,D,273,273,586,5160,5693,2227,313,D
2226,M,675,675,1261,1095,6788,2227,586,M
2226,N,493,493,1754,90,6878,2227,1261,N
2226,O,981,981,2735,1250,8128,2227,1754,O
2226,P,113,113,2848,3780,11908,2227,2735,P
2227,A,2788,2788,2788,2965,2965,2228,0,A
2227,B,458,458,3246,300,3265,2228,2788,B
2227,C,512,512,3758,835,4100,2228,3246,C
2227,D,361,361,4119,3870,7970,2228,3758,D
2227,M,58,58,4177,1020,8990,2228,4119,M
2227,N,1217,1217,5394,300,9290,2228,4177,N
2227,O,622,622,6016,795,10085,2228,5394,O
2227,P,88,88,6104,1140,11225,2228,6016,P
2228,AEI,112,112,112,842,842,2229,0,I
2228,AEJ,155,43,155,915,915,2229,0,E
2228,AFJ,826,783,938,150,992,2229,112,J
2228,AFK,1008,225,1163,300,1215,2229,155,F
2228,AGK,322,97,1260,120,1112,2229,938,K
2228,AGJ,713,616,1876,755,1970,2229,1163,G
2228,AFJ,230,230,2106,160,2130,2229,1876,F
2228,AGJ,175,175,2281,830,2960,2229,2106,G
2228,AHJ,1373,352,2633,1560,2672,2229,1260,J
2228,AHK,2889,256,2889,3900,3900,2229,0,A
2228,BHK,619,363,3252,650,3322,2229,2633,K
2228,BHL,1034,63,3315,1770,4730,2229,2281,H
2228,BL,1390,964,4279,300,4200,2229,2889,B
2228,CL,900,900,5179,1825,6025,2229,4279,C
2228,DL,2279,2279,7458,1890,7915,2229,5179,D
2228,L,4505,299,7757,4230,7552,2229,3252,L
2228,M,2176,2176,9933,2220,10135,2229,7757,M
2228,N,771,771,10704,780,10915,2229,9933,N
2228,O,695,695,11399,865,11780,2229,10704,O
2228,P,138,138,11537,1620,13400,2229,11399,P
2229,AE,623,623,623,3868,3868,2230,0,E
2229,AF,1650,1027,1650,2588,2588,2230,0,A
2229,BF,971,971,2621,90,2678,2230,1650,B
2229,CF,544,544,3165,905,3583,2230,2621,C
2229,BF,408,408,3573,15,3598,2230,3165,B
2229,CF,3365,415,3988,180,4048,2230,623,F
2229,CG,1192,777,4765,1590,5188,2230,3573,C
2229,DG,968,191,4956,910,4958,2230,3988,G
2229,DH,1225,1225,6181,550,5508,2230,4956,H
2229,D,6492,5076,11257,3780,8968,2230,4765,D
2229,M,981,981,12238,776,9744,2230,11257,M
2229,N,542,542,12780,780,10524,2230,12238,N
2229,O,1159,1159,13939,1381,11905,2230,12780,O
2229,P,1935,1935,15874,504,12409,2230,13939,P
2230,AE,262,262,262,1235,1235,2231,0,E
2230,AF,295,33,295,806,806,2231,0,A
2230,BF,652,652,947,180,986,2231,295,B
2230,CF,388,388,1335,255,1241,2231,947,C
2230,BF,1162,89,1424,240,1475,2231,262,F
2230,BG,226,226,1650,265,1740,2231,1424,G
2230,BH,493,178,1828,615,1856,2231,1335,B
2230,CH,642,642,2470,2235,4091,2231,1828,C
2230,DH,1416,596,3066,5460,7200,2231,1650,H
2230,D,2033,1437,4503,2190,6281,2231,2470,D
2230,M,1213,1213,5716,1197,8397,2231,4503,M
2230,N,109,109,5825,180,8577,2231,5716,N
2230,O,195,195,6020,335,8912,2231,5825,O
2230,N,1213,1213,7233,1070,9982,2231,6020,N
2230,O,743,743,7976,780,10762,2231,7233,O
2230,P,1373,1373,9349,7680,18442,2231,7976,P
2231,AE,581,581,581,1123,1123,2232,0,E
2231,AF,1005,424,1005,2141,2141,2232,0,A
2231,BF,753,329,1334,240,1363,2232,581,F
2231,BG,635,635,1969,960,2323,2232,1334,G
2231,BH,1166,202,2171,90,2231,2232,1005,B
2231,CH,521,521,2692,820,3051,2232,2171,C
2231,BH,370,370,3062,45,3096,2232,2692,B
2231,CH,1490,397,3459,3960,6283,2232,1969,H
2231,C,932,535,3994,1470,4566,2232,3062,C
2231,D,1631,1631,5625,3780,8346,2232,3994,D
2231,M,620,620,6245,955,9301,2232,5625,M
2231,N,575,575,6820,300,9601,2232,6245,N
2231,O,798,798,7618,725,10326,2232,6820,O
2231,P,974,974,8592,310,10636,2232,7618,P
2232,AE,385,385,385,1113,1113,2233,0,E
2232,AF,761,761,1146,90,1203,2233,385,F
2232,AG,1728,582,1728,1812,1812,2233,0,A
2232,BG,109,109,1837,90,1902,2233,1728,B
2232,CG,1149,458,2295,1230,2433,2233,1146,G
2232,CF,538,80,2375,945,2847,2233,1837,C
2232,BF,453,373,2748,375,2808,2233,2295,F
2232,BG,510,510,3258,815,3623,2233,2748,G
2232,BH,932,49,3307,500,3347,2233,2375,B
2232,CH,495,495,3802,805,4152,2233,3307,C
2232,DH,29400,28856,32658,3780,7403,2233,3258,H
2232,D,32160,3304,35962,3780,7932,2233,3802,D
2232,M,1200,1200,37162,2039,9971,2233,35962,M
2232,N,866,866,38028,90,10061,2233,37162,N
2232,O,666,666,38694,805,10866,2233,38028,O
2232,N,806,806,39500,630,11496,2233,38694,N
2232,O,657,657,40157,935,12431,2233,39500,O
2232,P,892,892,41049,3780,16211,2233,40157,P
2233,AEI,22,22,22,171,171,2234,0,E
2233,AFI,38,16,38,38,38,2234,0,I
2233,AFJ,92,54,92,119,119,2234,0,A
2233,BFJ,110,56,148,150,188,2234,38,J
2233,BFK,137,81,229,150,269,2234,92,B
2233,CFK,327,120,349,240,411,2234,22,F
2233,CGK,250,250,599,260,671,2234,349,G
2233,CHK,613,162,761,765,953,2234,148,K
2233,CHL,736,204,965,765,1034,2234,229,C
2233,DHL,435,231,1196,3600,4553,2234,761,L
2233,DH,746,149,1345,5160,5831,2234,599,H
2233,D,3343,2963,4308,3600,4634,2234,965,D
2233,M,151,151,4459,657,6488,2234,4308,M
2233,N,607,607,5066,150,6638,2234,4459,N
2233,O,2071,2071,7137,140,6778,2234,5066,O
2233,N,1032,1032,8169,2955,9733,2234,7137,N
2233,O,1241,1241,9410,1290,11023,2234,8169,O
2233,P,4840,4840,14250,3720,14743,2234,9410,P
2234,AEI,75,75,75,602,602,2235,0,E
2234,AFI,283,208,283,1840,1840,2235,0,I
2234,AFJ,719,511,794,240,842,2235,75,F
2234,AGJ,945,945,1739,930,1772,2235,794,G
2234,AHJ,1894,155,1894,3733,3733,2235,0,A
2234,BHJ,301,146,2040,550,2322,2235,1739,H
2234,BJ,1904,147,2187,240,2080,2235,283,J
2234,BK,1169,1169,3356,1140,3220,2235,2187,K
2234,BL,410,410,3766,550,3770,2235,3356,L
2234,B,1991,119,3885,180,3913,2235,1894,B
2234,C,893,893,4778,900,4813,2235,3885,C
2234,D,2396,2396,7174,550,5363,2235,4778,D
2234,M,420,420,7594,506,5869,2235,7174,M
2234,N,239,239,7833,210,6079,2235,7594,N
2234,O,809,809,8642,900,6979,2235,7833,O
2234,N,1767,1767,10409,1685,8664,2235,8642,N
2234,O,281,281,10690,400,9064,2235,10409,O
2234,P,1381,1381,12071,1260,10324,2235,10690,P
2235,A,661,661,661,1200,1200,2236,0,A
2235,B,598,598,1259,90,1290,2236,661,B
2235,C,343,343,1602,710,2000,2236,1259,C
2235,D,547,547,2149,3780,5780,2236,1602,D
2235,M,370,370,2519,1056,6836,2236,2149,M
2235,N,732,732,3251,90,6926,2236,2519,N
2235,O,118,118,3369,585,7511,2236,3251,O
2235,P,31967,31967,35336,3780,11291,2236,3369,P
2236,AEI,639,639,639,913,913,2237,0,A
2236,BEI,675,36,675,1251,1251,2237,0,I
2236,BEJ,759,84,759,1158,1158,2237,0,E
2236,BFJ,304,184,943,90,1003,2237,639,B
2236,CFJ,519,335,1278,180,1338,2237,759,F
2236,CGJ,736,133,1411,180,1431,2237,675,J
2236,CGK,644,176,1587,625,1628,2237,943,C
2236,DGK,936,627,2214,930,2268,2237,1278,G
2236,DHK,894,91,2305,930,2361,2237,1411,K
2236,DHL,728,10,2315,550,2178,2237,1587,D
2236,HL,2849,2839,5154,550,2911,2237,2305,L
2236,H,4057,1117,6271,550,2818,2237,2214,H
2236,M,234,234,6505,482,3393,2237,6271,M
2236,N,601,601,7106,420,3813,2237,6505,N
2236,O,433,433,7539,790,4603,2237,7106,O
2236,P,1638,1638,9177,1265,5868,2237,7539,P
2237,A,47,47,47,995,995,2238,0,A
2237,B,1141,1141,1188,240,1235,2238,47,B
2237,C,862,862,2050,995,2230,2238,1188,C
2237,D,91,91,2141,4680,6910,2238,2050,D
2237,M,6026,6026,8167,6193,13103,2238,2141,M
2237,N,197,197,8364,90,13193,2238,8167,N
2237,O,589,589,8953,820,14013,2238,8364,O
2237,N,530,530,9483,295,14308,2238,8953,N
2237,O,214,214,9697,535,14843,2238,9483,O
2237,P,560,560,10257,3780,18623,2238,9697,P
2238,A,5493,5493,5493,5937,5937,2239,0,A
2238,B,514,514,6007,120,6057,2239,5493,B
2238,C,142,142,6149,185,6242,2239,6007,C
2238,D,681,681,6830,5220,11462,2239,6149,D
2238,M,353,353,7183,762,12224,2239,6830,M
2238,N,675,675,7858,330,12554,2239,7183,N
2238,O,987,987,8845,1000,13554,2239,7858,O
2238,N,3623,3623,12468,3605,17159,2239,8845,N
2238,O,560,560,13028,540,17699,2239,12468,O
2238,P,72820,72820,85848,2880,20579,2239,13028,P
2239,AE,115,115,115,205,205,2240,0,E
2239,AF,151,36,151,928,928,2240,0,A
2239,BF,181,145,296,135,340,2240,115,F
2239,BG,570,570,866,390,730,2240,296,G
2239,BH,77,77,943,6110,6840,2240,866,H
2239,B,907,115,1058,180,1108,2240,151,B
2239,C,2718,2718,3776,2655,3763,2240,1058,C
2239,D,3393,3393,7169,1680,5443,2240,3776,D
2239,M,533,533,7702,1032,7872,2240,7169,M
2239,N,680,680,8382,240,8112,2240,7702,N
2239,O,176,176,8558,380,8492,2240,8382,O
2239,N,551,551,9109,310,8802,2240,8558,N
2239,O,546,546,9655,780,9582,2240,9109,O
2239,P,755,755,10410,3960,13542,2240,9655,P
2240,A,590,590,590,640,640,2241,0,A
2240,B,170,170,760,150,790,2241,590,B
2240,C,152,152,912,135,925,2241,760,C
2240,D,95,95,1007,4230,5155,2241,912,D
2240,M,322,322,1329,863,6018,2241,1007,M
2240,N,639,639,1968,150,6168,2241,1329,N
2240,O,175,175,2143,155,6323,2241,1968,O
2240,N,358,358,2501,370,6693,2241,2143,N
2240,O,360,360,2861,710,7403,2241,2501,O
2240,P,9069,9069,11930,3960,11363,2241,2861,P
2241,A,3050,3050,3050,3119,3119,2242,0,A
2241,B,362,362,3412,300,3419,2242,3050,B
2241,C,508,508,3920,811,4230,2242,3412,C
2241,D,457,457,4377,3885,8115,2242,3920,D
2241,M,27,27,4404,187,8302,2242,4377,M
2241,N,378,378,4782,240,8542,2242,4404,N
2241,O,302,302,5084,885,9427,2242,4782,O
2241,P,786,786,5870,3720,13147,2242,5084,P
2242,A,5730,5730,5730,5924,5924,2243,0,A
2242,B,244,244,5974,120,6044,2243,5730,B
2242,C,199,199,6173,390,6434,2243,5974,C
2242,B,1432,1432,7605,1225,7659,2243,6173,B
2242,C,945,945,8550,970,8629,2243,7605,C
2242,D,800,800,9350,5160,13789,2243,8550,D
2242,M,1267,1267,10617,1255,15044,2243,9350,M
2242,N,546,546,11163,240,15284,2243,10617,N
2242,O,2117,2117,13280,1195,16479,2243,11163,O
2242,P,658,658,13938,3960,20439,2243,13280,P
2243,AE,100,100,100,1163,1163,2244,0,A
2243,BE,138,38,138,196,196,2244,0,E
2243,BF,153,153,291,150,346,2244,138,F
2243,BG,189,189,480,130,476,2244,291,G
2243,BF,1103,723,1203,90,1253,2244,100,B
2243,CF,1494,771,1974,1535,2011,2244,480,F
2243,CG,1014,243,2217,1220,2473,2244,1203,C
2243,DG,4,4,2221,3780,6253,2244,2217,D
2243,G,794,547,2768,765,2776,2244,1974,G
2243,H,1519,1519,4287,4230,7006,2244,2768,H
2243,M,1251,1251,5538,3731,10737,2244,4287,M
2243,N,2510,2510,8048,90,10827,2244,5538,N
2243,O,336,336,8384,795,11622,2244,8048,O
2243,P,1981,1981,10365,3780,15402,2244,8384,P
2244,A,94,94,94,193,193,2245,0,A
2244,B,277,277,371,240,433,2245,94,B
2244,C,234,234,605,285,718,2245,371,C
2244,D,2814,2814,3419,5160,5878,2245,605,D
2244,M,41,41,3460,115,5993,2245,3419,M
2244,N,220,220,3680,180,6173,2245,3460,N
2244,O,219,219,3899,155,6328,2245,3680,O
2244,P,98,98,3997,385,6713,2245,3899,P
2245,AE,258,258,258,2696,2696,2246,0,A
2245,BE,834,576,834,2732,2732,2246,0,E
2245,BF,1990,1990,2824,90,2822,2246,834,F
2245,BG,2621,55,2879,240,2936,2246,258,B
2245,CG,906,906,3785,1020,3956,2246,2879,C
2245,DG,993,32,3817,1380,4202,2246,2824,G
2245,DF,209,177,3994,4680,8636,2246,3785,D
2245,F,417,240,4234,85,4287,2246,3817,F
2245,G,348,348,4582,795,5082,2246,4234,G
2245,H,517,517,5099,3780,8862,2246,4582,H
2245,M,3623,3623,8722,3844,12706,2246,5099,M
2245,N,279,279,9001,90,12796,2246,8722,N
2245,O,515,515,9516,795,13591,2246,9001,O
2245,N,1836,1836,11352,1585,15176,2246,9516,N
2245,O,806,806,12158,940,16116,2246,11352,O
2245,P,1115,1115,13273,3780,19896,2246,12158,P
2246,AEI,154,154,154,231,231,2247,0,E
2246,AFI,328,174,328,552,552,2247,0,A
2246,BFI,189,15,343,150,381,2247,154,F
2246,BGI,270,255,598,90,642,2247,328,B
2246,CGI,346,346,944,800,1442,2247,598,C
2246,DGI,680,79,1023,660,1041,2247,343,G
2246,DHI,1689,666,1689,2383,2383,2247,0,I
2246,DHJ,912,246,1935,4230,5271,2247,1023,H
2246,DJ,1464,473,2408,3780,5222,2247,944,D
2246,J,723,4,2412,90,2473,2247,1689,J
2246,K,423,423,2835,800,3273,2247,2412,K
2246,L,2415,2415,5250,3780,7053,2247,2835,L
2246,M,5557,5557,10807,5664,12717,2247,5250,M
2246,N,140,140,10947,90,12807,2247,10807,N
2246,O,581,581,11528,820,13627,2247,10947,O
2246,N,439,439,11967,200,13827,2247,11528,N
2246,O,516,516,12483,800,14627,2247,11967,O
2246,P,819,819,13302,3780,18407,2247,12483,P
2247,A,5902,5902,5902,10550,10550,2248,0,A
2247,B,5195,5195,11097,90,10640,2248,5902,B
2247,C,1119,1119,12216,1385,12025,2248,11097,C
2247,D,2364,2364,14580,3780,15805,2248,12216,D
2247,M,507,507,15087,872,16677,2248,14580,M
2247,N,409,409,15496,90,16767,2248,15087,N
2247,O,1394,1394,16890,1865,18632,2248,15496,O
2247,P,4219,4219,21109,3780,22412,2248,16890,P
2248,AE,572,572,572,726,726,2249,0,A
2248,BE,274,274,846,180,906,2249,572,B
2248,CE,850,850,1696,915,1821,2249,846,C
2248,DE,239,239,1935,360,2181,2249,1696,D
2248,E,4426,2491,4426,4866,4866,2249,0,E
2248,F,571,571,4997,180,5046,2249,4426,F
2248,G,979,979,5976,950,5996,2249,4997,G
2248,F,437,437,6413,595,6591,2249,5976,F
2248,G,396,396,6809,490,7081,2249,6413,G
2248,H,317,317,7126,375,7456,2249,6809,H
2248,M,1211,1211,8337,3228,10684,2249,7126,M
2248,N,2138,2138,10475,180,10864,2249,8337,N
2248,O,1099,1099,11574,820,11684,2249,10475,O
2248,P,9390,9390,20964,6680,18364,2249,11574,P
2249,AE,10,10,10,27,27,2250,0,A
2249,BE,84,74,84,243,243,2250,0,E
2249,BF,91,17,101,135,162,2250,10,B
2249,CF,234,217,318,135,378,2250,84,F
2249,CG,266,49,367,285,447,2250,101,C
2249,DG,98,98,465,5160,5607,2250,367,D
2249,G,150,3,468,290,668,2250,318,G
2249,H,102,102,570,5160,5828,2250,468,H
2249,M,9050,9050,9620,10475,16303,2250,570,M
2249,N,1553,1553,11173,180,16483,2250,9620,N
2249,O,1161,1161,12334,885,17368,2250,11173,O
2249,N,1619,1619,13953,1880,19248,2250,12334,N
2249,O,980,980,14933,1070,20318,2250,13953,O
2249,P,449,449,15382,6900,27218,2250,14933,P
2250,A,788,788,788,1004,1004,2251,0,A
2250,B,306,306,1094,150,1154,2251,788,B
2250,C,200,200,1294,165,1319,2251,1094,C
2250,D,4228,4228,5522,385,1704,2251,1294,D
2250,M,107,107,5629,255,1959,2251,5522,M
2250,N,371,371,6000,270,2229,2251,5629,N
2250,O,2403,2403,8403,1115,3344,2251,6000,O
2250,P,1119,1119,9522,335,3679,2251,8403,P
2251,A,2097,2097,2097,2892,2892,2252,0,A
2251,B,827,827,2924,90,2982,2252,2097,B
2251,C,1215,1215,4139,1430,4412,2252,2924,C
2251,D,3950,3950,8089,3780,8192,2252,4139,D
2251,M,1812,1812,9901,2539,10731,2252,8089,M
2251,N,783,783,10684,90,10821,2252,9901,N
2251,O,264,264,10948,695,11516,2252,10684,O
2251,P,21887,21887,32835,3780,15296,2252,10948,P
2252,A,26,26,26,103,103,2253,0,A
2252,B,190,190,216,150,253,2253,26,B
2252,C,143,143,359,110,363,2253,216,C
2252,D,2038,2038,2397,4230,4593,2253,359,D
2252,M,189,189,2586,753,5346,2253,2397,M
2252,N,744,744,3330,240,5586,2253,2586,N
2252,O,159,159,3489,223,5809,2253,3330,O
2252,P,287,287,3776,402,6211,2253,3489,P
2253,AE,1,1,1,11,11,2254,0,E
2253,AF,48,47,48,75,75,2254,0,A
2253,BF,104,104,152,135,210,2254,48,B
2253,CF,192,41,193,240,251,2254,1,F
2253,CG,215,174,367,295,505,2254,152,C
2253,DG,202,28,395,295,546,2254,193,G
2253,DH,69,41,436,5100,5605,2254,367,D
2253,H,3023,2982,3418,5100,5646,2254,395,H
2253,M,605,605,4023,1145,6791,2254,3418,M
2253,N,1116,1116,5139,180,6971,2254,4023,N
2253,O,334,334,5473,895,7866,2254,5139,O
2253,N,429,429,5902,300,8166,2254,5473,N
2253,O,338,338,6240,350,8516,2254,5902,O
2253,P,5657,5657,11897,6900,15416,2254,6240,P
2254,A,1793,1793,1793,2576,2576,2255,0,A
2254,B,966,966,2759,240,2816,2255,1793,B
2254,C,1181,1181,3940,1030,3846,2255,2759,C
2254,B,720,720,4660,850,4696,2255,3940,B
2254,C,340,340,5000,920,5616,2255,4660,C
2254,D,5975,5975,10975,3960,9576,2255,5000,D
2254,M,1481,1481,12456,1599,11175,2255,10975,M
2254,N,218,218,12674,150,11325,2255,12456,N
2254,O,575,575,13249,580,11905,2255,12674,O
2254,N,378,378,13627,370,12275,2255,13249,N
2254,O,99,99,13726,1055,13330,2255,13627,O
2254,P,1163,1163,14889,3300,16630,2255,13726,P
2255,AE,13,13,13,219,219,2256,0,A
2255,BE,443,443,456,270,489,2256,13,B
2255,CE,890,434,890,1261,1261,2256,0,E
2255,CF,401,401,1291,90,1351,2256,890,F
2255,CG,1010,175,1466,1100,1589,2256,456,C
2255,DG,520,345,1811,905,2256,2256,1291,G
2255,DH,5423,5078,6889,695,2284,2256,1466,D
2255,H,8253,3175,10064,3780,6036,2256,1811,H
2255,M,174,174,10238,1071,7107,2256,10064,M
2255,N,1017,1017,11255,180,7287,2256,10238,N
2255,O,896,896,12151,1050,8337,2256,11255,O
2255,N,1392,1392,13543,1235,9572,2256,12151,N
2255,O,103,103,13646,175,9747,2256,13543,O
2255,P,5143,5143,18789,5370,15117,2256,13646,P
2256,AEI,44,44,44,260,260,2257,0,E
2256,AFI,162,118,162,1235,1235,2257,0,A
2256,BFI,366,248,410,165,425,2257,44,F
2256,BGI,551,141,551,1412,1412,2257,0,I
2256,BGJ,636,495,1046,910,1335,2257,410,G
2256,BHJ,58,58,1104,3960,5295,2257,1046,H
2256,BJ,1285,343,1447,240,1475,2257,162,B
2256,CJ,1017,121,1568,180,1592,2257,551,J
2256,CK,609,609,2177,725,2317,2257,1568,K
2256,CL,883,153,2330,305,1780,2257,1447,C
2256,BL,242,89,2419,4140,6457,2257,2177,L
2256,B,607,518,2937,1200,2980,2257,2330,B
2256,C,583,583,3520,745,3725,2257,2937,C
2256,D,187,187,3707,4140,7865,2257,3520,D
2256,M,1679,1679,5386,1784,9649,2257,3707,M
2256,N,148,148,5534,90,9739,2257,5386,N
2256,O,535,535,6069,870,10609,2257,5534,O
2256,N,548,548,6617,225,10834,2257,6069,N
2256,O,712,712,7329,935,11769,2257,6617,O
2256,P,1327,1327,8656,3780,15549,2257,7329,P
2257,AE,63,63,63,879,879,2258,0,E
2257,AF,176,113,176,237,237,2258,0,A
2257,BF,437,437,613,390,627,2258,176,B
2257,CF,1019,469,1082,240,1119,2258,63,F
2257,CG,944,475,1557,1175,1802,2258,613,C
2257,BG,853,378,1935,880,1999,2258,1082,G
2257,BH,1128,750,2685,920,2722,2258,1557,B
2257,CH,862,862,3547,1162,3884,2258,2685,C
2257,DH,1550,1550,5097,473,4357,2258,3547,D
2257,H,5630,2468,7565,3960,5959,2258,1935,H
2257,M,3052,3052,10617,7377,13336,2258,7565,M
2257,N,1718,1718,12335,300,13636,2258,10617,N
2257,O,639,639,12974,705,14341,2258,12335,O
2257,P,12848,12848,25822,4080,18421,2258,12974,P
2258,A,679,679,679,1239,1239,2259,0,A
2258,B,697,697,1376,180,1419,2259,679,B
2258,C,942,942,2318,920,2339,2259,1376,C
2258,D,1875,1875,4193,550,2889,2259,2318,D
2258,M,1214,1214,5407,3590,6479,2259,4193,M
2258,N,2733,2733,8140,420,6899,2259,5407,N
2258,O,395,395,8535,635,7534,2259,8140,O
2258,P,7131,7131,15666,2560,10094,2259,8535,P
2259,AEI,605,605,605,1059,1059,2260,0,E
2259,AFI,527,527,1132,90,1149,2260,605,F
2259,AGI,990,990,2122,1250,2399,2260,1132,G
2259,AHI,420,420,2542,3780,6179,2260,2122,H
2259,AI,2691,149,2691,6265,6265,2260,0,A
2259,BI,2758,67,2758,2878,2878,2260,0,I
2259,BJ,155,155,2913,90,2968,2260,2758,J
2259,BK,422,422,3335,820,3788,2260,2913,K
2259,BL,2425,2425,5760,3780,7568,2260,3335,L
2259,B,3667,598,6358,90,6355,2260,2691,B
2259,C,1180,1180,7538,1470,7825,2260,6358,C
2259,D,101,101,7639,3780,11605,2260,7538,D
2259,M,641,641,8280,1184,12789,2260,7639,M
2259,N,573,573,8853,90,12879,2260,8280,N
2259,O,420,420,9273,815,13694,2260,8853,O
2259,P,30420,30420,39693,3780,17474,2260,9273,P
2260,A,23,23,23,141,141,2261,0,A
2260,B,196,196,219,135,276,2261,23,B
2260,C,194,194,413,295,571,2261,219,C
2260,D,67,67,480,5100,5671,2261,413,D
2260,M,849,849,1329,3322,8993,2261,480,M
2260,N,2324,2324,3653,180,9173,2261,1329,N
2260,O,460,460,4113,895,10068,2261,3653,O
2260,N,1104,1104,5217,400,10468,2261,4113,N
2260,O,506,506,5723,565,11033,2261,5217,O
2260,P,1592,1592,7315,6960,17993,2261,5723,P
2261,A,153,153,153,708,708,2262,0,A
2261,B,652,652,805,150,858,2262,153,B
2261,C,125,125,930,100,958,2262,805,C
2261,B,550,550,1480,570,1528,2262,930,B
2261,C,731,731,2211,660,2188,2262,1480,C
2261,D,1221,1221,3432,4230,6418,2262,2211,D
2261,M,990,990,4422,1695,8113,2262,3432,M
2261,N,960,960,5382,300,8413,2262,4422,N
2261,O,798,798,6180,1220,9633,2262,5382,O
2261,N,653,653,6833,235,9868,2262,6180,N
2261,O,384,384,7217,535,10403,2262,6833,O
2261,N,296,296,7513,95,10498,2262,7217,N
2261,O,567,567,8080,870,11368,2262,7513,O
2261,P,357,357,8437,1620,12988,2262,8080,P
2262,AEI,40,40,40,498,498,2263,0,I
2262,AEJ,182,142,182,1187,1187,2263,0,E
2262,AFJ,663,521,703,240,738,2263,40,J
2262,AFK,1196,675,1378,240,1427,2263,182,F
2262,AGK,684,9,1387,960,1698,2263,703,K
2262,AGL,1727,340,1727,1801,1801,2263,0,A
2262,BGL,268,268,1995,240,2041,2263,1727,B
2262,CGL,817,200,2195,930,2357,2263,1378,G
2262,CHL,1362,554,2749,3960,5658,2263,1387,L
2262,CH,821,67,2816,700,2741,2263,1995,C
2262,BH,2706,2706,5522,2810,5551,2263,2816,B
2262,CH,635,635,6157,960,6511,2263,5522,C
2262,DH,4885,4885,11042,3960,10471,2263,6157,D
2262,H,10362,1515,12557,6990,9347,2263,2195,H
2262,M,37201,37201,49758,37669,48140,2263,12557,M
2262,N,857,857,50615,480,48620,2263,49758,N
2262,O,736,736,51351,720,49340,2263,50615,O
2262,P,1028,1028,52379,310,49650,2263,51351,P
2263,AEI,143,143,143,300,300,2264,0,E
2263,AFI,211,68,211,730,730,2264,0,I
2263,AFJ,188,120,331,90,390,2264,143,F
2263,AGJ,618,498,829,150,880,2264,211,J
2263,AGK,160,160,989,125,1005,2264,829,K
2263,AGJ,1288,630,1619,1700,2090,2264,331,G
2263,AHJ,39,39,1658,3780,5870,2264,1619,H
2263,AJ,760,91,1749,785,1790,2264,989,J
2263,AK,780,780,2529,765,2555,2264,1749,K
2263,AL,310,310,2839,4230,6785,2264,2529,L
2263,A,37063,34224,37063,38053,38053,2264,0,A
2263,B,1016,1016,38079,90,38143,2264,37063,B
2263,C,1029,1029,39108,1220,39363,2264,38079,C
2263,D,2,2,39110,3780,43143,2264,39108,D
2263,M,192,192,39302,923,44066,2264,39110,M
2263,N,1022,1022,40324,90,44156,2264,39302,N
2263,O,335,335,40659,710,44866,2264,40324,O
2263,P,2204,2204,42863,3780,48646,2264,40659,P
2264,AEI,262,262,262,319,319,2265,0,A
2264,BEI,137,137,399,150,469,2265,262,B
2264,CEI,89,89,488,60,529,2265,399,C
2264,DEI,957,469,957,1180,1180,2265,0,I
2264,DEJ,340,340,1297,180,1360,2265,957,J
2264,DEK,1334,37,1334,1558,1558,2265,0,E
2264,DFK,133,96,1430,110,1470,2265,1297,K
2264,DFL,120,120,1550,2880,4350,2265,1430,L
2264,DF,332,116,1666,150,1708,2265,1334,F
2264,DG,1287,109,1775,2880,3409,2265,488,D
2264,G,706,597,2372,645,2353,2265,1666,G
2264,F,599,599,2971,670,3023,2265,2372,F
2264,G,560,560,3531,120,3143,2265,2971,G
2264,H,322,322,3853,4230,7373,2265,3531,H
2264,M,160,160,4013,841,8214,2265,3853,M
2264,N,779,779,4792,150,8364,2265,4013,N
2264,O,185,185,4977,120,8484,2265,4792,O
2264,N,1592,1592,6569,1640,10124,2265,4977,N
2264,O,1108,1108,7677,1295,11419,2265,6569,O
2264,P,1977,1977,9654,3660,15079,2265,7677,P
2265,AEI,79,79,79,425,425,2266,0,I
2265,AEJ,466,466,545,180,605,2266,79,J
2265,AEK,559,14,559,2693,2693,2266,0,E
2265,AFK,573,559,1118,840,1445,2266,545,K
2265,AFL,62,62,1180,6680,8125,2266,1118,L
2265,AF,2254,1633,2813,180,2873,2266,559,F
2265,AG,562,562,3375,860,3733,2266,2813,G
2265,AH,4262,887,4262,5285,5285,2266,0,A
2265,BH,1150,1150,5412,180,5465,2266,4262,B
2265,CH,675,675,6087,845,6310,2266,5412,C
2265,DH,793,793,6880,6680,12990,2266,6087,D
2265,H,25583,22078,28958,6680,10413,2266,3375,H
2265,M,1515,1515,30473,2112,15102,2266,28958,M
2265,N,730,730,31203,180,15282,2266,30473,N
2265,O,440,440,31643,390,15672,2266,31203,O
2265,P,8344,8344,39987,6960,22632,2266,31643,P
2266,AEI,337,337,337,285,285,2267,0,I
2266,AEJ,220,220,557,270,555,2267,337,J
2266,AEK,1069,1069,1626,1032,1587,2267,557,K
2266,AEL,1,1,1627,333,1920,2267,1626,L
2266,AE,1728,101,1728,2998,2998,2267,0,A
2266,BE,1466,1466,3194,240,3238,2267,1728,B
2266,CE,727,727,3921,845,4083,2267,3194,C
2266,DE,3942,21,3942,4753,4753,2267,0,E
2266,DF,838,838,4780,90,4843,2267,3942,F
2266,DG,370,370,5150,800,5643,2267,4780,G
2266,DH,1054,1054,6204,3780,9423,2267,5150,H
2266,D,2621,338,6542,9700,13783,2267,3921,D
2266,M,2215,2215,8757,2585,16368,2267,6542,M
2266,N,623,623,9380,300,16668,2267,8757,N
2266,O,940,940,10320,1045,17713,2267,9380,O
2266,P,1177,1177,11497,1140,18853,2267,10320,P
2267,AEI,115,115,115,3200,3200,2268,0,E
2267,AFI,348,233,348,1209,1209,2268,0,A
2267,BFI,900,900,1248,90,1299,2268,348,B
2267,CFI,948,948,2196,1200,2499,2268,1248,C
2267,DFI,53,53,2249,3780,6279,2268,2196,D
2267,FI,3115,981,3230,90,3290,2268,115,F
2267,GI,3024,3024,6254,1365,4655,2268,3230,G
2267,HI,268,268,6522,3780,8435,2268,6254,H
2267,I,10025,3503,10025,10299,10299,2268,0,I
2267,J,304,304,10329,90,10389,2268,10025,J
2267,K,1626,1626,11955,1874,12263,2268,10329,K
2267,L,93,93,12048,3780,16043,2268,11955,L
2267,M,4180,4180,16228,4858,20901,2268,12048,M
2267,N,712,712,16940,90,20991,2268,16228,N
2267,O,253,253,17193,695,21686,2268,16940,O
2267,P,8750,8750,25943,3780,25466,2268,17193,P
2268,A,5,5,5,425,425,2269,0,A
2268,B,542,542,547,185,610,2269,5,B
2268,C,528,528,1075,525,1135,2269,547,C
2268,D,133,133,1208,2880,4015,2269,1075,D
2268,M,556,556,1764,1997,6012,2269,1208,M
2268,N,1686,1686,3450,90,6102,2269,1764,N
2268,O,1293,1293,4743,1360,7462,2269,3450,O
2268,P,121,121,4864,3780,11242,2269,4743,P
2269,A,3618,3618,3618,3841,3841,2270,0,A
2269,B,281,281,3899,90,3931,2270,3618,B
2269,C,501,501,4400,795,4726,2270,3899,C
2269,B,327,327,4727,55,4781,2270,4400,B
2269,C,709,709,5436,1060,5841,2270,4727,C
2269,D,37,37,5473,3780,9621,2270,5436,D
2269,M,2799,2799,8272,2998,12619,2270,5473,M
2269,N,250,250,8522,90,12709,2270,8272,N
2269,O,801,801,9323,1115,13824,2270,8522,O
2269,N,726,726,10049,425,14249,2270,9323,N
2269,O,219,219,10268,535,14784,2270,10049,O
2269,P,14,14,10282,3780,18564,2270,10268,P
2270,AEI,93,93,93,160,160,2271,0,A
2270,BEI,177,84,177,187,187,2271,0,E
2270,BFI,90,90,267,135,322,2271,177,F
2270,BGI,132,132,399,280,602,2271,267,G
2270,BHI,345,39,438,300,460,2271,93,B
2270,CHI,231,192,630,5160,5762,2271,399,H
2270,CI,646,454,1084,780,1240,2271,438,C
2270,DI,2107,1023,2107,2366,2366,2271,0,I
2270,DJ,439,439,2546,240,2606,2271,2107,J
2270,DK,193,193,2739,295,2901,2271,2546,K
2270,DJ,1951,296,3035,1140,2380,2271,1084,D
2270,J,620,324,3359,515,3416,2271,2739,J
2270,K,240,240,3599,290,3706,2271,3359,K
2270,L,870,870,4469,5160,8866,2271,3599,L
2270,M,2419,2419,6888,2797,11663,2271,4469,M
2270,N,507,507,7395,180,11843,2271,6888,N
2270,O,706,706,8101,885,12728,2271,7395,O
2270,N,740,740,8841,570,13298,2271,8101,N
2270,O,463,463,9304,270,13568,2271,8841,O
2270,P,5283,5283,14587,7020,20588,2271,9304,P
2271,AE,296,296,296,1185,1185,2272,0,E
2271,AF,1161,865,1161,1296,1296,2272,0,A
2271,BF,929,64,1225,90,1275,2272,296,F
2271,BG,163,99,1324,90,1386,2272,1161,B
2271,CG,713,713,2037,1105,2491,2272,1324,C
2271,DG,247,247,2284,3780,6271,2272,2037,D
2271,G,1061,2,2286,1240,2515,2272,1225,G
2271,H,2757,2757,5043,3780,6295,2272,2286,H
2271,M,1010,1010,6053,1222,7517,2272,5043,M
2271,N,251,251,6304,90,7607,2272,6053,N
2271,O,578,578,6882,845,8452,2272,6304,O
2271,P,8694,8694,15576,3780,12232,2272,6882,P
2272,A,22157,22157,22157,21501,21501,2273,0,A
2272,B,311,311,22468,90,21591,2273,22157,B
2272,C,1319,1319,23787,1430,23021,2273,22468,C
2272,B,758,758,24545,1585,24606,2273,23787,B
2272,C,668,668,25213,935,25541,2273,24545,C
2272,D,922,922,26135,3780,29321,2273,25213,D
2272,M,370,370,26505,1357,30678,2273,26135,M
2272,N,1037,1037,27542,90,30768,2273,26505,N
2272,O,608,608,28150,960,31728,2273,27542,O
2272,N,738,738,28888,390,32118,2273,28150,N
2272,O,1265,1265,30153,1390,33508,2273,28888,O
2272,P,803,803,30956,3780,37288,2273,30153,P
2273,AEI,1136,1136,1136,1586,1586,2274,0,A
2273,BEI,1200,64,1200,1792,1792,2274,0,I
2273,BEJ,483,419,1619,90,1676,2274,1136,B
2273,CEJ,626,207,1826,90,1882,2274,1200,J
2273,CEK,975,975,2801,1310,3192,2274,1826,K
2273,CEJ,1236,54,2855,1600,3276,2274,1619,C
2273,BEJ,1863,1809,4664,1530,4722,2274,2801,J
2273,BEK,686,686,5350,900,5622,2274,4664,K
2273,BEL,100,100,5450,3780,9402,2274,5350,L
2273,BE,11046,8451,13901,10690,13966,2274,2855,B
2273,CE,648,648,14549,890,14856,2274,13901,C
2273,DE,145,145,14694,3780,18636,2274,14549,D
2273,E,20068,5374,20068,20364,20364,2274,0,E
2273,F,326,326,20394,90,20454,2274,20068,F
2273,G,1627,1627,22021,1874,22328,2274,20394,G
2273,F,617,617,22638,360,22688,2274,22021,F
2273,G,1761,1761,24399,1210,23898,2274,22638,G
2273,H,362,362,24761,3780,27678,2274,24399,H
2273,M,116,116,24877,1309,28987,2274,24761,M
2273,N,1236,1236,26113,90,29077,2274,24877,N
2273,O,571,571,26684,925,30002,2274,26113,O
2273,N,685,685,27369,325,30327,2274,26684,N
2273,O,220,220,27589,625,30952,2274,27369,O
2273,P,471,471,28060,3780,34732,2274,27589,P
2274,A,859,859,859,1839,1839,2275,0,A
2274,B,1058,1058,1917,90,1929,2275,859,B
2274,C,831,831,2748,1215,3144,2275,1917,C
2274,D,602,602,3350,3780,6924,2275,2748,D
2274,M,2141,2141,5491,2217,9141,2275,3350,M
2274,N,186,186,5677,150,9291,2275,5491,N
2274,O,818,818,6495,800,10091,2275,5677,O
2274,N,447,447,6942,460,10551,2275,6495,N
2274,O,496,496,7438,470,11021,2275,6942,O
2274,P,1465,1465,8903,4230,15251,2275,7438,P
2275,AEI,57,57,57,1227,1227,2276,0,A
2275,BEI,133,76,133,559,559,2276,0,I
2275,BEJ,476,343,476,564,564,2276,0,E
2275,BFJ,254,254,730,180,744,2276,476,F
2275,BGJ,698,101,831,300,859,2276,133,J
2275,BGK,138,37,868,260,1004,2276,730,G
2275,BFK,252,215,1083,285,1144,2276,831,K
2275,BFJ,1344,318,1401,240,1467,2276,57,B
2275,CFJ,161,161,1562,225,1692,2276,1401,C
2275,DFJ,980,286,1848,895,1899,2276,868,F
2275,DGJ,185,185,2033,225,2124,2276,1848,G
2275,DHJ,1483,533,2566,1470,2614,2276,1083,J
2275,DHK,163,163,2729,225,2839,2276,2566,K
2275,DHL,985,985,3714,4740,7579,2276,2729,L
2275,DH,3995,1843,5557,4740,6432,2276,1562,D
2275,H,11756,8232,13789,4860,6984,2276,2033,H
2275,M,1719,1719,15508,1749,9328,2276,13789,M
2275,N,211,211,15719,240,9568,2276,15508,N
2275,O,247,247,15966,295,9863,2276,15719,O
2275,N,572,572,16538,515,10378,2276,15966,N
2275,O,292,292,16830,290,10668,2276,16538,O
2275,P,2132,2132,18962,5160,15828,2276,16830,P
2276,AEI,219,219,219,466,466,2277,0,E
2276,AFI,623,623,842,420,886,2277,219,F
2276,AGI,1213,371,1213,1421,1421,2277,0,A
2276,BGI,405,405,1618,90,1511,2277,1213,B
2276,CGI,965,189,1807,1215,2101,2277,842,G
2276,CHI,659,659,2466,350,2451,2277,1807,H
2276,CI,1177,329,2795,1560,3071,2277,1618,C
2276,DI,70,70,2865,3780,6851,2277,2795,D
2276,I,4416,1551,4416,4725,4725,2277,0,I
2276,J,339,339,4755,90,4815,2277,4416,J
2276,K,281,281,5036,705,5520,2277,4755,K
2276,L,2546,2546,7582,3780,9300,2277,5036,L
2276,M,23513,23513,31095,23949,33249,2277,7582,M
2276,N,500,500,31595,90,33339,2277,31095,N
2276,O,380,380,31975,700,34039,2277,31595,O
2276,N,526,526,32501,225,34264,2277,31975,N
2276,O,576,576,33077,940,35204,2277,32501,O
2276,P,2844,2844,35921,3780,38984,2277,33077,P
2277,A,189,189,189,151,151,2278,0,A
2277,B,80,80,269,180,331,2278,189,B
2277,C,283,283,552,335,666,2278,269,C
2277,B,1168,1168,1720,1080,1746,2278,552,B
2277,C,809,809,2529,760,2506,2278,1720,C
2277,D,929,929,3458,7740,10246,2278,2529,D
2277,M,137,137,3595,330,10576,2278,3458,M
2277,N,312,312,3907,185,10761,2278,3595,N
2277,O,519,519,4426,525,11286,2278,3907,O
2277,N,283,283,4709,260,11546,2278,4426,N
2277,O,132,132,4841,100,11646,2278,4709,O
2277,N,88,88,4929,1570,13216,2278,4841,N
2277,O,598,598,5527,2910,16126,2278,4929,O
2277,P,214,214,5741,3450,19576,2278,5527,P
2278,A,635,635,635,855,855,2279,0,A
2278,B,244,244,879,90,945,2279,635,B
2278,C,807,807,1686,1105,2050,2279,879,C
2278,D,105,105,1791,3780,5830,2279,1686,D
2278,M,432,432,2223,1128,6958,2279,1791,M
2278,N,733,733,2956,90,7048,2279,2223,N
2278,O,251,251,3207,695,7743,2279,2956,O
2278,P,7349,7349,10556,3780,11523,2279,3207,P
2279,A,1555,1555,1555,1695,1695,2280,0,A
2279,B,409,409,1964,300,1995,2280,1555,B
2279,C,758,758,2722,835,2830,2280,1964,C
2279,D,1878,1878,4600,1140,3970,2280,2722,D
2279,M,389,389,4989,519,4489,2280,4600,M
2279,N,245,245,5234,180,4669,2280,4989,N
2279,O,995,995,6229,1250,5919,2280,5234,O
2279,P,2182,2182,8411,6680,12599,2280,6229,P
2280,A,18,18,18,265,265,2281,0,A
2280,B,337,337,355,135,400,2281,18,B
2280,C,562,562,917,630,1030,2281,355,C
2280,D,666,666,1583,6300,7330,2281,917,D
2280,M,11,11,1594,280,7610,2281,1583,M
2280,N,482,482,2076,270,7880,2281,1594,N
2280,O,628,628,2704,735,8615,2281,2076,O
2280,N,1043,1043,3747,925,9540,2281,2704,N
2280,O,28,28,3775,415,9955,2281,3747,O
2280,P,26419,26419,30194,6060,16015,2281,3775,P
2281,A,263,263,263,1075,1075,2282,0,A
2281,B,1075,1075,1338,300,1375,2282,263,B
2281,C,320,320,1658,445,1820,2282,1338,C
2281,B,469,469,2127,315,2135,2282,1658,B
2281,C,720,720,2847,735,2870,2282,2127,C
2281,D,43,43,2890,1560,4430,2282,2847,D
2281,M,535,535,3425,450,4880,2282,2890,M
2281,N,329,329,3754,300,5180,2282,3425,N
2281,O,695,695,4449,835,6015,2282,3754,O
2281,P,3246,3246,7695,1140,7155,2282,4449,P
2282,AE,90,90,90,1118,1118,2283,0,A
2282,BE,1206,1206,1296,240,1358,2283,90,B
2282,CE,1452,156,1452,1761,1761,2283,0,E
2282,CF,855,699,2151,995,2353,2283,1296,C
2282,DF,165,165,2316,4680,7033,2283,2151,D
2282,F,1268,404,2720,90,1851,2283,1452,F
2282,G,350,350,3070,800,2651,2283,2720,G
2282,H,799,799,3869,3780,6431,2283,3070,H
2282,M,998,998,4867,1417,8450,2283,3869,M
2282,N,539,539,5406,180,8630,2283,4867,N
2282,O,697,697,6103,765,9395,2283,5406,O
2282,P,751,751,6854,550,9945,2283,6103,P
2283,AEI,89,89,89,855,855,2284,0,I
2283,AEJ,319,230,319,469,469,2284,0,A
2283,BEJ,331,331,650,240,709,2284,319,B
2283,CEJ,874,313,963,150,1005,2284,89,J
2283,CEK,176,176,1139,130,1135,2284,963,K
2283,CEJ,327,327,1466,370,1505,2284,1139,J
2283,CEK,451,451,1917,470,1975,2284,1466,K
2283,CEL,186,186,2103,4230,6205,2284,1917,L
2283,CE,2770,1317,3420,3600,4309,2284,650,C
2283,BE,1058,1058,4478,200,4509,2284,3420,B
2283,CE,492,492,4970,740,5249,2284,4478,C
2283,DE,1158,1158,6128,3960,9209,2284,4970,D
2283,E,8191,2063,8191,8454,8454,2284,0,E
2283,F,462,462,8653,240,8694,2284,8191,F
2283,G,498,498,9151,740,9434,2284,8653,G
2283,H,106,106,9257,3960,13394,2284,9151,H
2283,M,1255,1255,10512,1360,14754,2284,9257,M
2283,N,308,308,10820,240,14994,2284,10512,N
2283,O,679,679,11499,740,15734,2284,10820,O
2283,N,1388,1388,12887,1355,17089,2284,11499,N
2283,O,491,491,13378,740,17829,2284,12887,O
2283,P,2351,2351,15729,5100,22929,2284,13378,P
2284,AEI,573,573,573,744,744,2285,0,E
2284,AFI,201,201,774,90,834,2285,573,F
2284,AGI,588,588,1362,820,1654,2285,774,G
2284,AFI,686,686,2048,445,2099,2285,1362,F
2284,AGI,766,766,2814,1080,3179,2285,2048,G
2284,AHI,794,794,3608,3780,6959,2285,2814,H
2284,AI,5773,2165,5773,6153,6153,2285,0,A
2284,BI,403,403,6176,90,6243,2285,5773,B
2284,CI,537,537,6713,730,6973,2285,6176,C
2284,BI,611,611,7324,370,7343,2285,6713,B
2284,CI,729,729,8053,1060,8403,2285,7324,C
2284,DI,839,839,8892,3780,12183,2285,8053,D
2284,I,33721,24829,33721,34843,34843,2285,0,I
2284,J,1193,1193,34914,90,34933,2285,33721,J
2284,K,1119,1119,36033,1365,36298,2285,34914,K
2284,J,591,591,36624,365,36663,2285,36033,J
2284,K,884,884,37508,1080,37743,2285,36624,K
2284,L,384,384,37892,3780,41523,2285,37508,L
2284,M,8528,8528,46420,8669,50192,2285,37892,M
2284,N,166,166,46586,90,50282,2285,46420,N
2284,O,739,739,47325,1105,51387,2285,46586,O
2284,P,486,486,47811,3780,55167,2285,47325,P
2285,AEI,74,74,74,1007,1007,2286,0,I
2285,AEJ,116,42,116,1057,1057,2286,0,E
2285,AFJ,767,651,767,1361,1361,2286,0,A
2285,BFJ,1108,415,1182,240,1247,2286,74,J
2285,BFK,1135,69,1251,240,1297,2286,116,F
2285,BGK,621,137,1388,90,1451,2286,767,B
2285,CGK,527,527,1915,800,2251,2286,1388,C
2285,DGK,841,108,2023,995,2242,2286,1182,K
2285,DGL,862,90,2113,1020,2317,2286,1251,G
2285,DHL,208,118,2231,4680,6922,2286,2023,L
2285,DH,2287,1971,4202,3780,6031,2286,1915,D
2285,H,4462,2373,6575,4680,6997,2286,2113,H
2285,M,2108,2108,8683,2241,9238,2286,6575,M
2285,N,311,311,8994,90,9328,2286,8683,N
2285,O,631,631,9625,815,10143,2286,8994,O
2285,N,2013,2013,11638,1930,12073,2286,9625,N
2285,O,1436,1436,13074,1275,13348,2286,11638,O
2285,P,170,170,13244,3780,17128,2286,13074,P
2286,AEI,72,72,72,380,380,2287,0,E
2286,AFI,480,408,480,896,896,2287,0,A
2286,BFI,598,190,670,240,620,2287,72,F
2286,BGI,625,435,1105,240,1136,2287,480,B
2286,CGI,794,359,1464,1545,2165,2287,670,G
2286,CFI,2296,832,2296,2307,2307,2287,0,I
2286,CFJ,1290,99,2395,1210,2346,2287,1105,C
2286,DFJ,190,91,2486,180,2487,2287,2296,J
2286,DFK,1321,299,2785,95,2260,2287,1464,F
2286,DGK,296,296,3081,540,2800,2287,2785,G
2286,DHK,852,257,3338,930,3417,2287,2486,K
2286,DHL,1274,331,3669,550,2896,2287,2395,D
2286,HL,2577,1989,5658,9780,12580,2287,3081,H
2286,L,4878,2558,8216,550,3967,2287,3338,L
2286,M,803,803,9019,2954,15534,2287,8216,M
2286,N,2528,2528,11547,420,15954,2287,9019,N
2286,O,991,991,12538,1376,17330,2287,11547,O
2286,P,2036,2036,14574,504,17834,2287,12538,P
2287,AE,737,737,737,1770,1770,2288,0,A
2287,BE,1782,1045,1782,2021,2021,2288,0,E
2287,BF,1066,21,1803,90,1860,2288,737,B
2287,CF,274,253,2056,90,2111,2288,1782,F
2287,CG,501,248,2304,710,2570,2288,1803,C
2287,DG,415,167,2471,820,2931,2288,2056,G
2287,DH,132,132,2603,3780,6711,2288,2471,H
2287,D,420,121,2724,3780,6350,2288,2304,D
2287,M,1556,1556,4280,1944,8655,2288,2724,M
2287,N,433,433,4713,90,8745,2288,4280,N
2287,O,730,730,5443,1135,9880,2288,4713,O
2287,P,498,498,5941,3780,13660,2288,5443,P
2288,AE,752,752,752,1033,1033,2289,0,E
2288,AF,312,312,1064,90,1123,2289,752,F
2288,AG,1149,1149,2213,1225,2348,2289,1064,G
2288,AH,2940,727,2940,3133,3133,2289,0,A
2288,BH,217,217,3157,90,3223,2289,2940,B
2288,CH,513,513,3670,905,4128,2289,3157,C
2288,DH,398,398,4068,3780,7908,2289,3670,D
2288,H,28975,27120,31188,4505,6853,2289,2213,H
2288,M,3046,3046,34234,3236,11144,2289,31188,M
2288,N,223,223,34457,90,11234,2289,34234,N
2288,O,557,557,35014,805,12039,2289,34457,O
2288,P,6300,6300,41314,3780,15819,2289,35014,P
2289,A,545,545,545,1041,1041,2290,0,A
2289,B,727,727,1272,300,1341,2290,545,B
2289,C,746,746,2018,765,2106,2290,1272,C
2289,D,1453,1453,3471,4080,6186,2290,2018,D
2289,M,8627,8627,12098,8806,14992,2290,3471,M
2289,N,472,472,12570,300,15292,2290,12098,N
2289,O,233,233,12803,1900,17192,2290,12570,O
2289,P,1454,1454,14257,7380,24572,2290,12803,P
2290,A,91,91,91,94,94,2291,0,A
2290,B,201,201,292,240,334,2291,91,B
2290,C,231,231,523,895,1229,2291,292,C
2290,D,721,721,1244,3490,4719,2291,523,D
2290,M,503,503,1747,1298,6017,2291,1244,M
2290,N,860,860,2607,180,6197,2291,1747,N
2290,O,1556,1556,4163,1505,7702,2291,2607,O
2290,N,1008,1008,5171,1005,8707,2291,4163,N
2290,O,911,911,6082,831,9538,2291,5171,O
2290,P,1825,1825,7907,414,9952,2291,6082,P
2291,A,24,24,24,107,107,2292,0,A
2291,B,178,178,202,135,242,2292,24,B
2291,C,171,171,373,285,527,2292,202,C
2291,D,135,135,508,5160,5687,2292,373,D
2291,M,2170,2170,2678,2612,8299,2292,508,M
2291,N,480,480,3158,90,8389,2292,2678,N
2291,O,1070,1070,4228,1240,9629,2292,3158,O
2291,N,2205,2205,6433,2035,11664,2292,4228,N
2291,O,1815,1815,8248,1220,12884,2292,6433,O
2291,P,2845,2845,11093,3780,16664,2292,8248,P
2292,AEI,497,497,497,1111,1111,2293,0,I
2292,AEJ,772,275,772,1373,1373,2293,0,E
2292,AFJ,688,413,1185,90,1201,2293,497,J
2292,AFK,628,215,1400,90,1463,2293,772,F
2292,AGK,381,166,1566,800,2001,2293,1185,K
2292,AGL,352,186,1752,800,2263,2293,1400,G
2292,AHL,835,649,2401,3780,5781,2293,1566,L
2292,AH,933,284,2685,3780,6043,2293,1752,H
2292,A,12878,10193,12878,12870,12870,2293,0,A
2292,B,269,269,13147,300,13170,2293,12878,B
2292,C,901,901,14048,1005,14175,2293,13147,C
2292,D,3944,3944,17992,1200,15375,2293,14048,D
2292,M,473,473,18465,917,16292,2293,17992,M
2292,N,565,565,19030,180,16472,2293,18465,N
2292,O,938,938,19968,900,17372,2293,19030,O
2292,P,210,210,20178,550,17922,2293,19968,P
2293,AEI,78,78,78,128,128,2294,0,E
2293,AFI,210,132,210,231,231,2294,0,A
2293,BFI,97,97,307,135,366,2294,210,B
2293,CFI,243,14,321,240,368,2294,78,F
2293,CGI,147,133,454,280,646,2294,307,C
2293,DGI,175,42,496,285,653,2294,321,G
2293,DHI,308,266,762,5160,5806,2294,454,D
2293,HI,5847,5581,6343,5160,5813,2294,496,H
2293,I,11452,5109,11452,11500,11500,2294,0,I
2293,J,349,349,11801,300,11800,2294,11452,J
2293,K,683,683,12484,800,12600,2294,11801,K
2293,L,1311,1311,13795,1140,13740,2294,12484,L
2293,M,97,97,13892,1275,15015,2294,13795,M
2293,N,1319,1319,15211,180,15195,2294,13892,N
2293,O,806,806,16017,885,16080,2294,15211,O
2293,P,3469,3469,19486,6680,22760,2294,16017,P
2294,A,147,147,147,238,238,2295,0,A
2294,B,280,280,427,240,478,2295,147,B
2294,C,525,525,952,765,1243,2295,427,C
2294,B,927,927,1879,495,1738,2295,952,B
2294,C,862,862,2741,1260,2998,2295,1879,C
2294,D,7176,7176,9917,3960,6958,2295,2741,D
2294,M,8456,8456,18373,9055,16013,2295,9917,M
2294,N,730,730,19103,180,16193,2295,18373,N
2294,O,950,950,20053,885,17078,2295,19103,O
2294,N,641,641,20694,695,17773,2295,20053,N
2294,O,585,585,21279,710,18483,2295,20694,O
2294,P,22935,22935,44214,6960,25443,2295,21279,P
2295,AEI,10,10,10,352,352,2296,0,E
2295,AFI,62,52,62,2875,2875,2296,0,A
2295,BFI,131,69,131,433,433,2296,0,I
2295,BFJ,384,384,515,135,568,2296,131,J
2295,BFK,567,62,577,240,592,2296,10,F
2295,BGK,224,162,739,285,853,2296,515,K
2295,BGL,248,86,825,285,877,2296,577,G
2295,BHL,156,70,895,5160,6013,2296,739,L
2295,BH,1539,1469,2364,5160,6037,2296,825,H
2295,B,2996,694,3058,240,3115,2296,62,B
2295,C,255,255,3313,285,3400,2296,3058,C
2295,D,2714,2714,6027,5160,8560,2296,3313,D
2295,M,9157,9157,15184,10617,19177,2296,6027,M
2295,N,1591,1591,16775,180,19357,2296,15184,N
2295,O,904,904,17679,885,20242,2296,16775,O
2295,N,3345,3345,21024,3325,23567,2296,17679,N
2295,O,909,909,21933,1070,24637,2296,21024,O
2295,P,964,964,22897,6900,31537,2296,21933,P
2296,AE,13,13,13,607,607,2297,0,A
2296,BE,299,286,299,350,350,2297,0,E
2296,BF,192,192,491,180,530,2297,299,F
2296,BG,734,256,747,180,787,2297,13,B
2296,CG,291,35,782,460,990,2297,491,G
2296,CF,299,299,1081,135,1125,2297,782,F
2296,CG,424,90,1171,335,1122,2297,747,C
2296,BG,175,85,1256,2970,4095,2297,1081,G
2296,BH,1615,1530,2786,1705,2827,2297,1171,B
2296,CH,654,654,3440,825,3652,2297,2786,C
2296,DH,4024,1840,5280,1440,5535,2297,1256,H
2296,D,3068,1228,6508,4140,7792,2297,3440,D
2296,M,1694,1694,8202,2164,9956,2297,6508,M
2296,N,728,728,8930,300,10256,2297,8202,N
2296,O,925,925,9855,860,11116,2297,8930,O
2296,N,834,834,10689,955,12071,2297,9855,N
2296,O,288,288,10977,377,12448,2297,10689,O
2296,P,6929,6929,17906,983,13431,2297,10977,P
2297,AEI,28,28,28,44,44,2298,0,I
2297,AEJ,48,20,48,4539,4539,2298,0,A
2297,BEJ,121,101,149,150,194,2298,28,J
2297,BEK,213,213,362,130,324,2298,149,K
2297,BEJ,1300,1300,1662,1350,1674,2298,362,J
2297,BEK,571,571,2233,635,2309,2298,1662,K
2297,BEL,307,307,2540,4230,6539,2298,2233,L
2297,BE,2899,359,2899,3071,3071,2298,0,E
2297,BF,127,127,3026,90,3161,2298,2899,F
2297,BG,547,547,3573,1050,4211,2298,3026,G
2297,BF,4611,1086,4659,165,4704,2298,48,B
2297,CF,620,620,5279,895,5599,2298,4659,C
2297,DF,1874,168,5447,1290,5501,2298,3573,F
2297,DG,1009,1009,6456,1255,6756,2298,5447,G
2297,DH,170,170,6626,3960,10716,2298,6456,H
2297,D,1527,180,6806,3960,9559,2298,5279,D
2297,M,1540,1540,8346,1853,12569,2298,6806,M
2297,N,348,348,8694,90,12659,2298,8346,N
2297,O,497,497,9191,855,13514,2298,8694,O
2297,N,1578,1578,10769,1195,14709,2298,9191,N
2297,O,391,391,11160,790,15499,2298,10769,O
2297,P,900,900,12060,3780,19279,2298,11160,P
2298,AEI,72,72,72,248,248,2299,0,E
2298,AFI,196,124,196,1680,1680,2299,0,A
2298,BFI,245,121,317,135,383,2299,72,F
2298,BGI,721,721,1038,845,1228,2299,317,G
2298,BHI,1741,899,1937,300,1980,2299,196,B
2298,CHI,736,736,2673,745,2725,2299,1937,C
2298,DHI,122,122,2795,1560,4285,2299,2673,D
2298,HI,2127,370,3165,5220,6448,2299,1038,H
2298,I,14866,11701,14866,14855,14855,2299,0,I
2298,J,306,306,15172,300,15155,2299,14866,J
2298,K,600,600,15772,735,15890,2299,15172,K
2298,L,78,78,15850,1560,17450,2299,15772,L
2298,M,4538,4538,20388,4702,22152,2299,15850,M
2298,N,381,381,20769,240,22392,2299,20388,N
2298,O,923,923,21692,995,23387,2299,20769,O
2298,N,162,162,21854,290,23677,2299,21692,N
2298,O,915,915,22769,1080,24757,2299,21854,O
2298,P,1559,1559,24328,3960,28717,2299,22769,P
2299,AE,921,921,921,2671,2671,2300,0,E
2299,AF,1070,149,1070,1232,1232,2300,0,A
2299,BF,339,339,1409,240,1472,2300,1070,B
2299,CF,566,566,1975,630,2102,2300,1409,C
2299,DF,753,753,2728,6300,8402,2300,1975,D
2299,F,1927,120,2848,240,2911,2300,921,F
2299,G,602,602,3450,630,3541,2300,2848,G
2299,H,9886,9886,13336,6300,9841,2300,3450,H
2299,M,219,219,13555,200,10041,2300,13336,M
2299,N,191,191,13746,300,10341,2300,13555,N
2299,O,508,508,14254,690,11031,2300,13746,O
2299,N,617,617,14871,390,11421,2300,14254,N
2299,O,688,688,15559,750,12171,2300,14871,O
2299,P,5660,5660,21219,3960,16131,2300,15559,P
2300,A,649,649,649,1075,1075,2301,0,A
2300,B,680,680,1329,300,1375,2301,649,B
2300,C,275,275,1604,405,1780,2301,1329,C
2300,B,512,512,2116,1685,3465,2301,1604,B
2300,C,651,651,2767,755,4220,2301,2116,C
2300,D,1857,1857,4624,1140,5360,2301,2767,D
2300,M,693,693,5317,1495,6855,2301,4624,M
2300,N,830,830,6147,90,6945,2301,5317,N
2300,O,964,964,7111,1240,8185,2301,6147,O
2300,P,298,298,7409,3780,11965,2301,7111,P
2301,AE,42,42,42,504,504,2302,0,E
2301,AF,682,682,724,240,744,2302,42,F
2301,AG,672,672,1396,960,1704,2302,724,G
2301,AH,313,313,1709,3960,5664,2302,1396,H
2301,A,6172,4463,6172,7920,7920,2302,0,A
2301,B,2501,2501,8673,780,8700,2302,6172,B
2301,C,1047,1047,9720,1307,10007,2302,8673,C
2301,D,7160,7160,16880,473,10480,2302,9720,D
2301,M,54,54,16934,321,10801,2302,16880,M
2301,N,437,437,17371,240,11041,2302,16934,N
2301,O,934,934,18305,975,12016,2302,17371,O
2301,N,1190,1190,19495,1100,13116,2302,18305,N
2301,O,169,169,19664,225,13341,2302,19495,O
2301,P,4248,4248,23912,4740,18081,2302,19664,P
2302,AEI,220,220,220,422,422,2303,0,I
2302,AEJ,633,413,633,623,623,2303,0,A
2302,BEJ,640,7,640,856,856,2303,0,E
2302,BFJ,100,93,733,170,793,2303,633,B
2302,CFJ,622,109,842,480,902,2303,220,J
2302,CFK,246,44,886,90,946,2303,640,F
2302,CGK,569,416,1302,520,1313,2303,733,C
2302,DGK,600,184,1486,625,1571,2303,886,G
2302,DHK,727,83,1569,725,1627,2303,842,K
2302,DHL,734,651,2220,385,1956,2303,1486,H
2302,DL,3429,2778,4998,550,2177,2303,1569,L
2302,D,7237,3541,8539,385,1698,2303,1302,D
2302,M,499,499,9038,1098,3275,2303,8539,M
2302,N,719,719,9757,180,3455,2303,9038,N
2302,O,820,820,10577,830,4285,2303,9757,O
2302,N,1154,1154,11731,1110,5395,2303,10577,N
2302,O,233,233,11964,210,5605,2303,11731,O
2302,P,25004,25004,36968,7080,12685,2303,11964,P
2303,AE,495,495,495,2002,2002,2304,0,E
2303,AF,544,49,544,737,737,2304,0,A
2303,BF,313,313,857,180,917,2304,544,B
2303,CF,1627,1265,2122,180,2182,2304,495,F
2303,CG,1368,103,2225,1380,2297,2304,857,C
2303,DG,1234,1131,3356,1445,3627,2304,2122,G
2303,DH,3734,2603,5959,3835,6132,2304,2225,D
2303,H,5390,2787,8746,890,4517,2304,3356,H
2303,M,94,94,8840,226,6358,2304,8746,M
2303,N,491,491,9331,420,6778,2304,8840,N
2303,O,1727,1727,11058,1740,8518,2304,9331,O
2303,P,271,271,11329,420,8938,2304,11058,P
2304,AEI,1363,1363,1363,1420,1420,2305,0,I
2304,AEJ,108,108,1471,90,1510,2305,1363,J
2304,AEK,1599,1599,3070,1940,3450,2305,1471,K
2304,AEJ,758,758,3828,435,3885,2305,3070,J
2304,AEK,730,730,4558,1080,4965,2305,3828,K
2304,AEL,5193,635,5193,5599,5599,2305,0,A
2304,BEL,450,450,5643,90,5689,2305,5193,B
2304,CEL,1087,1087,6730,1280,6969,2305,5643,C
2304,DEL,410,410,7140,3780,10749,2305,6730,D
2304,EL,2841,259,7399,3780,8745,2305,4558,L
2304,E,35913,28514,35913,36373,36373,2305,0,E
2304,F,765,765,36678,90,36463,2305,35913,F
2304,G,1240,1240,37918,1385,37848,2305,36678,G
2304,F,1009,1009,38927,1135,38983,2305,37918,F
2304,G,725,725,39652,1060,40043,2305,38927,G
2304,H,159,159,39811,3780,43823,2305,39652,H
2304,M,5760,5760,45571,5887,49710,2305,39811,M
2304,N,153,153,45724,90,49800,2305,45571,N
2304,O,752,752,46476,1130,50930,2305,45724,O
2304,P,494,494,46970,3780,54710,2305,46476,P
2305,AEI,72,72,72,166,166,2306,0,A
2305,BEI,252,180,252,438,438,2306,0,I
2305,BEJ,218,38,290,180,346,2306,72,B
2305,CEJ,466,176,466,645,645,2306,0,E
2305,CFJ,358,144,610,240,678,2306,252,J
2305,CFK,277,133,743,150,795,2306,466,F
2305,CGK,34,34,777,100,895,2306,743,G
2305,CFK,754,267,1044,855,1201,2306,290,C
2305,BFK,454,187,1231,385,1280,2306,777,F
2305,BGK,779,158,1389,975,1653,2306,610,K
2305,BGJ,177,19,1408,225,1505,2306,1231,G
2305,BHJ,1056,1056,2464,4740,6245,2306,1408,H
2305,BJ,1510,90,2554,1385,2586,2306,1044,B
2305,CJ,1305,140,2694,1100,2753,2306,1389,J
2305,CK,174,34,2728,225,2811,2306,2554,C
2305,DK,177,143,2871,225,2978,2306,2694,K
2305,DL,4356,4356,7227,4740,7718,2306,2871,L
2305,D,89537,85038,92265,4740,7551,2306,2728,D
2305,M,1208,1208,93473,1330,9048,2306,92265,M
2305,N,297,297,93770,240,9288,2306,93473,N
2305,O,236,236,94006,295,9583,2306,93770,O
2305,N,580,580,94586,515,10098,2306,94006,N
2305,O,276,276,94862,295,10393,2306,94586,O
2305,P,1827,1827,96689,5160,15553,2306,94862,P
2306,AE,1429,1429,1429,1854,1854,2307,0,A
2306,BE,1435,6,1435,1994,1994,2307,0,E
2306,BF,617,611,2046,240,2094,2307,1429,B
2306,CF,758,147,2193,240,2234,2307,1435,F
2306,CG,847,700,2893,985,3079,2307,2046,C
2306,BG,857,157,3050,976,3210,2307,2193,G
2306,BF,861,704,3754,750,3829,2307,2893,B
2306,CF,1003,299,4053,795,4005,2307,3050,F
2306,CG,390,91,4144,510,4339,2307,3754,C
2306,DG,62,62,4206,4020,8359,2307,4144,D
2306,G,393,240,4446,510,4515,2307,4053,G
2306,H,49,49,4495,3960,8475,2307,4446,H
2306,M,5414,5414,9909,6136,14611,2307,4495,M
2306,N,1356,1356,11265,90,14701,2307,9909,N
2306,O,1029,1029,12294,1370,16071,2307,11265,O
2306,P,238,238,12532,3780,19851,2307,12294,P
2307,AE,194,194,194,1110,1110,2308,0,A
2307,BE,1016,1016,1210,150,1260,2308,194,B
2307,CE,137,137,1347,370,1630,2308,1210,C
2307,BE,551,551,1898,300,1930,2308,1347,B
2307,CE,727,727,2625,660,2590,2308,1898,C
2307,DE,96,96,2721,4230,6820,2308,2625,D
2307,E,12111,9390,12111,13069,13069,2308,0,E
2307,F,1214,1214,13325,300,13369,2308,12111,F
2307,G,1000,1000,14325,1010,14379,2308,13325,G
2307,H,472,472,14797,1200,15579,2308,14325,H
2307,M,1471,1471,16268,1574,17153,2308,14797,M
2307,N,132,132,16400,90,17243,2308,16268,N
2307,O,543,543,16943,820,18063,2308,16400,O
2307,N,659,659,17602,370,18433,2308,16943,N
2307,O,235,235,17837,695,19128,2308,17602,O
2307,P,1781,1781,19618,3780,22908,2308,17837,P
2308,A,196,196,196,350,350,2309,0,A
2308,B,225,225,421,240,590,2309,196,B
2308,C,1332,1332,1753,1560,2150,2309,421,C
2308,B,2418,2418,4171,2061,4211,2309,1753,B
2308,C,1064,1064,5235,1245,5456,2309,4171,C
2308,D,154,154,5389,335,5791,2309,5235,D
2308,M,1235,1235,6624,1605,7396,2309,5389,M
2308,N,629,629,7253,300,7696,2309,6624,N
2308,O,806,806,8059,1045,8741,2309,7253,O
2308,P,50,50,8109,1140,9881,2309,8059,P
2309,AEI,131,131,131,286,286,2310,0,I
2309,AEJ,279,279,410,180,466,2310,131,J
2309,AEK,701,291,701,1264,1264,2310,0,E
2309,AFK,722,722,1423,180,1444,2310,701,F
2309,AGK,1048,35,1458,935,1401,2310,410,K
2309,AGL,2091,633,2091,2698,2698,2310,0,A
2309,BGL,895,227,2318,900,2344,2310,1423,G
2309,BHL,1168,941,3259,600,3298,2310,2091,B
2309,CHL,2290,489,3748,385,1786,2310,1458,L
2309,CH,1327,838,4586,1285,4583,2310,3259,C
2309,DH,734,734,5320,385,4968,2310,4586,D
2309,H,3139,137,5457,550,2894,2310,2318,H
2309,M,677,677,6134,1160,6128,2310,5457,M
2309,N,865,865,6999,420,6548,2310,6134,N
2309,O,1086,1086,8085,1240,7788,2310,6999,O
2309,P,20,20,8105,335,8123,2310,8085,P
2310,AEI,44,44,44,1560,1560,2311,0,E
2310,AFI,54,10,54,1599,1599,2311,0,I
2310,AFJ,133,79,133,1418,1418,2311,0,A
2310,BFJ,1481,1481,1614,240,1658,2311,133,B
2310,CFJ,1690,120,1734,165,1725,2311,44,F
2310,CGJ,1721,41,1775,165,1764,2311,54,J
2310,CGK,518,357,2132,765,2423,2311,1614,C
2310,DGK,622,224,2356,910,2635,2311,1734,G
2310,DHK,608,27,2383,910,2674,2311,1775,K
2310,DHL,303,52,2435,9700,12123,2311,2132,D
2310,HL,1115,1063,3498,3960,6634,2311,2383,L
2310,H,1350,208,3706,3960,6595,2311,2356,H
2310,M,1540,1540,5246,1566,13689,2311,3706,M
2310,N,220,220,5466,240,13929,2311,5246,N
2310,O,787,787,6253,1000,14929,2311,5466,O
2310,N,532,532,6785,355,15284,2311,6253,N
2310,O,242,242,7027,390,15674,2311,6785,O
2310,P,217,217,7244,3960,19634,2311,7027,P
2311,AEI,62,62,62,691,691,2312,0,I
2311,AEJ,186,124,186,679,679,2312,0,E
2311,AFJ,687,687,873,240,919,2312,186,F
2311,AGJ,821,10,883,240,931,2312,62,J
2311,AGK,235,225,1108,280,1199,2312,873,G
2311,AHK,324,99,1207,280,1211,2312,883,K
2311,AHL,1608,401,1608,2257,2257,2312,0,A
2311,BHL,679,679,2287,90,2347,2312,1608,B
2311,CHL,1184,104,2391,5160,6371,2312,1207,L
2311,CH,508,404,2795,820,3167,2312,2287,C
2311,BH,3071,1384,4179,5160,6359,2312,1108,H
2311,B,1733,349,4528,1405,4572,2312,2795,B
2311,C,1160,1160,5688,1405,5977,2312,4528,C
2311,D,3207,3207,8895,3780,9757,2312,5688,D
2311,M,1664,1664,10559,4479,14236,2312,8895,M
2311,N,2947,2947,13506,90,14326,2312,10559,N
2311,O,862,862,14368,1250,15576,2312,13506,O
2311,N,899,899,15267,600,16176,2312,14368,N
2311,O,373,373,15640,705,16881,2312,15267,O
2311,P,1567,1567,17207,3780,20661,2312,15640,P
2312,A,13,13,13,159,159,2313,0,A
2312,B,338,338,351,240,399,2313,13,B
2312,C,459,459,810,780,1179,2313,351,C
2312,D,123,123,933,3960,5139,2313,810,D
2312,M,1881,1881,2814,3035,8174,2313,933,M
2312,N,1434,1434,4248,300,8474,2313,2814,N
2312,O,594,594,4842,910,9384,2313,4248,O
2312,P,306,306,5148,3960,13344,2313,4842,P
2313,A,480,480,480,1442,1442,2314,0,A
2313,B,990,990,1470,90,1532,2314,480,B
2313,C,892,892,2362,1200,2732,2314,1470,C
2313,D,127,127,2489,3780,6512,2314,2362,D
2313,M,726,726,3215,856,7368,2314,2489,M
2313,N,178,178,3393,90,7458,2314,3215,N
2313,O,537,537,3930,920,8378,2314,3393,O
2313,P,1276,1276,5206,3780,12158,2314,3930,P
2314,AE,2535,2535,2535,2681,2681,2315,0,A
2314,BE,180,180,2715,90,2771,2315,2535,B
2314,CE,720,720,3435,1130,3901,2315,2715,C
2314,DE,133,133,3568,3780,7681,2315,3435,D
2314,E,10694,7126,10694,11602,11602,2315,0,E
2314,F,938,938,11632,90,11692,2315,10694,F
2314,G,1368,1368,13000,1240,12932,2315,11632,G
2314,H,4,4,13004,3780,16712,2315,13000,H
2314,M,725,725,13729,1358,18070,2315,13004,M
2314,N,684,684,14413,90,18160,2315,13729,N
2314,O,368,368,14781,800,18960,2315,14413,O
2314,P,879,879,15660,3780,22740,2315,14781,P
2315,AE,454,454,454,1084,1084,2316,0,A
2315,BE,746,746,1200,150,1234,2316,454,B
2315,CE,43,43,1243,90,1324,2316,1200,C
2315,BE,284,284,1527,255,1579,2316,1243,B
2315,CE,294,294,1821,280,1859,2316,1527,C
2315,DE,284,284,2105,5280,7139,2316,1821,D
2315,E,9658,7553,9658,8410,8410,2316,0,E
2315,F,158,158,9816,1445,9855,2316,9658,F
2315,G,317,317,10133,490,10345,2316,9816,G
2315,F,432,432,10565,255,10600,2316,10133,F
2315,G,613,613,11178,770,11370,2316,10565,G
2315,H,211,211,11389,1140,12510,2316,11178,H
2315,M,1767,1767,13156,2846,15356,2316,11389,M
2315,N,1145,1145,14301,90,15446,2316,13156,N
2315,O,1043,1043,15344,1250,16696,2316,14301,O
2315,N,693,693,16037,510,17206,2316,15344,N
2315,O,657,657,16694,890,18096,2316,16037,O
2315,P,126,126,16820,3780,21876,2316,16694,P
2316,A,1395,1395,1395,1373,1373,2317,0,A
2316,B,201,201,1596,240,1613,2317,1395,B
2316,C,625,625,2221,850,2463,2317,1596,C
2316,B,1948,1948,4169,1785,4248,2317,2221,B
2316,C,3798,3798,7967,2820,7068,2317,4169,C
2316,D,350,350,8317,3960,11028,2317,7967,D
2316,M,109,109,8426,51,11079,2317,8317,M
2316,N,77,77,8503,180,11259,2317,8426,N
2316,O,126,126,8629,220,11479,2317,8503,O
2316,N,875,875,9504,775,12254,2317,8629,N
2316,O,5774,5774,15278,745,12999,2317,9504,O
2316,P,31645,31645,46923,4140,17139,2317,15278,P
2317,AE,4235,4235,4235,4820,4820,2318,0,E
2317,AF,4267,32,4267,4816,4816,2318,0,A
2317,BF,622,590,4857,90,4910,2318,4235,F
2317,BG,605,15,4872,90,4906,2318,4267,B
2317,CG,348,348,5220,765,5671,2318,4872,C
2317,DG,392,29,5249,765,5675,2318,4857,G
2317,DH,1176,1147,6396,3780,9451,2318,5220,D
2317,H,1377,230,6626,3780,9455,2318,5249,H
2317,M,2490,2490,9116,2829,12284,2318,6626,M
2317,N,697,697,9813,300,12584,2318,9116,N
2317,O,1046,1046,10859,1319,13903,2318,9813,O
2317,N,414,414,11273,366,14269,2318,10859,N
2317,O,1068,1068,12341,1260,15529,2318,11273,O
2317,P,422,422,12763,3960,19489,2318,12341,P
2318,AE,204,204,204,1285,1285,2319,0,E
2318,AF,507,303,507,1397,1397,2319,0,A
2318,BF,1111,808,1315,90,1375,2319,204,F
2318,BG,920,112,1427,90,1487,2319,507,B
2318,CG,927,815,2242,1240,2615,2319,1315,G
2318,CH,882,67,2309,1200,2687,2319,1427,C
2318,DH,101,101,2410,3780,6467,2319,2309,D
2318,H,2950,2782,5192,3780,6395,2319,2242,H
2318,M,1731,1731,6923,2480,8947,2319,5192,M
2318,N,783,783,7706,90,9037,2319,6923,N
2318,O,155,155,7861,585,9622,2319,7706,O
2318,P,7060,7060,14921,3780,13402,2319,7861,P
2319,A,583,583,583,1815,1815,2320,0,A
2319,B,1511,1511,2094,300,2115,2320,583,B
2319,C,848,848,2942,895,3010,2320,2094,C
2319,D,1333,1333,4275,2760,5770,2320,2942,D
2319,M,216,216,4491,875,6645,2320,4275,M
2319,N,915,915,5406,300,6945,2320,4491,N
2319,O,951,951,6357,930,7875,2320,5406,O
2319,P,1274,1274,7631,2760,10635,2320,6357,P
2320,AE,19,19,19,957,957,2321,0,E
2320,AF,1116,1116,1135,240,1197,2321,19,F
2320,AG,462,462,1597,760,1957,2321,1135,G
2320,AH,1036,1036,2633,3540,5497,2321,1597,H
2320,A,3566,933,3566,3764,3764,2321,0,A
2320,B,602,602,4168,180,3944,2321,3566,B
2320,C,3113,3113,7281,880,4824,2321,4168,C
2320,D,1713,1713,8994,6660,11484,2321,7281,D
2320,M,4374,4374,13368,5412,16896,2321,8994,M
2320,N,1158,1158,14526,180,17076,2321,13368,N
2320,O,1101,1101,15627,900,17976,2321,14526,O
2320,N,1364,1364,16991,1560,19536,2321,15627,N
2320,O,476,476,17467,715,20251,2321,16991,O
2320,P,4981,4981,22448,6840,27091,2321,17467,P
2321,A,22,22,22,102,102,2322,0,A
2321,B,185,185,207,150,252,2322,22,B
2321,C,115,115,322,115,367,2322,207,C
2321,D,585,585,907,4230,4597,2322,322,D
2321,M,111,111,1018,708,5305,2322,907,M
2321,N,699,699,1717,150,5455,2322,1018,N
2321,O,268,268,1985,410,5865,2322,1717,O
2321,N,199,199,2184,60,5925,2322,1985,N
2321,O,122,122,2306,245,6170,2322,2184,O
2321,P,1101,1101,3407,4110,10280,2322,2306,P
2322,AEI,289,289,289,298,298,2323,0,E
2322,AFI,390,101,390,757,757,2323,0,I
2322,AFJ,259,158,548,300,598,2323,289,F
2322,AGJ,633,85,633,2520,2520,2323,0,A
2322,BGJ,426,183,816,90,847,2323,390,J
2322,BGK,972,704,1520,965,1563,2323,548,G
2322,BHK,888,184,1704,1240,2087,2323,816,K
2322,BHL,373,189,1893,550,2113,2323,1520,H
2322,BL,2007,747,2640,180,2700,2323,633,B
2322,CL,1679,743,3383,3780,5867,2323,1704,L
2322,C,1231,488,3871,900,3600,2323,2640,C
2322,D,635,635,4506,550,4150,2323,3871,D
2322,M,1890,1890,6396,2339,8206,2323,4506,M
2322,N,551,551,6947,150,8356,2323,6396,N
2322,O,73,73,7020,50,8406,2323,6947,O
2322,N,100,100,7120,135,8541,2323,7020,N
2322,O,149,149,7269,235,8776,2323,7120,O
2322,P,177,177,7446,5280,14056,2323,7269,P
2323,AE,164,164,164,650,650,2324,0,E
2323,AF,248,84,248,362,362,2324,0,A
2323,BF,174,174,422,120,482,2324,248,B
2323,CF,662,404,826,240,890,2324,164,F
2323,CG,502,98,924,450,932,2324,422,C
2323,BG,345,247,1171,255,1145,2324,826,G
2323,BH,403,156,1327,475,1407,2324,924,B
2323,CH,565,565,1892,575,1982,2324,1327,C
2323,DH,1190,469,2361,5250,6395,2324,1171,H
2323,D,3077,2608,4969,385,2367,2324,1892,D
2323,M,877,877,5846,1147,7542,2324,4969,M
2323,N,595,595,6441,330,7872,2324,5846,N
2323,O,825,825,7266,952,8824,2324,6441,O
2323,P,556,556,7822,348,9172,2324,7266,P
2324,AEI,501,501,501,697,697,2325,0,E
2324,AFI,228,228,729,90,787,2325,501,F
2324,AGI,766,37,766,1320,1320,2325,0,I
2324,AGJ,381,344,1110,800,1587,2325,729,G
2324,AHJ,583,239,1349,90,1410,2325,766,J
2324,AHK,1521,172,1521,2251,2251,2325,0,A
2324,BHK,381,209,1730,800,2210,2325,1349,K
2324,BHL,758,549,2279,90,2341,2325,1521,B
2324,CHL,1428,259,2538,3780,5367,2325,1110,H
2324,CL,365,106,2644,795,3136,2325,2279,C
2324,DL,2460,1546,4190,3780,5990,2325,1730,L
2324,D,1845,299,4489,3780,6916,2325,2644,D
2324,M,469,469,4958,637,7553,2325,4489,M
2324,N,288,288,5246,180,7733,2325,4958,N
2324,O,738,738,5984,780,8513,2325,5246,O
2324,P,1905,1905,7889,550,9063,2325,5984,P
2325,AEI,44,44,44,197,197,2326,0,I
2325,AEJ,150,106,150,885,885,2326,0,A
2325,BEJ,356,250,400,240,437,2326,44,J
2325,BEK,229,229,629,280,717,2326,400,K
2325,BEL,829,350,979,150,1035,2326,150,B
2325,CEL,145,145,1124,120,1155,2326,979,C
2325,BEL,284,284,1408,290,1445,2326,1124,B
2325,CEL,175,175,1583,115,1560,2326,1408,C
2325,DEL,1378,424,2007,5160,5877,2326,629,L
2325,DE,1732,1308,3315,4230,5790,2326,1583,D
2325,E,3994,679,3994,3988,3988,2326,0,E
2325,F,75,75,4069,150,4138,2326,3994,F
2325,G,198,198,4267,285,4423,2326,4069,G
2325,H,801,801,5068,5160,9583,2326,4267,H
2325,M,2243,2243,7311,2864,12447,2326,5068,M
2325,N,685,685,7996,90,12537,2326,7311,N
2325,O,992,992,8988,1250,13787,2326,7996,O
2325,P,35,35,9023,3780,17567,2326,8988,P
2326,AEI,388,388,388,355,355,2327,0,E
2326,AFI,92,92,480,180,535,2327,388,F
2326,AGI,679,199,679,1864,1864,2327,0,A
2326,BGI,1283,604,1283,1725,1725,2327,0,I
2326,BGJ,1004,201,1484,965,1500,2327,480,G
2326,BHJ,679,478,1962,270,1995,2327,1283,J
2326,BHK,1670,387,2349,540,2404,2327,679,B
2326,CHK,1025,160,2509,385,1885,2327,1484,H
2326,CK,816,269,2778,810,2805,2327,1962,K
2326,CL,848,419,3197,795,3199,2327,2349,C
2326,DL,323,323,3520,550,3749,2327,3197,D
2326,L,3615,2873,6393,550,3355,2327,2778,L
2326,M,937,937,7330,2097,5846,2327,6393,M
2326,N,1517,1517,8847,420,6266,2327,7330,N
2326,O,815,815,9662,920,7186,2327,8847,O
2326,P,3816,3816,13478,775,7961,2327,9662,P
2327,A,3716,3716,3716,3829,3829,2328,0,A
2327,B,187,187,3903,90,3919,2328,3716,B
2327,C,647,647,4550,790,4709,2328,3903,C
2327,B,861,861,5411,760,5469,2328,4550,B
2327,C,418,418,5829,815,6284,2328,5411,C
2327,D,47700,47700,53529,3780,10064,2328,5829,D
2327,M,952,952,54481,2077,12141,2328,53529,M
2327,N,1157,1157,55638,90,12231,2328,54481,N
2327,O,569,569,56207,805,13036,2328,55638,O
2327,N,557,557,56764,315,13351,2328,56207,N
2327,O,623,623,57387,970,14321,2328,56764,O
2327,P,5781,5781,63168,3780,18101,2328,57387,P
2328,AEI,239,239,239,1348,1348,2329,0,I
2328,AEJ,1326,1326,1565,240,1588,2329,239,J
2328,AEK,1639,74,1639,2460,2460,2329,0,E
2328,AFK,288,214,1853,915,2503,2329,1565,K
2328,AFL,2548,695,2548,2679,2679,2329,0,A
2328,BFL,996,87,2635,180,2640,2329,1639,F
2328,BGL,161,74,2709,90,2769,2329,2548,B
2328,CGL,537,537,3246,820,3589,2329,2709,C
2328,BGL,1602,209,3455,3960,6463,2329,1853,L
2328,BG,915,95,3550,1055,3695,2329,2635,G
2328,BH,559,255,3805,275,3864,2329,3246,B
2328,CH,1514,1514,5319,2320,6184,2329,3805,C
2328,DH,3076,3076,8395,3420,9604,2329,5319,D
2328,H,9951,5106,13501,540,4235,2329,3550,H
2328,M,231,231,13732,1784,11388,2329,13501,M
2328,N,1673,1673,15405,180,11568,2329,13732,N
2328,O,1163,1163,16568,840,12408,2329,15405,O
2328,P,752,752,17320,660,13068,2329,16568,P
2329,A,986,986,986,1425,1425,2330,0,A
2329,B,879,879,1865,90,1515,2330,986,B
2329,C,899,899,2764,1250,2765,2330,1865,C
2329,D,208,208,2972,3780,6545,2330,2764,D
2329,M,364,364,3336,690,7235,2330,2972,M
2329,N,369,369,3705,90,7325,2330,3336,N
2329,O,510,510,4215,880,8205,2330,3705,O
2329,P,294,294,4509,3780,11985,2330,4215,P
2330,AEI,110,110,110,457,457,2331,0,A
2330,BEI,308,198,308,985,985,2331,0,E
2330,BFI,376,178,486,90,547,2331,110,B
2330,CFI,514,514,1000,850,1397,2331,486,C
2330,DFI,706,14,1014,90,1075,2331,308,F
2330,DGI,520,520,1534,845,1920,2331,1014,G
2330,DHI,672,138,1672,3780,5177,2331,1000,D
2330,HI,393,255,1927,3780,5700,2331,1534,H
2330,I,4872,2945,4872,7149,7149,2331,0,I
2330,J,2480,2480,7352,240,7389,2331,4872,J
2330,K,748,748,8100,860,8249,2331,7352,K
2330,L,4566,4566,12666,3960,12209,2331,8100,L
2330,M,134,134,12800,917,13126,2331,12666,M
2330,N,1066,1066,13866,300,13426,2331,12800,N
2330,O,1089,1089,14955,910,14336,2331,13866,O
2330,N,624,624,15579,865,15201,2331,14955,N
2330,O,577,577,16156,780,15981,2331,15579,O
2330,P,236,236,16392,3960,19941,2331,16156,P
2331,AE,214,214,214,444,444,2332,0,A
2331,BE,465,251,465,718,718,2332,0,E
2331,BF,263,12,477,90,534,2332,214,B
2331,CF,286,274,751,90,808,2332,465,F
2331,CG,1040,766,1517,1315,1849,2332,477,C
2331,DG,1127,361,1878,1315,2123,2332,751,G
2331,DH,101,101,1979,3780,5903,2332,1878,H
2331,D,703,241,2220,3780,5629,2332,1517,D
2331,M,1168,1168,3388,2222,8125,2332,2220,M
2331,N,1264,1264,4652,240,8365,2332,3388,N
2331,O,615,615,5267,960,9325,2332,4652,O
2331,P,3622,3622,8889,3840,13165,2332,5267,P
2332,A,3069,3069,3069,3345,3345,2333,0,A
2332,B,304,304,3373,90,3435,2333,3069,B
2332,C,717,717,4090,1130,4565,2333,3373,C
2332,D,174,174,4264,3780,8345,2333,4090,D
2332,M,4165,4165,8429,4825,13170,2333,4264,M
2332,N,693,693,9122,90,13260,2333,8429,N
2332,O,249,249,9371,695,13955,2333,9122,O
2332,P,10315,10315,19686,3780,17735,2333,9371,P
2333,AEI,157,157,157,1131,1131,2334,0,A
2333,BEI,622,465,622,2775,2775,2334,0,E
2333,BFI,1004,539,1161,90,1221,2334,157,B
2333,CFI,931,931,2092,1220,2441,2334,1161,C
2333,DFI,7,7,2099,3780,6221,2334,2092,D
2333,FI,2183,706,2805,90,2865,2334,622,F
2333,GI,1089,1089,3894,1355,4220,2334,2805,G
2333,HI,1993,1993,5887,3780,8000,2334,3894,H
2333,I,30774,24887,30774,31734,31734,2334,0,I
2333,J,990,990,31764,90,31824,2334,30774,J
2333,K,1044,1044,32808,1220,33044,2334,31764,K
2333,L,479,479,33287,3780,36824,2334,32808,L
2333,M,176,176,33463,500,37324,2334,33287,M
2333,N,374,374,33837,90,37414,2334,33463,N
2333,O,531,531,34368,845,38259,2334,33837,O
2333,P,379,379,34747,3780,42039,2334,34368,P
2334,AE,135,135,135,1138,1138,2335,0,A
2334,BE,175,40,175,311,311,2335,0,E
2334,BF,316,316,491,270,581,2335,175,F
2334,BG,1189,833,1324,240,1378,2335,135,B
2334,CG,829,829,2153,995,2373,2335,1324,C
2334,DG,181,181,2334,4680,7053,2335,2153,D
2334,G,2540,697,3031,2610,3191,2335,491,G
2334,F,1047,1047,4078,915,4106,2335,3031,F
2334,G,968,968,5046,1250,5356,2335,4078,G
2334,H,29,29,5075,335,5691,2335,5046,H
2334,M,1771,1771,6846,1922,8975,2335,5075,M
2334,N,195,195,7041,90,9065,2335,6846,N
2334,O,542,542,7583,800,9865,2335,7041,O
2334,N,349,349,7932,80,9945,2335,7583,N
2334,O,192,192,8124,605,10550,2335,7932,O
2334,P,10232,10232,18356,3840,14390,2335,8124,P
2335,A,470,470,470,1093,1093,2336,0,A
2335,B,748,748,1218,180,1273,2336,470,B
2335,C,251,251,1469,280,1553,2336,1218,C
2335,B,1523,1523,2992,1470,3023,2336,1469,B
2335,C,339,339,3331,740,3763,2336,2992,C
2335,B,496,496,3827,545,4308,2336,3331,B
2335,C,1131,1131,4958,840,5148,2336,3827,C
2335,D,14873,14873,19831,3900,9048,2336,4958,D
2335,M,316,316,20147,365,9413,2336,19831,M
2335,N,305,305,20452,300,9713,2336,20147,N
2335,O,657,657,21109,780,10493,2336,20452,O
2335,P,461,461,21570,1140,11633,2336,21109,P
2336,A,1759,1759,1759,2196,2196,2337,0,A
2336,B,584,584,2343,180,2376,2337,1759,B
2336,C,900,900,3243,930,3306,2337,2343,C
2336,D,4065,4065,7308,550,3856,2337,3243,D
2336,M,12659,12659,19967,13136,16992,2337,7308,M
2336,N,597,597,20564,180,17172,2337,19967,N
2336,O,690,690,21254,830,18002,2337,20564,O
2336,N,845,845,22099,705,18707,2337,21254,N
2336,O,653,653,22752,695,19402,2337,22099,O
2336,P,16919,16919,39671,6960,26362,2337,22752,P
2337,AEI,131,131,131,1140,1140,2338,0,E
2337,AFI,895,764,895,1141,1141,2338,0,A
2337,BFI,265,265,1160,90,1231,2338,895,B
2337,CFI,1129,100,1260,180,1320,2338,131,F
2337,CGI,419,319,1579,790,2021,2338,1160,C
2337,BGI,1809,230,1809,3322,3322,2338,0,I
2337,BGJ,934,385,2194,1055,2375,2338,1260,G
2337,BFJ,1881,1496,3690,420,3742,2338,1809,J
2337,BFK,2280,169,3859,1880,3901,2338,1579,B
2337,CFK,1695,30,3889,1555,3930,2338,2194,F
2337,CGK,592,562,4451,1130,5031,2338,3859,C
2337,DGK,786,25,4476,1046,4788,2338,3690,K
2337,DGL,702,115,4591,820,4750,2338,3889,G
2337,DHL,110,110,4701,5040,9790,2338,4591,H
2337,DL,1102,877,5578,1049,5837,2338,4476,L
2337,D,10425,9298,14876,3780,8811,2338,4451,D
2337,M,235,235,15111,385,10175,2338,14876,M
2337,N,336,336,15447,240,10415,2338,15111,N
2337,O,780,780,16227,970,11385,2338,15447,O
2337,N,748,748,16975,569,11954,2338,16227,N
2337,O,645,645,17620,661,12615,2338,16975,O
2337,P,5625,5625,23245,3960,16575,2338,17620,P
2338,AEI,711,711,711,1024,1024,2339,0,E
2338,AFI,370,370,1081,90,1114,2339,711,F
2338,AGI,1210,129,1210,1637,1637,2339,0,I
2338,AGJ,491,362,1572,815,1929,2339,1081,G
2338,AFJ,406,406,1978,105,2034,2339,1572,F
2338,AGJ,511,511,2489,805,2839,2339,1978,G
2338,AHJ,1867,588,3077,1500,3137,2339,1210,J
2338,AHK,733,733,3810,1000,4137,2339,3077,K
2338,AHJ,1328,1328,5138,1065,5202,2339,3810,J
2338,AHK,5401,263,5401,5545,5545,2339,0,A
2338,BHK,538,275,5676,740,5942,2339,5138,K
2338,BHL,374,99,5775,240,5785,2339,5401,B
2338,CHL,494,494,6269,880,6665,2339,5775,C
2338,DHL,689,689,6958,3960,10625,2339,6269,D
2338,HL,17760,13291,20249,3780,6619,2339,2489,H
2338,L,28336,13763,34012,5100,11042,2339,5676,L
2338,M,769,769,34781,1474,12516,2339,34012,M
2338,N,735,735,35516,90,12606,2339,34781,N
2338,O,494,494,36010,805,13411,2339,35516,O
2338,N,1387,1387,37397,1040,14451,2339,36010,N
2338,O,740,740,38137,1060,15511,2339,37397,O
2338,P,856,856,38993,3780,19291,2339,38137,P
2339,A,470,470,470,2759,2759,2340,0,A
2339,B,2326,2326,2796,90,2849,2340,470,B
2339,C,852,852,3648,1200,4049,2340,2796,C
2339,D,1739,1739,5387,3780,7829,2340,3648,D
2339,M,2034,2034,7421,2370,10199,2340,5387,M
2339,N,363,363,7784,90,10289,2340,7421,N
2339,O,286,286,8070,625,10914,2340,7784,O
2339,P,233,233,8303,3780,14694,2340,8070,P
2340,A,263,263,263,355,355,2341,0,A
2340,B,199,199,462,180,535,2341,263,B
2340,C,323,323,785,155,690,2341,462,C
2340,D,30,30,815,2880,3570,2341,785,D
2340,M,189,189,1004,265,3835,2341,815,M
2340,N,168,168,1172,150,3985,2341,1004,N
2340,O,80,80,1252,590,4575,2341,1172,O
2340,N,688,688,1940,175,4750,2341,1252,N
2340,O,122,122,2062,125,4875,2341,1940,O
2340,P,70,70,2132,2880,7755,2341,2062,P
2341,AEI,457,457,457,1793,1793,2342,0,A
2341,BEI,1956,1956,2413,90,1883,2342,457,B
2341,CEI,2765,352,2765,4093,4093,2342,0,E
2341,CFI,1055,703,3468,1370,3253,2342,2413,C
2341,DFI,230,230,3698,3780,7033,2342,3468,D
2341,FI,1365,432,4130,90,4183,2342,2765,F
2341,GI,956,956,5086,1225,5408,2342,4130,G
2341,HI,3,3,5089,3780,9188,2342,5086,H
2341,I,12848,7759,12848,13529,13529,2342,0,I
2341,J,730,730,13578,90,13619,2342,12848,J
2341,K,836,836,14414,1215,14834,2342,13578,K
2341,L,276,276,14690,3780,18614,2342,14414,L
2341,M,772,772,15462,1710,20324,2342,14690,M
2341,N,1432,1432,16894,530,20854,2342,15462,N
2341,O,1205,1205,18099,1215,22069,2342,16894,O
2341,P,2006,2006,20105,550,22619,2342,18099,P
2342,AE,47,47,47,240,240,2343,0,E
2342,AF,64,17,64,193,193,2343,0,A
2342,BF,200,200,264,135,328,2343,64,B
2342,CF,279,62,326,135,375,2343,47,F
2342,CG,187,125,451,285,613,2343,264,C
2342,DG,184,59,510,285,660,2343,326,G
2342,DH,105,105,615,5160,5820,2343,510,H
2342,D,224,60,675,5160,5773,2343,451,D
2342,M,2240,2240,2915,2736,8556,2343,675,M
2342,N,629,629,3544,180,8736,2343,2915,N
2342,O,791,791,4335,885,9621,2343,3544,O
2342,N,1517,1517,5852,1410,11031,2343,4335,N
2342,O,727,727,6579,635,11666,2343,5852,O
2342,P,1156,1156,7735,6960,18626,2343,6579,P
2343,AEI,680,680,680,1243,1243,2344,0,I
2343,AEJ,922,242,922,2118,2118,2344,0,E
2343,AFJ,585,343,1265,90,1333,2344,680,J
2343,AFK,1220,877,2142,90,2208,2344,922,F
2343,AGK,1039,162,2304,1250,2583,2344,1265,K
2343,AGL,7,7,2311,3780,6363,2344,2304,L
2343,AG,609,440,2751,805,3013,2344,2142,G
2343,AH,1307,1307,4058,4625,7638,2344,2751,H
2343,A,17613,13555,17613,18945,18945,2344,0,A
2343,B,1361,1361,18974,90,19035,2344,17613,B
2343,C,1104,1104,20078,1370,20405,2344,18974,C
2343,D,866,866,20944,3780,24185,2344,20078,D
2343,M,448,448,21392,795,24980,2344,20944,M
2343,N,407,407,21799,90,25070,2344,21392,N
2343,O,477,477,22276,880,25950,2344,21799,O
2343,P,319,319,22595,3780,29730,2344,22276,P
2344,AE,40,40,40,1299,1299,2345,0,E
2344,AF,1458,1458,1498,240,1539,2345,40,F
2344,AG,617,617,2115,620,2159,2345,1498,G
2344,AH,636,636,2751,6300,8459,2345,2115,H
2344,A,2932,181,2932,3825,3825,2345,0,A
2344,B,1004,1004,3936,150,3975,2345,2932,B
2344,C,773,773,4709,760,4735,2345,3936,C
2344,B,1145,1145,5854,1155,5890,2345,4709,B
2344,C,597,597,6451,595,6485,2345,5854,C
2344,D,4432,4432,10883,4140,10625,2345,6451,D
2344,M,110,110,10993,240,10865,2345,10883,M
2344,N,388,388,11381,300,11165,2345,10993,N
2344,O,437,437,11818,640,11805,2345,11381,O
2344,P,234,234,12052,1140,12945,2345,11818,P
2345,AE,722,722,722,1658,1658,2346,0,E
2345,AF,842,120,842,863,863,2346,0,A
2345,BF,321,321,1163,360,1223,2346,842,B
2345,CF,966,525,1688,90,1748,2346,722,F
2345,CG,735,210,1898,880,2103,2346,1163,C
2345,BG,1220,1220,3118,1060,3163,2346,1898,B
2345,CG,1452,22,3140,1040,2788,2346,1688,G
2345,CH,595,573,3713,677,3840,2346,3118,C
2345,DH,772,199,3912,3780,6568,2346,3140,H
2345,D,312,113,4025,373,4213,2346,3713,D
2345,M,2018,2018,6043,3134,9702,2346,4025,M
2345,N,1187,1187,7230,90,9792,2346,6043,N
2345,O,1229,1229,8459,1365,11157,2346,7230,O
2345,N,759,759,9218,665,11822,2346,8459,N
2345,O,218,218,9436,610,12432,2346,9218,O
2345,P,2742,2742,12178,3780,16212,2346,9436,P
2346,AEI,70,70,70,330,330,2347,0,A
2346,BEI,142,72,142,218,218,2347,0,I
2346,BEJ,164,22,164,265,265,2347,0,E
2346,BFJ,172,150,314,150,368,2347,142,J
2346,BFK,221,71,385,150,415,2347,164,F
2346,BGK,114,43,428,830,1198,2347,314,K
2346,BGL,410,52,480,180,510,2347,70,B
2346,CGL,118,23,503,830,1245,2347,385,G
2346,CHL,351,328,831,660,1170,2347,480,C
2346,BHL,609,281,1112,3490,4735,2347,503,H
2346,BL,690,6,1118,3490,4688,2347,428,L
2346,B,304,17,1135,20,1190,2347,831,B
2346,C,190,190,1325,280,1470,2347,1135,C
2346,D,2718,2718,4043,4050,5520,2347,1325,D
2346,M,423,423,4466,859,6379,2347,4043,M
2346,N,592,592,5058,150,6529,2347,4466,N
2346,O,198,198,5256,220,6749,2347,5058,O
2346,N,432,432,5688,460,7209,2347,5256,N
2346,O,633,633,6321,665,7874,2347,5688,O
2346,P,661,661,6982,4140,12014,2347,6321,P
2347,AE,42,42,42,136,136,2348,0,A
2347,BE,196,196,238,150,286,2348,42,B
2347,CE,198,198,436,745,1031,2348,238,C
2347,DE,417,417,853,3600,4631,2348,436,D
2347,E,1487,634,1487,1676,1676,2348,0,E
2347,F,305,305,1792,150,1826,2348,1487,F
2347,G,468,468,2260,455,2281,2348,1792,G
2347,F,205,205,2465,235,2516,2348,2260,F
2347,G,234,234,2699,115,2631,2348,2465,G
2347,H,1018,1018,3717,4230,6861,2348,2699,H
2347,M,3435,3435,7152,4353,11214,2348,3717,M
2347,N,950,950,8102,90,11304,2348,7152,N
2347,O,1063,1063,9165,1200,12504,2348,8102,O
2347,N,352,352,9517,205,12709,2348,9165,N
2347,O,219,219,9736,605,13314,2348,9517,O
2347,P,15660,15660,25396,3780,17094,2348,9736,P
2348,AEI,62,62,62,69,69,2349,0,I
2348,AEJ,89,27,89,168,168,2349,0,E
2348,AFJ,104,77,166,155,224,2349,62,J
2348,AFK,83,83,249,100,324,2349,166,K
2348,AFL,179,19,268,150,318,2349,89,F
2348,AGL,119,100,368,2880,3204,2349,249,L
2348,AG,119,19,387,120,438,2349,268,G
2348,AF,762,762,1149,755,1193,2349,387,F
2348,AG,146,146,1295,110,1303,2349,1149,G
2348,AH,1436,141,1436,1455,1455,2349,0,A
2348,BH,146,146,1582,150,1605,2349,1436,B
2348,CH,202,202,1784,155,1760,2349,1582,C
2348,BH,1152,1152,2936,1215,2975,2349,1784,B
2348,CH,121,121,3057,285,3260,2349,2936,C
2348,DH,45,45,3102,5100,8360,2349,3057,D
2348,DH,1807,0,3102,4230,5533,2349,1295,H
2348,M,484,484,3586,1414,9774,2349,3102,M
2348,N,960,960,4546,90,9864,2349,3586,N
2348,O,820,820,5366,1200,11064,2349,4546,O
2348,P,272,272,5638,3780,14844,2349,5366,P
2349,AEI,238,238,238,951,951,2350,0,E
2349,AFI,902,902,1140,240,1191,2350,238,F
2349,AGI,828,828,1968,995,2186,2350,1140,G
2349,AHI,2226,258,2226,2146,2146,2350,0,I
2349,AHJ,215,215,2441,330,2476,2350,2226,J
2349,AHK,775,775,3216,942,3418,2350,2441,K
2349,AHL,4456,1240,4456,4853,4853,2350,0,A
2349,BHL,468,468,4924,90,4943,2350,4456,B
2349,CHL,360,360,5284,795,5738,2350,4924,C
2349,DHL,874,874,6158,3780,9518,2350,5284,D
2349,HL,4584,394,6552,4680,6866,2350,1968,H
2349,L,6061,2725,9277,348,3766,2350,3216,L
2349,M,1782,1782,11059,2019,11537,2350,9277,M
2349,N,272,272,11331,90,11627,2350,11059,N
2349,O,415,415,11746,820,12447,2350,11331,O
2349,N,494,494,12240,90,12537,2350,11746,N
2349,O,142,142,12382,585,13122,2350,12240,O
2349,P,30022,30022,42404,3780,16902,2350,12382,P
2350,AEI,454,454,454,585,585,2351,0,A
2350,BEI,394,394,848,300,885,2351,454,B
2350,CEI,690,690,1538,740,1625,2351,848,C
2350,DEI,62,62,1600,1560,3185,2351,1538,D
2350,EI,13128,11528,13128,13135,13135,2351,0,E
2350,FI,13152,24,13152,13480,13480,2351,0,I
2350,FJ,262,238,13390,300,13435,2351,13128,F
2350,GJ,599,361,13751,300,13780,2351,13152,J
2350,GK,547,186,13937,735,14170,2351,13390,G
2350,HK,388,388,14325,1560,15730,2351,13937,H
2350,K,679,105,14430,740,14520,2351,13751,K
2350,L,25,25,14455,1560,16080,2351,14430,L
2350,M,4239,4239,18694,4559,20639,2351,14455,M
2350,N,645,645,19339,180,20819,2351,18694,N
2350,O,932,932,20271,1505,22324,2351,19339,O
2350,N,8173,8173,28444,6020,28344,2351,20271,N
2350,O,150,150,28594,735,29079,2351,28444,O
2350,P,4580,4580,33174,3720,32799,2351,28594,P
2351,A,198,198,198,1473,1473,2352,0,A
2351,B,1307,1307,1505,90,1563,2352,198,B
2351,C,1049,1049,2554,1255,2818,2352,1505,C
2351,D,151,151,2705,3780,6598,2352,2554,D
2351,M,4623,4623,7328,4715,11313,2352,2705,M
2351,N,121,121,7449,90,11403,2352,7328,N
2351,O,300,300,7749,705,12108,2352,7449,O
2351,P,2531,2531,10280,3780,15888,2352,7749,P
2352,AE,92,92,92,1470,1470,2353,0,E
2352,AF,860,768,860,1340,1340,2353,0,A
2352,BF,723,723,1583,300,1640,2353,860,B
2352,CF,1561,70,1653,240,1710,2353,92,F
2352,CG,713,713,2366,780,2490,2353,1653,G
2352,CH,935,152,2518,1045,2685,2353,1583,C
2352,DH,131,131,2649,1140,3825,2353,2518,D
2352,H,2907,2624,5273,7680,10170,2353,2366,H
2352,M,1185,1185,6458,1270,11440,2353,5273,M
2352,N,224,224,6682,180,11620,2353,6458,N
2352,O,586,586,7268,665,12285,2353,6682,O
2352,P,623,623,7891,4080,16365,2353,7268,P
2353,AEI,84,84,84,115,115,2354,0,E
2353,AFI,134,50,134,1577,1577,2354,0,A
2353,BFI,271,221,355,300,415,2354,84,F
2353,BGI,604,249,604,1677,1677,2354,0,I
2353,BGJ,931,682,1286,1139,1554,2354,355,G
2353,BFJ,308,308,1594,311,1865,2354,1286,F
2353,BGJ,1644,184,1778,240,1817,2354,134,B
2353,CGJ,1572,398,2176,555,2232,2354,604,J
2353,CGK,683,101,2277,765,2630,2354,1594,G
2353,CHK,922,423,2700,910,2727,2354,1778,C
2353,DHK,556,556,3256,550,3277,2354,2700,D
2353,HK,1253,173,3429,1235,3467,2354,2176,K
2353,HL,2382,2382,5811,550,4017,2354,3429,L
2353,H,7624,4090,9901,3960,6590,2354,2277,H
2353,M,2322,2322,12223,3049,9639,2354,9901,M
2353,N,1086,1086,13309,420,10059,2354,12223,N
2353,O,848,848,14157,956,11015,2354,13309,O
2353,P,3788,3788,17945,414,11429,2354,14157,P
2354,AE,43,43,43,306,306,2355,0,A
2354,BE,351,351,394,135,441,2355,43,B
2354,CE,209,209,603,295,736,2355,394,C
2354,DE,126,126,729,5100,5836,2355,603,D
2354,E,4454,3725,4454,5414,5414,2355,0,E
2354,F,989,989,5443,90,5504,2355,4454,F
2354,G,610,610,6053,905,6409,2355,5443,G
2354,F,1639,1639,7692,1325,7734,2355,6053,F
2354,G,1052,1052,8744,1465,9199,2355,7692,G
2354,H,734,734,9478,3780,12979,2355,8744,H
2354,M,701,701,10179,1140,14119,2355,9478,M
2354,N,1047,1047,11226,180,14299,2355,10179,N
2354,O,146,146,11372,895,15194,2355,11226,O
2354,N,366,366,11738,105,15299,2355,11372,N
2354,O,793,793,12531,660,15959,2355,11738,O
2354,P,1001,1001,13532,6660,22619,2355,12531,P
2355,AE,88,88,88,1093,1093,2356,0,E
2355,AF,371,283,371,989,989,2356,0,A
2355,BF,727,727,1098,150,1139,2356,371,B
2355,CF,174,174,1272,370,1509,2356,1098,C
2355,BF,1199,15,1287,240,1333,2356,88,F
2355,BG,491,476,1763,300,1809,2356,1272,B
2355,CG,866,390,2153,1020,2353,2356,1287,G
2355,CH,58,58,2211,4740,7093,2356,2153,H
2355,C,773,325,2536,660,2469,2356,1763,C
2355,D,1097,1097,3633,4230,6699,2356,2536,D
2355,M,1695,1695,5328,1900,8993,2356,3633,M
2355,N,249,249,5577,90,9083,2356,5328,N
2355,O,385,385,5962,800,9883,2356,5577,O
2355,N,491,491,6453,60,9943,2356,5962,N
2355,O,463,463,6916,790,10733,2356,6453,O
2355,P,1658,1658,8574,3780,14513,2356,6916,P
2356,A,44,44,44,1613,1613,2357,0,A
2356,B,1745,1745,1789,165,1778,2357,44,B
2356,C,608,608,2397,910,2688,2357,1789,C
2356,D,289,289,2686,3960,6648,2357,2397,D
2356,M,316,316,3002,321,6969,2357,2686,M
2356,N,116,116,3118,180,7149,2357,3002,N
2356,O,962,962,4080,1610,8759,2357,3118,O
2356,N,1722,1722,5802,705,9464,2357,4080,N
2356,O,2752,2752,8554,3360,12824,2357,5802,O
2356,P,1841,1841,10395,9660,22484,2357,8554,P
2357,AEI,36,36,36,10,10,2358,0,A
2357,BEI,194,158,194,1385,1385,2358,0,I
2357,BEJ,214,56,250,300,310,2358,36,B
2357,CEJ,492,242,492,864,864,2358,0,E
2357,CFJ,449,207,699,690,1000,2358,250,C
2357,BFJ,674,467,1166,360,1224,2358,492,F
2357,BGJ,661,194,1360,390,1390,2358,699,B
2357,CGJ,1347,181,1541,180,1565,2358,194,J
2357,CGK,593,412,1953,750,2140,2358,1360,C
2357,DGK,466,54,2007,585,2150,2358,1541,K
2357,DGL,1088,247,2254,1125,2349,2358,1166,G
2357,DFL,458,458,2712,425,2774,2358,2254,F
2357,DGL,197,197,2909,120,2894,2358,2712,G
2357,DHL,202,202,3111,550,3444,2358,2909,H
2357,DL,1982,878,3989,6960,9110,2358,2007,L
2357,D,4930,2894,6883,3960,6100,2358,1953,D
2357,M,432,432,7315,1097,10207,2358,6883,M
2357,N,752,752,8067,150,10357,2358,7315,N
2357,O,65,65,8132,50,10407,2358,8067,O
2357,N,123,123,8255,135,10542,2358,8132,N
2357,O,161,161,8416,295,10837,2358,8255,O
2357,P,1355,1355,9771,5160,15997,2358,8416,P
2358,A,261,261,261,1293,1293,2359,0,A
2358,B,1060,1060,1321,90,1383,2359,261,B
2358,C,986,986,2307,1210,2593,2359,1321,C
2358,D,39,39,2346,3780,6373,2359,2307,D
2358,M,686,686,3032,1313,7686,2359,2346,M
2358,N,683,683,3715,90,7776,2359,3032,N
2358,O,698,698,4413,1080,8856,2359,3715,O
2358,P,3673,3673,8086,3780,12636,2359,4413,P
2359,AEI,4702,4702,4702,5652,5652,2360,0,I
2359,AEJ,1309,1309,6011,420,6072,2360,4702,J
2359,AEK,951,951,6962,1094,7166,2360,6011,K
2359,AEL,7129,167,7129,8424,8424,2360,0,A
2359,BEL,850,683,7812,351,7517,2360,6962,L
2359,BE,1340,657,8469,120,8544,2360,7129,B
2359,CE,323,323,8792,420,8964,2360,8469,C
2359,BE,576,576,9368,465,9429,2360,8792,B
2359,CE,9998,630,9998,10327,10327,2360,0,E
2359,CF,866,236,10234,970,10399,2360,9368,C
2359,DF,359,123,10357,90,10417,2360,9998,F
2359,DG,697,574,10931,5220,15619,2360,10234,D
2359,G,1135,561,11492,1534,11951,2360,10357,G
2359,H,30,30,11522,3780,15731,2360,11492,H
2359,M,9,9,11531,420,16151,2360,11522,M
2359,N,561,561,12092,240,16391,2360,11531,N
2359,O,862,862,12954,996,17387,2360,12092,O
2359,P,2315,2315,15269,5280,22667,2360,12954,P
2360,A,923,923,923,3923,3923,2361,0,A
2360,B,3481,3481,4404,420,4343,2361,923,B
2360,C,945,945,5349,1250,5593,2361,4404,C
2360,D,318,318,5667,335,5928,2361,5349,D
2360,M,2520,2520,8187,2613,8541,2361,5667,M
2360,N,120,120,8307,90,8631,2361,8187,N
2360,O,455,455,8762,800,9431,2361,8307,O
2360,N,1098,1098,9860,745,10176,2361,8762,N
2360,O,206,206,10066,605,10781,2361,9860,O
2360,P,7371,7371,17437,3780,14561,2361,10066,P
2361,AEI,117,117,117,198,198,2362,0,E
2361,AFI,273,156,273,1221,1221,2362,0,I
2361,AFJ,197,41,314,150,348,2362,117,F
2361,AGJ,179,179,493,160,508,2362,314,G
2361,AFJ,311,311,804,335,843,2362,493,F
2361,AGJ,124,124,928,125,968,2362,804,G
2361,AHJ,1134,206,1134,1474,1474,2362,0,A
2361,BHJ,1047,186,1320,150,1371,2362,273,J
2361,BHK,179,179,1499,190,1561,2362,1320,K
2361,BHJ,437,72,1571,150,1624,2362,1134,B
2361,CHJ,690,47,1618,4230,5198,2362,928,H
2361,CJ,171,124,1742,165,1789,2362,1571,C
2361,BJ,1056,813,2555,1040,2601,2362,1499,J
2361,BK,834,21,2576,830,2619,2362,1742,B
2361,CK,99,78,2654,125,2726,2362,2555,K
2361,CL,123,45,2699,130,2749,2362,2576,C
2361,DL,351,351,3050,4230,6979,2362,2699,D
2361,L,1410,1014,4064,4230,6956,2362,2654,L
2361,M,393,393,4457,1511,8490,2362,4064,M
2361,N,1218,1218,5675,150,8640,2362,4457,N
2361,O,148,148,5823,125,8765,2362,5675,O
2361,N,1500,1500,7323,1515,10280,2362,5823,N
2361,O,675,675,7998,675,10955,2362,7323,O
2361,P,17355,17355,25353,4290,15245,2362,7998,P
2362,A,2803,2803,2803,3250,3250,2363,0,A
2362,B,705,705,3508,300,3550,2363,2803,B
2362,C,492,492,4000,1965,5515,2363,3508,C
2362,D,1546,1546,5546,2760,8275,2363,4000,D
2362,M,36242,36242,41788,37142,45417,2363,5546,M
2362,N,930,930,42718,90,45507,2363,41788,N
2362,O,1008,1008,43726,1240,46747,2363,42718,O
2362,P,11,11,43737,3780,50527,2363,43726,P
2363,AEI,107,107,107,1136,1136,2364,0,A
2363,BEI,548,441,548,1380,1380,2364,0,E
2363,BFI,1059,618,1166,90,1226,2364,107,B
2363,CFI,1225,59,1225,1607,1607,2364,0,I
2363,CFJ,942,265,1490,90,1470,2364,548,F
2363,CGJ,406,141,1631,90,1697,2364,1225,J
2363,CGK,423,282,1913,855,2325,2364,1490,G
2363,CHK,1034,287,2200,1220,2446,2364,1166,C
2363,DHK,844,275,2475,1025,2722,2364,1631,K
2363,DHL,382,107,2582,3780,6226,2364,2200,D
2363,HL,124,17,2599,3780,6502,2364,2475,L
2363,H,816,130,2729,3780,6105,2364,1913,H
2363,M,767,767,3496,1123,7625,2364,2729,M
2363,N,395,395,3891,90,7715,2364,3496,N
2363,O,362,362,4253,705,8420,2364,3891,O
2363,P,1055,1055,5308,3780,12200,2364,4253,P
2364,AEI,218,218,218,1650,1650,2365,0,E
2364,AFI,228,10,228,891,891,2365,0,A
2364,BFI,314,86,314,849,849,2365,0,I
2364,BFJ,631,631,945,150,999,2365,314,J
2364,BFK,753,36,981,150,1041,2365,228,B
2364,CFK,139,103,1084,120,1119,2365,945,K
2364,CFJ,216,113,1197,120,1161,2365,981,C
2364,BFJ,544,431,1628,550,1669,2365,1084,J
2364,BFK,1708,298,1926,300,1950,2365,218,F
2364,BGK,768,470,2396,665,2334,2365,1628,K
2364,BGL,1437,238,2634,1515,2676,2365,1197,B
2364,CGL,930,222,2856,1000,2950,2365,1926,G
2364,CHL,482,482,3338,1200,4150,2365,2856,H
2364,CL,825,121,3459,1020,3696,2365,2634,C
2364,DL,1125,62,3521,4230,6564,2365,2396,L
2364,D,14897,14835,18356,4740,8436,2365,3459,D
2364,M,5014,5014,23370,5188,13624,2365,18356,M
2364,N,185,185,23555,90,13714,2365,23370,N
2364,O,510,510,24065,795,14509,2365,23555,O
2364,N,1394,1394,25459,1095,15604,2365,24065,N
2364,O,740,740,26199,1155,16759,2365,25459,O
2364,P,60,60,26259,3780,20539,2365,26199,P
2365,A,156,156,156,821,821,2366,0,A
2365,B,739,739,895,135,956,2366,156,B
2365,C,245,245,1140,300,1256,2366,895,C
2365,D,81,81,1221,5100,6356,2366,1140,D
2365,M,383,383,1604,954,7310,2366,1221,M
2365,N,731,731,2335,180,7490,2366,1604,N
2365,O,580,580,2915,895,8385,2366,2335,O
2365,N,380,380,3295,105,8490,2366,2915,N
2365,O,618,618,3913,660,9150,2366,3295,O
2365,P,1401,1401,5314,6660,15810,2366,3913,P
2366,AEI,132,132,132,300,300,2367,0,A
2366,BEI,475,343,475,1362,1362,2367,0,E
2366,BFI,345,2,477,240,540,2367,132,B
2366,CFI,636,636,1113,745,1285,2367,477,C
2366,BFI,1294,181,1294,1333,1333,2367,0,I
2366,BFJ,946,127,1421,90,1452,2367,475,F
2366,BGJ,245,118,1539,240,1573,2367,1294,J
2366,BGK,436,10,1549,325,1610,2367,1113,B
2366,CGK,132,132,1681,195,1805,2367,1549,C
2366,DGK,559,299,1980,960,2412,2367,1421,G
2366,DFK,732,433,2413,5220,7025,2367,1681,D
2366,FK,1202,328,2741,740,2313,2367,1539,K
2366,FJ,767,6,2747,390,2802,2367,1980,F
2366,GJ,520,514,3261,1000,3313,2367,2741,J
2366,GK,399,399,3660,510,3823,2367,3261,K
2366,GL,110,110,3770,3960,7783,2367,3660,L
2366,G,1284,261,4031,1390,4192,2367,2747,G
2366,H,543,543,4574,3780,7972,2367,4031,H
2366,M,10620,10620,15194,11464,19436,2367,4574,M
2366,N,876,876,16070,90,19526,2367,15194,N
2366,O,1224,1224,17294,1430,20956,2367,16070,O
2366,N,772,772,18066,560,21516,2367,17294,N
2366,O,155,155,18221,585,22101,2367,18066,O
2366,P,3004,3004,21225,3780,25881,2367,18221,P
2367,A,1085,1085,1085,1573,1573,2368,0,A
2367,B,694,694,1779,270,1843,2368,1085,B
2367,C,535,535,2314,735,2578,2368,1779,C
2367,B,1867,1867,4181,1685,4263,2368,2314,B
2367,C,1311,1311,5492,1320,5583,2368,4181,C
2367,D,11035,11035,16527,6060,11643,2368,5492,D
2367,M,4303,4303,20830,4106,15749,2368,16527,M
2367,N,66,66,20896,300,16049,2368,20830,N
2367,O,691,691,21587,840,16889,2368,20896,O
2367,P,1641,1641,23228,4080,20969,2368,21587,P
2368,A,326,326,326,402,402,2369,0,A
2368,B,225,225,551,180,582,2369,326,B
2368,C,622,622,1173,725,1307,2369,551,C
2368,D,275,275,1448,4200,5507,2369,1173,D
2368,M,1651,1651,3099,2523,8030,2369,1448,M
2368,N,923,923,4022,90,8120,2369,3099,N
2368,O,504,504,4526,855,8975,2369,4022,O
2368,P,333,333,4859,3780,12755,2369,4526,P
2369,AE,230,230,230,1260,1260,2370,0,E
2369,AF,400,170,400,1315,1315,2370,0,A
2369,BF,1309,1139,1539,300,1560,2370,230,F
2369,BG,1226,87,1626,300,1615,2370,400,B
2369,CG,634,547,2173,805,2365,2370,1539,G
2369,CH,597,50,2223,2185,3800,2370,1626,C
2369,DH,163,113,2336,4020,6385,2370,2173,H
2369,D,3324,3211,5547,2760,6560,2370,2223,D
2369,M,298,298,5845,353,6913,2370,5547,M
2369,N,210,210,6055,180,7093,2370,5845,N
2369,O,638,638,6693,875,7968,2370,6055,O
2369,P,116,116,6809,6680,14648,2370,6693,P
2370,AE,273,273,273,631,631,2371,0,A
2370,BE,524,251,524,685,685,2371,0,E
2370,BF,387,136,660,90,721,2371,273,B
2370,CF,348,212,872,240,925,2371,524,F
2370,CG,760,548,1420,1240,1961,2371,660,C
2370,DG,697,149,1569,910,1835,2371,872,G
2370,DH,2243,2243,3812,4020,5855,2371,1569,H
2370,D,3273,881,4693,3780,5741,2371,1420,D
2370,M,362,362,5055,805,6660,2371,4693,M
2370,N,592,592,5647,180,6840,2371,5055,N
2370,O,755,755,6402,205,7045,2371,5647,O
2370,N,163,163,6565,725,7770,2371,6402,N
2370,O,132,132,6697,600,8370,2371,6565,O
2370,P,603,603,7300,3750,12120,2371,6697,P
2371,A,526,526,526,792,792,2372,0,A
2371,B,447,447,973,180,972,2372,526,B
2371,C,923,923,1896,930,1902,2372,973,C
2371,D,2992,2992,4888,550,2452,2372,1896,D
2371,M,18598,18598,23486,19166,21618,2372,4888,M
2371,N,700,700,24186,180,21798,2372,23486,N
2371,O,1359,1359,25545,830,22628,2372,24186,O
2371,P,8094,8094,33639,6680,29308,2372,25545,P
2372,AE,423,423,423,338,338,2373,0,A
2372,BE,111,111,534,240,578,2373,423,B
2372,CE,730,730,1264,2040,2618,2373,534,C
2372,BE,1838,1838,3102,210,2828,2373,1264,B
2372,CE,3451,349,3451,5267,5267,2373,0,E
2372,CF,407,407,3858,90,5357,2373,3451,F
2372,CG,468,468,4326,805,6162,2373,3858,G
2372,CF,1366,142,4468,2340,5168,2373,3102,C
2372,BF,2613,2613,7081,1955,7123,2373,4468,B
2372,CF,732,732,7813,920,8043,2373,7081,C
2372,DF,3624,137,7950,1330,7492,2373,4326,F
2372,DG,1369,1369,9319,1885,9377,2373,7950,G
2372,DH,1448,1448,10767,3780,13157,2373,9319,H
2372,D,11057,8103,18870,3960,12003,2373,7813,D
2372,M,689,689,19559,2343,15500,2373,18870,M
2372,N,1684,1684,21243,90,15590,2373,19559,N
2372,O,2651,2651,23894,2105,17695,2373,21243,O
2372,N,583,583,24477,1110,18805,2373,23894,N
2372,O,540,540,25017,735,19540,2373,24477,O
2372,P,6474,6474,31491,3780,23320,2373,25017,P
2373,AEI,47,47,47,121,121,2374,0,E
2373,AFI,108,61,108,808,808,2374,0,A
2373,BFI,151,90,198,135,256,2374,47,F
2373,BGI,355,157,355,410,410,2374,0,I
2373,BGJ,209,52,407,295,551,2374,198,G
2373,BHJ,128,128,535,5100,5651,2374,407,H
2373,BJ,373,193,728,300,710,2374,355,J
2373,BK,782,162,890,135,943,2374,108,B
2373,CK,166,166,1056,300,1243,2374,890,C
2373,DK,119,119,1175,5100,6343,2374,1056,D
2373,K,682,235,1410,835,1545,2374,728,K
2373,J,690,690,2100,595,2140,2374,1410,J
2373,K,563,563,2663,680,2820,2374,2100,K
2373,L,543,543,3206,1140,3960,2374,2663,L
2373,M,714,714,3920,1224,7567,2374,3206,M
2373,N,838,838,4758,180,7747,2374,3920,N
2373,O,602,602,5360,895,8642,2374,4758,O
2373,N,160,160,5520,75,8717,2374,5360,N
2373,O,1265,1265,6785,420,9137,2374,5520,O
2373,P,6676,6676,13461,7020,16157,2374,6785,P
2374,AE,106,106,106,192,192,2375,0,A
2374,BE,262,262,368,240,432,2375,106,B
2374,CE,805,805,1173,830,1262,2375,368,C
2374,DE,212,212,1385,5400,6662,2375,1173,D
2374,E,4357,2972,4357,4652,4652,2375,0,E
2374,F,410,410,4767,180,4832,2375,4357,F
2374,G,1196,1196,5963,1240,6072,2375,4767,G
2374,F,364,364,6327,315,6387,2375,5963,F
2374,G,437,437,6764,565,6952,2375,6327,G
2374,H,4152,4152,10916,6960,13912,2375,6764,H
2374,M,2913,2913,13829,3220,17132,2375,10916,M
2374,N,1077,1077,14906,90,17222,2375,13829,N
2374,O,323,323,15229,715,17937,2375,14906,O
2374,P,860,860,16089,3780,21717,2375,15229,P
2375,AE,176,176,176,110,110,2376,0,A
2375,BE,183,183,359,240,350,2376,176,B
2375,CE,506,506,865,120,470,2376,359,C
2375,DE,257,257,1122,4230,4700,2376,865,D
2375,E,1371,249,1371,1616,1616,2376,0,E
2375,F,344,344,1715,150,1766,2376,1371,F
2375,G,559,559,2274,585,2351,2376,1715,G
2375,F,451,451,2725,400,2751,2376,2274,F
2375,G,127,127,2852,1050,3801,2376,2725,G
2375,H,1432,1432,4284,3300,7101,2376,2852,H
2375,M,45,45,4329,800,7901,2376,4284,M
2375,N,852,852,5181,150,8051,2376,4329,N
2375,O,254,254,5435,125,8176,2376,5181,O
2375,N,259,259,5694,355,8531,2376,5435,N
2375,O,847,847,6541,809,9340,2376,5694,O
2375,P,3025,3025,9566,3840,13180,2376,6541,P
2376,A,285,285,285,1265,1265,2377,0,A
2376,B,1264,1264,1549,300,1565,2377,285,B
2376,C,643,643,2192,805,2370,2377,1549,C
2376,D,368,368,2560,4140,6510,2377,2192,D
2376,M,10249,10249,12809,11279,17789,2377,2560,M
2376,N,1237,1237,14046,240,18029,2377,12809,N
2376,O,1473,1473,15519,2880,20909,2377,14046,O
2376,P,462,462,15981,2400,23309,2377,15519,P
2377,AE,168,168,168,1534,1534,2378,0,A
2377,BE,319,151,319,331,331,2378,0,E
2377,BF,191,191,510,240,571,2378,319,F
2377,BG,169,169,679,240,811,2378,510,G
2377,BH,685,685,1364,5250,6061,2378,679,H
2377,B,1748,552,1916,420,1954,2378,168,B
2377,C,1011,1011,2927,1015,2969,2378,1916,C
2377,D,1949,1949,4876,550,3519,2378,2927,D
2377,M,776,776,5652,2980,9041,2378,4876,M
2377,N,2582,2582,8234,420,9461,2378,5652,N
2377,O,1341,1341,9575,2205,11666,2378,8234,O
2377,P,400,400,9975,1740,13406,2378,9575,P
2378,A,1382,1382,1382,1384,1384,2379,0,A
2378,B,174,174,1556,240,1624,2379,1382,B
2378,C,128,128,1684,265,1889,2379,1556,C
2378,B,903,903,2587,755,2644,2379,1684,B
2378,C,847,847,3434,1020,3664,2379,2587,C
2378,D,11384,11384,14818,4680,8344,2379,3434,D
2378,M,1846,1846,16664,2167,10511,2379,14818,M
2378,N,379,379,17043,90,10601,2379,16664,N
2378,O,486,486,17529,795,11396,2379,17043,O
2378,N,417,417,17946,140,11536,2379,17529,N
2378,O,458,458,18404,735,12271,2379,17946,O
2378,P,14131,14131,32535,3780,16051,2379,18404,P
2379,A,189,189,189,305,305,2380,0,A
2379,B,236,236,425,180,485,2380,189,B
2379,C,437,437,862,660,1145,2380,425,C
2379,D,3286,3286,4148,4080,5225,2380,862,D
2379,M,147,147,4295,874,6099,2380,4148,M
2379,N,820,820,5115,150,6249,2380,4295,N
2379,O,192,192,5307,170,6419,2380,5115,O
2379,P,33,33,5340,2880,9299,2380,5307,P
2380,AEI,163,163,163,741,741,2381,0,E
2380,AFI,895,732,895,1441,1441,2381,0,I
2380,AFJ,758,26,921,240,981,2381,163,F
2380,AGJ,254,254,1175,255,1236,2381,921,G
2380,AHJ,666,386,1561,180,1621,2381,895,J
2380,AHK,697,697,2258,765,2386,2381,1561,K
2380,AHL,4549,3466,5724,5250,6486,2381,1175,H
2380,AL,8768,3044,8768,9105,9105,2381,0,A
2380,BL,6679,169,8937,550,2936,2381,2258,L
2380,B,626,457,9394,300,9405,2381,8768,B
2380,C,838,838,10232,890,10295,2381,9394,C
2380,D,982,982,11214,310,10605,2381,10232,D
2380,M,564,564,11778,2253,12858,2381,11214,M
2380,N,2085,2085,13863,420,13278,2381,11778,N
2380,O,863,863,14726,676,13954,2381,13863,O
2380,P,3278,3278,18004,769,14723,2381,14726,P
2381,AEI,60,60,60,141,141,2382,0,A
2381,BEI,76,16,76,186,186,2382,0,E
2381,BFI,266,250,326,240,381,2382,60,B
2381,CFI,293,43,369,240,426,2382,76,F
2381,CGI,222,179,548,285,666,2382,326,C
2381,DGI,418,239,787,285,711,2382,369,G
2381,DHI,422,422,1209,5160,5871,2382,787,H
2381,DI,702,41,1250,5160,5826,2382,548,D
2381,I,1748,498,1748,2310,2310,2382,0,I
2381,J,592,592,2340,90,2400,2382,1748,J
2381,K,596,596,2936,820,3220,2382,2340,K
2381,J,4533,4533,7469,4285,7505,2382,2936,J
2381,K,1252,1252,8721,1405,8910,2382,7469,K
2381,L,2626,2626,11347,3780,12690,2382,8721,L
2381,M,728,728,12075,583,13273,2382,11347,M
2381,N,155,155,12230,360,13633,2382,12075,N
2381,O,1153,1153,13383,1495,15128,2382,12230,O
2381,N,2911,2911,16294,2555,17683,2382,13383,N
2381,O,1005,1005,17299,1190,18873,2382,16294,O
2381,P,18,18,17317,665,19538,2382,17299,P
2382,AEI,422,422,422,1356,1356,2383,0,E
2382,AFI,853,431,853,1161,1161,2383,0,A
2382,BFI,358,358,1211,90,1251,2383,853,B
2382,CFI,964,175,1386,90,1446,2383,422,F
2382,CGI,887,712,2098,1250,2501,2383,1211,C
2382,DGI,783,71,2169,1200,2646,2383,1386,G
2382,DHI,72,1,2170,3780,6281,2383,2098,D
2382,HI,359,358,2528,3780,6426,2383,2169,H
2382,I,3296,768,3296,6780,6780,2383,0,I
2382,J,4325,4325,7621,90,6870,2383,3296,J
2382,K,1157,1157,8778,1410,8280,2383,7621,K
2382,L,1080,1080,9858,3780,12060,2383,8778,L
2382,M,1541,1541,11399,2300,14360,2383,9858,M
2382,N,806,806,12205,150,14510,2383,11399,N
2382,O,570,570,12775,800,15310,2383,12205,O
2382,P,2733,2733,15508,3780,19090,2383,12775,P
2383,AEI,75,75,75,986,986,2384,0,A
2383,BEI,90,15,90,424,424,2384,0,E
2383,BFI,452,452,542,180,604,2384,90,F
2383,BGI,820,278,820,926,926,2384,0,I
2383,BGJ,304,304,1124,180,1106,2384,820,J
2383,BGK,1099,50,1174,240,1226,2384,75,B
2383,CGK,761,129,1303,855,1459,2384,542,G
2383,CFK,473,344,1647,760,1986,2384,1174,C
2383,DFK,997,474,2121,880,1986,2384,1124,K
2383,DFL,919,445,2566,3540,5526,2384,1647,D
2383,FL,1358,95,2661,1245,2704,2384,1303,F
2383,GL,483,483,3144,760,3464,2384,2661,G
2383,HL,2422,1399,4543,6660,8646,2384,2121,L
2383,H,2336,937,5480,3540,7004,2384,3144,H
2383,M,1528,1528,7008,3318,11964,2384,5480,M
2383,N,1996,1996,9004,240,12204,2384,7008,N
2383,O,727,727,9731,825,13029,2384,9004,O
2383,N,1081,1081,10812,1025,14054,2384,9731,N
2383,O,607,607,11419,780,14834,2384,10812,O
2383,P,1126,1126,12545,3960,18794,2384,11419,P
2384,AE,14,14,14,217,217,2385,0,A
2384,BE,97,83,97,162,162,2385,0,E
2384,BF,139,139,236,135,297,2385,97,F
2384,BG,281,59,295,135,352,2385,14,B
2384,CG,194,135,430,285,582,2385,236,G
2384,CH,191,56,486,280,632,2385,295,C
2384,DH,144,144,630,5160,5792,2385,486,D
2384,H,233,33,663,5160,5742,2385,430,H
2384,M,1453,1453,2116,2296,8088,2385,663,M
2384,N,977,977,3093,180,8268,2385,2116,N
2384,O,778,778,3871,885,9153,2385,3093,O
2384,N,1187,1187,5058,1085,10238,2385,3871,N
2384,O,483,483,5541,760,10998,2385,5058,O
2384,P,224,224,5765,1140,12138,2385,5541,P
2385,AE,211,211,211,212,212,2386,0,E
2385,AF,91,91,302,150,362,2386,211,F
2385,AG,631,631,933,665,1027,2386,302,G
2385,AH,170,170,1103,385,1412,2386,933,H
2385,A,1697,594,1697,2238,2238,2386,0,A
2385,B,907,907,2604,420,2658,2386,1697,B
2385,C,981,981,3585,975,3633,2386,2604,C
2385,D,2041,2041,5626,550,4183,2386,3585,D
2385,M,634,634,6260,1441,5624,2386,5626,M
2385,N,1110,1110,7370,330,5954,2386,6260,N
2385,O,1680,1680,9050,1950,7904,2386,7370,O
2385,P,8,8,9058,975,8879,2386,9050,P
2386,AE,51,51,51,1176,1176,2387,0,E
2386,AF,62,11,62,1356,1356,2387,0,A
2386,BF,1247,1236,1298,135,1311,2387,51,F
2386,BG,1381,145,1443,135,1491,2387,62,B
2386,CG,803,658,2101,890,2201,2387,1298,G
2386,CH,760,102,2203,890,2381,2387,1443,C
2386,DH,1541,1541,3744,5160,7541,2387,2203,D
2386,H,6026,4383,8127,5160,7361,2387,2101,H
2386,M,3086,3086,11213,3232,10773,2387,8127,M
2386,N,178,178,11391,90,10863,2387,11213,N
2386,O,843,843,12234,1145,12008,2387,11391,O
2386,N,792,792,13026,450,12458,2387,12234,N
2386,O,933,933,13959,950,13408,2387,13026,O
2386,P,940,940,14899,3780,17188,2387,13959,P
2387,AEI,67,67,67,90,90,2388,0,A
2387,BEI,156,156,223,180,270,2388,67,B
2387,CEI,324,101,324,450,450,2388,0,I
2387,CEJ,143,42,366,265,535,2388,223,C
2387,BEJ,231,189,555,160,610,2388,324,J
2387,BEK,91,91,646,75,685,2388,555,K
2387,BEJ,561,281,927,445,980,2388,366,B
2387,CEJ,83,83,1010,85,1065,2388,927,C
2387,DEJ,167,167,1177,5060,6125,2388,1010,D
2387,EJ,762,231,1408,780,1465,2388,646,J
2387,EK,1483,75,1483,1802,1802,2388,0,E
2387,FK,110,35,1518,85,1550,2388,1408,K
2387,FL,291,291,1809,2900,4450,2388,1518,L
2387,F,415,89,1898,160,1962,2388,1483,F
2387,G,105,105,2003,75,2037,2388,1898,G
2387,F,755,755,2758,780,2817,2388,2003,F
2387,G,96,96,2854,85,2902,2388,2758,G
2387,H,243,243,3097,2900,5802,2388,2854,H
2387,M,3972,3972,7069,4243,10368,2388,3097,M
2387,N,362,362,7431,150,10518,2388,7069,N
2387,O,200,200,7631,280,10798,2388,7431,O
2387,P,1195,1195,8826,5160,15958,2388,7631,P
2388,A,594,594,594,1535,1535,2389,0,A
2388,B,968,968,1562,90,1625,2389,594,B
2388,C,1018,1018,2580,1220,2845,2389,1562,C
2388,D,134,134,2714,3780,6625,2389,2580,D
2388,M,131,131,2845,495,7120,2389,2714,M
2388,N,664,664,3509,360,7480,2389,2845,N
2388,O,354,354,3863,947,8427,2389,3509,O
2388,P,1603,1603,5466,948,9375,2389,3863,P
2389,A,4041,4041,4041,4402,4402,2390,0,A
2389,B,397,397,4438,90,4492,2390,4041,B
2389,C,1610,1610,6048,1865,6357,2390,4438,C
2389,D,633,633,6681,3780,10137,2390,6048,D
2389,M,53,53,6734,259,10396,2390,6681,M
2389,N,431,431,7165,90,10486,2390,6734,N
2389,O,1044,1044,8209,1360,11846,2390,7165,O
2389,P,371,371,8580,3780,15626,2390,8209,P
2390,A,144,144,144,335,335,2391,0,A
2390,B,272,272,416,130,465,2391,144,B
2390,C,934,934,1350,910,1375,2391,416,C
2390,D,3485,3485,4835,550,1925,2391,1350,D
2390,M,1296,1296,6131,2434,4359,2391,4835,M
2390,N,1258,1258,7389,180,4539,2391,6131,N
2390,O,410,410,7799,840,5379,2391,7389,O
2390,N,891,891,8690,420,5799,2391,7799,N
2390,O,1032,1032,9722,1030,6829,2391,8690,O
2390,P,1424,1424,11146,6960,13789,2391,9722,P
2391,A,3357,3357,3357,3355,3355,2392,0,A
2391,B,170,170,3527,240,3595,2392,3357,B
2391,C,166,166,3693,295,3890,2392,3527,C
2391,B,677,677,4370,515,4405,2392,3693,B
2391,C,174,174,4544,290,4695,2392,4370,C
2391,D,994,994,5538,5160,9855,2392,4544,D
2391,M,661,661,6199,1855,11710,2392,5538,M
2391,N,1312,1312,7511,150,11860,2392,6199,N
2391,O,1402,1402,8913,1610,13470,2392,7511,O
2391,P,274,274,9187,2520,15990,2392,8913,P
2392,AEI,2062,2062,2062,2211,2211,2393,0,A
2392,BEI,190,190,2252,90,2301,2393,2062,B
2392,CEI,527,527,2779,790,3091,2393,2252,C
2392,BEI,3692,913,3692,3822,3822,2393,0,E
2392,BFI,951,38,3730,325,3416,2393,2779,B
2392,CFI,160,122,3852,90,3912,2393,3692,F
2392,CGI,426,426,4278,795,4707,2393,3852,G
2392,CFI,1407,859,5137,1885,5301,2393,3730,C
2392,DFI,1248,389,5526,425,5132,2393,4278,F
2392,DGI,1100,711,6237,3780,9081,2393,5137,D
2392,GI,1341,630,6867,1885,7017,2393,5526,G
2392,HI,2346,2346,9213,3780,10797,2393,6867,H
2392,I,13708,4495,13708,13719,13719,2393,0,I
2392,J,334,334,14042,360,14079,2393,13708,J
2392,K,681,681,14723,860,14939,2393,14042,K
2392,L,5766,5766,20489,1590,16529,2393,14723,L
2392,M,165,165,20654,890,17419,2393,20489,M
2392,N,977,977,21631,300,17719,2393,20654,N
2392,O,1010,1010,22641,930,18649,2393,21631,O
2392,P,5271,5271,27912,2760,21409,2393,22641,P
2393,A,2330,2330,2330,6030,6030,2394,0,A
2393,B,3737,3737,6067,90,6120,2394,2330,B
2393,C,681,681,6748,1140,7260,2394,6067,C
2393,D,22379,22379,29127,3780,11040,2394,6748,D
2393,M,1536,1536,30663,4228,15268,2394,29127,M
2393,N,2992,2992,33655,360,15628,2394,30663,N
2393,O,715,715,34370,695,16323,2394,33655,O
2393,P,1382,1382,35752,550,16873,2394,34370,P
2394,AE,94,94,94,360,360,2395,0,E
2394,AF,307,307,401,90,450,2395,94,F
2394,AG,508,107,508,1434,1434,2395,0,A
2394,BG,961,961,1469,90,1524,2395,508,B
2394,CG,1381,313,1782,1635,2085,2395,401,G
2394,CH,272,272,2054,3780,5865,2395,1782,H
2394,C,899,314,2368,1200,2724,2395,1469,C
2394,D,373,373,2741,3780,6504,2395,2368,D
2394,M,2080,2080,4821,2768,9272,2395,2741,M
2394,N,728,728,5549,90,9362,2395,4821,N
2394,O,179,179,5728,605,9967,2395,5549,O
2394,P,12939,12939,18667,3780,13747,2395,5728,P
2395,A,3942,3942,3942,4032,4032,2396,0,A
2395,B,294,294,4236,240,4272,2396,3942,B
2395,C,659,659,4895,785,5057,2396,4236,C
2395,D,1004,1004,5899,3960,9017,2396,4895,D
2395,M,167,167,6066,377,9394,2396,5899,M
2395,N,231,231,6297,90,9484,2396,6066,N
2395,O,1439,1439,7736,1780,11264,2396,6297,O
2395,P,46,46,7782,3780,15044,2396,7736,P
2396,AEI,1366,1366,1366,1658,1658,2397,0,E
2396,AFI,518,518,1884,90,1748,2397,1366,F
2396,AGI,709,709,2593,1060,2808,2397,1884,G
2396,AHI,275,275,2868,3780,6588,2397,2593,H
2396,AI,3256,388,3256,4523,4523,2397,0,A
2396,BI,1299,1299,4555,90,4613,2397,3256,B
2396,CI,1137,1137,5692,1405,6018,2397,4555,C
2396,DI,678,678,6370,3780,9798,2397,5692,D
2396,I,12824,6454,12824,13582,13582,2397,0,I
2396,J,1569,1569,14393,90,13672,2397,12824,J
2396,K,771,771,15164,1215,14887,2397,14393,K
2396,L,262,262,15426,3780,18667,2397,15164,L
2396,M,4129,4129,19555,5016,23683,2397,15426,M
2396,N,942,942,20497,90,23773,2397,19555,N
2396,O,710,710,21207,1155,24928,2397,20497,O
2396,P,60,60,21267,3780,28708,2397,21207,P
2397,A,818,818,818,986,986,2398,0,A
2397,B,271,271,1089,150,1136,2398,818,B
2397,C,805,805,1894,1261,2397,2398,1089,C
2397,D,802,802,2696,599,2996,2398,1894,D
2397,M,2559,2559,5255,2766,5762,2398,2696,M
2397,N,561,561,5816,420,6182,2398,5255,N
2397,O,686,686,6502,945,7127,2398,5816,O
2397,N,833,833,7335,565,7692,2398,6502,N
2397,O,164,164,7499,260,7952,2398,7335,O
2397,P,577,577,8076,5100,13052,2398,7499,P
2398,AE,82,82,82,1492,1492,2399,0,E
2398,AF,1589,1589,1671,240,1732,2399,82,F
2398,AG,807,807,2478,940,2672,2399,1671,G
2398,AH,1054,1054,3532,6990,9662,2399,2478,H
2398,A,5586,2054,5586,6107,6107,2399,0,A
2398,B,546,546,6132,90,6197,2399,5586,B
2398,C,443,443,6575,600,6797,2399,6132,C
2398,B,1511,1511,8086,1340,8137,2399,6575,B
2398,C,1475,1475,9561,1975,10112,2399,8086,C
2398,D,2996,2996,12557,3780,13892,2399,9561,D
2398,M,102,102,12659,346,14238,2399,12557,M
2398,N,421,421,13080,240,14478,2399,12659,N
2398,O,920,920,14000,975,15453,2399,13080,O
2398,N,686,686,14686,625,16078,2399,14000,N
2398,O,143,143,14829,285,16363,2399,14686,O
2398,P,180,180,15009,5100,21463,2399,14829,P
2399,AEI,9,9,9,91,91,2400,0,A
2399,BEI,286,286,295,240,331,2400,9,B
2399,CEI,416,121,416,1435,1435,2400,0,I
2399,CEJ,425,9,425,1138,1138,2400,0,E
2399,CFJ,688,558,983,960,1291,2400,295,C
2399,DFJ,394,394,1377,3960,5251,2400,983,D
2399,FJ,1037,85,1462,240,1378,2400,425,F
2399,GJ,1481,435,1897,420,1855,2400,416,J
2399,GK,686,251,2148,990,2368,2400,1462,G
2399,HK,970,719,2867,1255,3110,2400,1897,K
2399,HL,1623,904,3771,3960,6328,2400,2148,H
2399,L,8411,7507,11278,600,3710,2400,2867,L
2399,M,19658,19658,30936,19761,26089,2400,11278,M
2399,N,131,131,31067,90,26179,2400,30936,N
2399,O,609,609,31676,935,27114,2400,31067,O
2399,P,816,816,32492,3780,30894,2400,31676,P
2400,AEI,170,170,170,279,279,2401,0,A
2400,BEI,315,145,315,558,558,2401,0,E
2400,BFI,285,140,455,240,519,2401,170,B
2400,CFI,122,122,577,255,774,2401,455,C
2400,DFI,275,13,590,90,648,2401,315,F
2400,DGI,695,105,695,528,528,2401,0,I
2400,DGJ,554,554,1249,150,678,2401,695,J
2400,DGK,190,190,1439,490,1168,2401,1249,K
2400,DGL,1151,302,1741,1315,1963,2401,590,G
2400,DHL,1522,358,2099,5160,5934,2401,577,D
2400,HL,1841,1181,3280,720,1888,2401,1439,L
2400,H,2800,1261,4541,3780,5743,2401,1741,H
2400,M,44,44,4585,58,5992,2401,4541,M
2400,N,229,229,4814,240,6232,2401,4585,N
2400,O,932,932,5746,1275,7507,2401,4814,O
2400,P,8,8,5754,3780,11287,2401,5746,P
2401,A,1086,1086,1086,1041,1041,2402,0,A
2401,B,48,48,1134,150,1191,2402,1086,B
2401,C,132,132,1266,140,1331,2402,1134,C
2401,B,568,568,1834,550,1881,2402,1266,B
2401,C,781,781,2615,775,2656,2402,1834,C
2401,D,1238,1238,3853,4230,6886,2402,2615,D
2401,M,335,335,4188,1141,8027,2402,3853,M
2401,N,844,844,5032,90,8117,2402,4188,N
2401,O,550,550,5582,935,9052,2402,5032,O
2401,P,456,456,6038,3780,12832,2402,5582,P
2402,A,472,472,472,1013,1013,2403,0,A
2402,B,667,667,1139,180,1193,2403,472,B
2402,C,134,134,1273,220,1413,2403,1139,C
2402,B,544,544,1817,430,1843,2403,1273,B
2402,C,870,870,2687,750,2593,2403,1817,C
2402,D,2447,2447,5134,4140,6733,2403,2687,D
2402,M,1205,1205,6339,1685,8418,2403,5134,M
2402,N,721,721,7060,300,8718,2403,6339,N
2402,O,937,937,7997,1050,9768,2403,7060,O
2402,P,52,52,8049,1140,10908,2403,7997,P
2403,AEI,21,21,21,110,110,2404,0,A
2403,BEI,70,49,70,395,395,2404,0,E
2403,BFI,289,240,310,240,350,2404,21,B
2403,CFI,528,218,528,1327,1327,2404,0,I
2403,CFJ,551,93,621,270,665,2404,70,F
2403,CGJ,754,443,1064,960,1310,2404,310,C
2403,DGJ,100,100,1164,3960,5270,2404,1064,D
2403,GJ,966,423,1587,1160,1825,2404,621,G
2403,HJ,1176,117,1704,420,1747,2404,528,J
2403,HK,837,720,2424,695,2520,2404,1587,H
2403,K,1011,291,2715,1190,2937,2404,1704,K
2403,L,6484,6484,9199,665,3602,2404,2715,L
2403,M,624,624,9823,1095,6365,2404,9199,M
2403,N,663,663,10486,240,6605,2404,9823,N
2403,O,697,697,11183,925,7530,2404,10486,O
2403,P,2426,2426,13609,4020,11550,2404,11183,P
2404,AE,444,444,444,1274,1274,2405,0,A
2404,BE,863,863,1307,90,1364,2405,444,B
2404,CE,2022,715,2022,2159,2159,2405,0,E
2404,CF,170,170,2192,90,2249,2405,2022,F
2404,CG,1159,274,2466,1210,2574,2405,1307,C
2404,DG,580,306,2772,820,3069,2405,2192,G
2404,DH,344,38,2810,3780,6354,2405,2466,D
2404,H,49,11,2821,3780,6849,2405,2772,H
2404,M,4143,4143,6964,4847,11696,2405,2821,M
2404,N,743,743,7707,90,11786,2405,6964,N
2404,O,206,206,7913,605,12391,2405,7707,O
2404,P,8528,8528,16441,3780,16171,2405,7913,P
2405,A,317,317,317,1365,1365,2406,0,A
2405,B,1308,1308,1625,300,1665,2406,317,B
2405,C,624,624,2249,805,2470,2406,1625,C
2405,D,1363,1363,3612,2940,5410,2406,2249,D
2405,M,10234,10234,13846,11435,16845,2406,3612,M
2405,N,1425,1425,15271,240,17085,2406,13846,N
2405,O,371,371,15642,760,17845,2406,15271,O
2405,P,10,10,15652,3900,21745,2406,15642,P
2406,AE,132,132,132,400,400,2407,0,A
2406,BE,451,451,583,240,640,2407,132,B
2406,CE,697,697,1280,810,1450,2407,583,C
2406,DE,6776,5496,6776,7357,7357,2407,0,E
2406,DF,596,596,7372,120,7477,2407,6776,F
2406,DG,203,203,7575,390,7867,2407,7372,G
2406,DF,1458,1458,9033,1225,9092,2407,7575,F
2406,DG,678,678,9711,810,9902,2407,9033,G
2406,DH,308,308,10019,5040,14942,2407,9711,H
2406,D,23175,14436,24455,5040,6490,2407,1280,D
2406,M,266,266,24721,545,15487,2407,24455,M
2406,N,473,473,25194,240,15727,2407,24721,N
2406,O,804,804,25998,970,16697,2407,25194,O
2406,N,186,186,26184,80,16777,2407,25998,N
2406,O,2567,2567,28751,2590,19367,2407,26184,O
2406,P,1309,1309,30060,3960,23327,2407,28751,P
2407,AEI,80,80,80,1083,1083,2408,0,I
2407,AEJ,271,191,271,916,916,2408,0,A
2407,BEJ,764,764,1035,150,1066,2408,271,B
2407,CEJ,162,162,1197,140,1206,2408,1035,C
2407,BEJ,1196,79,1276,240,1323,2408,80,J
2407,BEK,1569,293,1569,1537,1537,2408,0,E
2407,BFK,431,59,1628,470,1676,2408,1197,B
2407,CFK,148,89,1717,240,1777,2408,1569,F
2407,CGK,850,409,2126,1020,2343,2408,1276,K
2407,CGL,732,234,2360,720,2396,2408,1628,C
2407,DGL,341,107,2467,4680,7023,2408,2126,L
2407,DG,1336,586,3053,1675,3452,2408,1717,G
2407,DF,1074,381,3434,4170,6566,2408,2360,D
2407,F,945,564,3998,580,4032,2408,3053,F
2407,G,1184,1184,5182,1240,5272,2408,3998,G
2407,H,9,9,5191,335,5607,2408,5182,H
2407,M,380,380,5571,1000,8023,2408,5191,M
2407,N,697,697,6268,120,8143,2408,5571,N
2407,O,919,919,7187,890,9033,2408,6268,O
2407,N,369,369,7556,400,9433,2408,7187,N
2407,O,586,586,8142,656,10089,2408,7556,O
2407,P,130,130,8272,399,10488,2408,8142,P
2408,A,3638,3638,3638,4276,4276,2409,0,A
2408,B,668,668,4306,90,4366,2409,3638,B
2408,C,831,831,5137,1200,5566,2409,4306,C
2408,B,777,777,5914,400,5966,2409,5137,B
2408,C,502,502,6416,815,6781,2409,5914,C
2408,D,5100,5100,11516,3780,10561,2409,6416,D
2408,M,1110,1110,12626,2050,12611,2409,11516,M
2408,N,972,972,13598,90,12701,2409,12626,N
2408,O,688,688,14286,805,13506,2409,13598,O
2408,N,375,375,14661,265,13771,2409,14286,N
2408,O,225,225,14886,625,14396,2409,14661,O
2408,P,17087,17087,31973,3780,18176,2409,14886,P
2409,AEI,766,766,766,1568,1568,2410,0,A
2409,BEI,830,830,1596,90,1658,2410,766,B
2409,CEI,965,965,2561,1240,2898,2410,1596,C
2409,DEI,296,296,2857,3780,6678,2410,2561,D
2409,EI,3226,369,3226,4478,4478,2410,0,E
2409,FI,1266,1266,4492,90,4568,2410,3226,F
2409,GI,1517,1517,6009,1405,5973,2410,4492,G
2409,HI,382,382,6391,3780,9753,2410,6009,H
2409,I,17217,10826,17217,17419,17419,2410,0,I
2409,J,284,284,17501,90,17509,2410,17217,J
2409,K,1532,1532,19033,1865,19374,2410,17501,K
2409,L,73,73,19106,3780,23154,2410,19033,L
2409,M,306,306,19412,819,23973,2410,19106,M
2409,N,546,546,19958,90,24063,2410,19412,N
2409,O,508,508,20466,845,24908,2410,19958,O
2409,P,11968,11968,32434,3780,28688,2410,20466,P
2410,A,440,440,440,375,375,2411,0,A
2410,B,264,264,704,300,675,2411,440,B
2410,C,678,678,1382,840,1515,2411,704,C
2410,D,7545,7545,8927,1140,2655,2411,1382,D
2410,M,300,300,9227,571,3226,2411,8927,M
2410,N,411,411,9638,90,3316,2411,9227,N
2410,O,1323,1323,10961,1780,5096,2411,9638,O
2410,P,49,49,11010,3780,8876,2411,10961,P
2411,AEI,121,121,121,363,363,2412,0,A
2411,BEI,266,266,387,90,453,2412,121,B
2411,CEI,715,328,715,1026,1026,2412,0,I
2411,CEJ,368,368,1083,90,1116,2412,715,J
2411,CEK,494,494,1577,815,1931,2412,1083,K
2411,CEL,1473,283,1860,1745,2198,2412,387,C
2411,DEL,53,53,1913,3780,5978,2412,1860,D
2411,EL,930,594,2507,3780,5711,2412,1577,L
2411,E,37015,34508,37015,37993,37993,2412,0,E
2411,F,1008,1008,38023,90,38083,2412,37015,F
2411,G,1025,1025,39048,1210,39293,2412,38023,G
2411,H,563,563,39611,3780,43073,2412,39048,H
2411,M,3633,3633,43244,4301,47374,2412,39611,M
2411,N,696,696,43940,90,47464,2412,43244,N
2411,O,905,905,44845,1275,48739,2412,43940,O
2411,P,9001,9001,53846,3780,52519,2412,44845,P
2412,AEI,40,40,40,1305,1305,2413,0,A
2412,BEI,236,196,236,872,872,2413,0,I
2412,BEJ,672,672,908,90,962,2413,236,J
2412,BEK,368,368,1276,800,1762,2413,908,K
2412,BEL,1530,294,1570,300,1605,2413,40,B
2412,CEL,919,919,2489,1005,2610,2413,1570,C
2412,DEL,1292,79,2568,3780,5542,2413,1276,L
2412,DE,590,511,3079,1200,3810,2413,2489,D
2412,E,14294,11215,14294,14180,14180,2413,0,E
2412,F,142,142,14436,300,14480,2413,14294,F
2412,G,842,842,15278,1005,15485,2413,14436,G
2412,H,577,577,15855,1200,16685,2413,15278,H
2412,M,3149,3149,19004,3263,19948,2413,15855,M
2412,N,142,142,19146,90,20038,2413,19004,N
2412,O,444,444,19590,820,20858,2413,19146,O
2412,N,671,671,20261,295,21153,2413,19590,N
2412,O,200,200,20461,535,21688,2413,20261,O
2412,P,1096,1096,21557,3780,25468,2413,20461,P
2413,AE,1330,1330,1330,1460,1460,2414,0,A
2413,BE,379,379,1709,90,1550,2414,1330,B
2413,CE,2515,806,2515,2653,2653,2414,0,E
2413,CF,918,112,2627,1240,2790,2414,1709,C
2413,DF,166,54,2681,90,2743,2414,2515,F
2413,DG,103,49,2730,3780,6570,2414,2627,D
2413,G,725,676,3406,1105,3848,2414,2681,G
2413,H,960,960,4366,3780,7628,2414,3406,H
2413,M,843,843,5209,1441,9069,2414,4366,M
2413,N,632,632,5841,90,9159,2414,5209,N
2413,O,371,371,6212,795,9954,2414,5841,O
2413,P,902,902,7114,3780,13734,2414,6212,P
2414,A,4383,4383,4383,4368,4368,2415,0,A
2414,B,165,165,4548,240,4608,2415,4383,B
2414,C,454,454,5002,195,4803,2415,4548,C
2414,B,369,369,5371,670,5473,2415,5002,B
2414,C,467,467,5838,500,5973,2415,5371,C
2414,D,2910,2910,8748,180,6153,2415,5838,D
2414,M,2728,2728,11476,4926,11079,2415,8748,M
2414,N,3398,3398,14874,1260,12339,2415,11476,N
2414,O,315,315,15189,400,12739,2415,14874,O
2414,P,4386,4386,19575,425,13164,2415,15189,P
2415,AE,1005,1005,1005,3702,3702,2416,0,A
2415,BE,3057,3057,4062,420,4122,2416,1005,B
2415,CE,1009,1009,5071,1245,5367,2416,4062,C
2415,DE,217,217,5288,350,5717,2416,5071,D
2415,E,30987,25699,30987,34599,34599,2416,0,E
2415,F,3645,3645,34632,90,34689,2416,30987,F
2415,G,922,922,35554,1220,35909,2416,34632,G
2415,H,164,164,35718,3780,39689,2416,35554,H
2415,M,461,461,36179,788,40477,2416,35718,M
2415,N,359,359,36538,90,40567,2416,36179,N
2415,O,1019,1019,37557,1240,41807,2416,36538,O
2415,P,1567,1567,39124,3780,45587,2416,37557,P
2416,AEI,129,129,129,1330,1330,2417,0,I
2416,AEJ,1099,970,1099,2261,2261,2417,0,E
2416,AFJ,1320,221,1320,1305,1305,2417,0,A
2416,BFJ,1385,194,1514,240,1570,2417,129,J
2416,BFK,244,50,1564,300,1605,2417,1320,B
2416,CFK,799,749,2313,995,2565,2417,1514,K
2416,CFL,885,136,2449,1005,2610,2417,1564,C
2416,DFL,157,21,2470,4680,7245,2417,2313,L
2416,DF,1467,96,2566,330,2591,2417,1099,F
2416,DG,572,455,3021,1200,3810,2417,2449,D
2416,G,767,312,3333,947,3538,2417,2566,G
2416,H,234,234,3567,348,3886,2417,3333,H
2416,M,1974,1974,5541,2057,9302,2417,3567,M
2416,N,106,106,5647,90,9392,2417,5541,N
2416,O,519,519,6166,800,10192,2417,5647,O
2416,N,2122,2122,8288,1835,12027,2417,6166,N
2416,O,449,449,8737,735,12762,2417,8288,O
2416,P,895,895,9632,3780,16542,2417,8737,P
2417,AEI,785,785,785,1273,1273,2418,0,I
2417,AEJ,548,548,1333,90,1363,2418,785,J
2417,AEK,2030,697,2030,3061,3061,2418,0,E
2417,AFK,977,280,2310,1230,2593,2418,1333,K
2417,AFL,30,30,2340,3780,6373,2418,2310,L
2417,AF,3065,725,3065,4318,4318,2418,0,A
2417,BF,1566,531,3596,90,3151,2418,2030,F
2417,BG,1275,744,4340,90,4408,2418,3065,B
2417,CG,1110,366,4706,1405,4556,2418,3596,G
2417,CH,1172,806,5512,1430,5838,2418,4340,C
2417,DH,423,423,5935,3780,9618,2418,5512,D
2417,H,1999,770,6705,3780,8336,2418,4706,H
2417,M,538,538,7243,1397,11015,2418,6705,M
2417,N,894,894,8137,90,11105,2418,7243,N
2417,O,893,893,9030,1285,12390,2418,8137,O
2417,P,1363,1363,10393,3780,16170,2418,9030,P
2418,A,118,118,118,655,655,2419,0,A
2418,B,834,834,952,300,955,2419,118,B
2418,C,561,561,1513,735,1690,2419,952,C
2418,D,227,227,1740,1560,3250,2419,1513,D
2418,M,86,86,1826,233,3483,2419,1740,M
2418,N,1597,1597,3423,1500,4983,2419,1826,N
2418,O,809,809,4232,995,5978,2419,3423,O
2418,N,1122,1122,5354,910,6888,2419,4232,N
2418,O,242,242,5596,300,7188,2419,5354,O
2418,P,659,659,6255,5100,12288,2419,5596,P
2419,AEI,1892,1892,1892,2161,2161,2420,0,I
2419,AEJ,2101,209,2101,2249,2249,2420,0,E
2419,AFJ,425,216,2317,90,2251,2420,1892,J
2419,AFK,222,6,2323,90,2339,2420,2101,F
2419,AGK,2484,161,2484,2275,2275,2420,0,A
2419,BGK,55,55,2539,300,2575,2420,2484,B
2419,CGK,422,200,2739,795,3046,2420,2317,K
2419,CGJ,616,200,2939,790,3129,2420,2323,G
2419,CFJ,744,344,3283,895,3470,2420,2539,C
2419,DFJ,92,92,3375,2040,5510,2420,3283,D
2419,FJ,1190,554,3929,425,3471,2420,2739,J
2419,FK,1058,68,3997,325,3454,2420,2939,F
2419,GK,1369,1301,5298,1885,5356,2420,3929,K
2419,GL,1382,81,5379,1885,5339,2420,3997,G
2419,HL,967,967,6346,3780,9119,2420,5379,H
2419,L,2345,1297,7643,3780,9136,2420,5298,L
2419,M,632,632,8275,4150,13286,2420,7643,M
2419,N,3796,3796,12071,300,13586,2420,8275,N
2419,O,238,238,12309,410,13996,2420,12071,O
2419,N,364,364,12673,185,14181,2420,12309,N
2419,O,536,536,13209,755,14936,2420,12673,O
2419,P,209,209,13418,1560,16496,2420,13209,P
2420,A,188,188,188,485,485,2421,0,A
2420,B,470,470,658,240,725,2421,188,B
2420,C,730,730,1388,975,1700,2421,658,C
2420,B,876,876,2264,625,2325,2421,1388,B
2420,C,135,135,2399,285,2610,2421,2264,C
2420,D,126,126,2525,5100,7710,2421,2399,D
2420,M,3477,3477,6002,5096,12806,2421,2525,M
2420,N,1640,1640,7642,90,12896,2421,6002,N
2420,O,1131,1131,8773,1380,14276,2421,7642,O
2420,N,328,328,9101,55,14331,2421,8773,N
2420,O,227,227,9328,695,15026,2421,9101,O
2420,P,6155,6155,15483,3780,18806,2421,9328,P
2421,AEI,723,723,723,2207,2207,2422,0,I
2421,AEJ,1524,801,1524,2344,2344,2422,0,E
2421,AFJ,1599,75,1599,1175,1175,2422,0,A
2421,BFJ,363,363,1962,90,1265,2422,1599,B
2421,CFJ,567,567,2529,815,2080,2422,1962,C
2421,BFJ,1859,53,2582,420,2627,2422,723,J
2421,BFK,617,564,3146,1075,3155,2422,2529,B
2421,CFK,1734,112,3258,780,3124,2422,1524,F
2421,CGK,1040,364,3622,1337,3964,2422,2582,K
2421,CGL,903,539,4161,1282,4406,2422,3258,G
2421,CHL,1240,225,4386,1790,4945,2422,3146,C
2421,DHL,1007,1007,5393,3780,8725,2422,4386,D
2421,HL,3867,2096,7489,958,4922,2422,3622,L
2421,H,4130,802,8291,358,4764,2422,4161,H
2421,M,5,5,8296,1470,10195,2422,8291,M
2421,N,1717,1717,10013,300,10495,2422,8296,N
2421,O,920,920,10933,1005,11500,2422,10013,O
2421,P,566,566,11499,1200,12700,2422,10933,P
2422,AE,1439,1439,1439,5252,5252,2423,0,A
2422,BE,4219,2780,4219,4823,4823,2423,0,E
2422,BF,788,788,5007,90,4913,2423,4219,F
2422,BG,3837,269,5276,90,5342,2423,1439,B
2422,CG,383,114,5390,765,5678,2423,5007,G
2422,CH,1132,1018,6408,1375,6717,2423,5276,C
2422,BH,1118,100,6508,3780,9458,2423,5390,H
2422,B,1295,1195,7703,1045,7762,2423,6408,B
2422,C,416,416,8119,765,8527,2423,7703,C
2422,D,2897,2897,11016,3780,12307,2423,8119,D
2422,M,2768,2768,13784,1335,13642,2423,11016,M
2422,N,260,260,14044,300,13942,2423,13784,N
2422,O,2034,2034,16078,1275,15217,2423,14044,O
2422,N,210,210,16288,1045,16262,2423,16078,N
2422,O,560,560,16848,780,17042,2423,16288,O
2422,P,8964,8964,25812,4020,21062,2423,16848,P
2423,AE,78,78,78,80,80,2424,0,A
2423,BE,215,215,293,240,320,2424,78,B
2423,CE,193,193,486,240,560,2424,293,C
2423,DE,488,2,488,991,991,2424,0,E
2423,DF,623,623,1111,180,1171,2424,488,F
2423,DG,1404,779,1890,5250,5810,2424,486,D
2423,G,927,148,2038,910,2081,2424,1111,G
2423,H,1771,1771,3809,550,2631,2424,2038,H
2423,M,1796,1796,5605,3196,9006,2424,3809,M
2423,N,1789,1789,7394,420,9426,2424,5605,N
2423,O,1205,1205,8599,2305,11731,2424,7394,O
2423,P,1093,1093,9692,4585,16316,2424,8599,P
2424,AEI,138,138,138,716,716,2425,0,E
2424,AFI,185,47,185,943,943,2425,0,A
2424,BFI,761,714,899,240,956,2425,138,F
2424,BGI,128,128,1027,195,1151,2425,899,G
2424,BHI,948,106,1133,240,1183,2425,185,B
2424,CHI,1938,805,1938,2166,2166,2425,0,I
2424,CHJ,1011,206,2144,1015,2198,2425,1133,C
2424,BHJ,270,64,2208,90,2256,2425,1938,J
2424,BHK,1503,322,2530,5220,6371,2425,1027,H
2424,BK,418,32,2562,485,2683,2425,2144,B
2424,CK,565,211,2773,730,2986,2425,2208,K
2424,CJ,385,174,2947,510,3193,2425,2562,C
2424,DJ,137,137,3084,3960,7153,2425,2947,D
2424,J,1130,819,3903,970,3956,2425,2773,J
2424,K,1227,1227,5130,1390,5346,2425,3903,K
2424,L,769,769,5899,3780,9126,2425,5130,L
2424,M,1082,1082,6981,1824,10950,2425,5899,M
2424,N,764,764,7745,90,11040,2425,6981,N
2424,O,1188,1188,8933,1365,12405,2425,7745,O
2424,P,175,175,9108,3780,16185,2425,8933,P
2425,AE,1287,1287,1287,3436,3436,2426,0,E
2425,AF,2179,2179,3466,90,3526,2426,1287,F
2425,AG,1257,1257,4723,1640,5166,2426,3466,G
2425,AH,167,167,4890,3780,8946,2426,4723,H
2425,A,7748,2858,7748,8033,8033,2426,0,A
2425,B,315,315,8063,90,8123,2426,7748,B
2425,C,756,756,8819,1105,9228,2426,8063,C
2425,D,573,573,9392,3780,13008,2426,8819,D
2425,M,1789,1789,11181,2334,15342,2426,9392,M
2425,N,577,577,11758,90,15432,2426,11181,N
2425,O,3473,3473,15231,1865,17297,2426,11758,O
2425,P,295,295,15526,3780,21077,2426,15231,P
2426,A,14565,14565,14565,14919,14919,2427,0,A
2426,B,625,625,15190,300,15219,2427,14565,B
2426,C,677,677,15867,740,15959,2427,15190,C
2426,D,87,87,15954,1560,17519,2427,15867,D
2426,M,1360,1360,17314,1410,18929,2427,15954,M
2426,N,320,320,17634,300,19229,2427,17314,N
2426,O,914,914,18548,1035,20264,2427,17634,O
2426,N,571,571,19119,480,20744,2427,18548,N
2426,O,683,683,19802,900,21644,2427,19119,O
2426,P,3472,3472,23274,1620,23264,2427,19802,P
2427,A,288,288,288,1885,1885,2428,0,A
2427,B,1867,1867,2155,330,2215,2428,288,B
2427,C,1716,1716,3871,1859,4074,2428,2155,C
2427,B,2348,2348,6219,2190,6264,2428,3871,B
2427,C,2048,2048,8267,1543,7807,2428,6219,C
2427,D,257,257,8524,797,8604,2428,8267,D
2427,M,75,75,8599,825,9429,2428,8524,M
2427,N,849,849,9448,150,9579,2428,8599,N
2427,O,171,171,9619,140,9719,2428,9448,O
2427,N,202,202,9821,230,9949,2428,9619,N
2427,O,595,595,10416,540,10489,2428,9821,O
2427,P,6127,6127,16543,4230,14719,2428,10416,P
2428,A,1656,1656,1656,2137,2137,2429,0,A
2428,B,498,498,2154,90,2227,2429,1656,B
2428,C,509,509,2663,880,3107,2429,2154,C
2428,B,1633,1633,4296,1250,4357,2429,2663,B
2428,C,2164,2164,6460,1740,6097,2429,4296,C
2428,D,1000,1000,7460,3780,9877,2429,6460,D
2428,M,4504,4504,11964,4935,14812,2429,7460,M
2428,N,561,561,12525,90,14902,2429,11964,N
2428,O,1128,1128,13653,1360,16262,2429,12525,O
2428,P,409,409,14062,3780,20042,2429,13653,P
2429,AE,45,45,45,2798,2798,2430,0,E
2429,AF,52,7,52,2395,2395,2430,0,A
2429,BF,2463,2463,2515,165,2560,2430,52,B
2429,CF,2873,403,2918,165,2963,2430,45,F
2429,CG,743,340,3258,1035,3595,2430,2515,C
2429,DG,541,201,3459,825,3788,2430,2918,G
2429,DH,222,21,3480,3960,7555,2430,3258,D
2429,H,325,304,3784,3960,7748,2430,3459,H
2429,M,1582,1582,5366,1533,9281,2430,3784,M
2429,N,229,229,5595,300,9581,2430,5366,N
2429,O,837,837,6432,970,10551,2430,5595,O
2429,N,411,411,6843,350,10901,2430,6432,N
2429,O,306,306,7149,390,11291,2430,6843,O
2429,P,171,171,7320,4020,15311,2430,7149,P
2430,AEI,197,197,197,4302,4302,2431,0,E
2430,AFI,2089,1892,2089,2510,2510,2431,0,A
2430,BFI,469,469,2558,90,2600,2431,2089,B
2430,CFI,579,579,3137,805,3405,2431,2558,C
2430,DFI,120,120,3257,3840,7245,2431,3137,D
2430,FI,4132,1072,4329,90,4392,2431,197,F
2430,GI,1028,1028,5357,1200,5592,2431,4329,G
2430,HI,1467,1467,6824,3780,9372,2431,5357,H
2430,I,29355,22531,29355,29569,29569,2431,0,I
2430,J,248,248,29603,90,29659,2431,29355,J
2430,K,762,762,30365,1130,30789,2431,29603,K
2430,L,127,127,30492,3780,34569,2431,30365,L
2430,M,1001,1001,31493,1371,35940,2431,30492,M
2430,N,406,406,31899,90,36030,2431,31493,N
2430,O,248,248,32147,605,36635,2431,31899,O
2430,P,1529,1529,33676,3780,40415,2431,32147,P
2431,AEI,241,241,241,1896,1896,2432,0,E
2431,AFI,413,172,413,696,696,2432,0,A
2431,BFI,497,497,910,240,936,2432,413,B
2431,CFI,1553,643,1553,1964,1964,2432,0,I
2431,CFJ,455,455,2008,90,2054,2432,1553,J
2431,CFK,2206,439,2447,240,2136,2432,241,F
2431,CGK,1771,234,2681,845,1781,2432,910,C
2431,DGK,686,13,2694,1135,3189,2432,2008,K
2431,DGL,744,497,3191,845,2981,2432,2447,G
2431,DHL,127,127,3318,3720,6701,2432,3191,H
2431,DL,9063,8426,11744,3720,5501,2432,2681,D
2431,L,39373,30323,42067,3780,6969,2432,2694,L
2431,M,106,106,42173,479,7448,2432,42067,M
2431,N,478,478,42651,150,7598,2432,42173,N
2431,O,224,224,42875,240,7838,2432,42651,O
2431,P,1132,1132,44007,550,8388,2432,42875,P
2432,AEI,77,77,77,1470,1470,2433,0,E
2432,AFI,121,44,121,1198,1198,2433,0,A
2432,BFI,280,159,280,1346,1346,2433,0,I
2432,BFJ,1268,1109,1389,240,1438,2433,121,B
2432,CFJ,1249,140,1529,240,1586,2433,280,J
2432,CFK,1575,123,1652,240,1710,2433,77,F
2432,CGK,753,490,2142,780,2218,2433,1389,C
2432,DGK,829,216,2358,760,2346,2433,1529,K
2432,DGL,825,119,2477,780,2490,2433,1652,G
2432,DHL,750,415,2892,7680,9898,2433,2142,D
2432,HL,695,280,3172,7680,10170,2433,2477,H
2432,L,4000,3186,6358,7680,10026,2433,2358,L
2432,M,570,570,6928,759,10929,2433,6358,M
2432,N,431,431,7359,300,11229,2433,6928,N
2432,O,688,688,8047,825,12054,2433,7359,O
2432,N,336,336,8383,255,12309,2433,8047,N
2432,O,1036,1036,9419,1320,13629,2433,8383,O
2432,P,14442,14442,23861,6060,19689,2433,9419,P
2433,AE,97,97,97,1105,1105,2434,0,A
2433,BE,204,107,204,1395,1395,2434,0,E
2433,BF,1206,1099,1303,240,1345,2434,97,B
2433,CF,1373,274,1577,240,1635,2434,204,F
2433,CG,690,416,1993,760,2105,2434,1303,C
2433,DG,674,258,2251,780,2415,2434,1577,G
2433,DH,858,600,2851,7740,9845,2434,1993,D
2433,H,2524,1924,4775,7680,10095,2434,2251,H
2433,M,128,128,4903,285,10380,2434,4775,M
2433,N,266,266,5169,180,10560,2434,4903,N
2433,O,614,614,5783,560,11120,2434,5169,O
2433,P,302,302,6085,2850,13970,2434,5783,P
2434,A,42,42,42,493,493,2435,0,A
2434,B,634,634,676,240,733,2435,42,B
2434,C,713,713,1389,850,1583,2435,676,C
2434,D,1937,1937,3326,5220,6803,2435,1389,D
2434,M,4760,4760,8086,4915,11718,2435,3326,M
2434,N,416,416,8502,300,12018,2435,8086,N
2434,O,682,682,9184,850,12868,2435,8502,O
2434,N,1690,1690,10874,1530,14398,2435,9184,N
2434,O,977,977,11851,930,15328,2435,10874,O
2434,P,1113,1113,12964,2760,18088,2435,11851,P
2435,A,2567,2567,2567,4772,4772,2436,0,A
2435,B,2233,2233,4800,90,4862,2436,2567,B
2435,C,379,379,5179,795,5657,2436,4800,C
2435,D,1721,1721,6900,3780,9437,2436,5179,D
2435,M,7789,7789,14689,8118,17555,2436,6900,M
2435,N,380,380,15069,90,17645,2436,14689,N
2435,O,617,617,15686,795,18440,2436,15069,O
2435,N,979,979,16665,810,19250,2436,15686,N
2435,O,141,141,16806,535,19785,2436,16665,O
2435,P,88,88,16894,3780,23565,2436,16806,P
2436,A,493,493,493,1187,1187,2437,0,A
2436,B,808,808,1301,150,1337,2437,493,B
2436,C,707,707,2008,640,1977,2437,1301,C
2436,B,997,997,3005,1070,3047,2437,2008,B
2436,C,455,455,3460,115,3162,2437,3005,C
2436,D,1065,1065,4525,4230,7392,2437,3460,D
2436,M,20,20,4545,35,7427,2437,4525,M
2436,N,73,73,4618,120,7547,2437,4545,N
2436,O,152,152,4770,125,7672,2437,4618,O
2436,P,874,874,5644,2880,10552,2437,4770,P
2437,AE,429,429,429,617,617,2438,0,A
2437,BE,379,379,808,240,857,2438,429,B
2437,CE,758,758,1566,970,1827,2438,808,C
2437,BE,2651,1085,2651,2839,2839,2438,0,E
2437,BF,1603,518,3169,1380,3207,2438,1566,B
2437,CF,555,37,3206,420,3259,2438,2651,F
2437,CG,652,615,3821,980,4187,2438,3169,C
2437,DG,197,197,4018,3960,8147,2438,3821,D
2437,G,1139,327,4345,1376,4635,2438,3206,G
2437,H,3749,3749,8094,654,5289,2438,4345,H
2437,M,6,6,8100,78,8225,2438,8094,M
2437,N,346,346,8446,300,8525,2438,8100,N
2437,O,700,700,9146,1025,9550,2438,8446,O
2437,P,15,15,9161,720,10270,2438,9146,P
2438,A,241,241,241,997,997,2439,0,A
2438,B,946,946,1187,240,1237,2439,241,B
2438,C,779,779,1966,1015,2252,2439,1187,C
2438,B,892,892,2858,650,2902,2439,1966,B
2438,C,110,110,2968,385,3287,2439,2858,C
2438,D,273,273,3241,3960,7247,2439,2968,D
2438,M,326,326,3567,344,7591,2439,3241,M
2438,N,111,111,3678,150,7741,2439,3567,N
2438,O,34,34,3712,100,7841,2439,3678,O
2438,N,454,454,4166,390,8231,2439,3712,N
2438,O,176,176,4342,225,8456,2439,4166,O
2438,P,142,142,4484,4740,13196,2439,4342,P
2439,AEI,414,414,414,1303,1303,2440,0,A
2439,BEI,912,498,912,1212,1212,2440,0,E
2439,BFI,335,335,1247,90,1302,2440,912,F
2439,BGI,966,133,1380,90,1393,2440,414,B
2439,CGI,1842,462,1842,2798,2798,2440,0,I
2439,CGJ,485,23,1865,855,2248,2440,1380,C
2439,DGJ,985,367,2232,1250,2552,2440,1247,G
2439,DHJ,17,17,2249,3780,6332,2440,2232,H
2439,DJ,627,243,2492,3780,6028,2440,1865,D
2439,J,987,337,2829,90,2888,2440,1842,J
2439,K,986,986,3815,1220,4108,2440,2829,K
2439,L,1632,1632,5447,4625,8733,2440,3815,L
2439,M,924,924,6371,1416,10149,2440,5447,M
2439,N,527,527,6898,90,10239,2440,6371,N
2439,O,235,235,7133,605,10844,2440,6898,O
2439,P,1544,1544,8677,3780,14624,2440,7133,P
2440,AEI,134,134,134,249,249,2441,0,E
2440,AFI,164,30,164,265,265,2441,0,A
2440,BFI,176,12,176,219,219,2441,0,I
2440,BFJ,145,145,321,150,369,2441,176,J
2440,BFK,219,32,353,150,399,2441,134,F
2440,BGK,221,32,385,150,415,2441,164,B
2440,CGK,119,119,504,830,1245,2441,385,C
2440,DGK,250,67,571,895,1264,2441,321,K
2440,DGL,232,14,585,890,1289,2441,353,G
2440,DHL,608,527,1112,3490,4735,2441,504,D
2440,HL,620,93,1205,3490,4779,2441,585,H
2440,L,812,178,1383,3490,4754,2441,571,L
2440,M,504,504,1887,1299,6078,2441,1383,M
2440,N,860,860,2747,180,6258,2441,1887,N
2440,O,1545,1545,4292,1505,7763,2441,2747,O
2440,N,1019,1019,5311,1005,8768,2441,4292,N
2440,O,906,906,6217,831,9599,2441,5311,O
2440,P,1831,1831,8048,414,10013,2441,6217,P
2441,AEI,114,114,114,1411,1411,2442,0,E
2441,AFI,162,48,162,1651,1651,2442,0,A
2441,BFI,521,359,521,1318,1318,2442,0,I
2441,BFJ,1052,1052,1573,315,1633,2442,521,J
2441,BFK,1597,138,1711,360,1771,2442,114,F
2441,BGK,363,225,1936,275,1908,2442,1573,K
2441,BGJ,716,491,2427,695,2466,2442,1711,G
2441,BHJ,2439,174,2601,250,1901,2442,162,B
2441,CHJ,857,192,2793,945,2853,2442,1936,J
2441,CHK,764,572,3365,990,2891,2442,2601,C
2441,DHK,442,442,3807,550,3441,2442,3365,D
2441,HK,1079,65,3872,975,3828,2442,2793,K
2441,HL,658,658,4530,550,4378,2442,3872,L
2441,H,3659,1556,6086,550,3016,2442,2427,H
2441,M,17723,17723,23809,19353,23731,2442,6086,M
2441,N,1691,1691,25500,150,23881,2442,23809,N
2441,O,792,792,26292,395,24276,2442,25500,O
2441,P,1163,1163,27455,660,24936,2442,26292,P
2442,A,725,725,725,958,958,2443,0,A
2442,B,543,543,1268,400,1358,2443,725,B
2442,C,1264,1264,2532,1210,2568,2443,1268,C
2442,D,2023,2023,4555,550,3118,2443,2532,D
2442,M,2279,2279,6834,4788,7906,2443,4555,M
2442,N,2877,2877,9711,420,8326,2443,6834,N
2442,O,953,953,10664,2049,10375,2443,9711,O
2442,P,663,663,11327,846,11221,2443,10664,P
2443,A,779,779,779,1274,1274,2444,0,A
2443,B,544,544,1323,90,1364,2444,779,B
2443,C,360,360,1683,795,2159,2444,1323,C
2443,D,2511,2511,4194,3780,5939,2444,1683,D
2443,M,2152,2152,6346,2307,8246,2444,4194,M
2443,N,311,311,6657,90,8336,2444,6346,N
2443,O,594,594,7251,795,9131,2444,6657,O
2443,N,180,180,7431,75,9206,2444,7251,N
2443,O,346,346,7777,735,9941,2444,7431,O
2443,P,2551,2551,10328,3780,13721,2444,7777,P
2444,A,484,484,484,695,695,2445,0,A
2444,B,691,691,1175,600,1295,2445,484,B
2444,C,1427,1427,2602,1220,2515,2445,1175,C
2444,D,327,327,2929,385,2900,2445,2602,D
2444,M,1967,1967,4896,3638,6538,2445,2929,M
2444,N,2060,2060,6956,420,6958,2445,4896,N
2444,O,639,639,7595,676,7634,2445,6956,O
2444,P,5233,5233,12828,759,8393,2445,7595,P
2445,AE,1638,1638,1638,2509,2509,2446,0,A
2445,BE,2394,756,2394,2299,2299,2446,0,E
2445,BF,1101,345,2739,240,2749,2446,1638,B
2445,CF,1315,970,3709,1470,3769,2446,2394,F
2445,CG,1286,316,4025,1050,3799,2446,2739,C
2445,BG,516,200,4225,575,4344,2446,3709,G
2445,BH,492,292,4517,720,4519,2446,4025,B
2445,CH,572,572,5089,780,5299,2446,4517,C
2445,DH,808,808,5897,3960,9259,2446,5089,D
2445,H,2937,1265,7162,550,4894,2446,4225,H
2445,M,303,303,7465,1044,10303,2446,7162,M
2445,N,947,947,8412,270,10573,2446,7465,N
2445,O,195,195,8607,145,10718,2446,8412,O
2445,N,1127,1127,9734,1175,11893,2446,8607,N
2445,O,1318,1318,11052,1280,13173,2446,9734,O
2445,P,3,3,11055,2880,16053,2446,11052,P
2446,AE,826,826,826,948,948,2447,0,E
2446,AF,858,32,858,1054,1054,2447,0,A
2446,BF,242,210,1068,180,1128,2447,826,F
2446,BG,270,60,1128,120,1174,2447,858,B
2446,CG,885,885,2013,930,2104,2447,1128,C
2446,DG,1077,132,2145,1210,2338,2447,1068,G
2446,DF,273,273,2418,255,2593,2447,2145,F
2446,DG,394,394,2812,465,3058,2447,2418,G
2446,DH,1496,697,3509,385,2489,2447,2013,D
2446,H,1368,671,4180,550,3608,2447,2812,H
2446,M,868,868,5048,4250,7858,2447,4180,M
2446,N,3757,3757,8805,420,8278,2447,5048,N
2446,O,585,585,9390,691,8969,2447,8805,O
2446,P,652,652,10042,609,9578,2447,9390,P
2447,AEI,27,27,27,313,313,2448,0,I
2447,AEJ,106,79,106,335,335,2448,0,A
2447,BEJ,114,8,114,50,50,2448,0,E
2447,BFJ,84,84,198,215,265,2448,114,F
2447,BGJ,154,62,260,150,485,2448,106,B
2447,CGJ,111,49,309,105,370,2448,198,G
2447,CHJ,84,35,344,520,1005,2448,260,C
2447,DHJ,54,19,363,2815,3185,2448,309,H
2447,DJ,30,11,374,2855,3860,2448,344,D
2447,J,494,147,521,270,583,2448,27,J
2447,K,732,732,1253,735,1318,2448,521,K
2447,J,1558,1558,2811,1530,2848,2448,1253,J
2447,K,154,154,2965,290,3138,2448,2811,K
2447,L,989,989,3954,5100,8238,2448,2965,L
2447,M,403,403,4357,1388,9626,2448,3954,M
2447,N,1015,1015,5372,90,9716,2448,4357,N
2447,O,833,833,6205,1200,10916,2448,5372,O
2447,N,885,885,7090,475,11391,2448,6205,N
2447,O,633,633,7723,940,12331,2448,7090,O
2447,P,1615,1615,9338,3780,16111,2448,7723,P
2448,A,3048,3048,3048,3381,3381,2449,0,A
2448,B,363,363,3411,90,3471,2449,3048,B
2448,C,500,500,3911,825,4296,2449,3411,C
2448,B,970,970,4881,655,4951,2449,3911,B
2448,C,2908,2908,7789,2320,7271,2449,4881,C
2448,D,1723,1723,9512,3420,10691,2449,7789,D
2448,M,1174,1174,10686,1393,12084,2449,9512,M
2448,N,425,425,11111,240,12324,2449,10686,N
2448,O,665,665,11776,855,13179,2449,11111,O
2448,N,1507,1507,13283,1260,14439,2449,11776,N
2448,O,462,462,13745,840,15279,2449,13283,O
2448,P,2391,2391,16136,3960,19239,2449,13745,P
2449,A,280,280,280,1039,1039,2450,0,A
2449,B,941,941,1221,240,1279,2450,280,B
2449,C,509,509,1730,740,2019,2450,1221,C
2449,D,7953,7953,9683,5100,7119,2450,1730,D
2449,M,1179,1179,10862,4435,11554,2450,9683,M
2449,N,3332,3332,14194,90,11644,2450,10862,N
2449,O,422,422,14616,805,12449,2450,14194,O
2449,N,414,414,15030,75,12524,2450,14616,N
2449,O,1384,1384,16414,1860,14384,2450,15030,O
2449,P,1300,1300,17714,3780,18164,2450,16414,P
2450,A,58,58,58,152,152,2451,0,A
2450,B,177,177,235,135,287,2451,58,B
2450,C,263,263,498,290,577,2451,235,C
2450,D,1439,1439,1937,5190,5767,2451,498,D
2450,M,291,291,2228,920,6687,2451,1937,M
2450,N,740,740,2968,150,6837,2451,2228,N
2450,O,196,196,3164,125,6962,2451,2968,O
2450,N,1981,1981,5145,2050,9012,2451,3164,N
2450,O,1221,1221,6366,2505,11517,2451,5145,O
2450,P,994,994,7360,1720,13237,2451,6366,P
2451,AEI,184,184,184,596,596,2452,0,A
2451,BEI,1135,1135,1319,785,1381,2452,184,B
2451,CEI,1489,170,1489,1490,1490,2452,0,E
2451,CFI,1006,1006,2495,1035,2525,2452,1489,F
2451,CGI,1280,104,2599,1200,2581,2452,1319,C
2451,DGI,2867,268,2867,3722,3722,2452,0,I
2451,DGJ,834,462,3329,790,3315,2452,2495,G
2451,DHJ,1195,465,3794,550,3131,2452,2599,D
2451,HJ,1130,203,3997,300,4022,2452,2867,J
2451,HK,1037,1037,5034,1050,5072,2452,3997,K
2451,HJ,688,688,5722,720,5792,2452,5034,J
2451,HK,2963,570,6292,550,3865,2452,3329,H
2451,K,603,33,6325,780,6572,2452,5722,K
2451,L,496,496,6821,3960,10532,2452,6325,L
2451,M,404,404,7225,1199,11731,2452,6821,M
2451,N,1086,1086,8311,330,12061,2452,7225,N
2451,O,857,857,9168,2174,14235,2452,8311,O
2451,P,1044,1044,10212,896,15131,2452,9168,P
2452,AE,319,319,319,265,265,2453,0,E
2452,AF,1,1,320,120,385,2453,319,F
2452,AG,313,313,633,225,610,2453,320,G
2452,AF,744,744,1377,830,1440,2453,633,F
2452,AG,1943,566,1943,2138,2138,2453,0,A
2452,BG,590,24,1967,640,2080,2453,1377,G
2452,BH,253,229,2196,90,2228,2453,1943,B
2452,CH,622,622,2818,815,3043,2453,2196,C
2452,BH,1669,818,3636,2880,4960,2453,1967,H
2452,B,3878,3060,6696,3710,6753,2453,2818,B
2452,C,1374,1374,8070,1860,8613,2453,6696,C
2452,D,1386,1386,9456,3780,12393,2453,8070,D
2452,M,12,12,9468,401,12794,2453,9456,M
2452,N,616,616,10084,300,13094,2453,9468,N
2452,O,623,623,10707,820,13914,2453,10084,O
2452,N,1433,1433,12140,1245,15159,2453,10707,N
2452,O,325,325,12465,430,15589,2453,12140,O
2452,P,2909,2909,15374,8050,23639,2453,12465,P
2453,A,37,37,37,1610,1610,2454,0,A
2453,B,236,236,273,180,1790,2454,37,B
2453,C,2570,2570,2843,1320,3110,2454,273,C
2453,B,227,227,3070,20,3130,2454,2843,B
2453,C,485,485,3555,565,3695,2454,3070,C
2453,D,1159,1159,4714,6960,10655,2454,3555,D
2453,M,219,219,4933,710,11365,2454,4714,M
2453,N,592,592,5525,150,11515,2454,4933,N
2453,O,228,228,5753,125,11640,2454,5525,O
2453,N,244,244,5997,345,11985,2454,5753,N
2453,O,141,141,6138,120,12105,2454,5997,O
2453,P,1089,1089,7227,4230,16335,2454,6138,P
2454,AEI,232,232,232,221,221,2455,0,I
2454,AEJ,326,94,326,719,719,2455,0,A
2454,BEJ,109,15,341,180,401,2455,232,J
2454,BEK,516,516,857,495,896,2455,341,K
2454,BEL,686,155,1012,300,1019,2455,326,B
2454,CEL,534,379,1391,550,1446,2455,857,L
2454,CE,811,432,1823,890,1909,2455,1012,C
2454,DE,1967,144,1967,2675,2675,2455,0,E
2454,DF,619,475,2442,385,2294,2455,1823,D
2454,F,745,270,2712,120,2795,2455,1967,F
2454,G,1058,1058,3770,1025,3820,2455,2712,G
2454,H,634,634,4404,550,4370,2455,3770,H
2454,M,882,882,5286,1042,5412,2455,4404,M
2454,N,280,280,5566,180,5592,2455,5286,N
2454,O,86,86,5652,230,5822,2455,5566,O
2454,N,630,630,6282,480,6302,2455,5652,N
2454,O,341,341,6623,500,6802,2455,6282,O
2454,P,4084,4084,10707,6000,12802,2455,6623,P
2455,A,875,875,875,1200,1200,2456,0,A
2455,B,478,478,1353,180,1380,2456,875,B
2455,C,930,930,2283,910,2290,2456,1353,C
2455,D,4416,4416,6699,550,2840,2456,2283,D
2455,M,137,137,6836,393,3233,2456,6699,M
2455,N,491,491,7327,270,3503,2456,6836,N
2455,O,968,968,8295,1160,4663,2456,7327,O
2455,P,2196,2196,10491,695,5358,2456,8295,P
2456,AE,236,236,236,257,257,2457,0,E
2456,AF,147,147,383,240,497,2457,236,F
2456,AG,415,32,415,565,565,2457,0,A
2456,BG,793,793,1208,695,1260,2457,415,B
2456,CG,217,217,1425,345,1605,2457,1208,C
2456,BG,1055,13,1438,1245,1742,2457,383,G
2456,BH,3,3,1441,335,2077,2457,1438,H
2456,B,1408,1392,2833,1275,2880,2457,1425,B
2456,C,956,956,3789,1050,3930,2457,2833,C
2456,D,257,257,4046,1200,5130,2457,3789,D
2456,M,3382,3382,7428,3926,9056,2457,4046,M
2456,N,679,679,8107,180,9236,2457,7428,N
2456,O,918,918,9025,930,10166,2457,8107,O
2456,P,425,425,9450,550,10716,2457,9025,P
2457,AEI,85,85,85,359,359,2458,0,E
2457,AFI,236,151,236,215,215,2458,0,I
2457,AFJ,97,97,333,180,395,2458,236,J
2457,AFK,420,87,420,892,892,2458,0,A
2457,BFK,115,28,448,560,955,2458,333,K
2457,BFL,369,6,454,180,539,2458,85,F
2457,BGL,347,347,801,660,1199,2458,454,G
2457,BHL,605,252,1053,2960,3915,2458,448,L
2457,BH,741,108,1161,300,1192,2458,420,B
2457,CH,190,190,1351,310,1502,2458,1161,C
2457,BH,914,914,2265,825,2327,2458,1351,B
2457,CH,243,243,2508,285,2612,2458,2265,C
2457,DH,534,534,3042,5100,7712,2458,2508,D
2457,H,3259,1018,4060,3960,5159,2458,801,H
2457,M,219,219,4279,746,8458,2458,4060,M
2457,N,625,625,4904,150,8608,2458,4279,N
2457,O,636,636,5540,115,8723,2458,4904,O
2457,N,1735,1735,7275,2255,10978,2458,5540,N
2457,O,125,125,7400,390,11368,2458,7275,O
2457,P,608,608,8008,3960,15328,2458,7400,P
2458,AEI,250,250,250,145,145,2459,0,E
2458,AFI,15,15,265,180,325,2459,250,F
2458,AGI,328,63,328,320,320,2459,0,I
2458,AGJ,172,172,500,240,560,2459,328,J
2458,AGK,419,184,684,840,1165,2459,265,G
2458,AFK,939,755,1439,1020,1580,2459,500,K
2458,AFJ,1633,194,1633,1813,1813,2459,0,A
2458,BFJ,960,11,1644,525,1690,2459,684,F
2458,BGJ,322,117,1761,210,1790,2459,1439,J
2458,BGK,268,140,1901,150,1963,2459,1633,B
2458,CGK,480,480,2381,455,2418,2459,1901,C
2458,BGK,755,18,2399,805,2495,2459,1644,G
2458,BHK,670,32,2431,755,2545,2459,1761,K
2458,BHL,86,54,2485,1140,3635,2459,2399,H
2458,BL,303,199,2684,320,2738,2459,2381,B
2458,CL,212,212,2896,185,2923,2459,2684,C
2458,DL,4489,4024,6920,1140,3685,2459,2431,L
2458,D,5300,1276,8196,4230,7153,2459,2896,D
2458,M,268,268,8464,1208,8361,2459,8196,M
2458,N,1180,1180,9644,300,8661,2459,8464,N
2458,O,225,225,9869,310,8971,2459,9644,O
2458,N,721,721,10590,640,9611,2459,9869,N
2458,O,267,267,10857,290,9901,2459,10590,O
2458,P,4223,4223,15080,5190,15091,2459,10857,P
2459,AEI,133,133,133,273,273,2460,0,I
2459,AEJ,181,181,314,90,363,2460,133,J
2459,AEK,419,419,733,690,1053,2460,314,K
2459,AEJ,1101,1101,1834,825,1878,2460,733,J
2459,AEK,1959,125,1959,2705,2705,2460,0,A
2459,BEK,380,255,2214,735,2613,2460,1834,K
2459,BEL,795,540,2754,90,2795,2460,1959,B
2459,CEL,578,578,3332,855,3650,2460,2754,C
2459,BEL,2454,1336,4668,3780,6393,2460,2214,L
2459,BE,5276,608,5276,5454,5454,2460,0,E
2459,BF,221,221,5497,90,5544,2460,5276,F
2459,BG,456,456,5953,735,6279,2460,5497,G
2459,BH,5898,3277,9230,5630,9280,2460,3332,B
2459,CH,386,386,9616,735,10015,2460,9230,C
2459,DH,999,999,10615,3780,13795,2460,9616,D
2459,H,9500,4838,15453,3780,10059,2460,5953,H
2459,M,391,391,15844,624,14419,2460,15453,M
2459,N,263,263,16107,90,14509,2460,15844,N
2459,O,701,701,16808,805,15314,2460,16107,O
2459,N,1237,1237,18045,1115,16429,2460,16808,N
2459,O,1095,1095,19140,2239,18668,2460,18045,O
2459,P,978,978,20118,846,19514,2460,19140,P
2460,A,2945,2945,2945,2967,2967,2461,0,A
2460,B,202,202,3147,240,3207,2461,2945,B
2460,C,1318,1318,4465,1320,4527,2461,3147,C
2460,B,1074,1074,5539,1035,5562,2461,4465,B
2460,C,903,903,6442,1250,6812,2461,5539,C
2460,D,144,144,6586,335,7147,2461,6442,D
2460,M,719,719,7305,1146,8293,2461,6586,M
2460,N,609,609,7914,180,8473,2461,7305,N
2460,O,924,924,8838,1200,9673,2461,7914,O
2460,N,1736,1736,10574,1550,11223,2461,8838,N
2460,O,656,656,11230,670,11893,2461,10574,O
2460,P,84,84,11314,550,12443,2461,11230,P
2461,A,268,268,268,516,516,2462,0,A
2461,B,280,280,548,90,606,2462,268,B
2461,C,363,363,911,795,1401,2462,548,C
2461,D,1440,1440,2351,3780,5181,2462,911,D
2461,M,5552,5552,7903,5710,10891,2462,2351,M
2461,N,200,200,8103,90,10981,2462,7903,N
2461,O,617,617,8720,820,11801,2462,8103,O
2461,N,954,954,9674,765,12566,2462,8720,N
2461,O,230,230,9904,535,13101,2462,9674,O
2461,P,152,152,10056,3780,16881,2462,9904,P
2462,AEI,139,139,139,295,295,2463,0,I
2462,AEJ,170,31,170,530,530,2463,0,A
2462,BEJ,335,304,474,220,515,2463,139,J
2462,BEK,480,176,650,180,710,2463,170,B
2462,CEK,1135,959,1609,1110,1625,2463,474,K
2462,CEL,1663,54,1663,1648,1648,2463,0,E
2462,CFL,242,242,1905,300,1948,2463,1663,F
2462,CGL,1498,243,2148,1560,2270,2463,650,C
2462,BGL,1077,834,2982,1275,3223,2463,1905,G
2462,BFL,1393,20,3002,385,2010,2463,1609,L
2462,BF,144,124,3126,765,3988,2463,2982,F
2462,BG,1297,319,3445,1235,3505,2463,2148,B
2462,CG,514,195,3640,810,4798,2463,3126,G
2462,CH,358,358,3998,3960,8758,2463,3640,H
2462,C,727,174,4172,570,4075,2463,3445,C
2462,D,1683,1683,5855,550,4625,2463,4172,D
2462,M,1012,1012,6867,1674,10432,2463,5855,M
2462,N,907,907,7774,270,10702,2463,6867,N
2462,O,918,918,8692,1020,11722,2463,7774,O
2462,N,352,352,9044,285,12007,2463,8692,N
2462,O,721,721,9765,800,12807,2463,9044,O
2462,P,255,255,10020,4170,16977,2463,9765,P
2463,AEI,345,345,345,1205,1205,2464,0,I
2463,AEJ,1118,1118,1463,300,1505,2464,345,J
2463,AEK,2232,769,2232,2385,2385,2464,0,A
2463,BEK,243,243,2475,90,2475,2464,2232,B
2463,CEK,2645,170,2645,2749,2749,2464,0,E
2463,CFK,1273,91,2736,895,2400,2464,1463,K
2463,CFL,154,63,2799,90,2839,2464,2645,F
2463,CGL,434,110,2909,815,3290,2464,2475,C
2463,BGL,461,351,3260,820,3659,2464,2799,G
2463,BFL,1059,535,3795,2040,4440,2464,2736,L
2463,BF,680,145,3940,335,3994,2464,3260,F
2463,BG,1425,394,4334,1105,4395,2464,2909,B
2463,CG,1346,952,5286,1840,5834,2464,3940,G
2463,CH,1326,374,5660,1850,6245,2464,4334,C
2463,DH,1059,685,6345,3780,9614,2464,5286,H
2463,D,2431,1746,8091,3780,10025,2464,5660,D
2463,M,307,307,8398,730,10755,2464,8091,M
2463,N,751,751,9149,300,11055,2464,8398,N
2463,O,235,235,9384,405,11460,2464,9149,O
2463,N,204,204,9588,110,11570,2464,9384,N
2463,O,295,295,9883,3030,14600,2464,9588,O
2463,P,5078,5078,14961,1440,16040,2464,9883,P
2464,A,1983,1983,1983,2580,2580,2465,0,A
2464,B,647,647,2630,90,2670,2465,1983,B
2464,C,709,709,3339,1100,3770,2465,2630,C
2464,D,5594,5594,8933,3780,7550,2465,3339,D
2464,M,1056,1056,9989,2329,9879,2465,8933,M
2464,N,1393,1393,11382,180,10059,2465,9989,N
2464,O,960,960,12342,1050,11109,2465,11382,O
2464,N,861,861,13203,830,11939,2465,12342,N
2464,O,332,332,13535,300,12239,2465,13203,O
2464,P,1373,1373,14908,5100,17339,2465,13535,P
2465,AE,363,363,363,1339,1339,2466,0,A
2465,BE,1009,1009,1372,90,1429,2466,363,B
2465,CE,350,350,1722,680,2109,2466,1372,C
2465,DE,677,677,2399,3780,5889,2466,1722,D
2465,E,4950,2551,4950,5161,5161,2466,0,E
2465,F,253,253,5203,90,5251,2466,4950,F
2465,G,527,527,5730,815,6066,2466,5203,G
2465,F,1159,1159,6889,880,6946,2466,5730,F
2465,G,838,838,7727,1080,8026,2466,6889,G
2465,H,46,46,7773,3780,11806,2466,7727,H
2465,M,2904,2904,10677,3052,14858,2466,7773,M
2465,N,185,185,10862,90,14948,2466,10677,N
2465,O,726,726,11588,1130,16078,2466,10862,O
2465,P,53,53,11641,3780,19858,2466,11588,P
2466,A,5592,5592,5592,5662,5662,2467,0,A
2466,B,405,405,5997,360,6022,2467,5592,B
2466,C,290,290,6287,685,6707,2467,5997,C
2466,B,1223,1223,7510,830,7537,2467,6287,B
2466,C,1716,1716,9226,1759,9296,2467,7510,C
2466,D,1336,1336,10562,1096,10392,2467,9226,D
2466,M,1143,1143,11705,1399,11791,2467,10562,M
2466,N,293,293,11998,240,12031,2467,11705,N
2466,O,1170,1170,13168,735,12766,2467,11998,O
2466,P,2708,2708,15876,550,13316,2467,13168,P
2467,A,316,316,316,3508,3508,2468,0,A
2467,B,3277,3277,3593,90,3598,2468,316,B
2467,C,420,420,4013,725,4323,2468,3593,C
2467,D,1942,1942,5955,3780,8103,2468,4013,D
2467,M,9169,9169,15124,9322,17425,2468,5955,M
2467,N,273,273,15397,180,17605,2468,15124,N
2467,O,288,288,15685,955,18560,2468,15397,O
2467,N,997,997,16682,330,18890,2468,15685,N
2467,O,639,639,17321,850,19740,2468,16682,O
2467,P,107,107,17428,2580,22320,2468,17321,P
2468,AEI,176,176,176,1362,1362,2469,0,A
2468,BEI,185,9,185,742,742,2469,0,E
2468,BFI,368,183,368,1018,1018,2469,0,I
2468,BFJ,651,468,836,150,892,2469,185,F
2468,BGJ,94,94,930,95,987,2469,836,G
2468,BFJ,851,289,1219,240,1258,2469,368,J
2468,BFK,613,324,1543,585,1572,2469,930,F
2468,BGK,1384,17,1560,240,1602,2469,176,B
2468,CGK,876,535,2095,1020,2278,2469,1219,K
2468,CGL,753,201,2296,665,2237,2469,1543,G
2468,CHL,790,54,2350,995,2597,2469,1560,C
2468,DHL,527,272,2622,4680,6958,2469,2095,L
2468,DH,1171,845,3467,4290,6527,2469,2296,H
2468,D,4283,3166,6633,4680,7277,2469,2350,D
2468,M,935,935,7568,1199,8476,2469,6633,M
2468,N,445,445,8013,180,8656,2469,7568,N
2468,O,962,962,8975,930,9586,2469,8013,O
2468,P,4958,4958,13933,550,10136,2469,8975,P
2469,A,9,9,9,487,487,2470,0,A
2469,B,592,592,601,150,637,2470,9,B
2469,C,211,211,812,145,782,2470,601,C
2469,D,201,201,1013,4230,5012,2470,812,D
2469,M,397,397,1410,955,5967,2470,1013,M
2469,N,668,668,2078,150,6117,2470,1410,N
2469,O,176,176,2254,140,6257,2470,2078,O
2469,N,321,321,2575,360,6617,2470,2254,N
2469,O,1053,1053,3628,655,7272,2470,2575,O
2469,P,5394,5394,9022,4230,11502,2470,3628,P
2470,AEI,141,141,141,171,171,2471,0,A
2470,BEI,125,125,266,150,321,2471,141,B
2470,CEI,179,179,445,140,461,2471,266,C
2470,BEI,450,5,450,1948,1948,2471,0,I
2470,BEJ,669,219,669,1432,1432,2471,0,E
2470,BFJ,883,659,1328,900,1361,2471,445,B
2470,CFJ,819,160,1488,90,1522,2471,669,F
2470,CGJ,350,190,1678,650,2011,2471,1328,C
2470,DGJ,495,305,1983,880,2402,2471,1488,G
2470,DFJ,1678,145,2128,240,2188,2471,450,J
2470,DFK,481,336,2464,110,2512,2471,1983,F
2470,DGK,1433,1433,3897,2315,4827,2471,2464,G
2470,DHK,1784,15,3912,2130,4318,2471,2128,K
2470,DHJ,3883,3883,7795,3545,7863,2471,3912,J
2470,DHK,4558,660,8455,3420,8247,2471,3897,H
2470,DK,740,80,8535,926,8789,2471,7795,K
2470,DL,7548,691,9226,4230,6241,2471,1678,D
2470,L,2232,1541,10767,414,9203,2471,8535,L
2470,M,2464,2464,13231,3000,12203,2471,10767,M
2470,N,656,656,13887,240,12443,2471,13231,N
2470,O,1309,1309,15196,875,13318,2471,13887,O
2470,P,332,332,15528,660,13978,2471,15196,P
2471,A,289,289,289,918,918,2472,0,A
2471,B,809,809,1098,240,1158,2472,289,B
2471,C,939,939,2037,995,2153,2472,1098,C
2471,D,7241,7241,9278,4680,6833,2472,2037,D
2471,M,3424,3424,12702,3581,10414,2472,9278,M
2471,N,245,245,12947,90,10504,2472,12702,N
2471,O,675,675,13622,815,11319,2472,12947,O
2471,N,913,913,14535,830,12149,2472,13622,N
2471,O,456,456,14991,800,12949,2472,14535,O
2471,P,864,864,15855,3780,16729,2472,14991,P
2472,AEI,321,321,321,459,459,2473,0,E
2472,AFI,444,123,444,350,350,2473,0,A
2472,BFI,489,45,489,650,650,2473,0,I
2472,BFJ,86,41,530,240,590,2473,444,B
2472,CFJ,233,24,554,180,639,2473,321,F
2472,CGJ,63,63,617,660,1299,2473,554,G
2472,CFJ,161,33,650,150,800,2473,489,J
2472,CFK,38,38,688,690,1490,2473,650,K
2472,CFJ,572,414,1102,660,1250,2473,530,C
2472,BFJ,240,240,1342,145,1395,2473,1102,B
2472,CFJ,768,43,1385,140,1439,2473,617,F
2472,CGJ,686,643,2028,805,2200,2473,1342,C
2472,DGJ,694,51,2079,835,2274,2473,1385,G
2472,DHJ,2355,964,3043,175,1665,2473,688,J
2472,DHK,1104,89,3132,3960,6160,2473,2028,D
2472,HK,728,639,3771,805,2470,2473,3043,K
2472,HL,4109,2417,6188,3960,6234,2473,2079,H
2472,L,4509,2092,8280,3960,6430,2473,3771,L
2472,M,1337,1337,9617,4847,11277,2473,8280,M
2472,N,3532,3532,13149,90,11367,2473,9617,N
2472,O,1211,1211,14360,1600,12967,2473,13149,O
2472,N,948,948,15308,550,13517,2473,14360,N
2472,O,696,696,16004,900,14417,2473,15308,O
2472,P,79,79,16083,3780,18197,2473,16004,P
2473,A,894,894,894,1208,1208,2474,0,A
2473,B,480,480,1374,180,1388,2474,894,B
2473,C,852,852,2226,900,2288,2474,1374,C
2473,D,3033,3033,5259,550,2838,2474,2226,D
2473,M,492,492,5751,1035,3873,2474,5259,M
2473,N,633,633,6384,150,4023,2474,5751,N
2473,O,1,1,6385,50,4073,2474,6384,O
2473,N,200,200,6585,135,4208,2474,6385,N
2473,O,207,207,6792,295,4503,2474,6585,O
2473,P,1267,1267,8059,5160,9663,2474,6792,P
2474,AEI,70,70,70,1138,1138,2475,0,A
2474,BEI,831,761,831,1293,1293,2475,0,E
2474,BFI,1101,340,1171,90,1228,2475,70,B
2474,CFI,495,155,1326,90,1383,2475,831,F
2474,CGI,1010,855,2181,1220,2448,2475,1171,C
2474,DGI,7,7,2188,3780,6228,2475,2181,D
2474,GI,985,123,2311,1250,2633,2475,1326,G
2474,HI,9,9,2320,3780,6413,2475,2311,H
2474,I,37089,34769,37089,37994,37994,2475,0,I
2474,J,935,935,38024,90,38084,2475,37089,J
2474,K,989,989,39013,1220,39304,2475,38024,K
2474,L,15,15,39028,3780,43084,2475,39013,L
2474,M,3578,3578,42606,4155,47239,2475,39028,M
2474,N,606,606,43212,90,47329,2475,42606,N
2474,O,148,148,43360,585,47914,2475,43212,O
2474,P,12936,12936,56296,3780,51694,2475,43360,P
2475,AEI,45,45,45,130,130,2476,0,E
2475,AFI,49,4,49,612,612,2476,0,A
2475,BFI,86,37,86,635,635,2476,0,I
2475,BFJ,188,147,233,150,280,2476,45,F
2475,BGJ,664,480,713,150,762,2476,49,B
2475,CGJ,728,101,814,240,875,2476,86,J
2475,CGK,614,33,847,765,1045,2476,233,G
2475,CHK,164,30,877,135,897,2476,713,C
2475,DHK,320,257,1134,255,1130,2476,814,K
2475,DHL,427,140,1274,3600,4645,2476,847,H
2475,DL,463,66,1340,4230,5127,2476,877,D
2475,L,3010,2804,4144,5160,6290,2476,1134,L
2475,M,1124,1124,5268,1112,7402,2476,4144,M
2475,N,101,101,5369,600,8002,2476,5268,N
2475,O,1650,1650,7019,2220,10222,2476,5369,O
2475,N,1203,1203,8222,175,10397,2476,7019,N
2475,O,1110,1110,9332,1295,11692,2476,8222,O
2475,P,3235,3235,12567,3660,15352,2476,9332,P
2476,AE,19,19,19,45,45,2477,0,A
2476,BE,144,125,144,418,418,2477,0,E
2476,BF,224,99,243,240,285,2477,19,B
2476,CF,384,285,528,150,568,2477,144,F
2476,CG,663,378,906,895,1180,2477,243,C
2476,DG,852,474,1380,840,1408,2477,528,G
2476,DF,440,440,1820,295,1703,2477,1380,F
2476,DG,1108,194,2014,3960,5140,2477,906,D
2476,G,3105,2911,4925,625,2328,2477,1820,G
2476,H,99,99,5024,4230,6558,2477,4925,H
2476,M,38,38,5062,313,6871,2477,5024,M
2476,N,398,398,5460,180,7051,2477,5062,N
2476,O,734,734,6194,695,7746,2477,5460,O
2476,N,2055,2055,8249,1930,9676,2477,6194,N
2476,O,1000,1000,9249,900,10576,2477,8249,O
2476,P,1228,1228,10477,3960,14536,2477,9249,P
2477,A,334,334,334,1775,1775,2478,0,A
2477,B,1686,1686,2020,90,1865,2478,334,B
2477,C,1293,1293,3313,1360,3225,2478,2020,C
2477,D,55,55,3368,3780,7005,2478,3313,D
2477,M,2231,2231,5599,2639,9644,2478,3368,M
2477,N,474,474,6073,90,9734,2478,5599,N
2477,O,513,513,6586,880,10614,2478,6073,O
2477,P,5310,5310,11896,3780,14394,2478,6586,P
2478,A,309,309,309,367,367,2479,0,A
2478,B,295,295,604,270,637,2479,309,B
2478,C,937,937,1541,840,1477,2479,604,C
2478,D,2427,2427,3968,550,2027,2479,1541,D
2478,M,689,689,4657,1652,3679,2479,3968,M
2478,N,1343,1343,6000,420,4099,2479,4657,N
2478,O,978,978,6978,1114,5213,2479,6000,O
2478,P,49,49,7027,341,5554,2479,6978,P
2479,AE,160,160,160,1567,1567,2480,0,A
2479,BE,1471,1471,1631,135,1702,2480,160,B
2479,CE,592,592,2223,615,2317,2480,1631,C
2479,DE,349,349,2572,1520,3837,2480,2223,D
2479,E,2783,211,2783,2852,2852,2480,0,E
2479,F,269,269,3052,240,3092,2480,2783,F
2479,G,693,693,3745,1160,4252,2480,3052,G
2479,H,1364,1364,5109,3360,7612,2480,3745,H
2479,M,64,64,5173,614,8226,2480,5109,M
2479,N,716,716,5889,180,8406,2480,5173,N
2479,O,127,127,6016,380,8786,2480,5889,O
2479,P,805,805,6821,3960,12746,2480,6016,P
2480,AE,2089,2089,2089,2184,2184,2481,0,A
2480,BE,120,120,2209,90,2274,2481,2089,B
2480,CE,2218,9,2218,2828,2828,2481,0,E
2480,CF,630,621,2839,820,3094,2481,2209,C
2480,BF,740,119,2958,90,2918,2481,2218,F
2480,BG,853,734,3692,655,3749,2481,2839,B
2480,CG,1046,312,4004,1450,4368,2481,2958,G
2480,CF,667,355,4359,935,4684,2481,3692,C
2480,DF,363,8,4367,30,4398,2481,4004,F
2480,DG,593,593,4960,920,5318,2481,4367,G
2480,DH,882,281,5241,3780,8464,2481,4359,D
2480,H,1022,741,5982,3780,9098,2481,4960,H
2480,M,531,531,6513,1516,10614,2481,5982,M
2480,N,1018,1018,7531,90,10704,2481,6513,N
2480,O,634,634,8165,935,11639,2481,7531,O
2480,N,1122,1122,9287,815,12454,2481,8165,N
2480,O,693,693,9980,935,13389,2481,9287,O
2480,P,894,894,10874,3780,17169,2481,9980,P
2481,AEI,83,83,83,657,657,2482,0,E
2481,AFI,102,19,102,269,269,2482,0,I
2481,AFJ,359,359,461,240,509,2482,102,J
2481,AFK,226,226,687,285,794,2482,461,K
2481,AFL,775,171,858,240,897,2482,83,F
2481,AGL,165,165,1023,280,1177,2482,858,G
2481,AHL,224,224,1247,5160,6337,2482,1023,H
2481,AL,815,255,1502,5160,5954,2482,687,L
2481,A,1718,216,1718,2329,2329,2482,0,A
2481,B,636,636,2354,90,2419,2482,1718,B
2481,C,474,474,2828,820,3239,2482,2354,C
2481,B,4632,4632,7460,4285,7524,2482,2828,B
2481,C,1347,1347,8807,1405,8929,2482,7460,C
2481,D,2357,2357,11164,3780,12709,2482,8807,D
2481,M,1597,1597,12761,4470,17179,2482,11164,M
2481,N,2957,2957,15718,90,17269,2482,12761,N
2481,O,846,846,16564,1250,18519,2482,15718,O
2481,N,946,946,17510,600,19119,2482,16564,N
2481,O,306,306,17816,705,19824,2482,17510,O
2481,P,1653,1653,19469,3780,23604,2482,17816,P
2482,AE,13,13,13,220,220,2483,0,E
2482,AF,162,149,162,280,280,2483,0,A
2482,BF,396,247,409,240,460,2483,13,F
2482,BG,166,166,575,285,745,2483,409,G
2482,BH,474,61,636,300,580,2483,162,B
2482,CH,654,654,1290,795,1375,2483,636,C
2482,DH,1701,986,2276,5160,5905,2483,575,H
2482,D,1414,428,2704,1140,2515,2483,1290,D
2482,M,913,913,3617,1995,7900,2483,2704,M
2482,N,1238,1238,4855,150,8050,2483,3617,N
2482,O,1436,1436,6291,1685,9735,2483,4855,O
2482,P,1402,1402,7693,2520,12255,2483,6291,P
2483,AE,48,48,48,986,986,2484,0,A
2483,BE,104,56,104,1063,1063,2484,0,E
2483,BF,1138,1082,1186,240,1226,2484,48,B
2483,CF,1146,64,1250,240,1303,2484,104,F
2483,CG,828,764,2014,1020,2246,2484,1186,C
2483,DG,844,80,2094,1020,2323,2484,1250,G
2483,DH,235,155,2249,4680,6926,2484,2014,D
2483,H,1701,1546,3795,4680,7003,2484,2094,H
2483,M,901,901,4696,1277,8280,2484,3795,M
2483,N,515,515,5211,180,8460,2484,4696,N
2483,O,960,960,6171,900,9360,2484,5211,O
2483,P,2773,2773,8944,550,9910,2484,6171,P
2484,A,28,28,28,104,104,2485,0,A
2484,B,157,157,185,135,239,2485,28,B
2484,C,155,155,340,290,529,2485,185,C
2484,D,202,202,542,5160,5689,2485,340,D
2484,M,617,617,1159,1130,6819,2485,542,M
2484,N,543,543,1702,90,6909,2485,1159,N
2484,O,1039,1039,2741,1250,8159,2485,1702,O
2484,P,3,3,2744,3780,11939,2485,2741,P
2485,AE,317,317,317,878,878,2486,0,E
2485,AF,751,751,1068,240,1118,2486,317,F
2485,AG,241,241,1309,400,1518,2486,1068,G
2485,AF,1378,69,1378,2994,2994,2486,0,A
2485,BF,904,835,2213,590,2108,2486,1309,F
2485,BG,462,462,2675,810,2918,2486,2213,G
2485,BH,2181,884,3559,180,3174,2486,1378,B
2485,CH,1350,1350,4909,835,4009,2486,3559,C
2485,BH,819,819,5728,1765,5774,2486,4909,B
2485,CH,537,537,6265,610,6384,2486,5728,C
2485,DH,4312,722,6987,4020,6938,2486,2675,H
2485,D,1868,1146,8133,6960,13344,2486,6265,D
2485,M,219,219,8352,418,13762,2486,8133,M
2485,N,610,610,8962,420,14182,2486,8352,N
2485,O,1041,1041,10003,1215,15397,2486,8962,O
2485,P,100,100,10103,350,15747,2486,10003,P
2486,AE,108,108,108,1038,1038,2487,0,E
2486,AF,1113,1113,1221,240,1278,2487,108,F
2486,AG,726,726,1947,780,2058,2487,1221,G
2486,AH,2550,603,2550,2920,2920,2487,0,A
2486,BH,862,259,2809,7680,9738,2487,1947,H
2486,B,634,375,3184,300,3220,2487,2550,B
2486,C,972,972,4156,1045,4265,2487,3184,C
2486,D,1214,1214,5370,1140,5405,2487,4156,D
2486,M,1200,1200,6570,1554,11292,2487,5370,M
2486,N,601,601,7171,300,11592,2487,6570,N
2486,O,651,651,7822,825,12417,2487,7171,O
2486,N,1238,1238,9060,1080,13497,2487,7822,N
2486,O,250,250,9310,515,14012,2487,9060,O
2486,P,18750,18750,28060,6150,20162,2487,9310,P
2487,A,4038,4038,4038,4676,4676,2488,0,A
2487,B,687,687,4725,90,4766,2488,4038,B
2487,C,375,375,5100,795,5561,2488,4725,C
2487,D,1031,1031,6131,3780,9341,2488,5100,D
2487,M,1205,1205,7336,1575,10916,2488,6131,M
2487,N,630,630,7966,300,11216,2488,7336,N
2487,O,986,986,8952,1045,12261,2488,7966,O
2487,P,73,73,9025,1140,13401,2488,8952,P
2488,A,3493,3493,3493,3703,3703,2489,0,A
2488,B,244,244,3737,90,3793,2489,3493,B
2488,C,1185,1185,4922,1315,5108,2489,3737,C
2488,D,585,585,5507,3780,8888,2489,4922,D
2488,M,116,116,5623,340,9228,2489,5507,M
2488,N,505,505,6128,240,9468,2489,5623,N
2488,O,989,989,7117,885,10353,2489,6128,O
2488,P,1202,1202,8319,3720,14073,2489,7117,P
2489,AEI,271,271,271,195,195,2490,0,E
2489,AFI,352,81,352,750,750,2490,0,I
2489,AFJ,267,186,538,300,495,2490,271,F
2489,AGJ,266,266,804,775,1270,2490,538,G
2489,AFJ,708,256,1060,300,1050,2490,352,J
2489,AFK,231,231,1291,405,1455,2490,1060,K
2489,AFJ,632,145,1436,185,1455,2490,804,F
2489,AGJ,218,218,1654,1360,2815,2490,1436,G
2489,AHJ,1360,997,2651,1255,2710,2490,1291,J
2489,AHK,214,214,2865,1360,4070,2490,2651,K
2489,AHL,1476,265,3130,3060,5875,2490,1654,H
2489,AL,3825,695,3825,4530,4530,2490,0,A
2489,BL,1220,260,4085,3060,7130,2490,2865,L
2489,B,945,685,4770,300,4830,2490,3825,B
2489,C,918,918,5688,1220,6050,2490,4770,C
2489,B,659,659,6347,335,6385,2490,5688,B
2489,C,1189,1189,7536,535,6920,2490,6347,C
2489,B,261,261,7797,930,7850,2490,7536,B
2489,C,171,171,7968,1360,9210,2490,7797,C
2489,D,1543,1543,9511,3060,12270,2490,7968,D
2489,M,1614,1614,11125,1485,13755,2490,9511,M
2489,N,875,875,12000,1065,14820,2490,11125,N
2489,O,283,283,12283,455,15275,2490,12000,O
2489,N,1485,1485,13768,1300,16575,2490,12283,N
2489,O,208,208,13976,950,17525,2490,13768,O
2489,P,858,858,14834,1680,19205,2490,13976,P
2490,AE,57,57,57,217,217,2491,0,A
2490,BE,238,238,295,135,352,2491,57,B
2490,CE,405,110,405,713,713,2491,0,E
2490,CF,166,56,461,295,647,2491,295,C
2490,DF,340,284,745,90,803,2491,405,F
2490,DG,951,667,1412,5100,5747,2491,461,D
2490,G,1134,467,1879,1425,2228,2491,745,G
2490,H,338,338,2217,3780,6008,2491,1879,H
2490,M,1104,1104,3321,1952,7960,2491,2217,M
2490,N,995,995,4316,180,8140,2491,3321,N
2490,O,946,946,5262,895,9035,2491,4316,O
2490,N,393,393,5655,450,9485,2491,5262,N
2490,O,499,499,6154,690,10175,2491,5655,O
2490,P,1890,1890,8044,6660,16835,2491,6154,P
2491,AEI,162,162,162,772,772,2492,0,E
2491,AFI,367,205,367,526,526,2492,0,A
2491,BFI,205,205,572,240,766,2492,367,B
2491,CFI,704,294,866,150,922,2492,162,F
2491,CGI,174,174,1040,95,1017,2492,866,G
2491,CFI,525,525,1565,585,1602,2492,1040,F
2491,CGI,1512,519,2084,1680,2446,2492,572,C
2491,BGI,723,204,2288,665,2267,2492,1565,G
2491,BHI,1186,1186,3474,4230,6497,2492,2288,H
2491,BI,2241,851,4325,1926,4372,2492,2084,B
2491,CI,1147,1147,5472,1240,5612,2492,4325,C
2491,DI,321,321,5793,335,5947,2492,5472,D
2491,I,13956,8163,13956,13950,13950,2492,0,I
2491,J,248,248,14204,300,14250,2492,13956,J
2491,K,905,905,15109,1005,15255,2492,14204,K
2491,L,723,723,15832,1200,16455,2492,15109,L
2491,M,785,785,16617,937,17392,2492,15832,M
2491,N,240,240,16857,90,17482,2492,16617,N
2491,O,633,633,17490,815,18297,2492,16857,O
2491,N,3033,3033,20523,2915,21212,2492,17490,N
2491,O,368,368,20891,740,21952,2492,20523,O
2491,P,1176,1176,22067,3780,25732,2492,20891,P
2492,A,808,808,808,1068,1068,2493,0,A
2492,B,253,253,1061,150,1218,2493,808,B
2492,C,351,351,1412,290,1508,2493,1061,C
2492,B,1871,1871,3283,1825,3333,2493,1412,B
2492,C,582,582,3865,655,3988,2493,3283,C
2492,D,425,425,4290,4230,8218,2493,3865,D
2492,M,4082,4082,8372,4410,12628,2493,4290,M
2492,N,410,410,8782,90,12718,2493,8372,N
2492,O,484,484,9266,860,13578,2493,8782,O
2492,N,1057,1057,10323,705,14283,2493,9266,N
2492,O,768,768,11091,1060,15343,2493,10323,O
2492,P,1090,1090,12181,3780,19123,2493,11091,P
2493,AE,196,196,196,721,721,2494,0,E
2493,AF,1028,1028,1224,540,1261,2494,196,F
2493,AG,587,587,1811,845,2106,2494,1224,G
2493,AF,937,937,2748,690,2796,2494,1811,F
2493,AG,3464,716,3464,4186,4186,2494,0,A
2493,BG,841,125,3589,1310,4106,2494,2748,G
2493,BH,320,320,3909,1175,5281,2494,3589,H
2493,B,1473,1028,4937,780,4966,2494,3464,B
2493,C,707,707,5644,835,5801,2494,4937,C
2493,D,1497,1497,7141,350,6151,2494,5644,D
2493,M,852,852,7993,1027,7178,2494,7141,M
2493,N,332,332,8325,120,7298,2494,7993,N
2493,O,783,783,9108,1025,8323,2494,8325,O
2493,N,1096,1096,10204,965,9288,2494,9108,N
2493,O,2059,2059,12263,2062,11350,2494,10204,O
2493,P,2062,2062,14325,668,12018,2494,12263,P
2494,AEI,541,541,541,1101,1101,2495,0,A
2494,BEI,814,814,1355,300,1401,2495,541,B
2494,CEI,754,754,2109,780,2181,2495,1355,C
2494,DEI,2630,521,2630,3148,3148,2495,0,I
2494,DEJ,713,713,3343,240,3388,2495,2630,J
2494,DEK,1517,283,3626,4080,6261,2495,2109,D
2494,EK,4389,763,4389,6531,6531,2495,0,E
2494,FK,1470,424,4813,925,4313,2495,3343,K
2494,FL,255,255,5068,3960,8273,2495,4813,L
2494,F,2398,1719,6787,300,6831,2495,4389,F
2494,G,682,682,7469,820,7651,2495,6787,G
2494,H,4119,4119,11588,4080,11731,2495,7469,H
2494,M,600,600,12188,1751,13482,2495,11588,M
2494,N,1416,1416,13604,300,13782,2495,12188,N
2494,O,652,652,14256,785,14567,2495,13604,O
2494,P,380,380,14636,4080,18647,2495,14256,P
2495,AE,261,261,261,357,357,2496,0,A
2495,BE,302,41,302,459,459,2496,0,E
2495,BF,151,110,412,110,467,2496,261,B
2495,CF,13,13,425,50,517,2496,412,C
2495,BF,128,128,553,95,612,2496,425,B
2495,CF,114,114,667,385,997,2496,553,C
2495,DF,425,60,727,300,759,2496,302,F
2495,DG,635,575,1302,6115,7112,2496,667,D
2495,G,995,420,1722,1110,1869,2496,727,G
2495,F,1359,1359,3081,1260,3129,2496,1722,F
2495,G,1224,1224,4305,1220,4349,2496,3081,G
2495,H,359,359,4664,3120,7469,2496,4305,H
2495,M,109,109,4773,88,7557,2496,4664,M
2495,N,99,99,4872,180,7737,2496,4773,N
2495,O,196,196,5068,265,8002,2496,4872,O
2495,N,1097,1097,6165,1020,9022,2496,5068,N
2495,O,146,146,6311,235,9257,2496,6165,O
2495,P,2431,2431,8742,5280,14537,2496,6311,P
2496,A,510,510,510,555,555,2497,0,A
2496,B,168,168,678,180,735,2497,510,B
2496,C,248,248,926,155,890,2497,678,C
2496,D,12,12,938,2880,3770,2497,926,D
2496,M,1370,1370,2308,1334,5104,2497,938,M
2496,N,152,152,2460,240,5344,2497,2308,N
2496,O,171,171,2631,405,5749,2497,2460,O
2496,N,865,865,3496,620,6369,2497,2631,N
2496,O,649,649,4145,920,7289,2497,3496,O
2496,P,6015,6015,10160,3960,11249,2497,4145,P
2497,AEI,1429,1429,1429,1584,1584,2498,0,I
2497,AEJ,1487,58,1487,1543,1543,2498,0,E
2497,AFJ,1509,22,1509,1572,1572,2498,0,A
2497,BFJ,155,133,1642,150,1693,2498,1487,F
2497,BGJ,272,59,1701,150,1734,2498,1429,J
2497,BGK,210,18,1719,150,1722,2498,1509,B
2497,CGK,551,474,2193,850,2543,2498,1642,G
2497,CFK,594,102,2295,585,2319,2498,1701,K
2497,CFJ,622,46,2341,580,2302,2498,1719,C
2497,BFJ,399,251,2592,100,2643,2498,2193,F
2497,BGJ,288,37,2629,370,2672,2498,2341,B
2497,CGJ,394,60,2689,400,2719,2498,2295,J
2497,CGK,110,50,2739,125,2797,2498,2629,C
2497,DGK,136,86,2825,120,2839,2498,2689,K
2497,DGL,1272,1039,3864,2495,5138,2498,2592,G
2497,DHL,1816,1816,5680,1860,6998,2498,3864,H
2497,DL,5474,2619,8299,4230,7069,2498,2825,L
2497,D,6768,1208,9507,4230,7027,2498,2739,D
2497,M,106,106,9613,380,7449,2498,9507,M
2497,N,328,328,9941,120,7569,2498,9613,N
2497,O,153,153,10094,125,7694,2498,9941,O
2497,P,842,842,10936,2880,10574,2498,10094,P
2498,AE,1418,1418,1418,1737,1737,2499,0,E
2498,AF,1823,405,1823,2293,2293,2499,0,A
2498,BF,529,124,1947,270,2007,2499,1418,F
2498,BG,495,371,2318,90,2383,2499,1823,B
2498,CG,466,466,2784,820,3203,2499,2318,C
2498,BG,1151,1151,3935,760,3963,2499,2784,B
2498,CG,353,353,4288,800,4763,2499,3935,C
2498,DG,2739,398,4686,2775,4782,2499,1947,G
2498,DF,769,371,5057,3780,8543,2499,4288,D
2498,F,844,473,5530,725,5507,2499,4686,F
2498,G,1089,1089,6619,1240,6747,2499,5530,G
2498,H,8,8,6627,335,7082,2499,6619,H
2498,M,1995,1995,8622,2811,11354,2499,6627,M
2498,N,883,883,9505,90,11444,2499,8622,N
2498,O,572,572,10077,820,12264,2499,9505,O
2498,N,1053,1053,11130,845,13109,2499,10077,N
2498,O,466,466,11596,740,13849,2499,11130,O
2498,P,3736,3736,15332,3780,17629,2499,11596,P
2499,A,438,438,438,630,630,2500,0,A
2499,B,424,424,862,90,720,2500,438,B
2499,C,527,527,1389,720,1440,2500,862,C
2499,D,86,86,1475,3780,5220,2500,1389,D
2499,M,191,191,1666,1255,6475,2500,1475,M
2499,N,1217,1217,2883,180,6655,2500,1666,N
2499,O,1107,1107,3990,1133,7788,2500,2883,O
2499,P,9175,9175,13165,4080,11868,2500,3990,P
2500,AEI,108,108,108,1068,1068,2501,0,E
2500,AFI,619,511,619,2605,2605,2501,0,I
2500,AFJ,1139,628,1247,240,1308,2501,108,F
2500,AGJ,807,807,2054,940,2248,2501,1247,G
2500,AHJ,2184,749,2803,240,2845,2501,619,J
2500,AHK,382,382,3185,960,3805,2501,2803,K
2500,AHL,560,560,3745,3960,7765,2501,3185,L
2500,AH,4645,900,4645,4831,4831,2501,0,A
2500,BH,227,227,4872,90,4921,2501,4645,B
2500,CH,353,353,5225,595,5516,2501,4872,C
2500,BH,658,658,5883,260,5776,2501,5225,B
2500,CH,1253,1253,7136,1810,7586,2501,5883,C
2500,DH,6057,975,8111,6990,9238,2501,2054,H
2500,D,4308,3333,11444,3780,11366,2501,7136,D
2500,M,210,210,11654,291,11657,2501,11444,M
2500,N,253,253,11907,240,11897,2501,11654,N
2500,O,748,748,12655,975,12872,2501,11907,O
2500,N,841,841,13496,605,13477,2501,12655,N
2500,O,203,203,13699,260,13737,2501,13496,O
2500,P,14647,14647,28346,5160,18897,2501,13699,P
2501,AEI,2195,2195,2195,2598,2598,2502,0,I
2501,AEJ,429,429,2624,90,2688,2502,2195,J
2501,AEK,569,569,3193,815,3503,2502,2624,K
2501,AEJ,294,294,3487,45,3548,2502,3193,J
2501,AEK,369,369,3856,740,4288,2502,3487,K
2501,AEL,4268,412,4268,6138,6138,2502,0,A
2501,BEL,5306,1038,5306,5447,5447,2502,0,E
2501,BFL,168,168,5474,90,5537,2502,5306,F
2501,BGL,414,414,5888,740,6277,2502,5474,G
2501,BHL,1903,283,6171,90,6228,2502,4268,B
2501,CHL,492,492,6663,735,6963,2502,6171,C
2501,DHL,5162,2355,9018,3780,8068,2502,3856,L
2501,DH,13066,10711,19729,3780,10743,2502,6663,D
2501,H,51554,37713,57442,3780,10057,2502,5888,H
2501,M,1323,1323,58765,2036,12779,2502,57442,M
2501,N,743,743,59508,90,12869,2502,58765,N
2501,O,631,631,60139,805,13674,2502,59508,O
2501,N,1853,1853,61992,1650,15324,2502,60139,N
2501,O,909,909,62901,2049,17373,2502,61992,O
2501,P,738,738,63639,846,18219,2502,62901,P
2502,AE,96,96,96,1167,1167,2503,0,E
2502,AF,299,203,299,2004,2004,2503,0,A
2502,BF,1101,898,1197,90,1257,2503,96,F
2502,BG,1735,837,2034,90,2094,2503,299,B
2502,CG,964,127,2161,1210,2467,2503,1197,G
2502,CH,65,65,2226,3780,6247,2503,2161,H
2502,C,585,393,2619,950,3044,2503,2034,C
2502,D,508,508,3127,3780,6824,2503,2619,D
2502,M,2963,2963,6090,3743,10567,2503,3127,M
2502,N,809,809,6899,90,10657,2503,6090,N
2502,O,809,809,7708,1100,11757,2503,6899,O
2502,P,23,23,7731,3780,15537,2503,7708,P
2503,AEI,76,76,76,1156,1156,2504,0,A
2503,BEI,613,537,613,764,764,2504,0,E
2503,BFI,175,175,788,90,854,2504,613,F
2503,BGI,1110,398,1186,90,1246,2504,76,B
2503,CGI,487,89,1275,905,1759,2504,788,G
2503,CHI,495,495,1770,3780,5539,2504,1275,H
2503,CI,982,398,2168,1210,2456,2504,1186,C
2503,DI,12,12,2180,3780,6236,2504,2168,D
2503,I,4237,2057,4237,4537,4537,2504,0,I
2503,J,318,318,4555,90,4627,2504,4237,J
2503,K,454,454,5009,905,5532,2504,4555,K
2503,L,298,298,5307,3780,9312,2504,5009,L
2503,M,1248,1248,6555,1638,10950,2504,5307,M
2503,N,414,414,6969,90,11040,2504,6555,N
2503,O,89,89,7058,735,11775,2504,6969,O
2503,P,18292,18292,25350,3780,15555,2504,7058,P
2504,A,260,260,260,450,450,2505,0,A
2504,B,250,250,510,120,570,2505,260,B
2504,C,833,833,1343,1020,1590,2505,510,C
2504,D,229,229,1572,4740,6330,2505,1343,D
2504,M,573,573,2145,2035,8365,2505,1572,M
2504,N,1660,1660,3805,180,8545,2505,2145,N
2504,O,787,787,4592,1035,9580,2505,3805,O
2504,N,828,828,5420,695,10275,2505,4592,N
2504,O,312,312,5732,390,10665,2505,5420,O
2504,P,7941,7941,13673,485,11150,2505,5732,P
2505,AE,117,117,117,727,727,2506,0,E
2505,AF,156,39,156,853,853,2506,0,A
2505,BF,870,870,1026,240,1093,2506,156,B
2505,CF,1161,252,1278,240,967,2506,117,F
2505,CG,372,120,1398,845,1938,2506,1026,C
2505,DG,477,477,1875,3720,5658,2506,1398,D
2505,G,744,147,2022,845,1812,2506,1278,G
2505,H,124,124,2146,3720,5532,2506,2022,H
2505,M,17,17,2163,1397,7055,2506,2146,M
2505,N,1410,1410,3573,90,7145,2506,2163,N
2505,O,786,786,4359,1170,8315,2506,3573,O
2505,N,828,828,5187,425,8740,2506,4359,N
2505,O,675,675,5862,1060,9800,2506,5187,O
2505,P,1059,1059,6921,3780,13580,2506,5862,P
2506,AE,737,737,737,1140,1140,2507,0,E
2506,AF,523,523,1260,180,1320,2507,737,F
2506,AG,1109,1109,2369,1045,2365,2507,1260,G
2506,AH,1347,1347,3716,550,2915,2507,2369,H
2506,A,4965,1249,4965,8192,8192,2507,0,A
2506,B,3587,3587,8552,420,8612,2507,4965,B
2506,C,1040,1040,9592,985,9597,2507,8552,C
2506,D,2335,2335,11927,550,10147,2507,9592,D
2506,M,25374,25374,37301,26332,36479,2507,11927,M
2506,N,1306,1306,38607,420,36899,2507,37301,N
2506,O,473,473,39080,790,37689,2507,38607,O
2506,P,1706,1706,40786,1265,38954,2507,39080,P
2507,A,145,145,145,1756,1756,2508,0,A
2507,B,1784,1784,1929,240,1996,2508,145,B
2507,C,1163,1163,3092,1140,3136,2508,1929,C
2507,D,1634,1634,4726,550,3686,2508,3092,D
2507,M,118,118,4844,382,4068,2508,4726,M
2507,N,422,422,5266,180,4248,2508,4844,N
2507,O,484,484,5750,830,5078,2508,5266,O
2507,P,476,476,6226,6680,11758,2508,5750,P
2508,A,1136,1136,1136,1405,1405,2509,0,A
2508,B,299,299,1435,300,1705,2509,1136,B
2508,C,704,704,2139,720,2425,2509,1435,C
2508,B,1294,1294,3433,920,3345,2509,2139,B
2508,C,655,655,4088,910,4255,2509,3433,C
2508,D,2951,2951,7039,3960,8215,2509,4088,D
2508,M,4650,4650,11689,4575,12790,2509,7039,M
2508,N,189,189,11878,300,13090,2509,11689,N
2508,O,705,705,12583,855,13945,2509,11878,O
2508,N,318,318,12901,185,14130,2509,12583,N
2508,O,99,99,13000,300,14430,2509,12901,O
2508,P,4579,4579,17579,2100,16530,2509,13000,P
2509,A,143,143,143,284,284,2510,0,A
2509,B,244,244,387,150,434,2510,143,B
2509,C,153,153,540,140,574,2510,387,C
2509,B,1326,1326,1866,1295,1869,2510,540,B
2509,C,698,698,2564,660,2529,2510,1866,C
2509,D,159,159,2723,4230,6759,2510,2564,D
2509,M,433,433,3156,608,7367,2510,2723,M
2509,N,205,205,3361,90,7457,2510,3156,N
2509,O,479,479,3840,820,8277,2510,3361,O
2509,N,748,748,4588,405,8682,2510,3840,N
2509,O,708,708,5296,965,9647,2510,4588,O
2509,P,203,203,5499,3780,13427,2510,5296,P
2510,AEI,22,22,22,205,205,2511,0,A
2510,BEI,209,209,231,90,295,2511,22,B
2510,CEI,816,816,1047,1105,1400,2511,231,C
2510,DEI,13,13,1060,3780,5180,2511,1047,D
2510,EI,4527,3467,4527,5603,5603,2511,0,I
2510,EJ,4767,240,4767,5065,5065,2511,0,E
2510,FJ,320,320,5087,90,5155,2511,4767,F
2510,GJ,533,533,5620,905,6060,2511,5087,G
2510,HJ,312,312,5932,3780,9840,2511,5620,H
2510,J,1479,74,6006,90,5693,2511,4527,J
2510,K,1176,1176,7182,1430,7123,2511,6006,K
2510,L,78,78,7260,3780,10903,2511,7182,L
2510,M,1012,1012,8272,1239,12142,2511,7260,M
2510,N,258,258,8530,90,12232,2511,8272,N
2510,O,419,419,8949,815,13047,2511,8530,O
2510,P,7320,7320,16269,3780,16827,2511,8949,P
2511,AEI,292,292,292,199,199,2512,0,A
2511,BEI,57,57,349,210,409,2512,292,B
2511,CEI,656,307,656,1152,1152,2512,0,I
2511,CEJ,546,239,895,690,1099,2512,349,C
2511,BEJ,94,94,989,90,1189,2512,895,B
2511,CEJ,498,165,1154,90,1242,2512,656,J
2511,CEK,560,560,1714,801,2043,2512,1154,K
2511,CEJ,910,185,1899,900,2089,2512,989,C
2511,BEJ,2575,676,2575,3211,3211,2512,0,E
2511,BFJ,727,51,2626,595,2684,2512,1899,B
2511,CFJ,716,665,3291,90,3301,2512,2575,F
2511,CGJ,670,5,3296,640,3324,2512,2626,C
2511,DGJ,1717,135,3431,1425,3468,2512,1714,J
2511,DGK,1426,1286,4717,1935,5236,2512,3291,G
2511,DHK,1343,57,4774,1865,5333,2512,3431,K
2511,DHL,4309,2831,7605,5370,8694,2512,3296,D
2511,HL,4526,1695,9300,3780,9113,2512,4774,L
2511,H,4630,47,9347,3780,9016,2512,4717,H
2511,M,182,182,9529,385,9498,2512,9347,M
2511,N,318,318,9847,180,9678,2512,9529,N
2511,O,982,982,10829,1250,10928,2512,9847,O
2511,P,1323,1323,12152,6680,17608,2512,10829,P
2512,AEI,69,69,69,1432,1432,2513,0,E
2512,AFI,228,159,228,725,725,2513,0,I
2512,AFJ,917,917,1145,540,1265,2513,228,J
2512,AFK,1542,466,1611,240,1672,2513,69,F
2512,AGK,211,211,1822,240,1912,2513,1611,G
2512,AHK,2296,474,2296,2307,2307,2513,0,A
2512,BHK,1254,103,2399,1095,2360,2513,1145,K
2512,BHL,190,87,2486,180,2487,2513,2296,B
2512,CHL,716,52,2538,5250,7162,2513,1822,H
2512,CL,852,800,3338,930,3417,2513,2486,C
2512,DL,986,47,3385,460,2820,2513,2399,L
2512,D,3078,3031,6416,550,3967,2513,3338,D
2512,M,129,129,6545,360,7522,2513,6416,M
2512,N,351,351,6896,180,7702,2513,6545,N
2512,O,602,602,7498,840,8542,2513,6896,O
2512,P,83,83,7581,6680,15222,2513,7498,P
2513,AEI,303,303,303,991,991,2514,0,E
2513,AFI,788,788,1091,150,1141,2514,303,F
2513,AGI,1334,243,1334,1281,1281,2514,0,I
2513,AGJ,287,44,1378,435,1576,2514,1091,G
2513,AFJ,336,292,1670,420,1701,2514,1334,J
2513,AFK,1112,1112,2782,1259,2960,2514,1670,K
2513,AFL,886,886,3668,351,3311,2514,2782,L
2513,AF,2863,573,4241,2675,4251,2514,1378,F
2513,AG,947,947,5188,880,5131,2514,4241,G
2513,AH,7608,2420,7608,8308,8308,2514,0,A
2513,BH,1089,1089,8697,420,8728,2514,7608,B
2513,CH,1117,1117,9814,1259,9987,2514,8697,C
2513,DH,732,732,10546,351,10338,2514,9814,D
2513,H,12566,7208,17754,4230,9361,2514,5188,H
2513,M,332,332,18086,1618,11956,2514,17754,M
2513,N,2146,2146,20232,420,12376,2514,18086,N
2513,O,1035,1035,21267,985,13361,2514,20232,O
2513,P,4618,4618,25885,550,13911,2514,21267,P
2514,AEI,2,2,2,447,447,2515,0,A
2514,BEI,132,130,132,564,564,2515,0,I
2514,BEJ,365,233,365,605,605,2515,0,E
2514,BFJ,159,159,524,135,740,2515,365,F
2514,BGJ,476,84,608,90,654,2515,132,J
2514,BGK,654,48,656,270,717,2515,2,B
2514,CGK,482,350,1006,535,1275,2515,524,G
2514,CHK,204,204,1210,1520,2795,2515,1006,H
2514,CK,651,97,1307,735,1452,2515,656,C
2514,BK,1203,504,1811,1315,1969,2515,608,K
2514,BL,311,311,2122,3780,5749,2515,1811,L
2514,B,1125,310,2432,1030,2482,2515,1307,B
2514,C,113,113,2545,255,2737,2515,2432,C
2514,D,532,532,3077,5160,7897,2515,2545,D
2514,M,165,165,3242,320,8217,2515,3077,M
2514,N,337,337,3579,240,8457,2515,3242,N
2514,O,1009,1009,4588,1290,9747,2515,3579,O
2514,P,96,96,4684,3780,13527,2515,4588,P
2515,AE,34,34,34,1350,1350,2516,0,A
2515,BE,854,820,854,1189,1189,2516,0,E
2515,BF,518,518,1372,90,1279,2516,854,F
2515,BG,1529,191,1563,240,1590,2516,34,B
2515,CG,896,705,2268,1240,2519,2516,1372,G
2515,CH,16,16,2284,3780,6299,2516,2268,H
2515,C,763,42,2326,1040,2630,2516,1563,C
2515,D,648,648,2974,3960,6590,2516,2326,D
2515,M,2632,2632,5606,3118,9708,2516,2974,M
2515,N,547,547,6153,90,9798,2516,5606,N
2515,O,568,568,6721,920,10718,2516,6153,O
2515,P,1493,1493,8214,3780,14498,2516,6721,P
2516,AE,142,142,142,1513,1513,2517,0,A
2516,BE,722,580,722,1396,1396,2517,0,E
2516,BF,704,704,1426,90,1486,2517,722,F
2516,BG,1571,287,1713,240,1753,2517,142,B
2516,CG,779,492,2205,1225,2711,2517,1426,G
2516,CH,247,247,2452,3780,6491,2517,2205,H
2516,C,810,71,2523,1040,2793,2517,1713,C
2516,D,624,624,3147,3960,6753,2517,2523,D
2516,M,601,601,3748,1481,8234,2517,3147,M
2516,N,916,916,4664,90,8324,2517,3748,N
2516,O,759,759,5423,1195,9519,2517,4664,O
2516,P,60,60,5483,3780,13299,2517,5423,P
2517,AEI,39,39,39,867,867,2518,0,E
2517,AFI,306,267,306,260,260,2518,0,I
2517,AFJ,215,215,521,300,560,2518,306,J
2517,AFK,1006,524,1045,240,1107,2518,39,F
2517,AGK,666,142,1187,840,1400,2518,521,K
2517,AGL,1329,142,1329,1416,1416,2518,0,A
2517,BGL,232,232,1561,180,1596,2518,1329,B
2517,CGL,652,136,1697,665,1772,2518,1045,G
2517,CHL,281,145,1842,335,1931,2518,1561,C
2517,BHL,921,921,2763,890,2821,2518,1842,B
2517,CHL,661,661,3424,640,3461,2518,2763,C
2517,DHL,3258,1021,4445,1140,2540,2518,1187,L
2517,DH,3231,483,4928,5370,7142,2518,1697,H
2517,D,8322,6818,11746,5370,8831,2518,3424,D
2517,M,68,68,11814,164,8995,2518,11746,M
2517,N,173,173,11987,150,9145,2518,11814,N
2517,O,381,381,12368,465,9610,2518,11987,O
2517,N,364,364,12732,265,9875,2518,12368,N
2517,O,161,161,12893,225,10100,2518,12732,O
2517,P,1425,1425,14318,4740,14840,2518,12893,P
2518,AE,102,102,102,154,154,2519,0,A
2518,BE,143,143,245,150,304,2519,102,B
2518,CE,293,48,293,390,390,2519,0,E
2518,CF,164,116,409,135,439,2519,245,C
2518,DF,210,94,503,180,570,2519,293,F
2518,DG,150,150,653,155,725,2519,503,G
2518,DH,29,29,682,2880,3605,2519,653,H
2518,D,1591,1318,2000,4230,4669,2519,409,D
2518,M,206,206,2206,2485,7154,2519,2000,M
2518,N,2371,2371,4577,150,7304,2519,2206,N
2518,O,292,292,4869,240,7544,2519,4577,O
2518,P,1,1,4870,2880,10424,2519,4869,P
2519,AEI,260,260,260,908,908,2520,0,E
2519,AFI,568,308,568,3775,3775,2520,0,I
2519,AFJ,832,524,1092,240,1148,2520,260,F
2519,AGJ,827,827,1919,1015,2163,2520,1092,G
2519,AFJ,2004,85,2004,2359,2359,2520,0,A
2519,BFJ,1887,451,2455,180,3955,2520,568,J
2519,BFK,479,28,2483,180,2539,2520,2004,B
2519,CFK,1491,927,3410,1355,3518,2520,1919,F
2519,CGK,1665,738,4148,1200,3739,2520,2483,C
2519,BGK,1770,77,4225,1170,5125,2520,2455,K
2519,BGJ,1030,215,4440,1620,5138,2520,3410,G
2519,BHJ,254,254,4694,3960,9098,2520,4440,H
2519,BJ,832,286,4980,1360,5099,2520,4148,B
2519,CJ,1415,660,5640,645,5770,2520,4225,J
2519,CK,671,11,5651,648,5747,2520,4980,C
2519,DK,194,194,5845,372,6119,2520,5651,D
2519,K,937,732,6577,653,6423,2520,5640,K
2519,L,771,771,7348,1092,7515,2520,6577,L
2519,M,106,106,7454,212,9310,2520,7348,M
2519,N,209,209,7663,150,9460,2520,7454,N
2519,O,122,122,7785,110,9570,2520,7663,O
2519,N,931,931,8716,930,10500,2520,7785,N
2519,O,516,516,9232,540,11040,2520,8716,O
2519,P,4783,4783,14015,4230,15270,2520,9232,P
2520,AEI,274,274,274,1236,1236,2521,0,E
2520,AFI,492,218,492,784,784,2521,0,A
2520,BFI,321,321,813,90,874,2521,492,B
2520,CFI,981,168,981,1386,1386,2521,0,I
2520,CFJ,990,283,1264,90,1326,2521,274,F
2520,CGJ,501,50,1314,880,1754,2521,813,C
2520,DGJ,440,107,1421,90,1476,2521,981,J
2520,DGK,191,84,1505,3780,5534,2521,1314,D
2520,GK,969,728,2233,1200,2526,2521,1264,G
2520,HK,33,33,2266,3780,6306,2521,2233,H
2520,K,986,141,2407,1250,2726,2521,1421,K
2520,L,16,16,2423,3780,6506,2521,2407,L
2520,M,191,191,2614,384,6890,2521,2423,M
2520,N,225,225,2839,90,6980,2521,2614,N
2520,O,390,390,3229,795,7775,2521,2839,O
2520,P,1423,1423,4652,3780,11555,2521,3229,P
2521,AEI,65,65,65,164,164,2522,0,I
2521,AEJ,161,96,161,491,491,2522,0,E
2521,AFJ,244,83,244,674,674,2522,0,A
2521,BFJ,285,106,350,240,404,2522,65,J
2521,BFK,196,196,546,285,689,2522,350,K
2521,BFL,450,65,611,180,671,2522,161,F
2521,BGL,618,251,862,240,914,2522,244,B
2521,CGL,317,317,1179,285,1199,2522,862,C
2521,DGL,579,11,1190,700,1371,2522,611,G
2521,DFL,664,20,1210,5160,5849,2522,546,L
2521,DF,1064,1044,2254,940,2311,2522,1190,F
2521,DG,402,402,2656,285,2596,2522,2254,G
2521,DH,1311,1311,3967,5160,7756,2522,2656,H
2521,D,3165,377,4344,5160,6359,2522,1179,D
2521,M,1611,1611,5955,2943,10699,2522,4344,M
2521,N,1481,1481,7436,90,10789,2522,5955,N
2521,O,837,837,8273,1240,12029,2522,7436,O
2521,N,1328,1328,9601,1040,13069,2522,8273,N
2521,O,426,426,10027,860,13929,2522,9601,O
2521,P,12651,12651,22678,3780,17709,2522,10027,P
2522,A,183,183,183,224,224,2523,0,A
2522,B,149,149,332,150,374,2523,183,B
2522,C,549,549,881,605,979,2523,332,C
2522,D,349,349,1230,2880,3859,2523,881,D
2522,M,85,85,1315,98,3957,2523,1230,M
2522,N,105,105,1420,150,4107,2523,1315,N
2522,O,129,129,1549,400,4507,2523,1420,O
2522,N,1154,1154,2703,865,5372,2523,1549,N
2522,O,588,588,3291,809,6181,2523,2703,O
2522,P,2034,2034,5325,3840,10021,2523,3291,P
2523,AE,188,188,188,1144,1144,2524,0,A
2523,BE,986,986,1174,180,1324,2524,188,B
2523,CE,1904,1904,3078,1775,3099,2524,1174,C
2523,BE,4461,1383,4461,5600,5600,2524,0,E
2523,BF,1515,132,4593,1560,4659,2524,3078,B
2523,CF,1196,1196,5789,2030,6689,2524,4593,C
2523,DF,1413,85,5874,300,5900,2524,4461,F
2523,DG,1099,1099,6973,1045,6945,2524,5874,G
2523,DH,1228,44,7017,410,7099,2524,5789,D
2523,H,677,633,7650,1200,8145,2524,6973,H
2523,M,837,837,8487,2099,10244,2524,7650,M
2523,N,1305,1305,9792,90,10334,2524,8487,N
2523,O,527,527,10319,825,11159,2524,9792,O
2523,N,773,773,11092,490,11649,2524,10319,N
2523,O,710,710,11802,900,12549,2524,11092,O
2523,P,9844,9844,21646,3780,16329,2524,11802,P
2524,AE,6860,6860,6860,7163,7163,2525,0,E
2524,AF,313,313,7173,90,7253,2525,6860,F
2524,AG,2395,2395,9568,2530,9783,2525,7173,G
2524,AH,55,55,9623,3780,13563,2525,9568,H
2524,A,36280,26657,36280,40198,40198,2525,0,A
2524,B,126,126,36406,90,40288,2525,36280,B
2524,C,1222,1222,37628,1420,41708,2525,36406,C
2524,D,613,613,38241,3780,45488,2525,37628,D
2524,M,557,557,38798,831,46319,2525,38241,M
2524,N,303,303,39101,90,46409,2525,38798,N
2524,O,490,490,39591,880,47289,2525,39101,O
2524,P,337,337,39928,3780,51069,2525,39591,P
2525,AE,136,136,136,2415,2415,2526,0,A
2525,BE,1691,1555,1691,1904,1904,2526,0,E
2525,BF,597,597,2288,420,2324,2526,1691,F
2525,BG,2475,323,2611,240,2655,2526,136,B
2525,CG,884,561,3172,1120,3444,2526,2288,G
2525,CH,120,120,3292,335,3779,2526,3172,H
2525,C,860,179,3471,1020,3675,2526,2611,C
2525,D,357,357,3828,4680,8355,2526,3471,D
2525,M,2167,2167,5995,2267,10622,2526,3828,M
2525,N,260,260,6255,180,10802,2526,5995,N
2525,O,1041,1041,7296,930,11732,2526,6255,O
2525,P,359,359,7655,550,12282,2526,7296,P
2526,AEI,231,231,231,1308,1308,2527,0,I
2526,AEJ,1107,1107,1338,90,1398,2527,231,J
2526,AEK,924,924,2262,1210,2608,2527,1338,K
2526,AEJ,509,509,2771,205,2813,2527,2262,J
2526,AEK,170,170,2941,585,3398,2527,2771,K
2526,AEL,4291,1350,4291,4427,4427,2527,0,E
2526,AFL,169,169,4460,90,4517,2527,4291,F
2526,AGL,477,477,4937,820,5337,2527,4460,G
2526,AFL,2424,428,5365,3780,7178,2527,2941,L
2526,AF,717,289,5654,360,5697,2527,4937,F
2526,AG,116,116,5770,585,6282,2527,5654,G
2526,AH,1716,1716,7486,3780,10062,2527,5770,H
2526,A,46357,38871,46357,47190,47190,2527,0,A
2526,B,979,979,47336,90,47280,2527,46357,B
2526,C,534,534,47870,880,48160,2527,47336,C
2526,B,671,671,48541,420,48580,2527,47870,B
2526,C,191,191,48732,585,49165,2527,48541,C
2526,D,13190,13190,61922,3780,52945,2527,48732,D
2526,M,153,153,62075,308,53253,2527,61922,M
2526,N,195,195,62270,90,53343,2527,62075,N
2526,O,174,174,62444,575,53918,2527,62270,O
2526,N,1487,1487,63931,1095,55013,2527,62444,N
2526,O,559,559,64490,905,55918,2527,63931,O
2526,P,1808,1808,66298,3780,59698,2527,64490,P
2527,A,20,20,20,19,19,2528,0,A
2527,B,794,794,814,150,169,2528,20,B
2527,C,259,259,1073,205,374,2528,814,C
2527,D,105,105,1178,2880,3254,2528,1073,D
2527,M,548,548,1726,800,4054,2528,1178,M
2527,N,365,365,2091,180,4234,2528,1726,N
2527,O,150,150,2241,155,4389,2528,2091,O
2527,P,230,230,2471,2880,7269,2528,2241,P
2528,AE,522,522,522,1055,1055,2529,0,A
2528,BE,887,365,887,1378,1378,2529,0,E
2528,BF,690,690,1577,240,1618,2529,887,F
2528,BG,1271,216,1793,780,1835,2529,522,B
2528,CG,580,364,2157,875,2493,2529,1577,G
2528,CH,1118,754,2911,1162,2997,2529,1793,C
2528,DH,120,120,3031,473,3470,2529,2911,D
2528,H,1218,344,3375,3960,6453,2529,2157,H
2528,M,4049,4049,7424,4166,10619,2529,3375,M
2528,N,326,326,7750,240,10859,2529,7424,N
2528,O,576,576,8326,1045,11904,2529,7750,O
2528,N,964,964,9290,170,12074,2529,8326,N
2528,O,330,330,9620,630,12704,2529,9290,O
2528,P,3480,3480,13100,4380,17084,2529,9620,P
2529,AE,178,178,178,228,228,2530,0,A
2529,BE,281,281,459,270,498,2530,178,B
2529,CE,1342,883,1342,1313,1313,2530,0,E
2529,CF,1037,154,1496,1115,1613,2530,459,C
2529,DF,172,18,1514,240,1553,2530,1342,F
2529,DG,694,694,2208,960,2513,2530,1514,G
2529,DH,161,161,2369,3960,6473,2530,2208,H
2529,D,2320,1447,3816,335,1948,2530,1496,D
2529,M,198,198,4014,259,6732,2530,3816,M
2529,N,229,229,4243,220,6952,2530,4014,N
2529,O,1082,1082,5325,1080,8032,2530,4243,O
2529,N,816,816,6141,805,8837,2530,5325,N
2529,O,1299,1299,7440,2305,11142,2530,6141,O
2529,P,1009,1009,8449,4625,15767,2530,7440,P
2530,AEI,154,154,154,607,607,2531,0,A
2530,BEI,233,79,233,193,193,2531,0,E
2530,BFI,65,65,298,150,343,2531,233,F
2530,BGI,163,163,461,140,483,2531,298,G
2530,BFI,501,194,655,90,697,2531,154,B
2530,CFI,886,692,1347,900,1383,2531,461,F
2530,CGI,308,308,1655,650,2033,2531,1347,G
2530,CHI,1829,174,1829,1983,1983,2531,0,I
2530,CHJ,173,173,2002,90,2073,2531,1829,J
2530,CHK,1541,194,2196,2315,3012,2531,655,C
2530,DHK,173,173,2369,3420,6432,2531,2196,D
2530,HK,453,86,2455,800,2873,2531,2002,K
2530,HJ,1132,1132,3587,780,3653,2531,2455,J
2530,HK,1603,1603,5190,2315,5968,2531,3587,K
2530,HL,4523,988,6178,4230,6263,2531,1655,H
2530,L,5499,4511,10689,3420,9388,2531,5190,L
2530,M,349,349,11038,349,9737,2531,10689,M
2530,N,648,648,11686,540,10277,2531,11038,N
2530,O,817,817,12503,795,11072,2531,11686,O
2530,P,2195,2195,14698,550,11622,2531,12503,P
2531,AEI,166,166,166,1285,1285,2532,0,A
2531,BEI,1092,926,1092,1375,1375,2532,0,E
2531,BFI,1382,456,1548,300,1585,2532,166,B
2531,CFI,587,131,1679,300,1675,2532,1092,F
2531,CGI,598,467,2146,785,2370,2532,1548,C
2531,DGI,135,135,2281,2940,5310,2532,2146,D
2531,GI,626,24,2305,775,2450,2532,1679,G
2531,HI,228,228,2533,4020,6470,2532,2305,H
2531,I,5337,2804,5337,5681,5681,2532,0,I
2531,J,378,378,5715,90,5771,2532,5337,J
2531,K,1182,1182,6897,1315,7086,2532,5715,K
2531,L,560,560,7457,3780,10866,2532,6897,L
2531,M,9125,9125,16582,10160,21026,2532,7457,M
2531,N,1296,1296,17878,240,21266,2532,16582,N
2531,O,1419,1419,19297,2880,24146,2532,17878,O
2531,P,393,393,19690,2400,26546,2532,19297,P
2532,AEI,16,16,16,756,756,2533,0,E
2532,AFI,985,985,1001,300,1056,2533,16,F
2532,AGI,1070,69,1070,1206,1206,2533,0,I
2532,AGJ,337,337,1407,240,1446,2533,1070,J
2532,AGK,827,421,1828,810,1866,2533,1001,G
2532,AHK,729,308,2136,683,2129,2533,1407,K
2532,AHL,835,835,2971,372,2501,2533,2136,L
2532,AH,10529,7558,10529,11881,11881,2533,0,A
2532,BH,1460,1460,11989,150,12031,2533,10529,B
2532,CH,814,814,12803,2165,14196,2533,11989,C
2532,DH,9183,9183,21986,2880,17076,2533,12803,D
2532,H,56985,36827,58813,4080,5946,2533,1828,H
2532,M,613,613,59426,1961,19037,2533,58813,M
2532,N,1719,1719,61145,300,19337,2533,59426,N
2532,O,350,350,61495,1870,21207,2533,61145,O
2532,P,3009,3009,64504,7380,28587,2533,61495,P
2533,A,70,70,70,1110,1110,2534,0,A
2533,B,1222,1222,1292,240,1350,2534,70,B
2533,C,732,732,2024,780,2130,2534,1292,C
2533,D,1349,1349,3373,7680,9810,2534,2024,D
2533,M,1517,1517,4890,1595,11405,2534,3373,M
2533,N,352,352,5242,300,11705,2534,4890,N
2533,O,547,547,5789,695,12400,2534,5242,O
2533,P,408,408,6197,1140,13540,2534,5789,P
2534,AEI,168,168,168,1457,1457,2535,0,E
2534,AFI,476,308,476,476,476,2535,0,A
2534,BFI,460,460,936,480,956,2535,476,B
2534,CFI,1253,317,1253,1362,1362,2535,0,I
2534,CFJ,244,244,1497,195,1557,2535,1253,J
2534,CFK,858,297,1794,890,1846,2535,936,C
2534,DFK,1634,8,1802,330,1787,2535,168,F
2534,DGK,685,380,2182,695,2252,2535,1497,K
2534,DGL,192,192,2374,385,2637,2535,2182,L
2534,DG,586,14,2388,655,2442,2535,1802,G
2534,DH,2605,2605,4993,550,2992,2535,2388,H
2534,D,4259,1060,6053,550,2396,2535,1794,D
2534,M,18,18,6071,443,3435,2535,6053,M
2534,N,819,819,6890,240,3675,2535,6071,N
2534,O,1238,1238,8128,1300,4975,2535,6890,O
2534,P,639,639,8767,465,5440,2535,8128,P
2535,AE,147,147,147,278,278,2536,0,E
2535,AF,236,236,383,150,428,2536,147,F
2535,AG,852,852,1235,810,1238,2536,383,G
2535,AF,1259,24,1259,1348,1348,2536,0,A
2535,BF,159,135,1394,195,1433,2536,1235,F
2535,BG,184,49,1443,150,1498,2536,1259,B
2535,CG,143,94,1537,115,1548,2536,1394,G
2535,CH,349,349,1886,4230,5778,2536,1537,H
2535,C,639,196,2082,580,2078,2536,1443,C
2535,B,316,316,2398,370,2448,2536,2082,B
2535,C,125,125,2523,125,2573,2536,2398,C
2535,D,4130,4130,6653,4230,6803,2536,2523,D
2535,M,92,92,6745,210,7013,2536,6653,M
2535,N,197,197,6942,150,7163,2536,6745,N
2535,O,225,225,7167,125,7288,2536,6942,O
2535,P,2583,2583,9750,4200,11488,2536,7167,P
2536,AEI,84,84,84,1348,1348,2537,0,I
2536,AEJ,412,328,412,1428,1428,2537,0,E
2536,AFJ,1485,1157,1569,270,1618,2537,84,J
2536,AFK,1305,148,1717,330,1758,2537,412,F
2536,AGK,954,954,2671,2174,3932,2537,1717,G
2536,AHK,1149,47,2718,2204,3822,2537,1569,K
2536,AHL,463,416,3134,1781,5713,2537,2671,H
2536,AL,3502,368,3502,4184,4184,2537,0,A
2536,BL,1062,278,3780,846,4668,2537,2718,L
2536,B,1052,774,4554,420,4604,2537,3502,B
2536,C,996,996,5550,5001,9605,2537,4554,C
2536,D,1709,1709,7259,2034,11639,2537,5550,D
2536,M,173,173,7432,944,12583,2537,7259,M
2536,N,1512,1512,8944,780,13363,2537,7432,N
2536,O,207,207,9151,170,13533,2537,8944,O
2536,N,2267,2267,11418,2325,15858,2537,9151,N
2536,O,2668,2668,14086,2568,18426,2537,11418,O
2536,P,2,2,14088,762,19188,2537,14086,P
2537,AEI,320,320,320,565,565,2538,0,A
2537,BEI,275,275,595,90,655,2538,320,B
2537,CEI,1304,709,1304,1915,1915,2538,0,I
2537,CEJ,1344,635,1939,1670,2325,2538,595,C
2537,DEJ,892,257,2196,90,2005,2538,1304,J
2537,DEK,557,300,2496,3780,6105,2538,1939,D
2537,EK,930,630,3126,1240,3245,2538,2196,K
2537,EL,67,67,3193,3780,7025,2538,3126,L
2537,E,37838,34645,37838,38117,38117,2538,0,E
2537,F,307,307,38145,90,38207,2538,37838,F
2537,G,716,716,38861,1130,39337,2538,38145,G
2537,H,381,381,39242,3780,43117,2538,38861,H
2537,M,1729,1729,40971,2320,45437,2538,39242,M
2537,N,830,830,41801,90,45527,2538,40971,N
2537,O,524,524,42325,905,46432,2538,41801,O
2537,P,6718,6718,49043,3780,50212,2538,42325,P
2538,A,1126,1126,1126,1458,1458,2539,0,A
2538,B,467,467,1593,180,1638,2539,1126,B
2538,C,148,148,1741,260,1898,2539,1593,C
2538,B,875,875,2616,765,2663,2539,1741,B
2538,C,975,975,3591,1020,3683,2539,2616,C
2538,D,1255,1255,4846,4680,8363,2539,3591,D
2538,M,3695,3695,8541,3983,12346,2539,4846,M
2538,N,661,661,9202,90,12436,2539,8541,N
2538,O,554,554,9756,815,13251,2539,9202,O
2538,N,1149,1149,10905,1045,14296,2539,9756,N
2538,O,690,690,11595,935,15231,2539,10905,O
2538,P,689,689,12284,3780,19011,2539,11595,P
2539,A,89,89,89,495,495,2540,0,A
2539,B,611,611,700,240,735,2540,89,B
2539,C,657,657,1357,960,1695,2540,700,C
2539,D,1668,1668,3025,3960,5655,2540,1357,D
2539,M,353,353,3378,510,6165,2540,3025,M
2539,N,331,331,3709,240,6405,2540,3378,N
2539,O,922,922,4631,985,7390,2540,3709,O
2539,N,702,702,5333,615,8005,2540,4631,N
2539,O,209,209,5542,255,8260,2540,5333,O
2539,P,173,173,5715,5160,13420,2540,5542,P
2540,AEI,45,45,45,110,110,2541,0,E
2540,AFI,137,137,182,135,245,2541,45,F
2540,AGI,114,114,296,385,630,2541,182,G
2540,AHI,1267,971,1267,1443,1443,2541,0,I
2540,AHJ,987,16,1283,9245,9875,2541,296,H
2540,AJ,367,351,1634,240,1683,2541,1267,J
2540,AK,953,953,2587,740,2423,2541,1634,K
2540,AJ,250,250,2837,430,2853,2541,2587,J
2540,AK,2978,141,2978,3762,3762,2541,0,A
2540,BK,832,691,3669,1620,4473,2541,2837,K
2540,BL,967,276,3945,240,4002,2541,2978,B
2540,CL,347,71,4016,3960,8433,2541,3669,L
2540,C,765,694,4710,1030,5032,2541,3945,C
2540,B,1106,1106,5816,815,5847,2541,4710,B
2540,C,2793,2793,8609,2655,8502,2541,5816,C
2540,D,141,141,8750,1680,10182,2541,8609,D
2540,M,126,126,8876,634,10816,2541,8750,M
2540,N,704,704,9580,240,11056,2541,8876,N
2540,O,113,113,9693,385,11441,2541,9580,O
2540,N,507,507,10200,235,11676,2541,9693,N
2540,O,112,112,10312,375,12051,2541,10200,O
2540,P,4136,4136,14448,3960,16011,2541,10312,P
2541,A,1839,1839,1839,2327,2327,2542,0,A
2541,B,757,757,2596,300,2627,2542,1839,B
2541,C,810,810,3406,910,3537,2542,2596,C
2541,B,745,745,4151,660,4197,2542,3406,B
2541,C,504,504,4655,385,4582,2542,4151,C
2541,D,1177,1177,5832,3960,8542,2542,4655,D
2541,M,1077,1077,6909,2035,10577,2542,5832,M
2541,N,2204,2204,9113,90,10667,2542,6909,N
2541,O,1006,1006,10119,1240,11907,2542,9113,O
2541,P,471,471,10590,3780,15687,2542,10119,P
2542,A,1375,1375,1375,1517,1517,2543,0,A
2542,B,339,339,1714,240,1757,2543,1375,B
2542,C,601,601,2315,765,2522,2543,1714,C
2542,B,394,394,2709,295,2817,2543,2315,B
2542,C,954,954,3663,1260,4077,2543,2709,C
2542,D,202,202,3865,3960,8037,2543,3663,D
2542,M,730,730,4595,1221,9258,2543,3865,M
2542,N,645,645,5240,180,9438,2543,4595,N
2542,O,639,639,5879,885,10323,2543,5240,O
2542,P,1862,1862,7741,6680,17003,2543,5879,P
2543,A,226,226,226,1410,1410,2544,0,A
2543,B,1363,1363,1589,240,1650,2544,226,B
2543,C,772,772,2361,760,2410,2544,1589,C
2543,D,1050,1050,3411,7680,10090,2544,2361,D
2543,M,121,121,3532,292,10382,2544,3411,M
2543,N,338,338,3870,180,10562,2544,3532,N
2543,O,593,593,4463,683,11245,2544,3870,O
2543,P,9799,9799,14262,4080,15325,2544,4463,P
2544,A,3553,3553,3553,3657,3657,2545,0,A
2544,B,330,330,3883,240,3897,2545,3553,B
2544,C,682,682,4565,855,4752,2545,3883,C
2544,B,437,437,5002,340,5092,2545,4565,B
2544,C,2457,2457,7459,2820,7912,2545,5002,C
2544,D,1497,1497,8956,3960,11872,2545,7459,D
2544,M,100,100,9056,149,12021,2545,8956,M
2544,N,97,97,9153,120,12141,2545,9056,N
2544,O,104,104,9257,125,12266,2545,9153,O
2544,P,8298,8298,17555,2880,15146,2545,9257,P
2545,A,146,146,146,1183,1183,2546,0,A
2545,B,1229,1229,1375,240,1423,2546,146,B
2545,C,794,794,2169,760,2183,2546,1375,C
2545,D,1174,1174,3343,7680,9863,2546,2169,D
2545,M,1208,1208,4551,3023,12886,2546,3343,M
2545,N,2050,2050,6601,300,13186,2546,4551,N
2545,O,617,617,7218,820,14006,2546,6601,O
2545,N,1306,1306,8524,1070,15076,2546,7218,N
2545,O,388,388,8912,535,15611,2546,8524,O
2545,P,51711,51711,60623,2880,18491,2546,8912,P
2546,A,154,154,154,250,250,2547,0,A
2546,B,608,608,762,300,550,2547,154,B
2546,C,521,521,1283,735,1285,2547,762,C
2546,D,37,37,1320,1500,2785,2547,1283,D
2546,M,238,238,1558,384,3169,2547,1320,M
2546,N,1596,1596,3154,1500,4669,2547,1558,N
2546,O,870,870,4024,995,5664,2547,3154,O
2546,N,1061,1061,5085,910,6574,2547,4024,N
2546,O,243,243,5328,300,6874,2547,5085,O
2546,P,676,676,6004,5100,11974,2547,5328,P
2547,A,1346,1346,1346,1116,1116,2548,0,A
2547,B,1613,1613,2959,180,1296,2548,1346,B
2547,C,785,785,3744,885,2181,2548,2959,C
2547,D,567,567,4311,6680,8861,2548,3744,D
2547,M,372,372,4683,1094,9955,2548,4311,M
2547,N,842,842,5525,180,10135,2548,4683,N
2547,O,238,238,5763,370,10505,2548,5525,O
2547,P,8483,8483,14246,6960,17465,2548,5763,P
2548,AEI,30,30,30,2121,2121,2549,0,E
2548,AFI,393,363,393,923,923,2549,0,A
2548,BFI,568,568,961,90,1013,2549,393,B
2548,CFI,2051,1120,2081,90,2211,2549,30,F
2548,CGI,1176,56,2137,1250,2263,2549,961,C
2548,DGI,285,229,2366,505,2716,2549,2081,G
2548,DHI,416,187,2553,3780,6043,2549,2137,D
2548,HI,419,232,2785,3780,6496,2549,2366,H
2548,I,7336,4551,7336,6736,6736,2549,0,I
2548,J,1306,1306,8642,90,6826,2549,7336,J
2548,K,488,488,9130,760,7586,2549,8642,K
2548,L,1221,1221,10351,4625,12211,2549,9130,L
2548,M,490,490,10841,1184,13395,2549,10351,M
2548,N,720,720,11561,90,13485,2549,10841,N
2548,O,385,385,11946,705,14190,2549,11561,O
2548,P,1140,1140,13086,3780,17970,2549,11946,P
2549,AEI,127,127,127,221,221,2550,0,E
2549,AFI,306,306,433,240,461,2550,127,F
2549,AGI,514,514,947,780,1241,2550,433,G
2549,AHI,997,50,997,1205,1205,2550,0,A
2549,BHI,165,115,1112,4020,5261,2550,947,H
2549,BI,401,286,1398,240,1445,2550,997,B
2549,CI,2081,683,2081,2170,2170,2550,0,I
2549,CJ,209,209,2290,180,2350,2550,2081,J
2549,CK,1001,109,2399,1195,2640,2550,1398,C
2549,DK,1502,1393,3792,710,3060,2550,2290,K
2549,DJ,2036,643,4435,3960,6600,2550,2399,D
2549,J,1867,1224,5659,2615,5675,2550,3792,J
2549,K,991,991,6650,1020,6695,2550,5659,K
2549,L,804,804,7454,6960,13655,2550,6650,L
2549,M,44,44,7498,55,13710,2550,7454,M
2549,N,200,200,7698,240,13950,2550,7498,N
2549,O,521,521,8219,740,14690,2550,7698,O
2549,N,781,781,9000,300,14990,2550,8219,N
2549,O,855,855,9855,1210,16200,2550,9000,O
2549,P,1527,1527,11382,3960,20160,2550,9855,P
2550,AE,54,54,54,184,184,2551,0,E
2550,AF,99,45,99,156,156,2551,0,A
2550,BF,201,156,255,135,319,2551,54,F
2550,BG,245,89,344,240,396,2551,99,B
2550,CG,188,99,443,285,604,2551,255,G
2550,CH,212,113,556,285,681,2551,344,C
2550,DH,222,109,665,5160,5764,2551,443,H
2550,D,782,673,1338,5160,5841,2551,556,D
2550,M,269,269,1607,706,6547,2551,1338,M
2550,N,467,467,2074,90,6637,2551,1607,N
2550,O,955,955,3029,1250,7887,2551,2074,O
2550,N,754,754,3783,455,8342,2551,3029,N
2550,O,515,515,4298,790,9132,2551,3783,O
2550,P,793,793,5091,3780,12912,2551,4298,P
2551,A,40,40,40,977,977,2552,0,A
2551,B,1119,1119,1159,240,1217,2552,40,B
2551,C,862,862,2021,1020,2237,2552,1159,C
2551,D,4641,4641,6662,4680,6917,2552,2021,D
2551,M,1919,1919,8581,2011,8928,2552,6662,M
2551,N,117,117,8698,90,9018,2552,8581,N
2551,O,631,631,9329,820,9838,2552,8698,O
2551,N,570,570,9899,375,10213,2552,9329,N
2551,O,447,447,10346,740,10953,2552,9899,O
2551,P,903,903,11249,3780,14733,2552,10346,P
2552,AEI,111,111,111,1495,1495,2553,0,I
2552,AEJ,1306,1195,1306,1323,1323,2553,0,E
2552,AFJ,152,152,1458,195,1518,2553,1306,F
2552,AGJ,1562,104,1562,3244,3244,2553,0,A
2552,BGJ,1532,81,1643,195,1690,2553,111,J
2552,BGK,728,543,2186,695,2213,2553,1458,G
2552,BHK,721,178,2364,695,2385,2553,1643,K
2552,BHL,382,382,2746,385,2770,2553,2364,L
2552,BH,1316,756,3502,385,2598,2553,2186,H
2552,B,2054,114,3616,420,3664,2553,1562,B
2552,C,977,977,4593,985,4649,2553,3616,C
2552,D,3526,3526,8119,550,5199,2553,4593,D
2552,M,419,419,8538,919,6118,2553,8119,M
2552,N,1258,1258,9796,780,6898,2553,8538,N
2552,O,795,795,10591,2049,8947,2553,9796,O
2552,P,1231,1231,11822,846,9793,2553,10591,P
2553,A,112,112,112,103,103,2554,0,A
2553,B,118,118,230,150,253,2554,112,B
2553,C,143,143,373,410,663,2554,230,C
2553,B,1284,1284,1657,1025,1688,2554,373,B
2553,C,726,726,2383,660,2348,2554,1657,C
2553,D,1119,1119,3502,4230,6578,2554,2383,D
2553,M,1595,1595,5097,1169,7747,2554,3502,M
2553,N,361,361,5458,90,7837,2554,5097,N
2553,O,567,567,6025,815,8652,2554,5458,O
2553,N,617,617,6642,1075,9727,2554,6025,N
2553,O,1224,1224,7866,1790,11517,2554,6642,O
2553,P,1019,1019,8885,3780,15297,2554,7866,P
2554,A,1252,1252,1252,1575,1575,2555,0,A
2554,B,378,378,1630,90,1665,2555,1252,B
2554,C,569,569,2199,920,2585,2555,1630,C
2554,D,135,135,2334,3780,6365,2555,2199,D
2554,M,693,693,3027,1304,7669,2555,2334,M
2554,N,640,640,3667,90,7759,2555,3027,N
2554,O,120,120,3787,535,8294,2555,3667,O
2554,P,2823,2823,6610,3780,12074,2555,3787,P
2555,A,26300,26300,26300,27570,27570,2556,0,A
2555,B,1292,1292,27592,90,27660,2556,26300,B
2555,C,1099,1099,28691,1370,29030,2556,27592,C
2555,D,45,45,28736,3780,32810,2556,28691,D
2555,M,461,461,29197,1237,34047,2556,28736,M
2555,N,826,826,30023,90,34137,2556,29197,N
2555,O,230,230,30253,625,34762,2556,30023,O
2555,P,3400,3400,33653,3780,38542,2556,30253,P
2556,A,1777,1777,1777,2718,2718,2557,0,A
2556,B,966,966,2743,90,2808,2557,1777,B
2556,C,526,526,3269,880,3688,2557,2743,C
2556,B,849,849,4118,485,4173,2557,3269,B
2556,C,668,668,4786,1060,5233,2557,4118,C
2556,D,402,402,5188,3780,9013,2557,4786,D
2556,M,1220,1220,6408,1395,10408,2557,5188,M
2556,N,201,201,6609,90,10498,2557,6408,N
2556,O,915,915,7524,1105,11603,2557,6609,O
2556,P,387,387,7911,3780,15383,2557,7524,P
2557,AEI,38,38,38,132,132,2558,0,I
2557,AEJ,79,41,79,115,115,2558,0,A
2557,BEJ,171,130,209,135,267,2558,38,J
2557,BEK,301,171,380,300,415,2558,79,B
2557,CEK,256,85,465,285,552,2558,209,K
2557,CEL,199,199,664,5160,5712,2558,465,L
2557,CE,680,396,1060,780,1195,2558,380,C
2557,DE,1304,244,1304,1498,1498,2558,0,E
2557,DF,394,394,1698,240,1738,2558,1304,F
2557,DG,836,836,2534,765,2503,2558,1698,G
2557,DF,1615,141,2675,1140,2335,2558,1060,D
2557,F,178,37,2712,295,2798,2558,2534,F
2557,G,1790,1790,4502,1260,4058,2558,2712,G
2557,H,807,807,5309,3960,8018,2558,4502,H
2557,M,1214,1214,6523,1410,9428,2558,5309,M
2557,N,225,225,6748,90,9518,2558,6523,N
2557,O,978,978,7726,1240,10758,2558,6748,O
2557,P,54,54,7780,3780,14538,2558,7726,P
2558,A,11330,11330,11330,11320,11320,2559,0,A
2558,B,264,264,11594,300,11620,2559,11330,B
2558,C,865,865,12459,1005,12625,2559,11594,C
2558,D,751,751,13210,1200,13825,2559,12459,D
2558,M,884,884,14094,1020,14845,2559,13210,M
2558,N,205,205,14299,90,14935,2559,14094,N
2558,O,533,533,14832,815,15750,2559,14299,O
2558,N,1103,1103,15935,850,16600,2559,14832,N
2558,O,254,254,16189,695,17295,2559,15935,O
2558,P,4378,4378,20567,3780,21075,2559,16189,P
2559,AEI,14,14,14,579,579,2560,0,I
2559,AEJ,664,664,678,150,729,2560,14,J
2559,AEK,129,129,807,110,839,2560,678,K
2559,AEJ,191,191,998,200,1039,2560,807,J
2559,AEK,1055,57,1055,1236,1236,2560,0,E
2559,AFK,355,355,1410,240,1476,2560,1055,F
2559,AGK,1616,206,1616,1754,1754,2560,0,A
2559,BGK,626,8,1624,590,1629,2560,998,K
2559,BGL,228,220,1844,150,1904,2560,1616,B
2559,CGL,613,179,2023,630,2106,2560,1410,G
2559,CHL,627,448,2471,845,2749,2560,1844,C
2559,BHL,667,219,2690,6300,8406,2560,2023,H
2559,BL,1926,1707,4397,1690,4439,2560,2471,B
2559,CL,573,573,4970,620,5059,2560,4397,C
2559,DL,4560,1214,6184,4140,5769,2560,1624,L
2559,D,1441,227,6411,6300,11359,2560,4970,D
2559,M,199,199,6610,222,11581,2560,6411,M
2559,N,234,234,6844,270,11851,2560,6610,N
2559,O,465,465,7309,735,12586,2560,6844,O
2559,N,1250,1250,8559,980,13566,2560,7309,N
2559,O,111,111,8670,200,13766,2560,8559,O
2559,P,224,224,8894,3780,17546,2560,8670,P
2560,AE,619,619,619,8903,8903,2561,0,E
2560,AF,992,373,992,1338,1338,2561,0,A
2560,BF,410,410,1402,90,1428,2561,992,B
2560,CF,883,883,2285,1250,2678,2561,1402,C
2560,DF,44,44,2329,3780,6458,2561,2285,D
2560,F,8342,6632,8961,90,8993,2561,619,F
2560,G,1126,1126,10087,1340,10333,2561,8961,G
2560,H,356,356,10443,3780,14113,2561,10087,H
2560,M,1581,1581,12024,1809,15922,2561,10443,M
2560,N,260,260,12284,90,16012,2561,12024,N
2560,O,558,558,12842,805,16817,2561,12284,O
2560,P,12120,12120,24962,3780,20597,2561,12842,P
2561,AE,650,650,650,948,948,2562,0,A
2561,BE,421,421,1071,150,1098,2562,650,B
2561,CE,154,154,1225,120,1218,2562,1071,C
2561,BE,270,270,1495,320,1538,2562,1225,B
2561,CE,1499,4,1499,2348,2348,2562,0,E
2561,CF,111,107,1606,125,1663,2562,1495,C
2561,DF,956,849,2455,150,2498,2562,1499,F
2561,DG,178,178,2633,130,2628,2562,2455,G
2561,DF,1077,50,2683,4230,5893,2562,1606,D
2561,F,336,286,2969,380,3008,2562,2633,F
2561,G,126,126,3095,120,3128,2562,2969,G
2561,H,1013,1013,4108,4230,7358,2562,3095,H
2561,M,150,150,4258,873,8231,2562,4108,M
2561,N,829,829,5087,150,8381,2562,4258,N
2561,O,214,214,5301,125,8506,2562,5087,O
2561,N,264,264,5565,355,8861,2562,5301,N
2561,O,623,623,6188,809,9670,2562,5565,O
2561,P,3283,3283,9471,3840,13510,2562,6188,P
2562,A,52,52,52,35,35,2563,0,A
2562,B,131,131,183,210,245,2563,52,B
2562,C,136,136,319,255,500,2563,183,C
2562,B,1513,1513,1832,1390,1890,2563,319,B
2562,C,733,733,2565,845,2735,2563,1832,C
2562,D,615,615,3180,5160,7895,2563,2565,D
2562,M,265,265,3445,280,8175,2563,3180,M
2562,N,264,264,3709,300,8475,2563,3445,N
2562,O,739,739,4448,840,9315,2563,3709,O
2562,P,1369,1369,5817,1140,10455,2563,4448,P
2563,A,249,249,249,1029,1029,2564,0,A
2563,B,955,955,1204,150,1179,2564,249,B
2563,C,701,701,1905,805,1984,2564,1204,C
2563,D,4150,4150,6055,4230,6214,2564,1905,D
2563,M,3129,3129,9184,2854,9068,2564,6055,M
2563,N,105,105,9289,500,9568,2564,9184,N
2563,O,750,750,10039,690,10258,2564,9289,O
2563,P,1543,1543,11582,385,10643,2564,10039,P
2564,AE,84,84,84,995,995,2565,0,E
2564,AF,1113,1113,1197,240,1235,2565,84,F
2564,AG,1822,625,1822,4012,4012,2565,0,A
2564,BG,888,263,2085,1020,2255,2565,1197,G
2564,BH,23,23,2108,4680,6935,2565,2085,H
2564,B,2218,1932,4040,90,4102,2565,1822,B
2564,C,388,388,4428,795,4897,2565,4040,C
2564,D,1653,1653,6081,3780,8677,2565,4428,D
2564,M,2133,2133,8214,2242,10919,2565,6081,M
2564,N,132,132,8346,90,11009,2565,8214,N
2564,O,519,519,8865,800,11809,2565,8346,O
2564,N,1524,1524,10389,1220,13029,2565,8865,N
2564,O,194,194,10583,690,13719,2565,10389,O
2564,P,1567,1567,12150,3780,17499,2565,10583,P
2565,AE,147,147,147,539,539,2566,0,A
2565,BE,672,672,819,300,839,2566,147,B
2565,CE,841,841,1660,890,1729,2566,819,C
2565,DE,1122,1122,2782,310,2039,2566,1660,D
2565,E,4460,1678,4460,4665,4665,2566,0,E
2565,F,334,334,4794,180,4845,2566,4460,F
2565,G,653,653,5447,695,5540,2566,4794,G
2565,H,8572,8572,14019,4080,9620,2566,5447,H
2565,M,1359,1359,15378,3760,13380,2566,14019,M
2565,N,2846,2846,18224,420,13800,2566,15378,N
2565,O,1535,1535,19759,1726,15526,2566,18224,O
2565,P,4,4,19763,974,16500,2566,19759,P
2566,AE,231,231,231,3103,3103,2567,0,E
2566,AF,1203,972,1203,2659,2659,2567,0,A
2566,BF,1497,1497,2700,90,2749,2567,1203,B
2566,CF,2914,445,3145,90,3193,2567,231,F
2566,CG,729,284,3429,1135,3884,2567,2700,C
2566,DG,283,283,3712,3780,7664,2567,3429,D
2566,G,1672,1105,4817,1880,5073,2567,3145,G
2566,H,334,334,5151,3780,8853,2567,4817,H
2566,M,1566,1566,6717,1799,10652,2567,5151,M
2566,N,266,266,6983,90,10742,2567,6717,N
2566,O,937,937,7920,1175,11917,2567,6983,O
2566,P,286,286,8206,3780,15697,2567,7920,P
2567,AE,3303,3303,3303,6013,6013,2568,0,A
2567,BE,4649,1346,4649,4851,4851,2568,0,E
2567,BF,233,233,4882,90,4941,2568,4649,F
2567,BG,811,811,5693,1105,6046,2568,4882,G
2567,BH,52,52,5745,3780,9826,2568,5693,H
2567,B,3444,1002,6747,780,6793,2568,3303,B
2567,C,995,995,7742,1170,7963,2568,6747,C
2567,D,13532,13532,21274,590,8553,2568,7742,D
2567,M,119,119,21393,421,10247,2568,21274,M
2567,N,599,599,21992,360,10607,2568,21393,N
2567,O,1136,1136,23128,1125,11732,2568,21992,O
2567,N,72,72,23200,80,11812,2568,23128,N
2567,O,161,161,23361,120,11932,2568,23200,O
2567,P,3209,3209,26570,550,12482,2568,23361,P
2568,AEI,4,4,4,257,257,2569,0,E
2568,AFI,22,18,22,202,202,2569,0,I
2568,AFJ,97,75,97,156,156,2569,0,A
2568,BFJ,134,134,231,135,291,2569,97,B
2568,CFJ,266,57,288,135,337,2569,22,J
2568,CFK,343,59,347,150,407,2569,4,F
2568,CGK,221,105,452,290,581,2569,231,C
2568,DGK,186,22,474,290,627,2569,288,K
2568,DGL,42,20,494,5160,5741,2569,452,D
2568,GL,199,52,546,280,687,2569,347,G
2568,HL,73,1,547,5160,5787,2569,474,L
2568,H,1073,1072,1619,5160,5847,2569,546,H
2568,M,892,892,2511,1681,7528,2569,1619,M
2568,N,937,937,3448,150,7678,2569,2511,N
2568,O,1354,1354,4802,1610,9288,2569,3448,O
2568,P,272,272,5074,2520,11808,2569,4802,P
2569,A,631,631,631,1350,1350,2570,0,A
2569,B,839,839,1470,180,1530,2570,631,B
2569,C,805,805,2275,830,2360,2570,1470,C
2569,B,404,404,2679,290,2650,2570,2275,B
2569,C,537,537,3216,760,3410,2570,2679,C
2569,D,969,969,4185,1140,4550,2570,3216,D
2569,M,2562,2562,6747,2550,7100,2570,4185,M
2569,N,245,245,6992,300,7400,2570,6747,N
2569,O,821,821,7813,970,8370,2570,6992,O
2569,N,357,357,8170,530,8900,2570,7813,N
2569,O,313,313,8483,390,9290,2570,8170,O
2569,P,3115,3115,11598,4020,13310,2570,8483,P
2570,AE,86,86,86,261,261,2571,0,E
2570,AF,113,27,113,221,221,2571,0,A
2570,BF,295,295,408,240,461,2571,113,B
2570,CF,474,152,560,240,501,2571,86,F
2570,CG,218,66,626,285,746,2571,408,C
2570,DG,536,470,1096,755,1256,2571,560,G
2570,DF,174,174,1270,160,1416,2571,1096,F
2570,DG,1458,814,2084,5160,5906,2571,626,D
2570,G,871,57,2141,1260,2676,2571,1270,G
2570,H,391,391,2532,3960,6636,2571,2141,H
2570,M,430,430,2962,574,7210,2571,2532,M
2570,N,252,252,3214,150,7360,2571,2962,N
2570,O,181,181,3395,95,7455,2571,3214,O
2570,N,284,284,3679,390,7845,2571,3395,N
2570,O,171,171,3850,225,8070,2571,3679,O
2570,P,1619,1619,5469,4740,12810,2571,3850,P
2571,A,3123,3123,3123,3231,3231,2572,0,A
2571,B,136,136,3259,90,3321,2572,3123,B
2571,C,443,443,3702,820,4141,2572,3259,C
2571,D,3295,3295,6997,3780,7921,2572,3702,D
2571,M,531,531,7528,876,8797,2572,6997,M
2571,N,391,391,7919,90,8887,2572,7528,N
2571,O,405,405,8324,765,9652,2572,7919,O
2571,P,495,495,8819,3780,13432,2572,8324,P
2572,AE,48,48,48,1377,1377,2573,0,A
2572,BE,1516,1516,1564,240,1617,2573,48,B
2572,CE,830,830,2394,930,2547,2573,1564,C
2572,DE,1050,1050,3444,6990,9537,2573,2394,D
2572,E,5744,2300,5744,5979,5979,2573,0,E
2572,F,275,275,6019,90,6069,2573,5744,F
2572,G,590,590,6609,800,6869,2573,6019,G
2572,F,256,256,6865,55,6924,2573,6609,F
2572,G,1231,1231,8096,1625,8549,2573,6865,G
2572,H,3239,3239,11335,3780,12329,2573,8096,H
2572,M,11858,11858,23193,11772,24101,2573,11335,M
2572,N,381,381,23574,90,24191,2573,23193,N
2572,O,1149,1149,24723,1545,25736,2573,23574,O
2572,P,883,883,25606,3780,29516,2573,24723,P
2573,AE,104,104,104,978,978,2574,0,E
2573,AF,904,904,1008,90,1068,2574,104,F
2573,AG,1026,1026,2034,1220,2288,2574,1008,G
2573,AF,626,626,2660,430,2718,2574,2034,F
2573,AG,746,746,3406,970,3688,2574,2660,G
2573,AH,3539,133,3539,4410,4410,2574,0,A
2573,BH,888,888,4427,90,4500,2574,3539,B
2573,CH,1210,1210,5637,1430,5930,2574,4427,C
2573,BH,905,905,6542,670,6600,2574,5637,B
2573,CH,651,651,7193,970,7570,2574,6542,C
2573,DH,4126,339,7532,3780,7468,2574,3406,H
2573,D,575,236,7768,3780,11350,2574,7193,D
2573,M,264,264,8032,5980,17330,2574,7768,M
2573,N,5739,5739,13771,90,17420,2574,8032,N
2573,O,542,542,14313,970,18390,2574,13771,O
2573,N,661,661,14974,225,18615,2574,14313,N
2573,O,110,110,15084,535,19150,2574,14974,O
2573,P,134,134,15218,3780,22930,2574,15084,P
2574,AE,162,162,162,169,169,2575,0,E
2574,AF,185,185,347,240,409,2575,162,F
2574,AG,1119,1119,1466,1085,1494,2575,347,G
2574,AH,1537,71,1537,2083,2083,2575,0,A
2574,BH,497,426,1963,550,2044,2575,1466,H
2574,B,846,420,2383,360,2443,2575,1537,B
2574,C,1018,1018,3401,1000,3443,2575,2383,C
2574,D,2733,2733,6134,550,3993,2575,3401,D
2574,M,817,817,6951,1149,5142,2575,6134,M
2574,N,452,452,7403,180,5322,2575,6951,N
2574,O,650,650,8053,840,6162,2575,7403,O
2574,N,1285,1285,9338,1095,7257,2575,8053,N
2574,O,560,560,9898,680,7937,2575,9338,O
2574,P,501,501,10399,5460,13397,2575,9898,P
2575,A,1962,1962,1962,2886,2886,2576,0,A
2575,B,954,954,2916,90,2976,2576,1962,B
2575,C,487,487,3403,880,3856,2576,2916,C
2575,B,516,516,3919,110,3966,2576,3403,B
2575,C,1460,1460,5379,2315,6281,2576,3919,C
2575,D,2955,2955,8334,3420,9701,2576,5379,D
2575,M,1362,1362,9696,1418,11119,2576,8334,M
2575,N,107,107,9803,90,11209,2576,9696,N
2575,O,1598,1598,11401,1940,13149,2576,9803,O
2575,N,917,917,12318,590,13739,2576,11401,N
2575,O,670,670,12988,900,14639,2576,12318,O
2575,P,2907,2907,15895,3780,18419,2576,12988,P
2576,AEI,201,201,201,3346,3346,2577,0,A
2576,BEI,283,82,283,888,888,2577,0,E
2576,BFI,380,97,380,620,620,2577,0,I
2576,BFJ,240,61,441,150,3496,2577,201,B
2576,CFJ,695,537,978,150,1038,2577,283,F
2576,CGJ,801,203,1181,620,1240,2577,380,J
2576,CGK,248,45,1226,175,1213,2577,978,G
2576,CHK,947,162,1388,790,4286,2577,441,C
2576,DHK,215,8,1396,240,1480,2577,1181,K
2576,DHL,1776,1606,3002,1520,2733,2577,1226,H
2576,DL,1757,151,3153,4140,5620,2577,1396,L
2576,D,2725,960,4113,1520,5806,2577,1388,D
2576,M,26543,26543,30656,27331,33137,2577,4113,M
2576,N,818,818,31474,90,33227,2577,30656,N
2576,O,891,891,32365,1240,34467,2577,31474,O
2576,P,147,147,32512,3780,38247,2577,32365,P
2577,A,391,391,391,387,387,2578,0,A
2577,B,86,86,477,150,537,2578,391,B
2577,C,793,793,1270,690,1227,2578,477,C
2577,B,789,789,2059,855,2082,2578,1270,B
2577,C,857,857,2916,1029,3111,2578,2059,C
2577,D,243,243,3159,351,3462,2578,2916,D
2577,M,1951,1951,5110,1950,5412,2578,3159,M
2577,N,132,132,5242,180,5592,2578,5110,N
2577,O,1049,1049,6291,965,6557,2578,5242,O
2577,P,1074,1074,7365,385,6942,2578,6291,P
2578,A,856,856,856,1277,1277,2579,0,A
2578,B,598,598,1454,180,1457,2579,856,B
2578,C,927,927,2381,910,2367,2579,1454,C
2578,D,473,473,2854,550,2917,2579,2381,D
2578,M,2415,2415,5269,9484,12401,2579,2854,M
2578,N,7448,7448,12717,420,12821,2579,5269,N
2578,O,1295,1295,14012,611,13432,2579,12717,O
2578,P,1589,1589,15601,1209,14641,2579,14012,P
2579,A,330,330,330,1205,1205,2580,0,A
2579,B,961,961,1291,150,1355,2580,330,B
2579,C,180,180,1471,205,1560,2580,1291,C
2579,D,571,571,2042,2850,4410,2580,1471,D
2579,M,1902,1902,3944,2448,6858,2580,2042,M
2579,N,722,722,4666,180,7038,2580,3944,N
2579,O,754,754,5420,895,7933,2580,4666,O
2579,N,1025,1025,6445,220,8153,2580,5420,N
2579,O,301,301,6746,690,8843,2580,6445,O
2579,P,777,777,7523,6660,15503,2580,6746,P
2580,AEI,331,331,331,1015,1015,2581,0,A
2580,BEI,879,879,1210,240,1255,2581,331,B
2580,CEI,638,638,1848,895,2150,2581,1210,C
2580,DEI,1505,1505,3353,3960,6110,2581,1848,D
2580,EI,6512,3159,6512,7059,7059,2581,0,E
2580,FI,750,750,7262,240,7299,2581,6512,F
2580,GI,619,619,7881,875,8174,2581,7262,G
2580,HI,820,820,8701,3960,12134,2581,7881,H
2580,I,29335,20634,29335,29987,29987,2581,0,I
2580,J,912,912,30247,300,30287,2581,29335,J
2580,K,734,734,30981,750,31037,2581,30247,K
2580,L,103,103,31084,4080,35117,2581,30981,L
2580,M,334,334,31418,1666,36783,2581,31084,M
2580,N,1757,1757,33175,300,37083,2581,31418,N
2580,O,603,603,33778,675,37758,2581,33175,O
2580,P,452,452,34230,4080,41838,2581,33778,P
2581,A,3203,3203,3203,3481,3481,2582,0,A
2581,B,304,304,3507,90,3571,2582,3203,B
2581,C,568,568,4075,715,4286,2582,3507,C
2581,D,1362,1362,5437,3780,8066,2582,4075,D
2581,M,4216,4216,9653,4348,12414,2582,5437,M
2581,N,190,190,9843,90,12504,2582,9653,N
2581,O,406,406,10249,800,13304,2582,9843,O
2581,N,714,714,10963,340,13644,2582,10249,N
2581,O,531,531,11494,790,14434,2582,10963,O
2581,P,844,844,12338,3780,18214,2582,11494,P
2582,AEI,116,116,116,249,249,2583,0,A
2582,BEI,215,215,331,150,399,2583,116,B
2582,CEI,109,109,440,60,459,2583,331,C
2582,DEI,1430,990,1430,1519,1519,2583,0,I
2582,DEJ,1518,88,1518,2707,2707,2583,0,E
2582,DFJ,168,80,1598,150,1669,2583,1430,J
2582,DFK,582,582,2180,585,2254,2583,1598,K
2582,DFJ,418,418,2598,400,2654,2583,2180,J
2582,DFK,106,106,2704,120,2774,2583,2598,K
2582,DFL,1378,192,2896,240,2947,2583,1518,F
2582,DGL,714,714,3610,855,3802,2583,2896,G
2582,DFL,296,296,3906,130,3932,2583,3610,F
2582,DGL,127,127,4033,1050,4982,2583,3906,G
2582,DHL,3765,172,4205,2880,3339,2583,440,D
2582,DHL,1501,0,4205,4230,7004,2583,2704,L
2582,H,934,762,4967,3300,8282,2583,4033,H
2582,M,94,94,5061,150,8432,2583,4967,M
2582,N,112,112,5173,120,8552,2583,5061,N
2582,O,123,123,5296,125,8677,2583,5173,O
2582,P,64,64,5360,2880,11557,2583,5296,P
2583,AEI,372,372,372,900,900,2584,0,E
2583,AFI,865,493,865,1135,1135,2584,0,I
2583,AFJ,632,139,1004,150,1050,2584,372,F
2583,AGJ,125,125,1129,115,1165,2584,1004,G
2583,AFJ,311,47,1176,90,1225,2584,865,J
2583,AFK,366,366,1542,795,2020,2584,1176,K
2583,AFL,511,98,1640,500,1665,2584,1129,F
2583,AGL,2240,600,2240,4704,4704,2584,0,A
2583,BGL,696,96,2336,660,2325,2584,1640,G
2583,BHL,906,112,2448,3780,5800,2584,1542,L
2583,BH,1220,1108,3556,4230,6555,2584,2336,H
2583,B,2515,1199,4755,90,4794,2584,2240,B
2583,C,374,374,5129,795,5589,2584,4755,C
2583,D,1691,1691,6820,3780,9369,2584,5129,D
2583,M,13523,13523,20343,13740,23109,2584,6820,M
2583,N,274,274,20617,90,23199,2584,20343,N
2583,O,483,483,21100,820,24019,2584,20617,O
2583,N,656,656,21756,345,24364,2584,21100,N
2583,O,387,387,22143,790,25154,2584,21756,O
2583,P,1778,1778,23921,3780,28934,2584,22143,P
2584,AE,26,26,26,125,125,2585,0,A
2584,BE,75,49,75,637,637,2585,0,E
2584,BF,176,127,202,135,260,2585,26,B
2584,CF,197,197,399,295,555,2585,202,C
2584,DF,81,81,480,5100,5655,2585,399,D
2584,F,594,189,669,90,727,2585,75,F
2584,G,253,253,922,575,1302,2585,669,G
2584,F,5038,5038,5960,4720,6022,2585,922,F
2584,G,1058,1058,7018,1425,7447,2585,5960,G
2584,H,551,551,7569,3780,11227,2585,7018,H
2584,M,645,645,8214,1148,12375,2585,7569,M
2584,N,1059,1059,9273,180,12555,2585,8214,N
2584,O,483,483,9756,895,13450,2585,9273,O
2584,N,276,276,10032,300,13750,2585,9756,N
2584,O,196,196,10228,350,14100,2585,10032,O
2584,P,16052,16052,26280,6900,21000,2585,10228,P
2585,AE,188,188,188,1198,1198,2586,0,E
2585,AF,1040,1040,1228,90,1288,2586,188,F
2585,AG,989,989,2217,1210,2498,2586,1228,G
2585,AH,29,29,2246,3780,6278,2586,2217,H
2585,A,37207,34961,37207,38353,38353,2586,0,A
2585,B,1163,1163,38370,90,38443,2586,37207,B
2585,C,1216,1216,39586,1450,39893,2586,38370,C
2585,D,187,187,39773,3780,43673,2586,39586,D
2585,M,1247,1247,41020,1542,45215,2586,39773,M
2585,N,328,328,41348,90,45305,2586,41020,N
2585,O,458,458,41806,850,46155,2586,41348,O
2585,P,752,752,42558,3780,49935,2586,41806,P
2586,AEI,102,102,102,1320,1320,2587,0,I
2586,AEJ,215,113,215,1004,1004,2587,0,E
2586,AFJ,989,989,1204,240,1244,2587,215,F
2586,AGJ,1492,390,1594,300,1620,2587,102,J
2586,AGK,813,423,2017,995,2239,2587,1204,G
2586,AHK,2044,27,2044,2791,2791,2587,0,A
2586,BHK,918,468,2512,1005,2625,2587,1594,K
2586,BHL,799,331,2843,90,2881,2587,2044,B
2586,CHL,591,260,3103,1200,3825,2587,2512,L
2586,CH,375,115,3218,800,3681,2587,2843,C
2586,DH,1312,111,3329,4680,6919,2587,2017,H
2586,D,1949,1838,5167,3780,7461,2587,3218,D
2586,M,710,710,5877,1269,8730,2587,5167,M
2586,N,696,696,6573,180,8910,2587,5877,N
2586,O,942,942,7515,920,9830,2587,6573,O
2586,P,1228,1228,8743,550,10380,2587,7515,P
2587,AEI,219,219,219,234,234,2588,0,E
2587,AFI,255,255,474,300,534,2588,219,F
2587,AGI,603,129,603,944,944,2588,0,A
2587,BGI,371,371,974,90,1034,2588,603,B
2587,CGI,734,234,1208,690,1224,2588,474,G
2587,CFI,1451,243,1451,2996,2996,2588,0,I
2587,CFJ,361,118,1569,390,1614,2588,1208,F
2587,CGJ,789,194,1763,625,1659,2588,974,C
2587,DGJ,465,153,1916,420,3416,2588,1451,J
2587,DGK,548,201,2117,720,2334,2588,1569,G
2587,DHK,694,493,2610,715,4131,2588,1916,K
2587,DHL,1168,675,3285,3960,6294,2588,2117,H
2587,DL,2260,738,4023,550,2209,2588,1763,D
2587,L,1946,533,4556,550,4681,2588,2610,L
2587,M,505,505,5061,1033,7327,2588,4556,M
2587,N,632,632,5693,150,7477,2588,5061,N
2587,O,155,155,5848,115,7592,2588,5693,O
2587,N,2114,2114,7962,2155,9747,2588,5848,N
2587,O,628,628,8590,605,10352,2588,7962,O
2587,P,9989,9989,18579,4230,14582,2588,8590,P
2588,A,1595,1595,1595,1645,1645,2589,0,A
2588,B,360,360,1955,300,1945,2589,1595,B
2588,C,747,747,2702,735,2680,2589,1955,C
2588,B,181,181,2883,255,2935,2589,2702,B
2588,C,4462,4462,7345,410,3345,2589,2883,C
2588,D,24238,24238,31583,1140,4485,2589,7345,D
2588,M,330,330,31913,875,5360,2589,31583,M
2588,N,697,697,32610,180,5540,2589,31913,N
2588,O,330,330,32940,415,5955,2589,32610,O
2588,N,507,507,33447,430,6385,2589,32940,N
2588,O,250,250,33697,410,6795,2589,33447,O
2588,P,621,621,34318,1140,7935,2589,33697,P
2589,A,1059,1059,1059,1564,1564,2590,0,A
2589,B,447,447,1506,180,1744,2590,1059,B
2589,C,746,746,2252,1205,2949,2590,1506,C
2589,B,790,790,3042,120,3069,2590,2252,B
2589,C,648,648,3690,1050,4119,2590,3042,C
2589,D,1527,1527,5217,3780,7899,2590,3690,D
2589,M,271,271,5488,340,8239,2590,5217,M
2589,N,161,161,5649,150,8389,2590,5488,N
2589,O,73,73,5722,50,8439,2590,5649,O
2589,N,707,707,6429,725,9164,2590,5722,N
2589,O,229,229,6658,265,9429,2590,6429,O
2589,P,111,111,6769,5100,14529,2590,6658,P
2590,A,988,988,988,1361,1361,2591,0,A
2590,B,432,432,1420,90,1451,2591,988,B
2590,C,988,988,2408,1240,2691,2591,1420,C
2590,D,28,28,2436,3780,6471,2591,2408,D
2590,M,472,472,2908,1261,7732,2591,2436,M
2590,N,822,822,3730,90,7822,2591,2908,N
2590,O,322,322,4052,705,8527,2591,3730,O
2590,P,4067,4067,8119,3780,12307,2591,4052,P
2591,A,940,940,940,1003,1003,2592,0,A
2591,B,294,294,1234,300,1303,2592,940,B
2591,C,602,602,1836,775,2078,2592,1234,C
2591,B,1277,1277,3113,1085,3163,2592,1836,B
2591,C,505,505,3618,740,3903,2592,3113,C
2591,D,13737,13737,17355,5100,9003,2592,3618,D
2591,M,2486,2486,19841,2922,11925,2592,17355,M
2591,N,461,461,20302,90,12015,2592,19841,N
2591,O,434,434,20736,805,12820,2592,20302,O
2591,N,1619,1619,22355,1240,14060,2592,20736,N
2591,O,588,588,22943,920,14980,2592,22355,O
2591,P,1002,1002,23945,3780,18760,2592,22943,P
2592,AE,156,156,156,1909,1909,2593,0,A
2592,BE,1944,1788,1944,3753,3753,2593,0,E
2592,BF,1813,25,1969,300,2209,2593,156,B
2592,CF,700,700,2669,690,2899,2593,1969,C
2592,BF,580,580,3249,390,3289,2593,2669,B
2592,CF,583,583,3832,720,4009,2593,3249,C
2592,DF,1943,55,3887,180,3933,2593,1944,F
2592,DG,904,904,4791,900,4833,2593,3887,G
2592,DH,1877,918,5709,3960,7969,2593,3832,D
2592,H,1541,623,6332,550,5383,2593,4791,H
2592,M,13693,13693,20025,14326,22295,2593,6332,M
2592,N,983,983,21008,420,22715,2593,20025,N
2592,O,449,449,21457,790,23505,2593,21008,O
2592,P,1731,1731,23188,1315,24820,2593,21457,P
2593,AEI,513,513,513,720,720,2594,0,I
2593,AEJ,341,341,854,180,900,2594,513,J
2593,AEK,1041,187,1041,1392,1392,2594,0,A
2593,BEK,1072,31,1072,1490,1490,2594,0,E
2593,BFK,538,538,1610,180,1670,2594,1072,F
2593,BGK,592,23,1633,300,1692,2594,1041,B
2593,CGK,1207,428,2061,635,1535,2594,854,K
2593,CGJ,119,119,2180,705,2240,2594,2061,J
2593,CGK,697,127,2307,765,2435,2594,1610,G
2593,CHK,897,223,2530,895,2587,2594,1633,C
2593,DHK,484,134,2664,610,2850,2594,2180,K
2593,DHL,831,474,3138,550,2985,2594,2307,H
2593,DL,4060,3452,6590,550,3137,2594,2530,D
2593,L,9124,5198,11788,6960,9810,2594,2664,L
2593,M,955,955,12743,1052,10862,2594,11788,M
2593,N,217,217,12960,180,11042,2594,12743,N
2593,O,152,152,13112,230,11272,2594,12960,O
2593,N,573,573,13685,480,11752,2594,13112,N
2593,O,434,434,14119,500,12252,2594,13685,O
2593,P,3932,3932,18051,6000,18252,2594,14119,P
2594,A,1713,1713,1713,2429,2429,2595,0,A
2594,B,778,778,2491,90,2519,2595,1713,B
2594,C,678,678,3169,855,3374,2595,2491,C
2594,D,334,334,3503,3780,7154,2595,3169,D
2594,M,270,270,3773,477,7631,2595,3503,M
2594,N,243,243,4016,90,7721,2595,3773,N
2594,O,537,537,4553,845,8566,2595,4016,O
2594,P,409,409,4962,3780,12346,2595,4553,P
2595,A,4315,4315,4315,6624,6624,2596,0,A
2595,B,2439,2439,6754,180,6804,2596,4315,B
2595,C,631,631,7385,670,7474,2596,6754,C
2595,D,1700,1700,9085,550,8024,2596,7385,D
2595,M,265,265,9350,1244,9268,2596,9085,M
2595,N,1099,1099,10449,180,9448,2596,9350,N
2595,O,843,843,11292,830,10278,2596,10449,O
2595,P,4867,4867,16159,6680,16958,2596,11292,P
2596,AEI,2106,2106,2106,5811,5811,2597,0,A
2596,BEI,2264,158,2264,3007,3007,2597,0,E
2596,BFI,2310,46,2310,3371,3371,2597,0,I
2596,BFJ,772,726,3036,90,3097,2597,2264,F
2596,BGJ,1091,365,3401,90,3461,2597,2310,J
2596,BGK,661,296,3697,1125,4222,2597,3036,G
2596,BHK,699,403,4100,1130,4591,2597,3401,K
2596,BHL,3735,1741,5841,90,5901,2597,2106,B
2596,CHL,1842,101,5942,3780,8371,2597,4100,L
2596,CH,706,605,6547,1106,7007,2597,5841,C
2596,DH,2235,2235,8782,3780,10787,2597,6547,D
2596,H,8666,3581,12363,3780,8002,2597,3697,H
2596,M,2738,2738,15101,2713,13500,2597,12363,M
2596,N,333,333,15434,420,13920,2597,15101,N
2596,O,873,873,16307,945,14865,2597,15434,O
2596,N,396,396,16703,325,15190,2597,16307,N
2596,O,391,391,17094,260,15450,2597,16703,O
2596,P,6638,6638,23732,5160,20610,2597,17094,P
2597,AEI,1296,1296,1296,1476,1476,2598,0,I
2597,AEJ,1811,515,1811,2468,2468,2598,0,E
2597,AFJ,870,355,2166,750,2226,2598,1296,J
2597,AFK,717,362,2528,120,2588,2598,1811,F
2597,AGK,874,512,3040,855,3081,2598,2166,K
2597,AGL,891,379,3419,890,3478,2598,2528,G
2597,AHL,2411,2411,5830,385,3863,2598,3419,H
2597,AL,6748,918,6748,6766,6766,2598,0,A
2597,BL,148,148,6896,420,7186,2598,6748,B
2597,CL,4067,211,7107,550,3631,2598,3040,L
2597,C,2282,2071,9178,770,7956,2598,6896,C
2597,D,626,626,9804,550,8506,2598,9178,D
2597,M,2328,2328,12132,3321,11827,2598,9804,M
2597,N,1380,1380,13512,420,12247,2598,12132,N
2597,O,686,686,14198,920,13167,2598,13512,O
2597,P,4014,4014,18212,775,13942,2598,14198,P
2598,AEI,101,101,101,567,567,2599,0,A
2598,BEI,510,510,611,90,657,2599,101,B
2598,CEI,467,467,1078,805,1462,2599,611,C
2598,DEI,35,35,1113,3780,5242,2599,1078,D
2598,EI,1169,56,1169,1530,1530,2599,0,I
2598,EJ,1288,119,1288,1285,1285,2599,0,E
2598,FJ,103,103,1391,150,1435,2599,1288,F
2598,GJ,403,181,1572,90,1620,2599,1169,J
2598,GK,189,8,1580,140,1575,2599,1391,G
2598,FK,502,502,2082,550,2125,2599,1580,F
2598,GK,965,455,2537,1250,2870,2599,1572,K
2598,GL,4,4,2541,3780,6650,2599,2537,L
2598,G,791,332,2873,775,2900,2599,2082,G
2598,H,403,403,3276,4230,7130,2599,2873,H
2598,M,227,227,3503,474,7604,2599,3276,M
2598,N,522,522,4025,300,7904,2599,3503,N
2598,O,995,995,5020,1070,8974,2599,4025,O
2598,N,272,272,5292,215,9189,2599,5020,N
2598,O,147,147,5439,385,9574,2599,5292,O
2598,P,1246,1246,6685,4020,13594,2599,5439,P
2599,AE,46,46,46,1125,1125,2600,0,E
2599,AF,486,440,486,1201,1201,2600,0,A
2599,BF,1129,689,1175,165,1290,2600,46,F
2599,BG,789,100,1275,90,1291,2600,486,B
2599,CG,428,428,1703,860,2151,2600,1275,C
2599,DG,712,184,1887,885,2175,2600,1175,G
2599,DH,943,759,2646,3780,5931,2600,1703,D
2599,H,1747,988,3634,3960,6135,2600,1887,H
2599,M,1674,1674,5308,2517,8652,2600,3634,M
2599,N,1162,1162,6470,360,9012,2600,5308,N
2599,O,950,950,7420,1000,10012,2600,6470,O
2599,N,404,404,7824,355,10367,2600,7420,N
2599,O,196,196,8020,390,10757,2600,7824,O
2599,P,290,290,8310,3960,14717,2600,8020,P
2600,AE,189,189,189,1205,1205,2601,0,A
2600,BE,1045,1045,1234,90,1295,2601,189,B
2600,CE,928,928,2162,1220,2515,2601,1234,C
2600,DE,24,24,2186,3780,6295,2601,2162,D
2600,E,4841,2655,4841,8263,8263,2601,0,E
2600,F,3450,3450,8291,90,8353,2601,4841,F
2600,G,919,919,9210,1240,9593,2601,8291,G
2600,H,380,380,9590,3780,13373,2601,9210,H
2600,M,481,481,10071,897,14270,2601,9590,M
2600,N,712,712,10783,360,14630,2601,10071,N
2600,O,382,382,11165,395,15025,2601,10783,O
2600,P,1642,1642,12807,1500,16525,2601,11165,P
2601,AE,1594,1594,1594,3041,3041,2602,0,A
2601,BE,1786,192,1786,2025,2025,2602,0,E
2601,BF,374,374,2160,180,2205,2602,1786,F
2601,BG,1188,1188,3348,1810,4015,2602,2160,G
2601,BF,1917,163,3511,420,3461,2602,1594,B
2601,CF,957,957,4468,1015,4476,2602,3511,C
2601,DF,1154,34,4502,235,4250,2602,3348,F
2601,DG,324,324,4826,540,4790,2602,4502,G
2601,DH,439,439,5265,9780,14570,2602,4826,H
2601,D,2234,1437,6702,550,5026,2602,4468,D
2601,M,1004,1004,7706,1609,16179,2602,6702,M
2601,N,983,983,8689,420,16599,2602,7706,N
2601,O,971,971,9660,1114,17713,2602,8689,O
2601,P,76,76,9736,341,18054,2602,9660,P
2602,AEI,171,171,171,83,83,2603,0,E
2602,AFI,216,45,216,315,315,2603,0,I
2602,AFJ,206,161,377,285,368,2603,171,F
2602,AGJ,179,18,395,150,465,2603,216,J
2602,AGK,105,87,482,75,443,2603,377,G
2602,AHK,223,136,618,565,1030,2603,395,K
2602,AHJ,824,206,824,1062,1062,2603,0,A
2602,BHJ,506,300,1124,155,1185,2603,618,J
2602,BHK,339,39,1163,150,1212,2603,824,B
2602,CHK,89,50,1213,75,1260,2603,1124,K
2602,CHL,761,30,1243,2840,3283,2603,482,H
2602,CL,105,25,1268,115,1327,2603,1163,C
2602,DL,262,207,1475,2880,4140,2603,1213,L
2602,D,4730,4523,5998,4230,5557,2603,1268,D
2602,M,193,193,6191,874,6431,2603,5998,M
2602,N,783,783,6974,150,6581,2603,6191,N
2602,O,168,168,7142,120,6701,2603,6974,O
2602,N,332,332,7474,365,7066,2603,7142,N
2602,O,249,249,7723,150,7216,2603,7474,O
2602,P,1198,1198,8921,4230,11446,2603,7723,P
2603,AE,52,52,52,1189,1189,2604,0,E
2603,AF,1142,1090,1142,2615,2615,2604,0,A
2603,BF,1167,77,1219,90,1279,2604,52,F
2603,BG,952,952,2171,1210,2489,2604,1219,G
2603,BH,51,51,2222,3780,6269,2604,2171,H
2603,B,1503,423,2645,90,2705,2604,1142,B
2603,C,1001,1001,3646,1220,3925,2604,2645,C
2603,D,138,138,3784,3780,7705,2604,3646,D
2603,M,4188,4188,7972,4826,12531,2604,3784,M
2603,N,667,667,8639,90,12621,2604,7972,N
2603,O,512,512,9151,905,13526,2604,8639,O
2603,P,6692,6692,15843,3780,17306,2604,9151,P
2604,AEI,599,599,599,1005,1005,2605,0,A
2604,BEI,446,446,1045,90,1095,2605,599,B
2604,CEI,1511,466,1511,1762,1762,2605,0,E
2604,CFI,286,286,1797,90,1852,2605,1511,F
2604,CGI,1017,265,2062,1240,2335,2605,1045,C
2604,DGI,54,54,2116,3780,6115,2605,2062,D
2604,GI,485,166,2282,880,2732,2605,1797,G
2604,HI,285,285,2567,3780,6512,2605,2282,H
2604,I,6381,3814,6381,7147,7147,2605,0,I
2604,J,808,808,7189,90,7237,2605,6381,J
2604,K,927,927,8116,1250,8487,2605,7189,K
2604,L,235,235,8351,3780,12267,2605,8116,L
2604,M,618,618,8969,1365,13632,2605,8351,M
2604,N,784,784,9753,90,13722,2605,8969,N
2604,O,207,207,9960,605,14327,2605,9753,O
2604,P,3120,3120,13080,3780,18107,2605,9960,P
2605,A,187,187,187,911,911,2606,0,A
2605,B,749,749,936,90,1001,2606,187,B
2605,C,409,409,1345,795,1796,2606,936,C
2605,D,1015,1015,2360,3780,5576,2606,1345,D
2605,M,1073,1073,3433,1180,6756,2606,2360,M
2605,N,132,132,3565,90,6846,2606,3433,N
2605,O,479,479,4044,820,7666,2606,3565,O
2605,N,1537,1537,5581,1180,8846,2606,4044,N
2605,O,213,213,5794,605,9451,2606,5581,O
2605,P,2220,2220,8014,3780,13231,2606,5794,P
2606,A,690,690,690,1165,1165,2607,0,A
2606,B,642,642,1332,180,1345,2607,690,B
2606,C,902,902,2234,930,2275,2607,1332,C
2606,D,2347,2347,4581,550,2825,2607,2234,D
2606,M,2090,2090,6671,2739,5564,2607,4581,M
2606,N,708,708,7379,90,5654,2607,6671,N
2606,O,935,935,8314,1195,6849,2607,7379,O
2606,N,1996,1996,10310,1755,8604,2607,8314,N
2606,O,712,712,11022,1060,9664,2607,10310,O
2606,P,4201,4201,15223,3780,13444,2607,11022,P
2607,A,5,5,5,86,86,2608,0,A
2607,B,463,463,468,395,481,2608,5,B
2607,C,745,745,1213,830,1311,2608,468,C
2607,B,376,376,1589,310,1621,2608,1213,B
2607,C,907,907,2496,1080,2701,2608,1589,C
2607,D,854,854,3350,4080,6781,2608,2496,D
2607,M,2091,2091,5441,2206,8987,2608,3350,M
2607,N,143,143,5584,90,9077,2608,5441,N
2607,O,444,444,6028,820,9897,2608,5584,O
2607,N,671,671,6699,295,10192,2608,6028,N
2607,O,217,217,6916,535,10727,2608,6699,O
2607,P,918,918,7834,3780,14507,2608,6916,P
2608,A,267,267,267,329,329,2609,0,A
2608,B,159,159,426,150,479,2609,267,B
2608,C,174,174,600,130,609,2609,426,C
2608,B,899,899,1499,930,1539,2609,600,B
2608,C,394,394,1893,645,2184,2609,1499,C
2608,D,4837,4837,6730,4290,6474,2609,1893,D
2608,M,11312,11312,18042,11600,18074,2609,6730,M
2608,N,477,477,18519,240,18314,2609,18042,N
2608,O,636,636,19155,855,19169,2609,18519,O
2608,N,1619,1619,20774,1400,20569,2609,19155,N
2608,O,487,487,21261,1140,21709,2609,20774,O
2608,P,10170,10170,31431,3480,25189,2609,21261,P
2609,AEI,10,10,10,237,237,2610,0,E
2609,AFI,124,114,124,725,725,2610,0,I
2609,AFJ,429,315,439,240,477,2610,10,F
2609,AGJ,863,548,987,300,1025,2610,124,J
2609,AGK,719,171,1158,965,1442,2610,439,G
2609,AHK,242,242,1400,3960,5402,2610,1158,H
2609,AK,1018,605,2005,925,1950,2610,987,K
2609,AL,3250,1245,3250,3882,3882,2610,0,A
2609,BL,658,658,3908,90,3972,2610,3250,B
2609,CL,650,650,4558,1060,5032,2610,3908,C
2609,DL,120,120,4678,3780,8812,2610,4558,D
2609,L,4056,1383,6061,2760,4710,2610,2005,L
2609,M,3317,3317,9378,3373,12185,2610,6061,M
2609,N,154,154,9532,150,12335,2610,9378,N
2609,O,1050,1050,10582,970,13305,2610,9532,O
2609,N,2343,2343,12925,2425,15730,2610,10582,N
2609,O,1175,1175,14100,2270,18000,2610,12925,O
2609,P,1159,1159,15259,1715,19715,2610,14100,P
2610,A,1429,1429,1429,2235,2235,2611,0,A
2610,B,988,988,2417,240,2475,2611,1429,B
2610,C,830,830,3247,1015,3490,2611,2417,C
2610,B,1210,1210,4457,1020,4510,2611,3247,B
2610,C,647,647,5104,960,5470,2611,4457,C
2610,D,5539,5539,10643,3960,9430,2611,5104,D
2610,M,885,885,11528,525,9955,2611,10643,M
2610,N,192,192,11720,600,10555,2611,11528,N
2610,O,236,236,11956,420,10975,2611,11720,O
2610,N,430,430,12386,200,11175,2611,11956,N
2610,O,895,895,13281,1060,12235,2611,12386,O
2610,P,1702,1702,14983,3360,15595,2611,13281,P
2611,AE,140,140,140,1305,1305,2612,0,A
2611,BE,266,126,266,721,721,2612,0,E
2611,BF,514,514,780,90,811,2612,266,F
2611,BG,1344,704,1484,150,1455,2612,140,B
2611,CG,132,132,1616,135,1590,2612,1484,C
2611,BG,952,116,1732,1240,2051,2612,780,G
2611,BH,21,21,1753,3780,5831,2612,1732,H
2611,B,178,41,1794,250,1840,2612,1616,B
2611,C,826,826,2620,775,2615,2612,1794,C
2611,D,605,605,3225,4230,6845,2612,2620,D
2611,M,332,332,3557,515,7360,2612,3225,M
2611,N,431,431,3988,300,7660,2612,3557,N
2611,O,1235,1235,5223,1080,8740,2612,3988,O
2611,N,879,879,6102,1120,9860,2612,5223,N
2611,O,250,250,6352,390,10250,2612,6102,O
2611,P,226,226,6578,3960,14210,2612,6352,P
2612,AE,2344,2344,2344,5995,5995,2613,0,A
2612,BE,4169,1825,4169,4262,4262,2613,0,E
2612,BF,274,274,4443,240,4502,2613,4169,F
2612,BG,1630,1630,6073,1320,5822,2613,4443,G
2612,BF,4007,278,6351,420,6415,2613,2344,B
2612,CF,1542,1542,7893,1605,8020,2613,6351,C
2612,DF,2835,1015,8908,3155,8977,2613,6073,F
2612,DG,1595,580,9488,350,8370,2613,7893,D
2612,G,1657,1077,10565,1605,10582,2613,8908,G
2612,H,1758,1758,12323,350,10932,2613,10565,H
2612,M,281,281,12604,1009,11941,2613,12323,M
2612,N,829,829,13433,150,12091,2613,12604,N
2612,O,696,696,14129,640,12731,2613,13433,O
2612,N,868,868,14997,915,13646,2613,14129,N
2612,O,119,119,15116,135,13781,2613,14997,O
2612,P,279,279,15395,4230,18011,2613,15116,P
2613,AEI,82,82,82,84,84,2614,0,E
2613,AFI,131,49,131,310,310,2614,0,A
2613,BFI,93,44,175,155,239,2614,82,F
2613,BGI,94,94,269,100,339,2614,175,G
2613,BHI,25,25,294,2880,3219,2614,269,H
2613,BI,264,101,395,180,490,2614,131,B
2613,CI,383,383,778,660,1150,2614,395,C
2613,DI,278,278,1056,3960,5110,2614,778,D
2613,I,1106,50,1106,1230,1230,2614,0,I
2613,J,213,213,1319,150,1380,2614,1106,J
2613,K,191,191,1510,155,1535,2614,1319,K
2613,J,1200,1200,2710,1215,2750,2614,1510,J
2613,K,141,141,2851,285,3035,2614,2710,K
2613,L,1034,1034,3885,5100,8135,2614,2851,L
2613,M,33571,33571,37456,35306,43441,2614,3885,M
2613,N,1865,1865,39321,90,43531,2614,37456,N
2613,O,1133,1133,40454,1360,44891,2614,39321,O
2613,N,329,329,40783,200,45091,2614,40454,N
2613,O,572,572,41355,930,46021,2614,40783,O
2613,P,978,978,42333,3780,49801,2614,41355,P
2614,AEI,833,833,833,1359,1359,2615,0,A
2614,BEI,918,85,918,1421,1421,2615,0,E
2614,BFI,559,474,1392,90,1449,2615,833,B
2614,CFI,1430,38,1430,2418,2418,2615,0,I
2614,CFJ,542,30,1460,90,1511,2615,918,F
2614,CGJ,963,895,2355,1240,2689,2615,1392,C
2614,DGJ,4,4,2359,3780,6469,2615,2355,D
2614,GJ,928,29,2388,1240,2751,2615,1460,G
2614,HJ,36,36,2424,3780,6531,2615,2388,H
2614,J,1018,24,2448,90,2508,2615,1430,J
2614,K,524,524,2972,880,3388,2615,2448,K
2614,L,644,644,3616,3780,7168,2615,2972,L
2614,M,3159,3159,6775,3748,10916,2615,3616,M
2614,N,624,624,7399,90,11006,2615,6775,N
2614,O,114,114,7513,585,11591,2615,7399,O
2614,P,2768,2768,10281,3780,15371,2615,7513,P
2615,AE,33,33,33,47,47,2616,0,E
2615,AF,230,230,263,240,287,2616,33,F
2615,AG,989,989,1252,1220,1507,2616,263,G
2615,AH,46,46,1298,3960,5467,2616,1252,H
2615,A,36580,35282,36580,37411,37411,2616,0,A
2615,B,871,871,37451,90,37501,2616,36580,B
2615,C,926,926,38377,1240,38741,2616,37451,C
2615,B,352,352,38729,40,38781,2616,38377,B
2615,C,198,198,38927,585,39366,2616,38729,C
2615,D,122,122,39049,3780,43146,2616,38927,D
2615,M,3,3,39052,14,43160,2616,39049,M
2615,N,366,366,39418,390,43550,2616,39052,N
2615,O,1089,1089,40507,1175,44725,2616,39418,O
2615,N,1250,1250,41757,1190,45915,2616,40507,N
2615,O,165,165,41922,385,46300,2616,41757,O
2615,P,475,475,42397,370,46670,2616,41922,P
2616,A,45,45,45,196,196,2617,0,A
2616,B,331,331,376,240,436,2617,45,B
2616,C,199,199,575,285,721,2617,376,C
2616,D,2970,2970,3545,5160,5881,2617,575,D
2616,M,1049,1049,4594,1123,7004,2617,3545,M
2616,N,304,304,4898,240,7244,2617,4594,N
2616,O,148,148,5046,385,7629,2617,4898,O
2616,N,1328,1328,6374,1095,8724,2617,5046,N
2616,O,3611,3611,9985,925,9649,2617,6374,O
2616,P,46691,46691,56676,3960,13609,2617,9985,P
2617,AE,331,331,331,1277,1277,2618,0,E
2617,AF,976,976,1307,90,1367,2618,331,F
2617,AG,1634,327,1634,1901,1901,2618,0,A
2617,BG,292,292,1926,90,1991,2618,1634,B
2617,CG,815,196,2122,1200,2567,2618,1307,G
2617,CH,346,346,2468,3780,6347,2618,2122,H
2617,C,548,6,2474,905,2896,2618,1926,C
2617,D,29,29,2503,3780,6676,2618,2474,D
2617,M,310,310,2813,514,7190,2618,2503,M
2617,N,247,247,3060,90,7280,2618,2813,N
2617,O,155,155,3215,535,7815,2618,3060,O
2617,P,108,108,3323,3780,11595,2618,3215,P
2618,A,2410,2410,2410,2342,2342,2619,0,A
2618,B,105,105,2515,240,2582,2619,2410,B
2618,C,1554,1554,4069,2640,5222,2619,2515,C
2618,B,1552,1552,5621,3735,8957,2619,4069,B
2618,C,2739,2739,8360,930,9887,2619,5621,C
2618,D,2207,2207,10567,3960,13847,2619,8360,D
2618,M,2345,2345,12912,2515,16362,2619,10567,M
2618,N,317,317,13229,90,16452,2619,12912,N
2618,O,672,672,13901,795,17247,2619,13229,O
2618,N,751,751,14652,745,17992,2619,13901,N
2618,O,420,420,15072,815,18807,2619,14652,O
2618,P,28980,28980,44052,3780,22587,2619,15072,P
2619,AEI,81,81,81,39,39,2620,0,A
2619,BEI,161,161,242,240,279,2620,81,B
2619,CEI,977,977,1219,1220,1499,2620,242,C
2619,DEI,83,83,1302,3960,5459,2620,1219,D
2619,EI,2965,1663,2965,4269,4269,2620,0,E
2619,FI,4186,1221,4186,4631,4631,2620,0,I
2619,FJ,1335,114,4300,90,4359,2620,2965,F
2619,GJ,134,134,4434,585,4944,2620,4300,G
2619,HJ,505,257,4691,90,4721,2620,4186,J
2619,HK,551,551,5242,735,5456,2620,4691,K
2619,HJ,463,463,5705,280,5736,2620,5242,J
2619,HK,131,131,5836,585,6321,2620,5705,K
2619,HL,2751,1349,7185,3780,8724,2620,4434,H
2619,L,16771,15422,22607,3780,10101,2620,5836,L
2619,M,6001,6001,28608,6123,16224,2620,22607,M
2619,N,230,230,28838,180,16404,2620,28608,N
2619,O,806,806,29644,950,17354,2620,28838,O
2619,N,315,315,29959,145,17499,2620,29644,N
2619,O,1519,1519,31478,1050,18549,2620,29959,O
2619,P,245,245,31723,6960,25509,2620,31478,P
2620,A,97,97,97,174,174,2621,0,A
2620,B,197,197,294,180,354,2621,97,B
2620,C,678,678,972,980,1334,2621,294,C
2620,B,929,929,1901,625,1959,2621,972,B
2620,C,376,376,2277,465,2424,2621,1901,C
2620,D,4381,4381,6658,5760,8184,2621,2277,D
2620,M,887,887,7545,1280,9464,2621,6658,M
2620,N,386,386,7931,150,9614,2621,7545,N
2620,O,371,371,8302,560,10174,2621,7931,O
2620,N,612,612,8914,320,10494,2621,8302,N
2620,O,758,758,9672,665,11159,2621,8914,O
2620,P,1781,1781,11453,3690,14849,2621,9672,P
2621,A,146,146,146,124,124,2622,0,A
2621,B,186,186,332,240,364,2622,146,B
2621,C,160,160,492,131,495,2622,332,C
2621,D,56,56,548,379,874,2622,492,D
2621,M,361,361,909,3140,4014,2622,548,M
2621,N,2923,2923,3832,180,4194,2622,909,N
2621,O,657,657,4489,830,5024,2622,3832,O
2621,N,650,650,5139,455,5479,2622,4489,N
2621,O,900,900,6039,1070,6549,2622,5139,O
2621,P,1011,1011,7050,6900,13449,2622,6039,P
2622,AE,22,22,22,56,56,2623,0,A
2622,BE,106,106,128,135,191,2623,22,B
2622,CE,260,132,260,515,515,2623,0,E
2622,CF,161,29,289,285,476,2623,128,C
2622,DF,240,211,500,120,635,2623,260,F
2622,DG,107,107,607,90,725,2623,500,G
2622,DF,772,454,1061,5160,5636,2623,289,D
2622,F,662,208,1269,590,1315,2623,607,F
2622,G,171,171,1440,295,1610,2623,1269,G
2622,H,4778,4778,6218,5160,6770,2623,1440,H
2622,M,340,340,6558,872,7642,2623,6218,M
2622,N,640,640,7198,150,7792,2623,6558,N
2622,O,277,277,7475,800,8592,2623,7198,O
2622,P,393,393,7868,3600,12192,2623,7475,P
2623,A,120,120,120,114,114,2624,0,A
2623,B,96,96,216,150,264,2624,120,B
2623,C,88,88,304,100,364,2624,216,C
2623,D,2378,2378,2682,2880,3244,2624,304,D
2623,M,196,196,2878,904,4148,2624,2682,M
2623,N,885,885,3763,240,4388,2624,2878,N
2623,O,170,170,3933,295,4683,2624,3763,O
2623,N,1305,1305,5238,1150,5833,2624,3933,N
2623,O,432,432,5670,535,6368,2624,5238,O
2623,P,6981,6981,12651,2880,9248,2624,5670,P
2624,A,146,146,146,260,260,2625,0,A
2624,B,233,233,379,180,440,2625,146,B
2624,C,182,182,561,140,580,2625,379,C
2624,D,10,10,571,2880,3460,2625,561,D
2624,M,349,349,920,1797,5257,2625,571,M
2624,N,1468,1468,2388,90,5347,2625,920,N
2624,O,1200,1200,3588,1360,6707,2625,2388,O
2624,N,735,735,4323,530,7237,2625,3588,N
2624,O,203,203,4526,605,7842,2625,4323,O
2624,P,7404,7404,11930,3780,11622,2625,4526,P
2625,AE,597,597,597,1540,1540,2626,0,E
2625,AF,1067,470,1067,1465,1465,2626,0,A
2625,BF,1063,593,1660,180,1720,2626,597,F
2625,BG,640,47,1707,300,1765,2626,1067,B
2625,CG,606,606,2313,820,2585,2626,1707,C
2625,BG,419,419,2732,245,2830,2626,2313,B
2625,CG,1126,54,2786,685,2405,2626,1660,G
2625,CF,874,820,3606,1320,4150,2626,2732,C
2625,DF,2089,1269,4875,2530,4935,2626,2786,F
2625,DG,389,389,5264,700,5635,2626,4875,G
2625,DH,5447,5447,10711,6840,12475,2626,5264,H
2625,D,11634,4529,15240,6060,10210,2626,3606,D
2625,M,859,859,16099,1895,14370,2626,15240,M
2625,N,1243,1243,17342,240,14610,2626,16099,N
2625,O,282,282,17624,415,15025,2626,17342,O
2625,N,2766,2766,20390,2645,17670,2626,17624,N
2625,O,1050,1050,21440,1225,18895,2626,20390,O
2625,P,5422,5422,26862,3960,22855,2626,21440,P
2626,AE,241,241,241,479,479,2627,0,A
2626,BE,383,142,383,524,524,2627,0,E
2626,BF,266,124,507,90,569,2627,241,B
2626,CF,190,66,573,90,614,2627,383,F
2626,CG,358,292,865,795,1364,2627,507,C
2626,DG,374,82,947,800,1414,2627,573,G
2626,DH,1454,1372,2319,3780,5144,2627,865,D
2626,H,1386,14,2333,3780,5194,2627,947,H
2626,M,4442,4442,6775,4588,9782,2627,2333,M
2626,N,253,253,7028,90,9872,2627,6775,N
2626,O,550,550,7578,820,10692,2627,7028,O
2626,N,755,755,8333,560,11252,2627,7578,N
2626,O,184,184,8517,585,11837,2627,8333,O
2626,P,7057,7057,15574,3780,15617,2627,8517,P
2627,AE,49,49,49,112,112,2628,0,E
2627,AF,97,48,97,57,57,2628,0,A
2627,BF,136,88,185,135,247,2628,49,F
2627,BG,158,70,255,240,297,2628,97,B
2627,CG,234,164,419,285,532,2628,185,G
2627,CH,182,18,437,285,582,2628,255,C
2627,DH,141,123,560,5160,5692,2628,419,H
2627,D,2581,2458,3018,5160,5742,2628,437,D
2627,M,840,840,3858,1037,6779,2628,3018,M
2627,N,306,306,4164,150,6929,2628,3858,N
2627,O,1150,1150,5314,1680,8609,2628,4164,O
2627,P,1423,1423,6737,6000,14609,2628,5314,P
2628,AE,69,69,69,763,763,2629,0,E
2628,AF,552,483,552,511,511,2629,0,A
2628,BF,49,49,601,150,661,2629,552,B
2628,CF,903,371,972,240,1003,2629,69,F
2628,CG,426,55,1027,721,1382,2629,601,C
2628,BG,786,731,1758,940,1943,2629,972,G
2628,BH,1817,1086,2844,1510,2892,2629,1027,B
2628,CH,836,836,3680,930,3822,2629,2844,C
2628,DH,3157,1235,4915,6990,8933,2629,1758,H
2628,D,2638,1403,6318,6990,10812,2629,3680,D
2628,M,3104,3104,9422,3097,13909,2629,6318,M
2628,N,190,190,9612,90,13999,2629,9422,N
2628,O,1502,1502,11114,1910,15909,2629,9612,O
2628,N,980,980,12094,735,16644,2629,11114,N
2628,O,507,507,12601,935,17579,2629,12094,O
2628,P,479,479,13080,3780,21359,2629,12601,P
2629,A,104,104,104,1784,1784,2630,0,A
2629,B,1933,1933,2037,240,2024,2630,104,B
2629,C,878,878,2915,970,2994,2630,2037,C
2629,B,306,306,3221,350,3344,2630,2915,B
2629,C,843,843,4064,1260,4604,2630,3221,C
2629,D,275,275,4339,3960,8564,2630,4064,D
2629,M,517,517,4856,864,9428,2630,4339,M
2629,N,463,463,5319,150,9578,2630,4856,N
2629,O,180,180,5499,140,9718,2630,5319,O
2629,N,438,438,5937,495,10213,2630,5499,N
2629,O,653,653,6590,590,10803,2630,5937,O
2629,P,26639,26639,33229,4230,15033,2630,6590,P
2630,AEI,208,208,208,1840,1840,2631,0,E
2630,AFI,285,77,285,467,467,2631,0,A
2630,BFI,210,210,495,90,557,2631,285,B
2630,CFI,872,377,872,2958,2958,2631,0,I
2630,CFJ,1664,1000,1872,90,1930,2631,208,F
2630,CGJ,1433,56,1928,1745,2302,2631,495,C
2630,DGJ,109,109,2037,3780,6082,2631,1928,D
2630,GJ,2146,981,3018,90,3048,2631,872,J
2630,GK,1432,286,3304,1745,3675,2631,1872,G
2630,HK,76,76,3380,3780,7455,2631,3304,H
2630,K,932,570,3950,1250,4298,2631,3018,K
2630,L,3,3,3953,3780,8078,2631,3950,L
2630,M,1516,1516,5469,2364,10442,2631,3953,M
2630,N,892,892,6361,90,10532,2631,5469,N
2630,O,464,464,6825,585,11117,2631,6361,O
2630,P,2569,2569,9394,3780,14897,2631,6825,P
2631,AEI,852,852,852,1561,1561,2632,0,I
2631,AEJ,1453,601,1453,1780,1780,2632,0,A
2631,BEJ,755,154,1607,90,1651,2632,852,J
2631,BEK,398,244,1851,90,1870,2632,1453,B
2631,CEK,2060,209,2060,2991,2991,2632,0,E
2631,CFK,402,193,2253,860,2730,2632,1851,C
2631,DFK,920,274,2527,1240,2891,2632,1607,K
2631,DFL,322,322,2849,3780,6671,2632,2527,L
2631,DF,1266,477,3326,90,3081,2632,2060,F
2631,DG,1188,115,3441,3780,6510,2632,2253,D
2631,G,1124,1009,4450,1360,4441,2632,3326,G
2631,H,87,87,4537,3780,8221,2632,4450,H
2631,M,1891,1891,6428,2534,10755,2632,4537,M
2631,N,685,685,7113,90,10845,2632,6428,N
2631,O,355,355,7468,705,11550,2632,7113,O
2631,P,2410,2410,9878,3780,15330,2632,7468,P
2632,AE,45,45,45,140,140,2633,0,A
2632,BE,177,177,222,135,275,2633,45,B
2632,CE,202,202,424,285,560,2633,222,C
2632,DE,129,129,553,5160,5720,2633,424,D
2632,E,1674,1121,1674,1921,1921,2633,0,E
2632,F,300,300,1974,90,2011,2633,1674,F
2632,G,884,884,2858,1285,3296,2633,1974,G
2632,H,2082,2082,4940,3780,7076,2633,2858,H
2632,M,2493,2493,7433,4757,11833,2633,4940,M
2632,N,2288,2288,9721,90,11923,2633,7433,N
2632,O,890,890,10611,1240,13163,2633,9721,O
2632,P,843,843,11454,3780,16943,2633,10611,P
2633,A,63,63,63,99,99,2634,0,A
2633,B,215,215,278,180,279,2634,63,B
2633,C,226,226,504,225,504,2634,278,C
2633,B,220,220,724,265,769,2634,504,B
2633,C,3731,3731,4455,750,1519,2634,724,C
2633,D,749,749,5204,4140,5659,2634,4455,D
2633,M,712,712,5916,791,6450,2634,5204,M
2633,N,262,262,6178,180,6630,2634,5916,N
2633,O,66,66,6244,665,7295,2634,6178,O
2633,P,88352,88352,94596,6900,14195,2634,6244,P
2634,AEI,134,134,134,133,133,2635,0,A
2634,BEI,118,118,252,180,313,2635,134,B
2634,CEI,139,139,391,265,578,2635,252,C
2634,BEI,560,560,951,425,1003,2635,391,B
2634,CEI,984,33,984,1345,1345,2635,0,I
2634,CEJ,141,108,1092,415,1418,2635,951,C
2634,DEJ,595,487,1579,300,1645,2635,984,J
2634,DEK,727,727,2306,820,2465,2635,1579,K
2634,DEJ,3283,977,3283,3465,3465,2635,0,E
2634,DFJ,1140,163,3446,1115,3580,2635,2306,J
2634,DFK,326,163,3609,180,3645,2635,3283,F
2634,DGK,439,276,3885,630,4210,2635,3446,K
2634,DGL,1254,978,4863,695,4340,2635,3609,G
2634,DFL,2000,2000,6863,2555,6895,2635,4863,F
2634,DGL,378,378,7241,700,7595,2635,6863,G
2634,DHL,5916,2560,9801,6060,10270,2635,3885,L
2634,DH,8942,233,10034,6060,7478,2635,1092,D
2634,H,3174,381,10415,6840,14435,2635,7241,H
2634,M,1304,1304,11719,1121,15556,2635,10415,M
2634,N,73,73,11792,300,15856,2635,11719,N
2634,O,705,705,12497,820,16676,2635,11792,O
2634,P,1115,1115,13612,4080,20756,2635,12497,P
2635,AEI,91,91,91,770,770,2636,0,E
2635,AFI,161,70,161,1147,1147,2636,0,A
2635,BFI,961,891,1052,360,1130,2636,91,F
2635,BGI,1113,222,1274,180,1327,2636,161,B
2635,CGI,450,450,1724,585,1912,2636,1274,C
2635,DGI,1936,212,1936,3775,3775,2636,0,I
2635,DGJ,1047,163,2099,990,2120,2636,1052,G
2635,DHJ,2001,1626,3725,6960,8872,2636,1724,D
2635,HJ,1991,202,3927,180,3955,2636,1936,J
2635,HK,893,893,4820,900,4855,2636,3927,K
2635,HL,2008,2008,6828,550,5405,2636,4820,L
2635,H,5910,1181,8009,550,2670,2636,2099,H
2635,M,1063,1063,9072,1608,10480,2636,8009,M
2635,N,678,678,9750,180,10660,2636,9072,N
2635,O,899,899,10649,830,11490,2636,9750,O
2635,N,665,665,11314,705,12195,2636,10649,N
2635,O,2067,2067,13381,695,12890,2636,11314,O
2635,P,10007,10007,23388,6960,19850,2636,13381,P
2636,A,800,800,800,1262,1262,2637,0,A
2636,B,476,476,1276,90,1352,2637,800,B
2636,C,1534,1534,2810,1405,2757,2637,1276,C
2636,D,248,248,3058,3780,6537,2637,2810,D
2636,M,1129,1129,4187,1195,7732,2637,3058,M
2636,N,194,194,4381,180,7912,2637,4187,N
2636,O,462,462,4843,595,8507,2637,4381,O
2636,P,30,30,4873,4080,12587,2637,4843,P
2637,AEI,716,716,716,1932,1932,2638,0,I
2637,AEJ,1336,1336,2052,180,2112,2638,716,J
2637,AEK,948,948,3000,915,3027,2638,2052,K
2637,AEL,3343,343,3343,4143,4143,2638,0,E
2637,AFL,518,175,3518,360,3387,2638,3000,L
2637,AF,920,745,4263,180,4323,2638,3343,F
2637,AG,804,804,5067,810,5133,2638,4263,G
2637,AH,1024,1024,6091,835,5968,2638,5067,H
2637,A,17574,11483,17574,18566,18566,2638,0,A
2637,B,1258,1258,18832,300,18866,2638,17574,B
2637,C,489,489,19321,740,19606,2638,18832,C
2637,D,115,115,19436,5820,25426,2638,19321,D
2637,M,894,894,20330,850,26276,2638,19436,M
2637,N,246,246,20576,300,26576,2638,20330,N
2637,O,706,706,21282,830,27406,2638,20576,O
2637,P,3862,3862,25144,3960,31366,2638,21282,P
2638,A,1284,1284,1284,1783,1783,2639,0,A
2638,B,646,646,1930,90,1873,2639,1284,B
2638,C,984,984,2914,1250,3123,2639,1930,C
2638,D,190,190,3104,3780,6903,2639,2914,D
2638,M,4176,4176,7280,4623,11526,2639,3104,M
2638,N,499,499,7779,90,11616,2639,7280,N
2638,O,373,373,8152,735,12351,2639,7779,O
2638,P,10542,10542,18694,3780,16131,2639,8152,P
2639,AEI,18,18,18,129,129,2640,0,I
2639,AEJ,44,26,44,732,732,2640,0,A
2639,BEJ,403,377,421,240,369,2640,18,J
2639,BEK,734,357,778,90,822,2640,44,B
2639,CEK,789,432,1210,1045,1414,2640,421,K
2639,CEL,50,50,1260,3960,5374,2640,1210,L
2639,CE,1069,587,1847,1200,2022,2640,778,C
2639,DE,374,374,2221,3780,5802,2640,1847,D
2639,E,20875,18654,20875,21657,21657,2640,0,E
2639,F,817,817,21692,90,21747,2640,20875,F
2639,G,1001,1001,22693,1220,22967,2640,21692,G
2639,H,49,49,22742,3780,26747,2640,22693,H
2639,M,114,114,22856,401,27148,2640,22742,M
2639,N,313,313,23169,90,27238,2640,22856,N
2639,O,429,429,23598,860,28098,2640,23169,O
2639,P,49,49,23647,3780,31878,2640,23598,P
2640,AEI,211,211,211,487,487,2641,0,I
2640,AEJ,635,424,635,1487,1487,2641,0,E
2640,AFJ,478,54,689,240,727,2641,211,J
2640,AFK,827,827,1516,890,1617,2641,689,K
2640,AFJ,943,62,1578,150,1637,2641,635,F
2640,AGJ,305,243,1821,255,1872,2641,1516,J
2640,AGK,2006,185,2006,2897,2897,2641,0,A
2640,BGK,782,354,2360,1030,2667,2641,1578,G
2640,BFK,585,46,2406,780,2652,2641,1821,K
2640,BFL,1007,607,3013,150,3047,2641,2006,B
2640,CFL,1206,553,3566,925,3592,2641,2360,F
2640,CGL,757,204,3770,760,3807,2641,3013,C
2640,BGL,1392,28,3798,4140,6792,2641,2406,L
2640,BG,631,399,4197,705,4297,2641,3566,G
2640,BH,1296,869,5066,1195,5002,2641,3770,B
2640,CH,627,627,5693,705,5707,2641,5066,C
2640,DH,1706,210,5903,4230,8527,2641,4197,H
2640,D,25954,25744,31647,4230,9937,2641,5693,D
2640,M,755,755,32402,710,10647,2641,31647,M
2640,N,275,275,32677,300,10947,2641,32402,N
2640,O,230,230,32907,840,11787,2641,32677,O
2640,N,1280,1280,34187,745,12532,2641,32907,N
2640,O,2552,2552,36739,1160,13692,2641,34187,O
2640,P,1303,1303,38042,3060,16752,2641,36739,P
2641,AE,861,861,861,875,875,2642,0,E
2641,AF,274,274,1135,300,1175,2642,861,F
2641,AG,619,619,1754,815,1990,2642,1135,G
2641,AH,4039,4039,5793,3960,5950,2642,1754,H
2641,A,9834,4041,9834,9896,9896,2642,0,A
2641,B,278,278,10112,240,10136,2642,9834,B
2641,C,524,524,10636,785,10921,2642,10112,C
2641,D,925,925,11561,3960,14881,2642,10636,D
2641,M,1509,1509,13070,1780,16661,2642,11561,M
2641,N,848,848,13918,610,17271,2642,13070,N
2641,O,252,252,14170,435,17706,2642,13918,O
2641,N,1410,1410,15580,1220,18926,2642,14170,N
2641,O,149,149,15729,360,19286,2642,15580,O
2641,P,20191,20191,35920,4020,23306,2642,15729,P
2642,AE,46,46,46,762,762,2643,0,E
2642,AF,794,794,840,135,897,2643,46,F
2642,AG,1634,794,1634,2423,2423,2643,0,A
2642,BG,981,981,2615,240,2663,2643,1634,B
2642,CG,838,838,3453,1040,3703,2643,2615,C
2642,BG,1144,1144,4597,930,4633,2643,3453,B
2642,CG,921,921,5518,1560,6193,2643,4597,C
2642,DG,376,376,5894,3960,10153,2643,5518,D
2642,G,5091,37,5931,300,1197,2643,840,G
2642,H,44,44,5975,5100,6297,2643,5931,H
2642,M,180,180,6155,940,11093,2643,5975,M
2642,N,1048,1048,7203,300,11393,2643,6155,N
2642,O,640,640,7843,755,12148,2643,7203,O
2642,P,2917,2917,10760,1140,13288,2643,7843,P
2643,A,108,108,108,500,500,2644,0,A
2643,B,591,591,699,240,740,2644,108,B
2643,C,652,652,1351,960,1700,2644,699,C
2643,D,1898,1898,3249,3960,5660,2644,1351,D
2643,M,10548,10548,13797,11536,17196,2644,3249,M
2643,N,1204,1204,15001,300,17496,2644,13797,N
2643,O,764,764,15765,725,18221,2644,15001,O
2643,P,3082,3082,18847,310,18531,2644,15765,P
2644,A,4,4,4,6,6,2645,0,A
2644,B,280,280,284,300,306,2645,4,B
2644,C,573,573,857,715,1021,2645,284,C
2644,D,2828,2828,3685,4080,5101,2645,857,D
2644,M,341,341,4026,795,5896,2645,3685,M
2644,N,737,737,4763,300,6196,2645,4026,N
2644,O,594,594,5357,785,6981,2645,4763,O
2644,N,1563,1563,6920,1715,8696,2645,5357,N
2644,O,1043,1043,7963,900,9596,2645,6920,O
2644,P,429,429,8392,6120,15716,2645,7963,P
2645,AEI,45,45,45,1071,1071,2646,0,A
2645,BEI,320,275,320,694,694,2646,0,E
2645,BFI,471,471,791,150,844,2646,320,F
2645,BGI,122,122,913,125,969,2646,791,G
2645,BFI,1226,358,1271,240,1311,2646,45,B
2645,CFI,598,240,1511,545,1514,2646,913,F
2645,CGI,1519,8,1519,1722,1722,2646,0,I
2645,CGJ,303,303,1822,150,1872,2646,1519,J
2645,CGK,813,262,2084,995,2306,2646,1271,C
2645,DGK,703,130,2214,660,2174,2646,1511,G
2645,DHK,154,154,2368,4230,6404,2646,2214,H
2645,DK,655,109,2477,455,2327,2646,1822,K
2645,DJ,221,221,2698,290,2617,2646,2477,J
2645,DK,720,720,3418,665,3282,2646,2698,K
2645,DL,1466,132,3550,4680,6986,2646,2084,D
2645,L,139,7,3557,4230,7512,2646,3418,L
2645,M,2065,2065,5622,2215,9727,2646,3557,M
2645,N,193,193,5815,90,9817,2646,5622,N
2645,O,438,438,6253,815,10632,2646,5815,O
2645,N,601,601,6854,230,10862,2646,6253,N
2645,O,1063,1063,7917,1465,12327,2646,6854,O
2645,P,628,628,8545,3780,16107,2646,7917,P
2646,AE,199,199,199,251,251,2647,0,A
2646,BE,229,229,428,240,491,2647,199,B
2646,CE,565,565,993,745,1236,2647,428,C
2646,BE,1559,566,1559,2049,2049,2647,0,E
2646,BF,633,67,1626,455,1691,2647,993,B
2646,CF,343,343,1969,245,1936,2647,1626,C
2646,DF,520,110,2079,90,2139,2647,1559,F
2646,DG,731,731,2810,625,2764,2647,2079,G
2646,DH,1366,525,3335,5250,7186,2647,1969,D
2646,H,3481,2956,6291,550,3314,2647,2810,H
2646,M,2633,2633,8924,3278,10464,2647,6291,M
2646,N,765,765,9689,180,10644,2647,8924,N
2646,O,105,105,9794,235,10879,2647,9689,O
2646,N,881,881,10675,740,11619,2647,9794,N
2646,O,812,812,11487,890,12509,2647,10675,O
2646,P,4728,4728,16215,5160,17669,2647,11487,P
2647,AE,77,77,77,1094,1094,2648,0,E
2647,AF,131,54,131,286,286,2648,0,A
2647,BF,349,349,480,240,526,2648,131,B
2647,CF,512,512,992,725,1251,2648,480,C
2647,BF,1522,607,1599,540,1634,2648,77,F
2647,BG,121,121,1720,150,1784,2648,1599,G
2647,BH,786,58,1778,380,1631,2648,992,B
2647,CH,293,235,2013,550,2334,2648,1720,H
2647,C,593,358,2371,810,2441,2648,1778,C
2647,D,289,289,2660,3960,6401,2648,2371,D
2647,M,298,298,2958,894,7295,2648,2660,M
2647,N,776,776,3734,150,7445,2648,2958,N
2647,O,134,134,3868,115,7560,2648,3734,O
2647,N,488,488,4356,525,8085,2648,3868,N
2647,O,683,683,5039,590,8675,2648,4356,O
2647,P,28987,28987,34026,4230,12905,2648,5039,P
2648,AE,64,64,64,1140,1140,2649,0,A
2648,BE,521,457,521,1905,1905,2649,0,E
2648,BF,1322,865,1386,300,1440,2649,64,B
2648,CF,1636,771,2157,300,2205,2649,521,F
2648,CG,836,65,2222,885,2325,2649,1386,C
2648,DG,60,60,2282,2940,5265,2649,2222,D
2648,G,875,750,3032,840,3045,2649,2157,G
2648,H,10,10,3042,8375,11420,2649,3032,H
2648,M,5715,5715,8757,5765,17185,2649,3042,M
2648,N,312,312,9069,300,17485,2649,8757,N
2648,O,586,586,9655,750,18235,2649,9069,O
2648,N,1517,1517,11172,1330,19565,2649,9655,N
2648,O,232,232,11404,405,19970,2649,11172,O
2648,P,7573,7573,18977,1140,21110,2649,11404,P
2649,AE,516,516,516,1012,1012,2650,0,E
2649,AF,627,627,1143,180,1192,2650,516,F
2649,AG,908,908,2051,910,2102,2650,1143,G
2649,AH,3033,982,3033,3744,3744,2650,0,A
2649,BH,970,970,4003,300,4044,2650,3033,B
2649,CH,2334,382,4385,550,2652,2650,2051,H
2649,C,1132,750,5135,1050,5094,2650,4003,C
2649,B,559,559,5694,720,5814,2650,5135,B
2649,C,648,648,6342,780,6594,2650,5694,C
2649,D,2840,2840,9182,3960,10554,2650,6342,D
2649,M,602,602,9784,1366,11920,2650,9182,M
2649,N,1143,1143,10927,420,12340,2650,9784,N
2649,O,1025,1025,11952,1190,13530,2650,10927,O
2649,P,792,792,12744,665,14195,2650,11952,P
2650,A,1961,1961,1961,2656,2656,2651,0,A
2650,B,732,732,2693,90,2746,2651,1961,B
2650,C,429,429,3122,855,3601,2651,2693,C
2650,D,1071,1071,4193,3780,7381,2651,3122,D
2650,M,1768,1768,5961,1920,9301,2651,4193,M
2650,N,196,196,6157,90,9391,2651,5961,N
2650,O,542,542,6699,800,10191,2651,6157,O
2650,N,304,304,7003,60,10251,2651,6699,N
2650,O,253,253,7256,695,10946,2651,7003,O
2650,P,4524,4524,11780,3840,14786,2651,7256,P
2651,AE,117,117,117,1079,1079,2652,0,A
2651,BE,438,321,438,737,737,2652,0,E
2651,BF,317,317,755,90,827,2652,438,F
2651,BG,989,351,1106,90,1169,2652,117,B
2651,CG,454,103,1209,905,1732,2652,755,G
2651,CH,183,183,1392,3780,5512,2652,1209,H
2651,C,951,665,2057,1220,2389,2652,1106,C
2651,D,61,61,2118,3780,6169,2652,2057,D
2651,M,229,229,2347,529,6698,2652,2118,M
2651,N,328,328,2675,90,6788,2652,2347,N
2651,O,500,500,3175,860,7648,2652,2675,O
2651,P,335,335,3510,3780,11428,2652,3175,P
2652,AE,106,106,106,35,35,2653,0,E
2652,AF,241,241,347,300,335,2653,106,F
2652,AG,796,449,796,960,960,2653,0,A
2652,BG,189,189,985,90,1050,2653,796,B
2652,CG,822,184,1169,1005,1340,2653,347,G
2652,CH,391,207,1376,795,1845,2653,985,C
2652,DH,908,701,2077,1200,2540,2653,1169,H
2652,D,2886,2185,4262,3780,5625,2653,1376,D
2652,M,778,778,5040,866,6491,2653,4262,M
2652,N,160,160,5200,90,6581,2653,5040,N
2652,O,728,728,5928,815,7396,2653,5200,O
2652,N,294,294,6222,145,7541,2653,5928,N
2652,O,431,431,6653,740,8281,2653,6222,O
2652,P,3668,3668,10321,3780,12061,2653,6653,P
2653,A,838,838,838,1147,1147,2654,0,A
2653,B,359,359,1197,90,1237,2654,838,B
2653,C,887,887,2084,1250,2487,2654,1197,C
2653,D,72,72,2156,3780,6267,2654,2084,D
2653,M,98,98,2254,445,6712,2654,2156,M
2653,N,394,394,2648,90,6802,2654,2254,N
2653,O,524,524,3172,850,7652,2654,2648,O
2653,P,522,522,3694,3780,11432,2654,3172,P
2654,AE,293,293,293,386,386,2655,0,E
2654,AF,203,203,496,170,556,2655,293,F
2654,AG,576,576,1072,465,1021,2655,496,G
2654,AF,509,509,1581,585,1606,2655,1072,F
2654,AG,2193,612,2193,2525,2525,2655,0,A
2654,BG,902,290,2483,2049,3655,2655,1581,G
2654,BH,486,196,2679,180,2705,2655,2193,B
2654,CH,815,619,3298,886,4541,2655,2483,H
2654,C,916,297,3595,1200,3905,2655,2679,C
2654,B,1615,1615,5210,1355,5260,2655,3595,B
2654,C,996,996,6206,5001,10261,2655,5210,C
2654,D,1709,1709,7915,2034,12295,2655,6206,D
2654,M,5691,5691,13606,6022,18317,2655,7915,M
2654,N,998,998,14604,780,19097,2655,13606,N
2654,O,833,833,15437,810,19907,2655,14604,O
2654,P,1582,1582,17019,550,20457,2655,15437,P
2655,A,13,13,13,731,731,2656,0,A
2655,B,922,922,935,240,971,2656,13,B
2655,C,502,502,1437,845,1816,2656,935,C
2655,D,571,571,2008,3960,5776,2656,1437,D
2655,M,860,860,2868,2024,7800,2656,2008,M
2655,N,1205,1205,4073,90,7890,2656,2868,N
2655,O,584,584,4657,805,8695,2656,4073,O
2655,N,637,637,5294,420,9115,2656,4657,N
2655,O,712,712,6006,1080,10195,2656,5294,O
2655,P,852,852,6858,3780,13975,2656,6006,P
2656,AE,274,274,274,1295,1295,2657,0,A
2656,BE,1049,1049,1323,90,1385,2657,274,B
2656,CE,959,959,2282,1210,2595,2657,1323,C
2656,DE,85,85,2367,3780,6375,2657,2282,D
2656,E,20047,17680,20047,20801,20801,2657,0,E
2656,F,778,778,20825,90,20891,2657,20047,F
2656,G,901,901,21726,1215,22106,2657,20825,G
2656,H,238,238,21964,3780,25886,2657,21726,H
2656,M,130,130,22094,642,26528,2657,21964,M
2656,N,543,543,22637,90,26618,2657,22094,N
2656,O,525,525,23162,845,27463,2657,22637,O
2656,P,397,397,23559,3780,31243,2657,23162,P
2657,A,92,92,92,123,123,2658,0,A
2657,B,149,149,241,180,303,2658,92,B
2657,C,145,145,386,260,563,2658,241,C
2657,B,1026,1026,1412,895,1458,2658,386,B
2657,C,186,186,1598,225,1683,2658,1412,C
2657,D,90977,90977,92575,4740,6423,2658,1598,D
2657,M,1220,1220,93795,1305,7728,2658,92575,M
2657,N,268,268,94063,240,7968,2658,93795,N
2657,O,177,177,94240,295,8263,2658,94063,O
2657,N,637,637,94877,515,8778,2658,94240,N
2657,O,270,270,95147,295,9073,2658,94877,O
2657,P,1869,1869,97016,5160,14233,2658,95147,P
2658,AE,60,60,60,389,389,2659,0,A
2658,BE,422,422,482,150,539,2659,60,B
2658,CE,713,713,1195,850,1389,2659,482,C
2658,DE,1909,1909,3104,5220,6609,2659,1195,D
2658,E,14382,11278,14382,14919,14919,2659,0,E
2658,F,800,800,15182,300,15219,2659,14382,F
2658,G,592,592,15774,740,15959,2659,15182,G
2658,H,262,262,16036,1560,17519,2659,15774,H
2658,M,1650,1650,17686,1635,19154,2659,16036,M
2658,N,235,235,17921,300,19454,2659,17686,N
2658,O,673,673,18594,855,20309,2659,17921,O
2658,N,366,366,18960,185,20494,2659,18594,N
2658,O,105,105,19065,300,20794,2659,18960,O
2658,P,7341,7341,26406,2100,22894,2659,19065,P
2659,A,882,882,882,1523,1523,2660,0,A
2659,B,673,673,1555,90,1613,2660,882,B
2659,C,927,927,2482,1250,2863,2660,1555,C
2659,D,1552,1552,4034,3780,6643,2660,2482,D
2659,M,1439,1439,5473,1265,7908,2660,4034,M
2659,N,325,325,5798,530,8438,2660,5473,N
2659,O,1128,1128,6926,1215,9653,2660,5798,O
2659,P,2391,2391,9317,550,10203,2660,6926,P
2660,AE,633,633,633,1085,1085,2661,0,A
2660,BE,515,515,1148,90,1175,2661,633,B
2660,CE,989,989,2137,1250,2425,2661,1148,C
2660,DE,2201,64,2201,2437,2437,2661,0,E
2660,DF,271,271,2472,90,2527,2661,2201,F
2660,DG,758,758,3230,1105,3632,2661,2472,G
2660,DH,503,503,3733,3780,7412,2661,3230,H
2660,D,1852,256,3989,3780,6205,2661,2137,D
2660,M,172,172,4161,325,7737,2661,3989,M
2660,N,261,261,4422,145,7882,2661,4161,N
2660,O,944,944,5366,810,8692,2661,4422,O
2660,P,951,951,6317,385,9077,2661,5366,P
2661,AE,101,101,101,672,672,2662,0,A
2661,BE,705,705,806,180,852,2662,101,B
2661,CE,685,685,1491,840,1692,2662,806,C
2661,DE,1512,21,1512,1866,1866,2662,0,E
2661,DF,471,450,1962,6680,8372,2662,1491,D
2661,F,474,24,1986,180,2046,2662,1512,F
2661,G,1080,1080,3066,1290,3336,2662,1986,G
2661,H,26950,26950,30016,6680,10016,2662,3066,H
2661,M,1579,1579,31595,3119,13135,2662,30016,M
2661,N,1715,1715,33310,240,13375,2662,31595,N
2661,O,572,572,33882,731,14106,2662,33310,O
2661,N,334,334,34216,150,14256,2662,33882,N
2661,O,207,207,34423,455,14711,2662,34216,O
2661,P,937,937,35360,3960,18671,2662,34423,P
2662,A,1684,1684,1684,2741,2741,2663,0,A
2662,B,1167,1167,2851,180,2921,2663,1684,B
2662,C,201,201,3052,125,3046,2663,2851,C
2662,B,1090,1090,4142,1155,4201,2663,3052,B
2662,C,517,517,4659,540,4741,2663,4142,C
2662,D,31379,31379,36038,2880,7621,2663,4659,D
2662,M,61,61,36099,2810,10431,2663,36038,M
2662,N,2149,2149,38248,180,10611,2663,36099,N
2662,O,1024,1024,39272,545,11156,2663,38248,O
2662,N,812,812,40084,570,11726,2663,39272,N
2662,O,119,119,40203,165,11891,2663,40084,O
2662,P,349,349,40552,5100,16991,2663,40203,P
2663,A,31,31,31,318,318,2664,0,A
2663,B,371,371,402,135,453,2664,31,B
2663,C,188,188,590,295,748,2664,402,C
2663,D,145,145,735,5100,5848,2664,590,D
2663,M,473,473,1208,1206,7054,2664,735,M
2663,N,825,825,2033,90,7144,2664,1208,N
2663,O,1094,1094,3127,1380,8524,2664,2033,O
2663,N,546,546,3673,320,8844,2664,3127,N
2663,O,746,746,4419,970,9814,2664,3673,O
2663,P,1160,1160,5579,3780,13594,2664,4419,P
2664,A,54,54,54,60,60,2665,0,A
2664,B,106,106,160,155,215,2665,54,B
2664,C,178,178,338,85,300,2665,160,C
2664,D,668,668,1006,2880,3180,2665,338,D
2664,M,1421,1421,2427,1431,4611,2665,1006,M
2664,N,107,107,2534,150,4761,2665,2427,N
2664,O,160,160,2694,160,4921,2665,2534,O
2664,N,522,522,3216,510,5431,2665,2694,N
2664,O,946,946,4162,770,6201,2665,3216,O
2664,P,139,139,4301,4230,10431,2665,4162,P
2665,A,388,388,388,915,915,2666,0,A
2665,B,117,117,505,140,1055,2666,388,B
2665,C,624,624,1129,160,1215,2666,505,C
2665,B,1541,1541,2670,1495,2710,2666,1129,B
2665,C,659,659,3329,680,3390,2666,2670,C
2665,D,3091,3091,6420,320,3710,2666,3329,D
2665,M,97,97,6517,99,3809,2666,6420,M
2665,N,92,92,6609,150,3959,2666,6517,N
2665,O,631,631,7240,635,4594,2666,6609,O
2665,N,1360,1360,8600,1375,5969,2666,7240,N
2665,O,622,622,9222,493,6462,2666,8600,O
2665,P,1082,1082,10304,1232,7694,2666,9222,P
2666,AEI,76,76,76,1132,1132,2667,0,A
2666,BEI,840,764,840,650,650,2667,0,I
2666,BEJ,61,61,901,300,950,2667,840,J
2666,BEK,1151,250,1151,4406,4406,2667,0,E
2666,BFK,1249,174,1325,240,1372,2667,76,B
2666,CFK,987,563,1888,795,1745,2667,901,K
2666,CFL,128,128,2016,1140,2885,2667,1888,L
2666,CF,755,64,2080,760,2132,2667,1325,C
2666,DF,1370,1370,3450,7680,9812,2667,2080,D
2666,F,3310,1011,4461,90,4496,2667,1151,F
2666,G,422,422,4883,805,5301,2667,4461,G
2666,F,4960,4960,9843,4570,9871,2667,4883,F
2666,G,1698,1698,11541,2035,11906,2667,9843,G
2666,H,3906,3906,15447,3780,15686,2667,11541,H
2666,M,2007,2007,17454,2190,17876,2667,15447,M
2666,N,469,469,17923,300,18176,2667,17454,N
2666,O,305,305,18228,1350,19526,2667,17923,O
2666,P,1509,1509,19737,3300,22826,2667,18228,P
2667,AEI,1459,1459,1459,3053,3053,2668,0,E
2667,AFI,1500,41,1500,2506,2506,2668,0,I
2667,AFJ,1135,1135,2635,90,2596,2668,1500,J
2667,AFK,1623,447,3082,90,3143,2668,1459,F
2667,AGK,778,331,3413,680,3276,2668,2635,K
2667,AGL,182,182,3595,3780,7056,2668,3413,L
2667,AG,733,220,3815,1060,4203,2668,3082,G
2667,AH,847,847,4662,3780,7983,2668,3815,H
2667,A,9675,5013,9675,10117,10117,2668,0,A
2667,B,472,472,10147,90,10207,2668,9675,B
2667,C,373,373,10520,630,10837,2668,10147,C
2667,B,432,432,10952,170,11007,2668,10520,B
2667,C,795,795,11747,1080,12087,2668,10952,C
2667,D,525,525,12272,3780,15867,2668,11747,D
2667,M,4539,4539,16811,5078,20945,2668,12272,M
2667,N,592,592,17403,90,21035,2668,16811,N
2667,O,760,760,18163,1130,22165,2668,17403,O
2667,P,170,170,18333,3780,25945,2668,18163,P
2668,A,195,195,195,471,471,2669,0,A
2668,B,416,416,611,90,561,2669,195,B
2668,C,1381,1381,1992,1780,2341,2669,611,C
2668,D,60,60,2052,3780,6121,2669,1992,D
2668,M,3021,3021,5073,4614,10735,2669,2052,M
2668,N,1622,1622,6695,90,10825,2669,5073,N
2668,O,504,504,7199,850,11675,2669,6695,O
2668,P,710,710,7909,3780,15455,2669,7199,P
2669,AEI,135,135,135,772,772,2670,0,E
2669,AFI,786,651,786,3499,3499,2670,0,A
2669,BFI,761,110,896,180,952,2670,135,F
2669,BGI,192,192,1088,265,1217,2670,896,G
2669,BFI,1096,8,1096,1334,1334,2670,0,I
2669,BFJ,425,425,1521,240,1574,2670,1096,J
2669,BFK,442,9,1530,360,1577,2670,1088,F
2669,BGK,930,921,2451,835,2409,2670,1521,K
2669,BGJ,964,43,2494,195,1772,2670,1530,G
2669,BHJ,123,123,2617,6435,8207,2670,2494,H
2669,BJ,312,146,2763,450,2859,2670,2451,J
2669,BK,525,525,3288,900,3759,2670,2763,K
2669,BL,2833,331,3619,180,3679,2670,786,B
2669,CL,633,302,3921,3960,7719,2670,3288,L
2669,C,827,525,4446,900,4579,2670,3619,C
2669,B,1208,1208,5654,1160,5739,2670,4446,B
2669,C,700,700,6354,860,6599,2670,5654,C
2669,D,1340,1340,7694,1270,7869,2670,6354,D
2669,M,397,397,8091,983,9190,2670,7694,M
2669,N,1396,1396,9487,900,10090,2670,8091,N
2669,O,485,485,9972,630,10720,2670,9487,O
2669,N,940,940,10912,755,11475,2670,9972,N
2669,O,1410,1410,12322,1244,12719,2670,10912,O
2669,P,1382,1382,13704,351,13070,2670,12322,P
2670,AEI,166,166,166,1259,1259,2671,0,E
2670,AFI,502,336,502,846,846,2671,0,I
2670,AFJ,408,408,910,90,936,2671,502,J
2670,AFK,1280,536,1446,240,1499,2671,166,F
2670,AGK,1564,118,1564,2597,2597,2671,0,A
2670,BGK,1113,459,2023,1465,2401,2671,910,K
2670,BGL,59,59,2082,3780,6181,2671,2023,L
2670,BG,1062,544,2626,90,2687,2671,1564,B
2670,CG,793,793,3419,935,3622,2671,2626,C
2670,BG,3064,1091,4510,295,1794,2671,1446,G
2670,BH,1446,355,4865,1285,4907,2671,3419,B
2670,CH,1426,1071,5936,5100,6894,2671,4510,H
2670,C,1216,145,6081,1465,6372,2671,4865,C
2670,D,570,570,6651,3780,10152,2671,6081,D
2670,M,3493,3493,10144,3824,13976,2671,6651,M
2670,N,452,452,10596,180,14156,2671,10144,N
2670,O,621,621,11217,895,15051,2671,10596,O
2670,N,603,603,11820,330,15381,2671,11217,N
2670,O,445,445,12265,540,15921,2671,11820,O
2670,P,2477,2477,14742,6960,22881,2671,12265,P
2671,AE,1525,1525,1525,1510,1510,2672,0,E
2671,AF,1610,85,1610,2569,2569,2672,0,A
2671,BF,225,140,1750,300,1810,2672,1525,F
2671,BG,903,903,2653,900,2710,2672,1750,G
2671,BF,297,297,2950,270,2980,2672,2653,F
2671,BG,1708,368,3318,780,3349,2672,1610,B
2671,CG,641,273,3591,750,3730,2672,2950,G
2671,CH,721,448,4039,750,4099,2672,3318,C
2671,DH,2825,2825,6864,550,4649,2672,4039,D
2671,H,6060,2787,9651,3960,7690,2672,3591,H
2671,M,2268,2268,11919,3937,11627,2672,9651,M
2671,N,2994,2994,14913,780,12407,2672,11919,N
2671,O,1363,1363,16276,1410,13817,2672,14913,O
2671,P,1289,1289,17565,320,14137,2672,16276,P
2672,AEI,38,38,38,1717,1717,2673,0,A
2672,BEI,584,546,584,3146,3146,2673,0,E
2672,BFI,1540,956,1540,4874,4874,2673,0,I
2672,BFJ,2129,627,2167,510,2227,2673,38,B
2672,CFJ,936,936,3103,1218,3445,2673,2167,C
2672,DFJ,2636,117,3220,90,3236,2673,584,F
2672,DGJ,923,923,4143,1240,4476,2673,3220,G
2672,DFJ,1453,413,4556,1117,4562,2673,3103,D
2672,FJ,533,120,4676,260,4736,2673,4143,F
2672,GJ,3532,396,5072,240,5114,2673,1540,J
2672,GK,412,16,5088,755,5491,2673,4676,G
2672,HK,847,831,5919,976,6090,2673,5072,K
2672,HJ,457,457,6376,330,6420,2673,5919,J
2672,HK,1847,559,6935,3780,9271,2673,5088,H
2672,K,887,328,7263,1200,7620,2673,6376,K
2672,L,5763,5763,13026,3960,11580,2673,7263,L
2672,M,205,205,13231,472,12052,2673,13026,M
2672,N,427,427,13658,180,12232,2673,13231,N
2672,O,1254,1254,14912,1810,14042,2673,13658,O
2672,N,786,786,15698,1195,15237,2673,14912,N
2672,O,608,608,16306,600,15837,2673,15698,O
2672,P,1182,1182,17488,9840,25677,2673,16306,P
2673,AE,81,81,81,253,253,2674,0,A
2673,BE,323,323,404,135,388,2674,81,B
2673,CE,184,184,588,280,668,2674,404,C
2673,DE,326,326,914,5160,5828,2674,588,D
2673,E,1605,691,1605,1746,1746,2674,0,E
2673,F,341,341,1946,240,1986,2674,1605,F
2673,G,922,922,2868,765,2751,2674,1946,G
2673,F,92,92,2960,295,3046,2674,2868,F
2673,G,1796,1796,4756,1260,4306,2674,2960,G
2673,H,165,165,4921,3960,8266,2674,4756,H
2673,M,759,759,5680,1161,9427,2674,4921,M
2673,N,429,429,6109,90,9517,2674,5680,N
2673,O,966,966,7075,1250,10767,2674,6109,O
2673,P,6,6,7081,3780,14547,2674,7075,P
2674,AEI,2025,2025,2025,2163,2163,2675,0,A
2674,BEI,2044,19,2044,2200,2200,2675,0,E
2674,BFI,171,152,2196,90,2253,2675,2025,B
2674,CFI,208,56,2252,90,2290,2675,2044,F
2674,CGI,579,523,2775,820,3073,2675,2196,C
2674,BGI,536,13,2788,820,3110,2675,2252,G
2674,BFI,487,487,3275,210,3320,2675,2788,F
2674,BGI,508,8,3283,210,3283,2675,2775,B
2674,CGI,167,159,3442,585,3905,2675,3275,G
2674,CHI,188,29,3471,585,3868,2675,3283,C
2674,DHI,4201,730,4201,4331,4331,2675,0,I
2674,DHJ,188,188,4389,90,4421,2675,4201,J
2674,DHK,406,406,4795,800,5221,2675,4389,K
2674,DHJ,540,540,5335,175,5396,2675,4795,J
2674,DHK,175,175,5510,585,5981,2675,5335,K
2674,DHL,2402,334,5844,3780,7685,2675,3442,H
2674,DL,8957,8623,14467,3780,9761,2675,5510,L
2674,D,12407,1411,15878,3780,7648,2675,3471,D
2674,M,206,206,16084,118,9879,2675,15878,M
2674,N,267,267,16351,390,10269,2675,16084,N
2674,O,1089,1089,17440,1175,11444,2675,16351,O
2674,N,1250,1250,18690,1190,12634,2675,17440,N
2674,O,165,165,18855,385,13019,2675,18690,O
2674,P,475,475,19330,370,13389,2675,18855,P
2675,AE,1049,1049,1049,1238,1238,2676,0,E
2675,AF,1085,36,1085,1257,1257,2676,0,A
2675,BF,383,347,1432,240,1478,2676,1049,F
2675,BG,365,18,1450,240,1497,2676,1085,B
2675,CG,550,532,1982,630,2108,2676,1432,G
2675,CH,602,70,2052,630,2127,2676,1450,C
2675,DH,684,614,2666,6360,8468,2676,1982,H
2675,D,695,81,2747,6300,8427,2676,2052,D
2675,M,280,280,3027,175,8643,2676,2747,M
2675,N,135,135,3162,300,8943,2676,3027,N
2675,O,441,441,3603,690,9633,2676,3162,O
2675,N,661,661,4264,390,10023,2676,3603,N
2675,O,567,567,4831,720,10743,2676,4264,O
2675,P,1505,1505,6336,3960,14703,2676,4831,P
2676,A,689,689,689,4452,4452,2677,0,A
2676,B,3783,3783,4472,90,4542,2677,689,B
2676,C,908,908,5380,1240,5782,2677,4472,C
2676,D,1184,1184,6564,3780,9562,2677,5380,D
2676,M,352,352,6916,1215,10777,2677,6564,M
2676,N,922,922,7838,90,10867,2677,6916,N
2676,O,331,331,8169,705,11572,2677,7838,O
2676,P,1055,1055,9224,3780,15352,2677,8169,P
2677,AEI,44,44,44,1013,1013,2678,0,A
2677,BEI,47,3,47,968,968,2678,0,E
2677,BFI,63,16,63,1119,1119,2678,0,I
2677,BFJ,1103,1087,1150,240,1208,2678,47,F
2677,BGJ,1150,44,1194,240,1253,2678,44,B
2677,CGJ,1238,107,1301,240,1359,2678,63,J
2677,CGK,797,690,1991,995,2248,2678,1194,C
2677,DGK,869,28,2019,1020,2228,2678,1150,G
2677,DHK,776,58,2077,995,2354,2678,1301,K
2677,DHL,285,199,2276,4680,6928,2678,1991,D
2677,HL,355,98,2374,4680,6908,2678,2019,H
2677,L,405,108,2482,4680,7034,2678,2077,L
2677,M,8034,8034,10516,8298,15332,2678,2482,M
2677,N,304,304,10820,90,15422,2678,10516,N
2677,O,586,586,11406,795,16217,2678,10820,O
2677,N,1766,1766,13172,1570,17787,2678,11406,N
2677,O,879,879,14051,940,18727,2678,13172,O
2677,P,1268,1268,15319,3840,22567,2678,14051,P
2678,AEI,47,47,47,247,247,2679,0,I
2678,AEJ,56,9,56,1092,1092,2679,0,E
2678,AFJ,255,246,302,90,337,2679,47,J
2678,AFK,453,453,755,915,1252,2679,302,K
2678,AFL,1236,537,1292,240,1332,2679,56,F
2678,AGL,1441,149,1441,3396,3396,2679,0,A
2678,BGL,300,300,1741,270,3666,2679,1441,B
2678,CGL,815,366,2107,890,2222,2679,1292,G
2678,CHL,1988,636,2743,3780,5032,2679,755,L
2678,CH,2272,1270,4013,415,4081,2679,1741,C
2678,BH,1847,1847,5860,1805,5886,2679,4013,B
2678,CH,1962,1962,7822,1160,7046,2679,5860,C
2678,DH,5747,32,7854,5160,7382,2679,2107,H
2678,D,189,157,8011,665,7711,2679,7822,D
2678,M,1530,1530,9541,1718,9429,2679,8011,M
2678,N,231,231,9772,90,9519,2679,9541,N
2678,O,554,554,10326,945,10464,2679,9772,O
2678,N,893,893,11219,510,10974,2679,10326,N
2678,O,487,487,11706,740,11714,2679,11219,O
2678,P,826,826,12532,3780,15494,2679,11706,P
2679,AE,425,425,425,430,430,2680,0,A
2679,BE,252,252,677,180,610,2680,425,B
2679,CE,738,61,738,1141,1141,2680,0,E
2679,CF,523,523,1261,180,1321,2680,738,F
2679,CG,847,263,1524,1635,2245,2680,677,C
2679,BG,1109,846,2370,1045,2366,2680,1261,G
2679,BH,976,130,2500,525,2770,2680,1524,B
2679,CH,323,323,2823,540,3310,2680,2500,C
2679,DH,294,294,3117,9780,13090,2680,2823,D
2679,H,883,136,3253,550,2916,2680,2370,H
2679,M,27121,27121,30374,27676,40766,2680,3253,M
2679,N,618,618,30992,90,40856,2680,30374,N
2679,O,876,876,31868,1215,42071,2680,30992,O
2679,P,222,222,32090,3840,45911,2680,31868,P
2680,AE,584,584,584,777,777,2681,0,E
2680,AF,253,253,837,120,897,2681,584,F
2680,AG,842,842,1679,855,1752,2681,837,G
2680,AH,583,583,2262,375,2127,2681,1679,H
2680,A,4471,2209,4471,4590,4590,2681,0,A
2680,B,239,239,4710,180,4770,2681,4471,B
2680,C,869,869,5579,915,5685,2681,4710,C
2680,D,277,277,5856,360,6045,2681,5579,D
2680,M,1541,1541,7397,3546,9591,2681,5856,M
2680,N,2290,2290,9687,300,9891,2681,7397,N
2680,O,1502,1502,11189,1602,11493,2681,9687,O
2680,P,5980,5980,17169,4488,15981,2681,11189,P
2681,A,1,1,1,191,191,2682,0,A
2681,B,249,249,250,120,311,2682,1,B
2681,C,687,687,937,945,1256,2682,250,C
2681,D,212,212,1149,720,1976,2682,937,D
2681,M,194,194,1343,250,2226,2682,1149,M
2681,N,194,194,1537,180,2406,2682,1343,N
2681,O,248,248,1785,210,2616,2682,1537,O
2681,P,106,106,1891,2850,5466,2682,1785,P
2682,A,72,72,72,208,208,2683,0,A
2682,B,240,240,312,135,343,2683,72,B
2682,C,177,177,489,285,628,2683,312,C
2682,D,118,118,607,5160,5788,2683,489,D
2682,M,218,218,825,205,5993,2683,607,M
2682,N,100,100,925,180,6173,2683,825,N
2682,O,139,139,1064,140,6313,2683,925,O
2682,P,111,111,1175,2880,9193,2683,1064,P
2683,AEI,48,48,48,907,907,2684,0,E
2683,AFI,525,477,525,530,530,2684,0,A
2683,BFI,289,289,814,300,830,2684,525,B
2683,CFI,1038,272,1086,240,1147,2684,48,F
2683,CGI,1360,274,1360,1535,1535,2684,0,I
2683,CGJ,659,385,1745,640,1787,2684,1086,G
2683,CHJ,426,41,1786,300,1835,2684,1360,J
2683,CHK,995,23,1809,840,1670,2684,814,C
2683,DHK,704,681,2490,835,2670,2684,1786,K
2683,DHL,2951,2206,4696,5370,7157,2684,1745,H
2683,DL,8410,5523,10219,1200,2870,2684,1809,D
2683,L,8222,493,10712,1140,3810,2684,2490,L
2683,M,210,210,10922,361,7518,2684,10712,M
2683,N,266,266,11188,180,7698,2684,10922,N
2683,O,986,986,12174,1250,8948,2684,11188,O
2683,P,634,634,12808,6680,15628,2684,12174,P
2684,AE,251,251,251,282,282,2685,0,A
2684,BE,124,124,375,150,432,2685,251,B
2684,CE,145,145,520,140,572,2685,375,C
2684,BE,616,96,616,1400,1400,2685,0,E
2684,BF,830,830,1446,90,1490,2685,616,F
2684,BG,332,332,1778,800,2290,2685,1446,G
2684,BH,1548,290,2068,1540,2112,2685,520,B
2684,CH,871,581,2649,3780,6070,2685,1778,H
2684,C,701,120,2769,660,2772,2685,2068,C
2684,D,901,901,3670,4230,7002,2685,2769,D
2684,M,1963,1963,5633,2020,9022,2685,3670,M
2684,N,233,233,5866,180,9202,2685,5633,N
2684,O,199,199,6065,880,10082,2685,5866,O
2684,P,3140,3140,9205,6660,16742,2685,6065,P
2685,AEI,254,254,254,290,290,2686,0,A
2685,BEI,336,336,590,360,650,2686,254,B
2685,CEI,721,721,1311,655,1305,2686,590,C
2685,DEI,2376,1065,2376,3278,3278,2686,0,E
2685,DFI,2550,174,2550,3290,3290,2686,0,I
2685,DFJ,779,779,3329,90,3380,2686,2550,J
2685,DFK,1012,59,3388,180,3458,2686,2376,F
2685,DGK,628,569,3957,730,4110,2686,3329,K
2685,DGJ,1091,522,4479,1060,4518,2686,3388,G
2685,DHJ,4116,948,5427,550,1855,2686,1311,D
2685,HJ,1500,30,5457,1405,5515,2686,3957,J
2685,HK,842,842,6299,1245,6760,2686,5457,K
2685,HL,3096,1276,7575,550,5068,2686,4479,H
2685,L,4286,3010,10585,3780,10540,2686,6299,L
2685,M,858,858,11443,1797,12337,2686,10585,M
2685,N,1016,1016,12459,90,12427,2686,11443,N
2685,O,860,860,13319,1215,13642,2686,12459,O
2685,N,834,834,14153,510,14152,2686,13319,N
2685,O,787,787,14940,1060,15212,2686,14153,O
2685,P,126,126,15066,3780,18992,2686,14940,P
2686,AEI,115,115,115,777,777,2687,0,I
2686,AEJ,250,135,250,744,744,2687,0,A
2686,BEJ,753,618,868,150,927,2687,115,J
2686,BEK,887,19,887,1093,1093,2687,0,E
2686,BFK,680,43,930,240,984,2687,250,B
2686,CFK,186,124,1054,130,1057,2687,868,K
2686,CFJ,200,76,1130,390,1374,2687,930,C
2686,BFJ,301,58,1188,150,1243,2687,887,F
2686,BGJ,185,185,1373,180,1423,2687,1188,G
2686,BFJ,1493,1174,2547,1535,2592,2687,1054,J
2686,BFK,1512,95,2642,1300,2674,2687,1130,B
2686,CFK,313,218,2860,645,3237,2687,2547,K
2686,CFL,299,81,2941,915,3589,2687,2642,C
2686,DFL,1576,8,2949,1570,2993,2687,1373,F
2686,DGL,339,339,3288,645,3638,2687,2949,G
2686,DHL,3387,3387,6675,4230,7868,2687,3288,H
2686,DL,4683,868,7543,4230,7467,2687,2860,L
2686,D,13120,8518,16061,3960,7549,2687,2941,D
2686,M,1618,1618,17679,2896,10764,2687,16061,M
2686,N,1305,1305,18984,90,10854,2687,17679,N
2686,O,1641,1641,20625,1875,12729,2687,18984,O
2686,N,2416,2416,23041,2185,14914,2687,20625,N
2686,O,615,615,23656,1130,16044,2687,23041,O
2686,P,1701,1701,25357,3780,19824,2687,23656,P
2687,AE,52,52,52,306,306,2688,0,E
2687,AF,640,640,692,420,726,2688,52,F
2687,AG,855,163,855,1189,1189,2688,0,A
2687,BG,359,359,1214,90,1279,2688,855,B
2687,CG,1045,523,1737,1317,2043,2688,692,G
2687,CH,565,42,1779,815,2094,2688,1214,C
2687,BH,1528,1528,3307,1075,3169,2688,1779,B
2687,CH,2691,1121,4428,383,2426,2688,1737,H
2687,C,1272,151,4579,1790,4959,2688,3307,C
2687,D,925,925,5504,3780,8739,2688,4579,D
2687,M,261,261,5765,410,9149,2688,5504,M
2687,N,324,324,6089,240,9389,2688,5765,N
2687,O,884,884,6973,975,10364,2688,6089,O
2687,N,714,714,7687,615,10979,2688,6973,N
2687,O,175,175,7862,255,11234,2688,7687,O
2687,P,262,262,8124,5160,16394,2688,7862,P
2688,AEI,48,48,48,118,118,2689,0,A
2688,BEI,90,42,90,109,109,2689,0,E
2688,BFI,151,109,199,135,253,2689,48,B
2688,CFI,112,3,202,135,244,2689,90,F
2688,CGI,213,11,213,230,230,2689,0,I
2688,CGJ,93,93,306,135,365,2689,213,J
2688,CGK,152,48,354,285,529,2689,202,G
2688,CHK,221,66,420,285,538,2689,199,C
2688,DHK,146,32,452,280,645,2689,306,K
2688,DHL,80,48,500,5160,5698,2689,420,D
2688,HL,393,247,747,5160,5689,2689,354,H
2688,L,312,17,764,5160,5805,2689,452,L
2688,M,2965,2965,3729,3358,9163,2689,764,M
2688,N,417,417,4146,90,9253,2689,3729,N
2688,O,1003,1003,5149,1240,10493,2689,4146,O
2688,N,637,637,5786,395,10888,2689,5149,N
2688,O,421,421,6207,800,11688,2689,5786,O
2688,P,934,934,7141,3780,15468,2689,6207,P
2689,AEI,80,80,80,592,592,2690,0,A
2689,BEI,106,26,106,422,422,2690,0,I
2689,BEJ,406,406,512,150,572,2690,106,J
2689,BEK,602,170,682,150,742,2690,80,B
2689,CEK,514,344,1026,500,1072,2690,512,K
2689,CEL,532,188,1214,500,1242,2690,682,C
2689,DEL,293,105,1319,385,1457,2690,1026,L
2689,DE,244,139,1458,385,1627,2690,1214,D
2689,E,1607,149,1607,1965,1965,2690,0,E
2689,F,517,517,2124,230,2195,2690,1607,F
2689,G,572,572,2696,575,2770,2690,2124,G
2689,H,1430,1430,4126,385,3155,2690,2696,H
2689,M,2100,2100,6226,3548,6703,2690,4126,M
2689,N,1840,1840,8066,420,7123,2690,6226,N
2689,O,1212,1212,9278,1480,8603,2690,8066,O
2689,P,1866,1866,11144,350,8953,2690,9278,P
2690,A,175,175,175,921,921,2691,0,A
2690,B,844,844,1019,150,1071,2691,175,B
2690,C,185,185,1204,120,1191,2691,1019,C
2690,B,696,696,1900,745,1936,2691,1204,B
2690,C,842,842,2742,835,2771,2691,1900,C
2690,D,61,61,2803,4230,7001,2691,2742,D
2690,M,4142,4142,6945,4828,11829,2691,2803,M
2690,N,734,734,7679,90,11919,2691,6945,N
2690,O,224,224,7903,695,12614,2691,7679,O
2690,P,1595,1595,9498,3780,16394,2691,7903,P
2691,A,623,623,623,3868,3868,2692,0,A
2691,B,3365,3365,3988,180,4048,2692,623,B
2691,C,968,968,4956,910,4958,2692,3988,C
2691,D,1464,1464,6420,550,5508,2692,4956,D
2691,M,104,104,6524,295,5803,2692,6420,M
2691,N,1311,1311,7835,1250,7053,2692,6524,N
2691,O,1771,1771,9606,1665,8718,2692,7835,O
2691,P,23,23,9629,350,9068,2692,9606,P
2692,A,2238,2238,2238,2467,2467,2693,0,A
2692,B,642,642,2880,510,2977,2693,2238,B
2692,C,909,909,3789,585,3562,2693,2880,C
2692,D,6684,6684,10473,550,4112,2693,3789,D
2692,M,531,531,11004,1454,5566,2693,10473,M
2692,N,1298,1298,12302,420,5986,2693,11004,N
2692,O,714,714,13016,888,6874,2693,12302,O
2692,P,340,340,13356,402,7276,2693,13016,P
2693,AEI,3228,3228,3228,5659,5659,2694,0,A
2693,BEI,3311,83,3311,4266,4266,2694,0,I
2693,BEJ,1019,936,4247,90,5749,2694,3228,B
2693,CEJ,983,47,4294,90,4356,2694,3311,J
2693,CEK,542,542,4836,905,5261,2694,4294,K
2693,CEJ,835,835,5671,465,5726,2694,4836,J
2693,CEK,1917,493,6164,680,6429,2694,4247,C
2693,DEK,785,292,6456,1080,6806,2694,5671,K
2693,DEL,92,92,6548,3780,10586,2694,6456,L
2693,DE,559,175,6723,3780,10209,2694,6164,D
2693,E,23884,17161,23884,25920,25920,2694,0,E
2693,F,2109,2109,25993,90,26010,2694,23884,F
2693,G,992,992,26985,1250,27260,2694,25993,G
2693,F,559,559,27544,345,27605,2694,26985,F
2693,G,736,736,28280,1060,28665,2694,27544,G
2693,H,843,843,29123,3780,32445,2694,28280,H
2693,M,17705,17705,46828,18112,50557,2694,29123,M
2693,N,434,434,47262,90,50647,2694,46828,N
2693,O,730,730,47992,1105,51752,2694,47262,O
2693,P,175,175,48167,3780,55532,2694,47992,P
2694,AE,841,841,841,3326,3326,2695,0,E
2694,AF,1119,278,1119,1358,1358,2695,0,A
2694,BF,276,276,1395,90,1448,2695,1119,B
2694,CF,720,720,2115,1130,2578,2695,1395,C
2694,DF,185,185,2300,3840,6418,2695,2115,D
2694,F,6616,5157,7457,90,3416,2695,841,F
2694,G,878,878,8335,1250,4666,2695,7457,G
2694,H,3,3,8338,3780,8446,2695,8335,H
2694,M,91,91,8429,312,8758,2695,8338,M
2694,N,250,250,8679,90,8848,2695,8429,N
2694,O,530,530,9209,735,9583,2695,8679,O
2694,P,986,986,10195,3780,13363,2695,9209,P
2695,AEI,142,142,142,2500,2500,2696,0,I
2695,AEJ,1041,899,1041,735,735,2696,0,E
2695,AFJ,1281,240,1281,1425,1425,2696,0,A
2695,BFJ,251,11,1292,595,1330,2696,1041,F
2695,BGJ,298,298,1590,405,1735,2696,1292,G
2695,BFJ,391,82,1672,300,1725,2696,1281,B
2695,CFJ,281,281,1953,775,2500,2696,1672,C
2695,BFJ,555,555,2508,30,2530,2696,1953,B
2695,CFJ,2616,250,2758,300,2800,2696,142,J
2695,CFK,1223,55,2813,1100,2835,2696,1590,F
2695,CGK,527,222,3035,1530,4060,2696,2508,C
2695,DGK,360,83,3118,425,3225,2696,2758,K
2695,DGJ,529,224,3342,1530,4365,2696,2813,G
2695,DGJ,224,0,3342,165,3390,2696,3118,J
2695,DHK,264,264,3606,815,4205,2696,3342,K
2695,DHL,875,304,3910,2700,6760,2696,3035,D
2695,HL,449,145,4055,3655,7860,2696,3606,L
2695,H,873,160,4215,2700,7065,2696,3342,H
2695,M,1196,1196,5411,260,8120,2696,4215,M
2695,N,50,50,5461,1020,9140,2696,5411,N
2695,O,330,330,5791,460,9600,2696,5461,O
2695,N,245,245,6036,85,9685,2696,5791,N
2695,O,624,624,6660,755,10440,2696,6036,O
2695,P,1415,1415,8075,1140,11580,2696,6660,P
2696,AEI,155,155,155,345,345,2697,0,I
2696,AEJ,305,305,460,180,525,2697,155,J
2696,AEK,500,500,960,430,955,2697,460,K
2696,AEL,321,321,1281,385,1340,2697,960,L
2696,AE,2258,977,2258,2580,2580,2697,0,E
2696,AF,454,454,2712,180,2760,2697,2258,F
2696,AG,3174,462,3174,3364,3364,2697,0,A
2696,BG,412,412,3586,240,3604,2697,3174,B
2696,CG,878,4,3590,930,3690,2697,2712,G
2696,CH,928,924,4514,995,4599,2697,3586,C
2696,BH,407,407,4921,410,5009,2697,4514,B
2696,CH,641,641,5562,810,5819,2697,4921,C
2696,DH,2167,195,5757,550,4240,2697,3590,H
2696,D,2252,2057,7814,3960,9779,2697,5562,D
2696,M,1017,1017,8831,1511,11290,2697,7814,M
2696,N,869,869,9700,420,11710,2697,8831,N
2696,O,805,805,10505,960,12670,2697,9700,O
2696,N,910,910,11415,770,13440,2697,10505,N
2696,O,1057,1057,12472,1317,14757,2697,11415,O
2696,P,2811,2811,15283,303,15060,2697,12472,P
2697,AE,498,498,498,1343,1343,2698,0,E
2697,AF,578,80,578,1318,1318,2698,0,A
2697,BF,885,805,1383,90,1433,2698,498,F
2697,BG,807,2,1385,90,1408,2698,578,B
2697,CG,169,169,1554,605,2013,2698,1385,C
2697,DG,190,19,1573,605,2038,2698,1383,G
2697,DH,1680,1661,3234,3780,5793,2698,1554,D
2697,H,3117,1456,4690,3780,5818,2698,1573,H
2697,M,1218,1218,5908,1703,7521,2698,4690,M
2697,N,724,724,6632,300,7821,2698,5908,N
2697,O,912,912,7544,895,8716,2698,6632,O
2697,P,1079,1079,8623,550,9266,2698,7544,P
2698,AE,64,64,64,91,91,2699,0,E
2698,AF,194,130,194,169,169,2699,0,A
2698,BF,95,95,289,180,349,2699,194,B
2698,CF,229,4,293,240,331,2699,64,F
2698,CG,173,169,462,335,684,2699,289,C
2698,BG,533,364,826,740,1071,2699,293,G
2698,BH,853,853,1679,3960,5031,2699,826,H
2698,B,1230,13,1692,1065,1749,2699,462,B
2698,C,608,608,2300,625,2374,2699,1692,C
2698,D,2939,2939,5239,5100,7474,2699,2300,D
2698,M,1275,1275,6514,1361,8835,2699,5239,M
2698,N,312,312,6826,240,9075,2699,6514,N
2698,O,777,777,7603,695,9770,2699,6826,O
2698,N,541,541,8144,640,10410,2699,7603,N
2698,O,575,575,8719,810,11220,2699,8144,O
2698,P,628,628,9347,3960,15180,2699,8719,P
2699,A,1468,1468,1468,1969,1969,2700,0,A
2699,B,682,682,2150,240,2209,2700,1468,B
2699,C,697,697,2847,810,3019,2700,2150,C
2699,D,213,213,3060,5040,8059,2700,2847,D
2699,M,1140,1140,4200,1150,9209,2700,3060,M
2699,N,610,610,4810,660,9869,2700,4200,N
2699,O,413,413,5223,400,10269,2700,4810,O
2699,P,3162,3162,8385,425,10694,2700,5223,P
2700,A,52,52,52,304,304,2701,0,A
2700,B,452,452,504,240,544,2701,52,B
2700,C,1174,1174,1678,1165,1709,2701,504,C
2700,D,3367,3367,5045,550,2259,2701,1678,D
2700,M,489,489,5534,1392,3651,2701,5045,M
2700,N,1295,1295,6829,420,4071,2701,5534,N
2700,O,978,978,7807,1159,5230,2701,6829,O
2700,P,137,137,7944,341,5571,2701,7807,P
2701,AEI,49,49,49,71,71,2702,0,I
2701,AEJ,295,246,295,1138,1138,2702,0,A
2701,BEJ,382,136,431,420,491,2702,49,J
2701,BEK,1028,892,1323,240,1378,2702,295,B
2701,CEK,1381,489,1812,1800,2291,2702,431,K
2701,CEL,251,251,2063,335,2626,2702,1812,L
2701,CE,1015,275,2338,1020,2398,2702,1323,C
2701,DE,3074,736,3074,3583,3583,2702,0,E
2701,DF,887,887,3961,420,4003,2702,3074,F
2701,DG,903,903,4864,1250,5253,2702,3961,G
2701,DH,245,245,5109,335,5588,2702,4864,H
2701,D,11675,8904,14013,4680,7078,2702,2338,D
2701,M,781,781,14794,1108,8186,2702,14013,M
2701,N,480,480,15274,180,8366,2702,14794,N
2701,O,930,930,16204,910,9276,2702,15274,O
2701,P,1347,1347,17551,550,9826,2702,16204,P
2702,A,2860,2860,2860,3173,3173,2703,0,A
2702,B,409,409,3269,90,3263,2703,2860,B
2702,C,341,341,3610,715,3978,2703,3269,C
2702,D,1509,1509,5119,3780,7758,2703,3610,D
2702,M,3642,3642,8761,3794,11552,2703,5119,M
2702,N,308,308,9069,90,11642,2703,8761,N
2702,O,618,618,9687,795,12437,2703,9069,O
2702,N,1807,1807,11494,1740,14177,2703,9687,N
2702,O,723,723,12217,890,15067,2703,11494,O
2702,P,79,79,12296,3780,18847,2703,12217,P
2703,A,452,452,452,6175,6175,2704,0,A
2703,B,6058,6058,6510,480,6655,2704,452,B
2703,C,964,964,7474,1015,7670,2704,6510,C
2703,D,2347,2347,9821,550,8220,2704,7474,D
2703,M,33,33,9854,90,8310,2704,9821,M
2703,N,329,329,10183,300,8610,2704,9854,N
2703,O,524,524,10707,1280,9890,2704,10183,O
2703,P,2012,2012,12719,3960,13850,2704,10707,P
2704,A,1216,1216,1216,1869,1869,2705,0,A
2704,B,687,687,1903,90,1959,2705,1216,B
2704,C,1487,1487,3390,1745,3704,2705,1903,C
2704,D,64,64,3454,3780,7484,2705,3390,D
2704,M,478,478,3932,1171,8655,2705,3454,M
2704,N,742,742,4674,90,8745,2705,3932,N
2704,O,590,590,5264,935,9680,2705,4674,O
2704,P,408,408,5672,3780,13460,2705,5264,P
2705,AEI,296,296,296,460,460,2706,0,E
2705,AFI,444,148,444,435,435,2706,0,A
2705,BFI,246,246,690,300,735,2706,444,B
2705,CFI,519,125,815,300,760,2706,296,F
2705,CGI,564,439,1254,735,1470,2706,690,C
2705,DGI,735,296,1550,910,1670,2706,815,G
2705,DHI,356,60,1610,1560,3030,2706,1254,D
2705,HI,2646,2586,4196,3960,5630,2706,1550,H
2705,I,8660,4464,8660,10500,10500,2706,0,I
2705,J,2102,2102,10762,300,10800,2706,8660,J
2705,K,648,648,11410,760,11560,2706,10762,K
2705,L,25,25,11435,1560,13120,2706,11410,L
2705,M,1255,1255,12690,1430,14550,2706,11435,M
2705,N,435,435,13125,300,14850,2706,12690,N
2705,O,756,756,13881,840,15690,2706,13125,O
2705,P,4609,4609,18490,1140,16830,2706,13881,P
2706,A,5026,5026,5026,6887,6887,2707,0,A
2706,B,1897,1897,6923,90,6977,2707,5026,B
2706,C,903,903,7826,1225,8202,2707,6923,C
2706,D,49,49,7875,3780,11982,2707,7826,D
2706,M,2781,2781,10656,4648,16630,2707,7875,M
2706,N,1910,1910,12566,90,16720,2707,10656,N
2706,O,502,502,13068,735,17455,2707,12566,O
2706,P,3247,3247,16315,3780,21235,2707,13068,P
2707,A,233,233,233,501,501,2708,0,A
2707,B,333,333,566,90,591,2708,233,B
2707,C,1427,1427,1993,1745,2336,2708,566,C
2707,D,17,17,2010,3840,6176,2708,1993,D
2707,M,604,604,2614,1302,7478,2708,2010,M
2707,N,741,741,3355,90,7568,2708,2614,N
2707,O,293,293,3648,695,8263,2708,3355,O
2707,P,10221,10221,13869,3780,12043,2708,3648,P
2708,AE,144,144,144,920,920,2709,0,A
2708,BE,874,874,1018,150,1070,2709,144,B
2708,CE,133,133,1151,95,1165,2709,1018,C
2708,BE,563,563,1714,585,1750,2709,1151,B
2708,CE,676,676,2390,665,2415,2709,1714,C
2708,DE,2897,507,2897,3027,3027,2709,0,E
2708,DF,280,280,3177,270,3297,2709,2897,F
2708,DG,1236,449,3626,4230,6645,2709,2390,D
2708,G,2201,1752,5378,2730,6027,2709,3177,G
2708,F,1396,1396,6774,785,6812,2709,5378,F
2708,G,1200,1200,7974,1240,8052,2709,6774,G
2708,H,10,10,7984,335,8387,2709,7974,H
2708,M,5195,5195,13179,5675,14062,2709,7984,M
2708,N,727,727,13906,300,14362,2709,13179,N
2708,O,827,827,14733,1050,15412,2709,13906,O
2708,P,345,345,15078,1140,16552,2709,14733,P
2709,AE,8,8,8,695,695,2710,0,A
2709,BE,799,799,807,150,845,2710,8,B
2709,CE,163,163,970,115,960,2710,807,C
2709,BE,732,732,1702,775,1735,2710,970,B
2709,CE,959,959,2661,950,2685,2710,1702,C
2709,DE,3695,1034,3695,3866,3866,2710,0,E
2709,DF,238,238,3933,90,3956,2710,3695,F
2709,DG,528,528,4461,815,4771,2710,3933,G
2709,DF,393,393,4854,140,4911,2710,4461,F
2709,DG,286,286,5140,585,5496,2710,4854,G
2709,DH,5311,2832,7972,4230,6915,2710,2661,D
2709,H,15311,12479,20451,3780,9276,2710,5140,H
2709,M,1,1,20452,51,9327,2710,20451,M
2709,N,427,427,20879,390,9717,2710,20452,N
2709,O,965,965,21844,1175,10892,2710,20879,O
2709,N,1214,1214,23058,1070,11962,2710,21844,N
2709,O,223,223,23281,390,12352,2710,23058,O
2709,P,355,355,23636,485,12837,2710,23281,P
2710,A,49,49,49,149,149,2711,0,A
2710,B,220,220,269,180,329,2711,49,B
2710,C,242,242,511,335,664,2711,269,C
2710,B,1594,1594,2105,1495,2159,2711,511,B
2710,C,1358,1358,3463,810,2969,2711,2105,C
2710,B,264,264,3727,750,3719,2711,3463,B
2710,C,1092,1092,4819,1080,4799,2711,3727,C
2710,D,1434,1434,6253,5280,10079,2711,4819,D
2710,M,3,3,6256,111,10190,2711,6253,M
2710,N,288,288,6544,240,10430,2711,6256,N
2710,O,1102,1102,7646,1365,11795,2711,6544,O
2710,N,1991,1991,9637,1725,13520,2711,7646,N
2710,O,1590,1590,11227,1300,14820,2711,9637,O
2710,P,2956,2956,14183,360,15180,2711,11227,P
2711,AE,2025,2025,2025,2364,2364,2712,0,A
2711,BE,384,384,2409,90,2454,2712,2025,B
2711,CE,1020,1020,3429,1225,3679,2712,2409,C
2711,DE,3244,3244,6673,3780,7459,2712,3429,D
2711,E,10409,3736,10409,11563,11563,2712,0,E
2711,F,1617,1617,12026,90,11653,2712,10409,F
2711,G,1169,1169,13195,1340,12993,2712,12026,G
2711,H,302,302,13497,3780,16773,2712,13195,H
2711,M,550,550,14047,1285,18058,2712,13497,M
2711,N,776,776,14823,90,18148,2712,14047,N
2711,O,547,547,15370,850,18998,2712,14823,O
2711,P,412,412,15782,3780,22778,2712,15370,P
2712,AE,34,34,34,66,66,2713,0,A
2712,BE,122,122,156,150,216,2713,34,B
2712,CE,110,110,266,125,341,2713,156,C
2712,BE,556,290,556,1445,1445,2713,0,E
2712,BF,310,20,576,280,621,2713,266,B
2712,CF,885,885,1461,765,1386,2713,576,C
2712,DF,926,21,1482,90,1535,2713,556,F
2712,DG,207,186,1668,4230,5616,2713,1461,D
2712,G,852,666,2334,1200,2735,2713,1482,G
2712,H,228,228,2562,3780,6515,2713,2334,H
2712,M,510,510,3072,1398,7913,2713,2562,M
2712,N,943,943,4015,90,8003,2713,3072,N
2712,O,646,646,4661,925,8928,2713,4015,O
2712,P,1244,1244,5905,3780,12708,2713,4661,P
2713,A,1603,1603,1603,1969,1969,2714,0,A
2713,B,868,868,2471,600,2569,2714,1603,B
2713,C,989,989,3460,955,3524,2714,2471,C
2713,D,2595,2595,6055,385,3909,2714,3460,D
2713,M,6143,6143,12198,7064,10973,2714,6055,M
2713,N,1322,1322,13520,420,11393,2714,12198,N
2713,O,871,871,14391,1162,12555,2714,13520,O
2713,P,439,439,14830,473,13028,2714,14391,P
2714,AE,47,47,47,245,245,2715,0,A
2714,BE,48,1,48,2178,2178,2715,0,E
2714,BF,348,347,395,165,410,2715,47,B
2714,CF,643,643,1038,910,1320,2715,395,C
2714,DF,174,174,1212,3960,5280,2715,1038,D
2714,F,2250,1086,2298,165,2343,2715,48,F
2714,G,775,775,3073,1035,3378,2715,2298,G
2714,H,106,106,3179,3960,7338,2715,3073,H
2714,M,2570,2570,5749,2806,10144,2715,3179,M
2714,N,348,348,6097,150,10294,2715,5749,N
2714,O,1383,1383,7480,700,10994,2715,6097,O
2714,N,219,219,7699,895,11889,2715,7480,N
2714,O,1257,1257,8956,1290,13179,2715,7699,O
2714,P,1756,1756,10712,3660,16839,2715,8956,P
2715,AEI,108,108,108,1120,1120,2716,0,E
2715,AFI,422,314,422,757,757,2716,0,I
2715,AFJ,780,358,780,1489,1489,2716,0,A
2715,BFJ,400,42,822,90,847,2716,422,J
2715,BFK,1042,328,1150,90,1210,2716,108,F
2715,BGK,755,385,1535,90,1579,2716,780,B
2715,CGK,1026,641,2176,1210,2420,2716,1150,G
2715,CHK,1393,39,2215,1745,2592,2716,822,K
2715,CHL,23,23,2238,3780,6372,2716,2215,L
2715,CH,921,218,2456,1240,2819,2716,1535,C
2715,DH,481,201,2657,3780,6200,2716,2176,H
2715,D,321,120,2777,3780,6599,2716,2456,D
2715,M,481,481,3258,1117,7716,2716,2777,M
2715,N,669,669,3927,90,7806,2716,3258,N
2715,O,192,192,4119,690,8496,2716,3927,O
2715,P,10425,10425,14544,3780,12276,2716,4119,P
2716,A,163,163,163,1367,1367,2717,0,A
2716,B,1237,1237,1400,90,1457,2717,163,B
2716,C,962,962,2362,1220,2677,2717,1400,C
2716,D,90,90,2452,3780,6457,2717,2362,D
2716,M,4147,4147,6599,5028,11485,2717,2452,M
2716,N,918,918,7517,90,11575,2717,6599,N
2716,O,728,728,8245,1155,12730,2717,7517,O
2716,P,60,60,8305,3780,16510,2717,8245,P
2717,AEI,235,235,235,519,519,2718,0,I
2717,AEJ,372,137,372,885,885,2718,0,E
2717,AFJ,321,184,556,90,609,2718,235,J
2717,AFK,597,41,597,1681,1681,2718,0,A
2717,BFK,546,321,918,90,975,2718,372,F
2717,BGK,535,173,1091,850,1459,2718,556,K
2717,BGL,507,334,1425,845,1820,2718,918,G
2717,BHL,386,52,1477,3780,5239,2718,1091,L
2717,BH,1128,248,1725,90,1771,2718,597,B
2717,CH,418,418,2143,850,2621,2718,1725,C
2717,DH,777,777,2920,3780,6401,2718,2143,D
2717,H,5065,3570,6490,3780,5600,2718,1425,H
2717,M,4728,4728,11218,5328,11729,2718,6490,M
2717,N,878,878,12096,300,12029,2718,11218,N
2717,O,664,664,12760,920,12949,2718,12096,O
2717,N,2102,2102,14862,1905,14854,2718,12760,N
2717,O,338,338,15200,660,15514,2718,14862,O
2717,P,2835,2835,18035,3960,19474,2718,15200,P
2718,AE,135,135,135,160,160,2719,0,E
2718,AF,108,108,243,150,310,2719,135,F
2718,AG,551,308,551,888,888,2719,0,A
2718,BG,603,295,846,620,930,2719,243,G
2718,BH,17,17,863,2880,3810,2719,846,H
2718,B,699,387,1250,420,1308,2719,551,B
2718,C,569,569,1819,816,2124,2719,1250,C
2718,D,4714,4714,6533,414,2538,2719,1819,D
2718,M,1394,1394,7927,1609,5419,2719,6533,M
2718,N,336,336,8263,150,5569,2719,7927,N
2718,O,532,532,8795,495,6064,2719,8263,O
2718,N,744,744,9539,790,6854,2719,8795,N
2718,O,755,755,10294,706,7560,2719,9539,O
2718,P,2953,2953,13247,3630,11190,2719,10294,P
2719,AEI,71,71,71,757,757,2720,0,I
2719,AEJ,97,26,97,113,113,2720,0,E
2719,AFJ,173,76,173,516,516,2720,0,A
2719,BFJ,163,87,260,180,293,2720,97,F
2719,BGJ,151,151,411,165,458,2720,260,G
2719,BHJ,1,1,412,2880,3338,2720,411,H
2719,BJ,524,285,697,300,816,2720,173,B
2719,CJ,863,237,934,240,997,2720,71,J
2719,CK,243,243,1177,255,1252,2720,934,K
2719,CL,1055,575,1752,985,1801,2720,697,C
2719,BL,606,606,2358,615,2416,2720,1752,B
2719,CL,383,383,2741,255,2671,2720,2358,C
2719,DL,2523,2523,5264,5160,7831,2720,2741,D
2719,L,4324,237,5501,5160,6412,2720,1177,L
2719,M,145,145,5646,198,8029,2720,5501,M
2719,N,151,151,5797,150,8179,2720,5646,N
2719,O,171,171,5968,135,8314,2720,5797,O
2719,N,874,874,6842,855,9169,2720,5968,N
2719,O,645,645,7487,690,9859,2720,6842,O
2719,P,3485,3485,10972,4230,14089,2720,7487,P
2720,AEI,133,133,133,1396,1396,2721,0,A
2720,BEI,857,724,857,1534,1534,2721,0,E
2720,BFI,1294,570,1427,90,1486,2721,133,B
2720,CFI,739,169,1596,90,1624,2721,857,F
2720,CGI,2320,724,2320,2515,2515,2721,0,I
2720,CGJ,1006,113,2433,1210,2696,2721,1427,C
2720,DGJ,840,3,2436,1250,2874,2721,1596,G
2720,DHJ,224,108,2544,90,2605,2721,2320,J
2720,DHK,436,328,2872,3780,6654,2721,2436,H
2720,DK,1030,591,3463,3780,6476,2721,2433,D
2720,K,977,58,3521,1240,3845,2721,2544,K
2720,L,42,42,3563,3780,7625,2721,3521,L
2720,M,657,657,4220,1268,8893,2721,3563,M
2720,N,647,647,4867,90,8983,2721,4220,N
2720,O,241,241,5108,695,9678,2721,4867,O
2720,P,1670,1670,6778,3780,13458,2721,5108,P
2721,A,177,177,177,349,349,2722,0,A
2721,B,325,325,502,210,559,2722,177,B
2721,C,124,124,626,255,814,2722,502,C
2721,B,943,943,1569,815,1629,2722,626,B
2721,C,712,712,2281,760,2389,2722,1569,C
2721,D,3043,3043,5324,7680,10069,2722,2281,D
2721,M,23,23,5347,170,10239,2722,5324,M
2721,N,260,260,5607,180,10419,2722,5347,N
2721,O,565,565,6172,560,10979,2722,5607,O
2721,P,272,272,6444,2850,13829,2722,6172,P
2722,AE,44,44,44,355,355,2723,0,E
2722,AF,55,11,55,2016,2016,2723,0,A
2722,BF,411,400,455,165,520,2723,44,F
2722,BG,1054,1054,1509,1275,1795,2723,455,G
2722,BH,2081,627,2136,165,2181,2723,55,B
2722,CH,996,369,2505,4020,5815,2723,1509,H
2722,C,831,462,2967,1075,3256,2723,2136,C
2722,D,945,945,3912,3960,7216,2723,2967,D
2722,M,507,507,4419,1347,8563,2723,3912,M
2722,N,891,891,5310,90,8653,2723,4419,N
2722,O,474,474,5784,855,9508,2723,5310,O
2722,P,557,557,6341,3780,13288,2723,5784,P
2723,A,1729,1729,1729,1799,1799,2724,0,A
2723,B,225,225,1954,240,2039,2724,1729,B
2723,C,1066,1066,3020,1675,3714,2724,1954,C
2723,B,1279,1279,4299,590,4304,2724,3020,B
2723,C,1008,1008,5307,1250,5554,2724,4299,C
2723,D,5,5,5312,335,5889,2724,5307,D
2723,M,5272,5272,10584,5429,11318,2724,5312,M
2723,N,253,253,10837,90,11408,2724,10584,N
2723,O,735,735,11572,815,12223,2724,10837,O
2723,N,1313,1313,12885,1290,13513,2724,11572,N
2723,O,230,230,13115,695,14208,2724,12885,O
2723,P,11221,11221,24336,3780,17988,2724,13115,P
2724,A,1725,1725,1725,1798,1798,2725,0,A
2724,B,267,267,1992,240,2038,2725,1725,B
2724,C,652,652,2644,700,2738,2725,1992,C
2724,B,101,101,2745,65,2803,2725,2644,B
2724,C,203,203,2948,385,3188,2725,2745,C
2724,D,1315,1315,4263,3960,7148,2725,2948,D
2724,M,193,193,4456,999,8147,2725,4263,M
2724,N,898,898,5354,150,8297,2725,4456,N
2724,O,361,361,5715,255,8552,2725,5354,O
2724,N,136,136,5851,245,8797,2725,5715,N
2724,O,217,217,6068,235,9032,2725,5851,O
2724,P,1165,1165,7233,3510,12542,2725,6068,P
2725,A,12087,12087,12087,14639,14639,2726,0,A
2725,B,3189,3189,15276,90,14729,2726,12087,B
2725,C,1188,1188,16464,1365,16094,2726,15276,C
2725,D,193,193,16657,3780,19874,2726,16464,D
2725,M,290,290,16947,846,20720,2726,16657,M
2725,N,667,667,17614,90,20810,2726,16947,N
2725,O,1210,1210,18824,1330,22140,2726,17614,O
2725,P,992,992,19816,3780,25920,2726,18824,P
2726,AE,854,854,854,1552,1552,2727,0,E
2726,AF,750,750,1604,90,1642,2727,854,F
2726,AG,846,846,2450,1250,2892,2727,1604,G
2726,AH,434,434,2884,3780,6672,2727,2450,H
2726,A,16110,13226,16110,17492,17492,2727,0,A
2726,B,1401,1401,17511,90,17582,2727,16110,B
2726,C,1229,1229,18740,1370,18952,2727,17511,C
2726,D,101,101,18841,3780,22732,2727,18740,D
2726,M,653,653,19494,828,23560,2727,18841,M
2726,N,211,211,19705,90,23650,2727,19494,N
2726,O,1424,1424,21129,1935,25585,2727,19705,O
2726,P,1405,1405,22534,3780,29365,2727,21129,P
2727,A,338,338,338,876,876,2728,0,A
2727,B,666,666,1004,150,1026,2728,338,B
2727,C,151,151,1155,130,1156,2728,1004,C
2727,B,263,263,1418,310,1466,2728,1155,B
2727,C,763,763,2181,720,2186,2728,1418,C
2727,D,1093,1093,3274,4170,6356,2728,2181,D
2727,M,1985,1985,5259,2376,8732,2728,3274,M
2727,N,417,417,5676,90,8822,2728,5259,N
2727,O,569,569,6245,815,9637,2728,5676,O
2727,N,1118,1118,7363,860,10497,2728,6245,N
2727,O,261,261,7624,695,11192,2728,7363,O
2727,P,1978,1978,9602,3780,14972,2728,7624,P
2728,AE,496,496,496,670,670,2729,0,E
2728,AF,275,275,771,135,805,2729,496,F
2728,AG,1472,701,1472,1670,1670,2729,0,A
2728,BG,728,27,1499,845,1650,2729,771,G
2728,BH,465,438,1937,300,1970,2729,1472,B
2728,CH,754,754,2691,910,2880,2729,1937,C
2728,DH,156,156,2847,3960,6840,2729,2691,D
2728,H,1911,563,3410,5220,6870,2729,1499,H
2728,M,378,378,3788,619,7489,2729,3410,M
2728,N,1681,1681,5469,1500,8989,2729,3788,N
2728,O,980,980,6449,1000,9989,2729,5469,O
2728,N,1525,1525,7974,1505,11494,2729,6449,N
2728,O,289,289,8263,295,11789,2729,7974,O
2728,P,1521,1521,9784,5100,16889,2729,8263,P
2729,A,26,26,26,197,197,2730,0,A
2729,B,322,322,348,135,332,2730,26,B
2729,C,184,184,532,280,612,2730,348,C
2729,D,201,201,733,5160,5772,2730,532,D
2729,M,613,613,1346,1595,7367,2730,733,M
2729,N,1102,1102,2448,150,7517,2730,1346,N
2729,O,1365,1365,3813,1610,9127,2730,2448,O
2729,P,1632,1632,5445,2520,11647,2730,3813,P
2730,AE,123,123,123,349,349,2731,0,A
2730,BE,162,39,162,1168,1168,2731,0,E
2730,BF,306,267,429,90,439,2731,123,B
2730,CF,1036,769,1198,90,1258,2731,162,F
2730,CG,1416,647,1845,1780,2219,2731,429,C
2730,DG,51,51,1896,3780,5999,2731,1845,D
2730,G,956,258,2154,1210,2468,2731,1198,G
2730,H,44,44,2198,3780,6248,2731,2154,H
2730,M,513,513,2711,975,7223,2731,2198,M
2730,N,486,486,3197,90,7313,2731,2711,N
2730,O,217,217,3414,625,7938,2731,3197,O
2730,P,130,130,3544,3780,11718,2731,3414,P
2731,A,4568,4568,4568,4724,4724,2732,0,A
2731,B,198,198,4766,90,4814,2732,4568,B
2731,C,620,620,5386,820,5634,2732,4766,C
2731,B,1047,1047,6433,835,6469,2732,5386,B
2731,C,491,491,6924,805,7274,2732,6433,C
2731,D,10560,10560,17484,3780,11054,2732,6924,D
2731,M,702,702,18186,1652,12706,2732,17484,M
2731,N,977,977,19163,90,12796,2732,18186,N
2731,O,728,728,19891,805,13601,2732,19163,O
2731,N,1944,1944,21835,1860,15461,2732,19891,N
2731,O,873,873,22708,1080,16541,2732,21835,O
2731,P,740,740,23448,3780,20321,2732,22708,P
2732,A,248,248,248,194,194,2733,0,A
2732,B,720,720,968,780,974,2733,248,B
2732,C,894,894,1862,1717,2691,2733,968,C
2732,D,9290,9290,11152,338,3029,2733,1862,D
2732,M,1948,1948,13100,2068,5097,2733,11152,M
2732,N,596,596,13696,180,5277,2733,13100,N
2732,O,49,49,13745,665,5942,2733,13696,O
2732,P,103870,103870,117615,6900,12842,2733,13745,P
2733,AE,1374,1374,1374,1714,1714,2734,0,E
2733,AF,375,375,1749,90,1804,2734,1374,F
2733,AG,182,182,1931,585,2389,2734,1749,G
2733,AH,1964,1964,3895,3780,6169,2734,1931,H
2733,A,7349,3454,7349,8597,8597,2734,0,A
2733,B,1282,1282,8631,90,8687,2734,7349,B
2733,C,1005,1005,9636,1210,9897,2734,8631,C
2733,B,407,407,10043,205,10102,2734,9636,B
2733,C,205,205,10248,585,10687,2734,10043,C
2733,D,3744,3744,13992,3780,14467,2734,10248,D
2733,M,141,141,14133,1292,15759,2734,13992,M
2733,N,1182,1182,15315,90,15849,2734,14133,N
2733,O,219,219,15534,575,16424,2734,15315,O
2733,N,726,726,16260,365,16789,2734,15534,N
2733,O,817,817,17077,1270,18059,2734,16260,O
2733,P,625,625,17702,3780,21839,2734,17077,P
2734,AEI,50,50,50,685,685,2735,0,A
2734,BEI,106,56,106,145,145,2735,0,E
2734,BFI,340,234,340,320,320,2735,0,I
2734,BFJ,306,72,412,300,445,2735,106,F
2734,BGJ,73,1,413,150,470,2735,340,J
2734,BGK,190,190,603,280,750,2735,413,K
2734,BGL,991,438,1041,360,1045,2735,50,B
2734,CGL,732,103,1144,780,1225,2735,412,G
2734,CHL,528,425,1569,650,1695,2735,1041,C
2734,DHL,243,243,1812,1140,2835,2735,1569,D
2734,HL,1795,586,2398,5160,5910,2735,603,L
2734,H,1380,126,2524,1140,2365,2735,1144,H
2734,M,1195,1195,3719,7778,13688,2735,2524,M
2734,N,6578,6578,10297,90,13778,2735,3719,N
2734,O,1391,1391,11688,1655,15433,2735,10297,O
2734,P,593,593,12281,3780,19213,2735,11688,P
2735,A,682,682,682,1312,1312,2736,0,A
2735,B,766,766,1448,180,1492,2736,682,B
2735,C,904,904,2352,885,2377,2736,1448,C
2735,D,33270,33270,35622,6680,9057,2736,2352,D
2735,M,124,124,35746,353,9410,2736,35622,M
2735,N,349,349,36095,180,9590,2736,35746,N
2735,O,616,616,36711,710,10300,2736,36095,O
2735,P,7124,7124,43835,6960,17260,2736,36711,P
2736,AEI,292,292,292,249,249,2737,0,I
2736,AEJ,218,218,510,300,549,2737,292,J
2736,AEK,518,8,518,2183,2183,2737,0,A
2736,BEK,664,656,1174,840,1389,2737,510,K
2736,BEL,1744,1088,2262,90,2273,2737,518,B
2736,CEL,2656,394,2656,2740,2740,2737,0,E
2736,CFL,294,294,2950,240,2980,2737,2656,F
2736,CGL,671,671,3621,785,3765,2737,2950,G
2736,CHL,1423,64,3685,1935,4208,2737,2262,C
2736,DHL,178,114,3799,3960,7725,2737,3621,H
2736,DL,133,19,3818,3780,7988,2737,3685,D
2736,L,4833,2189,6007,1140,2529,2737,1174,L
2736,M,122,122,6129,1310,9298,2737,6007,M
2736,N,1476,1476,7605,300,9598,2737,6129,N
2736,O,278,278,7883,2930,12528,2737,7605,O
2736,P,1409,1409,9292,1570,14098,2737,7883,P
2737,AEI,44,44,44,775,775,2738,0,E
2737,AFI,177,133,177,738,738,2738,0,A
2737,BFI,258,81,258,247,247,2738,0,I
2737,BFJ,176,176,434,240,487,2738,258,J
2737,BFK,203,203,637,295,782,2738,434,K
2737,BFL,205,205,842,5100,5882,2738,637,L
2737,BF,807,9,851,135,910,2738,44,F
2737,BG,744,70,921,240,978,2738,177,B
2737,CG,184,184,1105,295,1273,2738,921,C
2737,DG,290,36,1141,300,1210,2738,851,G
2737,DH,64,64,1205,5100,6310,2738,1141,H
2737,D,3398,3298,4503,5220,6493,2738,1105,D
2737,M,595,595,5098,1190,7683,2738,4503,M
2737,N,916,916,6014,180,7863,2738,5098,N
2737,O,471,471,6485,895,8758,2738,6014,O
2737,N,1600,1600,8085,1365,10123,2738,6485,N
2737,O,561,561,8646,620,10743,2738,8085,O
2737,P,1285,1285,9931,6960,17703,2738,8646,P
2738,A,451,451,451,1094,1094,2739,0,A
2738,B,744,744,1195,150,1244,2739,451,B
2738,C,162,162,1357,400,1644,2739,1195,C
2738,B,497,497,1854,250,1894,2739,1357,B
2738,C,731,731,2585,660,2554,2739,1854,C
2738,D,194,194,2779,4230,6784,2739,2585,D
2738,M,2280,2280,5059,2543,9327,2739,2779,M
2738,N,303,303,5362,90,9417,2739,5059,N
2738,O,565,565,5927,795,10212,2739,5362,O
2738,N,929,929,6856,700,10912,2739,5927,N
2738,O,177,177,7033,585,11497,2739,6856,O
2738,P,7545,7545,14578,3780,15277,2739,7033,P
2739,AE,53,53,53,290,290,2740,0,A
2739,BE,568,568,621,240,530,2740,53,B
2739,CE,775,154,775,1114,1114,2740,0,E
2739,CF,375,375,1150,90,1204,2740,775,F
2739,CG,1148,619,1769,1530,2060,2740,621,C
2739,DG,314,314,2083,3960,6020,2740,1769,D
2739,G,962,29,2112,1225,2429,2740,1150,G
2739,H,37637,37637,39749,4505,6934,2740,2112,H
2739,M,784,784,40533,1203,8137,2740,39749,M
2739,N,448,448,40981,90,8227,2740,40533,N
2739,O,290,290,41271,625,8852,2740,40981,O
2739,P,2096,2096,43367,3780,12632,2740,41271,P
2740,AE,475,475,475,1074,1074,2741,0,E
2740,AF,867,867,1342,240,1314,2741,475,F
2740,AG,489,489,1831,840,2154,2741,1342,G
2740,AH,2003,172,2003,2054,2054,2741,0,A
2740,BH,736,564,2567,3960,6114,2741,1831,H
2740,B,949,385,2952,180,2234,2741,2003,B
2740,C,292,292,3244,880,3114,2741,2952,C
2740,D,2509,2509,5753,6660,9774,2741,3244,D
2740,M,1560,1560,7313,2354,12128,2741,5753,M
2740,N,317,317,7630,90,12218,2741,7313,N
2740,O,645,645,8275,820,13038,2741,7630,O
2740,N,710,710,8985,20,13058,2741,8275,N
2740,O,597,597,9582,920,13978,2741,8985,O
2740,P,300,300,9882,3780,17758,2741,9582,P
2741,AE,4,4,4,26,26,2742,0,A
2741,BE,118,114,118,170,170,2742,0,E
2741,BF,222,108,226,240,266,2742,4,B
2741,CF,245,137,363,240,410,2742,118,F
2741,CG,515,378,741,780,1046,2742,226,C
2741,DG,41,41,782,3960,5006,2742,741,D
2741,G,495,76,858,780,1190,2742,363,G
2741,H,158,158,1016,3960,5150,2742,858,H
2741,M,292,292,1308,305,5455,2742,1016,M
2741,N,221,221,1529,240,5695,2742,1308,N
2741,O,570,570,2099,610,6305,2742,1529,O
2741,P,1041,1041,3140,4080,10385,2742,2099,P
2742,AEI,27,27,27,52,52,2743,0,A
2742,BEI,28,1,28,133,133,2743,0,I
2742,BEJ,188,188,216,135,268,2743,28,J
2742,BEK,219,30,246,240,292,2743,27,B
2742,CEK,193,193,439,285,577,2743,246,C
2742,DEK,283,60,499,285,553,2743,216,K
2742,DEL,186,186,685,5160,5713,2743,499,L
2742,DE,2178,1932,2617,5160,5737,2743,439,D
2742,E,10033,7416,10033,10075,10075,2743,0,E
2742,F,313,313,10346,300,10375,2743,10033,F
2742,G,600,600,10946,800,11175,2743,10346,G
2742,H,979,979,11925,1140,12315,2743,10946,H
2742,M,396,396,12321,1155,13470,2743,11925,M
2742,N,801,801,13122,90,13560,2743,12321,N
2742,O,1052,1052,14174,1250,14810,2743,13122,O
2742,N,304,304,14478,120,14930,2743,14174,N
2742,O,172,172,14650,585,15515,2743,14478,O
2742,P,1213,1213,15863,3780,19295,2743,14650,P
2743,AEI,160,160,160,356,356,2744,0,E
2743,AFI,169,9,169,232,232,2744,0,A
2743,BFI,254,254,423,240,472,2744,169,B
2743,CFI,421,158,581,240,596,2744,160,F
2743,CGI,960,379,960,1132,1132,2744,0,I
2743,CGJ,362,362,1322,180,1312,2744,960,J
2743,CGK,977,78,1400,910,1382,2744,423,C
2743,DGK,1159,340,1740,1165,1761,2744,581,G
2743,DHK,383,43,1783,550,1932,2744,1400,D
2743,HK,852,391,2174,930,2242,2744,1322,K
2743,HL,476,42,2216,550,2311,2744,1740,H
2743,L,3315,3273,5489,550,2792,2744,2174,L
2743,M,12917,12917,18406,13164,15956,2744,5489,M
2743,N,367,367,18773,180,16136,2744,18406,N
2743,O,756,756,19529,840,16976,2744,18773,O
2743,N,809,809,20338,725,17701,2744,19529,N
2743,O,616,616,20954,710,18411,2744,20338,O
2743,P,17249,17249,38203,6960,25371,2744,20954,P
2744,AE,106,106,106,1155,1155,2745,0,A
2744,BE,1236,1236,1342,240,1395,2745,106,B
2744,CE,889,889,2231,1020,2415,2745,1342,C
2744,DE,91,91,2322,4680,7095,2745,2231,D
2744,E,6482,4160,6482,8533,8533,2745,0,E
2744,F,2143,2143,8625,90,8623,2745,6482,F
2744,G,1042,1042,9667,1380,10003,2745,8625,G
2744,F,359,359,10026,85,10088,2745,9667,F
2744,G,354,354,10380,795,10883,2745,10026,G
2744,H,477,477,10857,3780,14663,2745,10380,H
2744,M,3338,3338,14195,3493,18156,2745,10857,M
2744,N,195,195,14390,90,18246,2745,14195,N
2744,O,442,442,14832,800,19046,2745,14390,O
2744,N,799,799,15631,450,19496,2745,14832,N
2744,O,596,596,16227,920,20416,2745,15631,O
2744,P,194,194,16421,3780,24196,2745,16227,P
2745,AE,46,46,46,72,72,2746,0,E
2745,AF,53,7,53,93,93,2746,0,A
2745,BF,104,97,150,135,207,2746,46,F
2745,BG,125,28,178,135,228,2746,53,B
2745,CG,229,201,379,295,502,2746,150,G
2745,CH,206,5,384,285,513,2746,178,C
2745,DH,160,155,539,5160,5662,2746,379,H
2745,D,243,88,627,5160,5673,2746,384,D
2745,M,833,833,1460,1219,6892,2746,627,M
2745,N,518,518,1978,180,7072,2746,1460,N
2745,O,654,654,2632,885,7957,2746,1978,O
2745,P,5199,5199,7831,6680,14637,2746,2632,P
2746,A,115,115,115,166,166,2747,0,A
2746,B,159,159,274,135,301,2747,115,B
2746,C,283,283,557,285,586,2747,274,C
2746,D,834,834,1391,5160,5746,2747,557,D
2746,M,1797,1797,3188,1605,7351,2747,1391,M
2746,N,322,322,3510,180,7531,2747,3188,N
2746,O,764,764,4274,885,8416,2747,3510,O
2746,P,228,228,4502,6680,15096,2747,4274,P
2747,A,753,753,753,983,983,2748,0,A
2747,B,477,477,1230,240,1223,2748,753,B
2747,C,508,508,1738,845,2068,2748,1230,C
2747,D,645,645,2383,3960,6028,2748,1738,D
2747,M,3,3,2386,1623,7651,2748,2383,M
2747,N,1745,1745,4131,180,7831,2748,2386,N
2747,O,759,759,4890,835,8666,2748,4131,O
2747,N,1609,1609,6499,1535,10201,2748,4890,N
2747,O,581,581,7080,610,10811,2748,6499,O
2747,P,12877,12877,19957,5100,15911,2748,7080,P
2748,AEI,325,325,325,749,749,2749,0,A
2748,BEI,524,524,849,150,899,2749,325,B
2748,CEI,226,226,1075,120,1019,2749,849,C
2748,BEI,2095,1020,2095,2652,2652,2749,0,I
2748,BEJ,2119,24,2119,2823,2823,2749,0,E
2748,BFJ,1497,453,2572,1585,2604,2749,1075,B
2748,CFJ,736,283,2855,90,2913,2749,2119,F
2748,CGJ,313,30,2885,645,3249,2749,2572,C
2748,DGJ,917,127,3012,420,3072,2749,2095,J
2748,DGK,526,369,3381,880,3793,2749,2855,G
2748,DFK,474,474,3855,110,3903,2749,3381,F
2748,DGK,859,16,3871,926,3998,2749,3012,K
2748,DGL,3266,2280,6151,4230,7479,2749,2885,D
2748,GL,4343,2047,8198,2315,6218,2749,3855,G
2748,HL,1251,1251,9449,3420,9638,2749,8198,H
2748,L,6185,607,10056,414,4412,2749,3871,L
2748,M,2524,2524,12580,4308,13946,2749,10056,M
2748,N,1827,1827,14407,90,14036,2749,12580,N
2748,O,1599,1599,16006,1875,15911,2749,14407,O
2748,N,488,488,16494,215,16126,2749,16006,N
2748,O,449,449,16943,850,16976,2749,16494,O
2748,P,831,831,17774,3780,20756,2749,16943,P
2749,AE,26,26,26,2757,2757,2750,0,E
2749,AF,1049,1023,1049,2893,2893,2750,0,A
2749,BF,2761,1738,2787,90,2847,2750,26,F
2749,BG,1888,150,2937,90,2983,2750,1049,B
2749,CG,996,846,3783,1210,4057,2750,2787,G
2749,CH,3,3,3786,3780,7837,2750,3783,H
2749,C,1308,459,4245,1355,4338,2750,2937,C
2749,D,2,2,4247,3780,8118,2750,4245,D
2749,M,1548,1548,5795,2087,10205,2750,4247,M
2749,N,596,596,6391,90,10295,2750,5795,N
2749,O,350,350,6741,765,11060,2750,6391,O
2749,P,242,242,6983,3780,14840,2750,6741,P
2750,AEI,96,96,96,1118,1118,2751,0,I
2750,AEJ,518,422,518,659,659,2751,0,E
2750,AFJ,194,194,712,90,749,2751,518,F
2750,AGJ,1052,436,1148,90,1208,2751,96,J
2750,AGK,844,408,1556,820,1569,2751,712,G
2750,AFK,1876,320,1876,1958,1958,2751,0,A
2750,BFK,402,82,1958,445,2014,2751,1556,F
2750,BGK,129,47,2005,90,2048,2751,1876,B
2750,CGK,927,70,2075,1210,2418,2751,1148,K
2750,CGJ,540,470,2545,870,2918,2751,2005,C
2750,BGJ,734,147,2692,970,2984,2751,1958,G
2750,BHJ,747,130,2822,440,2858,2751,2075,J
2750,BHK,644,644,3466,940,3798,2751,2822,K
2750,BHL,1033,112,3578,725,3643,2751,2545,B
2750,CHL,357,245,3823,3780,7578,2751,3466,L
2750,CH,1571,440,4263,3780,6764,2751,2692,H
2750,C,706,21,4284,970,4613,2751,3578,C
2750,D,150,150,4434,3780,8393,2751,4284,D
2750,M,169,169,4603,1264,9657,2751,4434,M
2750,N,1215,1215,5818,180,9837,2751,4603,N
2750,O,1270,1270,7088,1485,11322,2751,5818,O
2750,N,1379,1379,8467,1150,12472,2751,7088,N
2750,O,540,540,9007,750,13222,2751,8467,O
2750,P,4417,4417,13424,2580,15802,2751,9007,P
2751,AEI,519,519,519,946,946,2752,0,A
2751,BEI,631,631,1150,240,1186,2752,519,B
2751,CEI,2227,1077,2227,3217,3217,2752,0,I
2751,CEJ,1116,39,2266,955,2141,2752,1150,C
2751,DEJ,1020,981,3247,90,3307,2752,2227,J
2751,DEK,645,645,3892,1130,4437,2752,3247,K
2751,DEL,5959,2067,5959,6007,6007,2752,0,E
2751,DFL,108,108,6067,120,6127,2752,5959,F
2751,DGL,229,229,6296,390,6517,2752,6067,G
2751,DFL,1411,1411,7707,1225,7742,2752,6296,F
2751,DGL,687,687,8394,820,8562,2752,7707,G
2751,DHL,2836,2836,11230,5040,13602,2752,8394,H
2751,DL,10203,2865,14095,3780,8217,2752,3892,L
2751,D,16009,4180,18275,3900,6041,2752,2266,D
2751,M,171,171,18446,1426,15028,2752,18275,M
2751,N,1555,1555,20001,360,15388,2752,18446,N
2751,O,741,741,20742,695,16083,2752,20001,O
2751,P,268,268,21010,550,16633,2752,20742,P
2752,AE,22,22,22,199,199,2753,0,A
2752,BE,357,357,379,240,439,2753,22,B
2752,CE,535,156,535,2991,2991,2753,0,E
2752,CF,645,489,1024,625,1064,2753,379,C
2752,BF,711,711,1735,710,1774,2753,1024,B
2752,CF,1299,1299,3034,2305,4079,2753,1735,C
2752,DF,2622,123,3157,210,3201,2753,535,F
2752,DG,1009,886,4043,4625,8704,2753,3034,D
2752,G,1339,453,4496,2205,5406,2753,3157,G
2752,H,1104,1104,5600,1780,7186,2753,4496,H
2752,M,1843,1843,7443,2467,11171,2753,5600,M
2752,N,1185,1185,8628,660,11831,2753,7443,N
2752,O,672,672,9300,710,12541,2753,8628,O
2752,N,270,270,9570,190,12731,2753,9300,N
2752,O,882,882,10452,1110,13841,2753,9570,O
2752,N,845,845,11297,660,14501,2753,10452,N
2752,O,250,250,11547,440,14941,2753,11297,O
2752,P,1441,1441,12988,995,15936,2753,11547,P
2753,AE,461,461,461,1100,1100,2754,0,A
2753,BE,789,789,1250,210,1310,2754,461,B
2753,CE,1276,1276,2526,1205,2515,2754,1250,C
2753,DE,3496,970,3496,3920,3920,2754,0,E
2753,DF,691,691,4187,300,4220,2754,3496,F
2753,DG,765,765,4952,825,5045,2754,4187,G
2753,DH,4378,1952,6904,460,2975,2754,2526,D
2753,H,13687,11735,18639,1140,6185,2754,4952,H
2753,M,957,957,19596,1234,7419,2754,18639,M
2753,N,1019,1019,20615,780,8199,2754,19596,N
2753,O,1048,1048,21663,1160,9359,2754,20615,O
2753,P,1070,1070,22733,635,9994,2754,21663,P
2754,AEI,200,200,200,1144,1144,2755,0,I
2754,AEJ,378,178,378,1355,1355,2755,0,E
2754,AFJ,1022,844,1222,135,1279,2755,200,J
2754,AFK,1152,308,1530,240,1595,2755,378,F
2754,AGK,778,470,2000,1020,2299,2755,1222,K
2754,AGL,822,352,2352,995,2590,2755,1530,G
2754,AHL,440,88,2440,4680,6979,2755,2000,L
2754,AH,227,139,2579,4680,7270,2755,2352,H
2754,A,3664,1085,3664,4291,4291,2755,0,A
2754,B,675,675,4339,90,4381,2755,3664,B
2754,C,423,423,4762,800,5181,2755,4339,C
2754,D,843,843,5605,3780,8961,2755,4762,D
2754,M,855,855,6460,962,9923,2755,5605,M
2754,N,305,305,6765,180,10103,2755,6460,N
2754,O,997,997,7762,880,10983,2755,6765,O
2754,P,2422,2422,10184,6660,17643,2755,7762,P
2755,A,118,118,118,71,71,2756,0,A
2755,B,146,146,264,240,311,2756,118,B
2755,C,664,664,928,785,1096,2756,264,C
2755,D,555,555,1483,3960,5056,2756,928,D
2755,M,546,546,2029,395,5451,2756,1483,M
2755,N,72,72,2101,300,5751,2756,2029,N
2755,O,661,661,2762,775,6526,2756,2101,O
2755,N,1211,1211,3973,1085,7611,2756,2762,N
2755,O,491,491,4464,740,8351,2756,3973,O
2755,P,905,905,5369,5100,13451,2756,4464,P
2756,AEI,69,69,69,345,345,2757,0,E
2756,AFI,284,215,284,355,355,2757,0,I
2756,AFJ,328,113,397,120,465,2757,69,F
2756,AGJ,125,12,409,120,475,2757,284,J
2756,AGK,206,206,615,105,580,2757,409,K
2756,AGJ,490,272,887,105,570,2757,397,G
2756,AFJ,650,378,1265,745,1325,2757,615,J
2756,AFK,129,129,1394,185,1510,2757,1265,K
2756,AFL,511,4,1398,885,1455,2757,887,F
2756,AGL,141,141,1539,185,1640,2757,1398,G
2756,AHL,517,517,2056,2850,4490,2757,1539,H
2756,AL,844,182,2238,2850,4360,2757,1394,L
2756,A,3202,964,3202,3481,3481,2757,0,A
2756,B,342,342,3544,90,3571,2757,3202,B
2756,C,1116,1116,4660,1355,4926,2757,3544,C
2756,B,1749,1749,6409,1525,6451,2757,4660,B
2756,C,1058,1058,7467,1465,7916,2757,6409,C
2756,D,676,676,8143,3780,11696,2757,7467,D
2756,M,1691,1691,9834,2293,13989,2757,8143,M
2756,N,923,923,10757,180,14169,2757,9834,N
2756,O,471,471,11228,895,15064,2757,10757,O
2756,N,631,631,11859,395,15459,2757,11228,N
2756,O,519,519,12378,495,15954,2757,11859,O
2756,P,54588,54588,66966,6900,22854,2757,12378,P
2757,AEI,52,52,52,114,114,2758,0,A
2757,BEI,261,209,261,1254,1254,2758,0,E
2757,BFI,320,111,372,240,354,2758,52,B
2757,CFI,819,819,1191,1045,1399,2758,372,C
2757,DFI,58,58,1249,3960,5359,2758,1191,D
2757,FI,1023,35,1284,90,1344,2758,261,F
2757,GI,2321,1037,2321,2161,2161,2758,0,I
2757,GJ,1042,5,2326,1220,2564,2758,1284,G
2757,HJ,227,222,2548,90,2251,2758,2321,J
2757,HK,480,258,2806,3780,6344,2758,2326,H
2757,K,609,351,3157,725,2976,2758,2548,K
2757,L,118,118,3275,3780,6756,2758,3157,L
2757,M,1618,1618,4893,1856,8612,2758,3275,M
2757,N,292,292,5185,90,8702,2758,4893,N
2757,O,228,228,5413,695,9397,2758,5185,O
2757,P,1483,1483,6896,3780,13177,2758,5413,P
2758,AE,47,47,47,76,76,2759,0,A
2758,BE,57,10,57,216,216,2759,0,E
2758,BF,147,137,194,135,211,2759,47,B
2758,CF,244,107,301,135,351,2759,57,F
2758,CG,228,121,422,295,506,2759,194,C
2758,DG,194,73,495,285,636,2759,301,G
2758,DH,133,60,555,5160,5666,2759,422,D
2758,H,111,51,606,5160,5796,2759,495,H
2758,M,128,128,734,99,5895,2759,606,M
2758,N,97,97,831,180,6075,2759,734,N
2758,O,182,182,1013,205,6280,2759,831,O
2758,P,862,862,1875,2850,9130,2759,1013,P
2759,A,101,101,101,159,159,2760,0,A
2759,B,141,141,242,135,294,2760,101,B
2759,C,209,209,451,285,579,2760,242,C
2759,D,154,154,605,5160,5739,2760,451,D
2759,M,124,124,729,117,5856,2760,605,M
2759,N,103,103,832,150,6006,2760,729,N
2759,O,37,37,869,115,6121,2760,832,O
2759,N,269,269,1138,210,6331,2760,869,N
2759,O,135,135,1273,225,6556,2760,1138,O
2759,P,20,20,1293,4740,11296,2760,1273,P
2760,AEI,15,15,15,3975,3975,2761,0,E
2760,AFI,1135,1120,1135,2650,2650,2761,0,A
2760,BFI,1794,1794,2929,300,2950,2761,1135,B
2760,CFI,713,713,3642,1035,3985,2761,2929,C
2760,BFI,396,396,4038,105,4090,2761,3642,B
2760,CFI,4159,136,4174,240,4215,2761,15,F
2760,CGI,192,56,4230,825,4915,2761,4038,C
2760,DGI,560,504,4734,810,5025,2761,4174,G
2760,DHI,5207,473,5207,5663,5663,2761,0,I
2760,DHJ,656,656,5863,240,5903,2761,5207,J
2760,DHK,558,558,6421,815,6718,2761,5863,K
2760,DHL,2645,454,6875,1560,6475,2761,4230,D
2760,HL,2883,742,7617,3960,8985,2761,4734,H
2760,L,11163,9967,17584,3960,10678,2761,6421,L
2760,M,238,238,17822,310,10988,2761,17584,M
2760,N,273,273,18095,240,11228,2761,17822,N
2760,O,510,510,18605,765,11993,2761,18095,O
2760,N,366,366,18971,110,12103,2761,18605,N
2760,O,673,673,19644,1045,13148,2761,18971,O
2760,P,592,592,20236,3960,17108,2761,19644,P
2761,AE,194,194,194,528,528,2762,0,A
2761,BE,382,382,576,90,618,2762,194,B
2761,CE,421,421,997,815,1433,2762,576,C
2761,DE,1730,733,1730,3541,3541,2762,0,E
2761,DF,991,258,1988,3780,5213,2762,997,D
2761,F,1814,1556,3544,90,3631,2762,1730,F
2761,G,1157,1157,4701,1360,4991,2762,3544,G
2761,F,2380,2380,7081,2150,7141,2762,4701,F
2761,G,469,469,7550,815,7956,2762,7081,G
2761,H,961,961,8511,3780,11736,2762,7550,H
2761,M,6332,6332,14843,6525,18261,2762,8511,M
2761,N,251,251,15094,90,18351,2762,14843,N
2761,O,615,615,15709,815,19166,2762,15094,O
2761,N,852,852,16561,680,19846,2762,15709,N
2761,O,1468,1468,18029,2315,22161,2762,16561,O
2761,P,2961,2961,20990,3420,25581,2762,18029,P
2762,AE,14,14,14,769,769,2763,0,A
2762,BE,80,66,80,77,77,2763,0,E
2762,BF,74,74,154,135,212,2763,80,F
2762,BG,188,188,342,295,507,2763,154,G
2762,BH,34,34,376,5100,5607,2763,342,H
2762,B,830,468,844,135,904,2763,14,B
2762,C,190,190,1034,300,1204,2763,844,C
2762,D,96,96,1130,5100,6304,2763,1034,D
2762,M,649,649,1779,926,7230,2763,1130,M
2762,N,833,833,2612,180,7410,2763,1779,N
2762,O,482,482,3094,895,8305,2763,2612,O
2762,N,277,277,3371,300,8605,2763,3094,N
2762,O,196,196,3567,350,8955,2763,3371,O
2762,P,13164,13164,16731,6900,15855,2763,3567,P
2763,AEI,199,199,199,1238,1238,2764,0,A
2763,BEI,534,335,534,1226,1226,2764,0,I
2763,BEJ,732,732,1266,90,1316,2764,534,J
2763,BEK,1069,2,1268,90,1328,2764,199,B
2763,CEK,1419,151,1419,1730,1730,2764,0,E
2763,CFK,383,383,1802,90,1820,2764,1419,F
2763,CGK,840,304,2106,1195,2511,2764,1266,K
2763,CGL,1004,166,2272,1210,2538,2764,1268,C
2763,DGL,1,1,2273,3780,6318,2764,2272,D
2763,GL,806,335,2608,1060,2880,2764,1802,G
2763,HL,606,104,2712,3780,6291,2764,2106,L
2763,H,1435,1331,4043,3780,6660,2764,2608,H
2763,M,2626,2626,6669,2975,9635,2764,4043,M
2763,N,389,389,7058,90,9725,2764,6669,N
2763,O,266,266,7324,535,10260,2764,7058,O
2763,P,865,865,8189,3780,14040,2764,7324,P
2764,AE,21,21,21,240,240,2765,0,E
2764,AF,193,172,193,184,184,2765,0,A
2764,BF,171,171,364,240,424,2765,193,B
2764,CF,407,64,428,240,480,2765,21,F
2764,CG,218,154,582,295,719,2765,364,C
2764,DG,179,25,607,295,775,2765,428,G
2764,DH,46,46,653,5100,5875,2765,607,H
2764,D,112,41,694,5100,5819,2765,582,D
2764,M,581,581,1275,1055,6930,2765,694,M
2764,N,517,517,1792,180,7110,2765,1275,N
2764,O,1079,1079,2871,895,8005,2765,1792,O
2764,P,16343,16343,19214,6680,14685,2765,2871,P
2765,A,16,16,16,324,324,2766,0,A
2765,B,882,882,898,420,744,2766,16,B
2765,C,1202,1202,2100,1221,1965,2766,898,C
2765,D,3816,3816,5916,479,2444,2766,2100,D
2765,M,759,759,6675,2126,4570,2766,5916,M
2765,N,1092,1092,7767,90,4660,2766,6675,N
2765,O,2140,2140,9907,1850,6510,2766,7767,O
2765,N,342,342,10249,295,6805,2766,9907,N
2765,O,475,475,10724,790,7595,2766,10249,O
2765,P,3143,3143,13867,3780,11375,2766,10724,P
2766,A,2797,2797,2797,3417,3417,2767,0,A
2766,B,2198,2198,4995,1620,5037,2767,2797,B
2766,C,820,820,5815,810,5847,2767,4995,C
2766,B,1428,1428,7243,1050,6897,2767,5815,B
2766,C,1029,1029,8272,1938,8835,2767,7243,C
2766,D,1914,1914,10186,1367,10202,2767,8272,D
2766,M,1624,1624,11810,1736,11938,2767,10186,M
2766,N,247,247,12057,195,12133,2767,11810,N
2766,O,699,699,12756,670,12803,2767,12057,O
2766,N,245,245,13001,255,13058,2767,12756,N
2766,O,80,80,13081,96,13154,2767,13001,O
2766,P,1537,1537,14618,419,13573,2767,13081,P
2767,AE,418,418,418,589,589,2768,0,E
2767,AF,199,199,617,90,679,2768,418,F
2767,AG,570,570,1187,905,1584,2768,617,G
2767,AH,1,1,1188,3780,5364,2768,1187,H
2767,A,2814,1626,2814,2394,2394,2768,0,A
2767,B,248,248,3062,90,2484,2768,2814,B
2767,C,598,598,3660,795,3279,2768,3062,C
2767,D,2350,2350,6010,3780,7059,2768,3660,D
2767,M,1686,1686,7696,1878,8937,2768,6010,M
2767,N,225,225,7921,90,9027,2768,7696,N
2767,O,557,557,8478,805,9832,2768,7921,O
2767,P,600,600,9078,3780,13612,2768,8478,P
2768,AEI,213,213,213,236,236,2769,0,A
2768,BEI,127,127,340,150,386,2769,213,B
2768,CEI,203,203,543,125,511,2769,340,C
2768,BEI,1427,1427,1970,1505,2016,2769,543,B
2768,CEI,820,820,2790,775,2791,2769,1970,C
2768,DEI,118,118,2908,4230,7021,2769,2790,D
2768,EI,7577,4669,7577,8300,8300,2769,0,E
2768,FI,763,763,8340,90,8390,2769,7577,F
2768,GI,976,976,9316,1240,9630,2769,8340,G
2768,HI,38,38,9354,3780,13410,2769,9316,H
2768,I,11235,1881,11235,11344,11344,2769,0,I
2768,J,132,132,11367,90,11434,2769,11235,J
2768,K,757,757,12124,1105,12539,2769,11367,K
2768,L,500,500,12624,3780,16319,2769,12124,L
2768,M,383,383,13007,731,17050,2769,12624,M
2768,N,380,380,13387,90,17140,2769,13007,N
2768,O,1394,1394,14781,1865,19005,2769,13387,O
2768,P,1295,1295,16076,3780,22785,2769,14781,P
2769,AEI,49,49,49,1072,1072,2770,0,A
2769,BEI,98,49,98,705,705,2770,0,I
2769,BEJ,169,71,169,1057,1057,2770,0,E
2769,BFJ,871,800,969,300,1005,2770,98,J
2769,BFK,1079,279,1248,240,1297,2770,169,F
2769,BGK,1215,16,1264,240,1312,2770,49,B
2769,CGK,998,703,1967,925,1930,2770,969,K
2769,CGL,743,24,1991,965,2262,2770,1248,G
2769,CHL,842,115,2106,890,2202,2770,1264,C
2769,DHL,1312,1197,3303,3960,6222,2770,1991,H
2769,DL,2396,1060,4363,2760,4690,2770,1967,L
2769,D,7166,4909,9272,5160,7362,2770,2106,D
2769,M,100,100,9372,824,8186,2770,9272,M
2769,N,930,930,10302,240,8426,2770,9372,N
2769,O,1033,1033,11335,1150,9576,2770,10302,O
2769,P,4596,4596,15931,720,10296,2770,11335,P
2770,AEI,150,150,150,2142,2142,2771,0,I
2770,AEJ,858,708,858,1027,1027,2771,0,A
2770,BEJ,326,326,1184,120,1147,2771,858,B
2770,CEJ,1366,182,1366,3144,3144,2771,0,E
2770,CFJ,776,594,1960,755,1902,2771,1184,C
2770,DFJ,2184,374,2334,240,2382,2771,150,J
2770,DFK,945,945,3279,930,3312,2771,2334,K
2770,DFL,1972,59,3338,240,3384,2771,1366,F
2770,DGL,872,872,4210,976,4360,2771,3338,G
2770,DFL,2257,7,4217,550,2452,2771,1960,D
2770,FL,622,615,4832,495,4855,2771,4210,F
2770,GL,817,817,5649,810,5665,2771,4832,G
2770,HL,2412,42,5691,550,3862,2771,3279,L
2770,H,5416,5374,11065,3960,9625,2771,5649,H
2770,M,934,934,11999,1090,10715,2771,11065,M
2770,N,282,282,12281,180,10895,2771,11999,N
2770,O,105,105,12386,230,11125,2771,12281,O
2770,N,609,609,12995,480,11605,2771,12386,N
2770,O,605,605,13600,500,12105,2771,12995,O
2770,P,2198,2198,15798,6000,18105,2771,13600,P
2771,A,2803,2803,2803,2982,2982,2772,0,A
2771,B,219,219,3022,90,3072,2772,2803,B
2771,C,583,583,3605,800,3872,2772,3022,C
2771,D,270,270,3875,3840,7712,2772,3605,D
2771,M,192,192,4067,545,8257,2772,3875,M
2771,N,384,384,4451,90,8347,2772,4067,N
2771,O,210,210,4661,625,8972,2772,4451,O
2771,P,1309,1309,5970,3780,12752,2772,4661,P
2772,AEI,1,1,1,57,57,2773,0,A
2772,BEI,249,249,250,240,297,2773,1,B
2772,CEI,381,131,381,1020,1020,2773,0,E
2772,CFI,575,444,825,925,1222,2773,250,C
2772,DFI,669,225,1050,90,1110,2773,381,F
2772,DGI,242,17,1067,3960,5182,2773,825,D
2772,GI,628,611,1678,860,1970,2773,1050,G
2772,HI,2548,2548,4226,3780,5750,2773,1678,H
2772,I,4257,31,4257,4805,4805,2773,0,I
2772,J,598,598,4855,90,4895,2773,4257,J
2772,K,489,489,5344,860,5755,2773,4855,K
2772,L,1454,1454,6798,3780,9535,2773,5344,L
2772,M,1439,1439,8237,1631,11166,2773,6798,M
2772,N,298,298,8535,90,11256,2773,8237,N
2772,O,551,551,9086,870,12126,2773,8535,O
2772,N,1065,1065,10151,820,12946,2773,9086,N
2772,O,484,484,10635,705,13651,2773,10151,O
2772,P,603,603,11238,3780,17431,2773,10635,P
2773,AEI,48,48,48,991,991,2774,0,A
2773,BEI,80,32,80,1026,1026,2774,0,E
2773,BFI,660,580,660,1237,1237,2774,0,I
2773,BFJ,1143,531,1191,240,1231,2774,48,B
2773,CFJ,1141,30,1221,240,1266,2774,80,F
2773,CGJ,604,43,1264,90,1327,2774,660,J
2773,CGK,373,373,1637,800,2127,2774,1264,K
2773,CGL,833,387,2024,1020,2251,2774,1191,C
2773,DGL,818,15,2039,995,2261,2774,1221,G
2773,DHL,190,190,2229,4680,6941,2774,2039,H
2773,DL,287,82,2311,4680,6931,2774,2024,D
2773,L,1020,346,2657,3780,5907,2774,1637,L
2773,M,3167,3167,5824,3956,10897,2774,2657,M
2773,N,885,885,6709,90,10987,2774,5824,N
2773,O,957,957,7666,815,11802,2774,6709,O
2773,P,157,157,7823,3780,15582,2774,7666,P
2774,AE,82,82,82,1047,1047,2775,0,E
2774,AF,536,454,536,1850,1850,2775,0,A
2774,BF,995,541,1077,90,1137,2775,82,F
2774,BG,1454,913,1990,90,1940,2775,536,B
2774,CG,1004,91,2081,1220,2357,2775,1077,G
2774,CH,1,1,2082,3780,6137,2775,2081,H
2774,C,1429,1337,3419,1780,3720,2775,1990,C
2774,D,520,520,3939,3780,7500,2775,3419,D
2774,M,709,709,4648,1354,8854,2775,3939,M
2774,N,676,676,5324,90,8944,2775,4648,N
2774,O,147,147,5471,535,9479,2775,5324,O
2774,P,1389,1389,6860,3780,13259,2775,5471,P
2775,AE,564,564,564,1368,1368,2776,0,A
2775,BE,991,991,1555,240,1608,2776,564,B
2775,CE,892,892,2447,1020,2628,2776,1555,C
2775,DE,303,303,2750,4680,7308,2776,2447,D
2775,E,3194,444,3194,3237,3237,2776,0,E
2775,F,133,133,3327,150,3387,2776,3194,F
2775,G,2699,2699,6026,3000,6387,2776,3327,G
2775,F,1337,1337,7363,915,7302,2776,6026,F
2775,G,1052,1052,8415,1250,8552,2776,7363,G
2775,H,127,127,8542,335,8887,2776,8415,H
2775,M,462,462,9004,1153,10040,2776,8542,M
2775,N,751,751,9755,120,10160,2776,9004,N
2775,O,772,772,10527,795,10955,2776,9755,O
2775,P,852,852,11379,385,11340,2776,10527,P
2776,AE,226,226,226,218,218,2777,0,E
2776,AF,142,142,368,210,428,2777,226,F
2776,AG,455,87,455,1260,1260,2777,0,A
2776,BG,467,380,835,690,1118,2777,368,G
2776,BF,265,265,1100,90,1208,2777,835,F
2776,BG,1061,416,1516,300,1560,2777,455,B
2776,CG,870,454,1970,900,2108,2777,1100,G
2776,CF,870,416,2386,905,2465,2777,1516,C
2776,DF,2333,1917,4303,2220,4328,2777,1970,F
2776,DG,847,847,5150,890,5218,2777,4303,G
2776,DH,2809,45,5195,2760,5225,2777,2386,D
2776,H,239,194,5389,5160,10378,2777,5150,H
2776,M,135,135,5524,3035,13413,2777,5389,M
2776,N,3108,3108,8632,250,13663,2777,5524,N
2776,O,1134,1134,9766,1110,14773,2777,8632,O
2776,P,500,500,10266,550,15323,2777,9766,P
2777,AE,302,302,302,507,507,2778,0,E
2777,AF,270,270,572,90,597,2778,302,F
2777,AG,795,223,795,1072,1072,2778,0,A
2777,BG,303,303,1098,90,1162,2778,795,B
2777,CG,900,900,1998,1240,2402,2778,1098,C
2777,DG,15,15,2013,3780,6182,2778,1998,D
2777,G,1486,45,2058,1745,2342,2778,572,G
2777,H,4,4,2062,3780,6122,2778,2058,H
2777,M,3551,3551,5613,5132,11314,2778,2062,M
2777,N,1626,1626,7239,90,11404,2778,5613,N
2777,O,591,591,7830,880,12284,2778,7239,O
2777,P,5670,5670,13500,3780,16064,2778,7830,P
2778,A,5548,5548,5548,6077,6077,2779,0,A
2778,B,1024,1024,6572,600,6677,2779,5548,B
2778,C,1321,1321,7893,1200,7877,2779,6572,C
2778,D,890,890,8783,385,8262,2779,7893,D
2778,M,163,163,8946,326,8588,2779,8783,M
2778,N,283,283,9229,180,8768,2779,8946,N
2778,O,696,696,9925,840,9608,2779,9229,O
2778,P,442,442,10367,6680,16288,2779,9925,P
2779,AE,88,88,88,200,200,2780,0,A
2779,BE,186,98,186,315,315,2780,0,E
2779,BF,192,94,280,150,350,2780,88,B
2779,CF,218,124,404,150,465,2780,186,F
2779,CG,150,26,430,130,480,2780,280,C
2779,DG,35,35,465,2880,3360,2780,430,D
2779,G,125,64,529,80,545,2780,404,G
2779,H,21,21,550,2880,3425,2780,529,H
2779,M,250,250,800,900,4325,2780,550,M
2779,N,742,742,1542,150,4475,2780,800,N
2779,O,188,188,1730,170,4645,2780,1542,O
2779,P,17,17,1747,2880,7525,2780,1730,P
2780,AEI,216,216,216,266,266,2781,0,A
2780,BEI,110,110,326,240,506,2781,216,B
2780,CEI,522,196,522,1269,1269,2781,0,I
2780,CEJ,829,307,829,1279,1279,2781,0,E
2780,CFJ,482,482,1311,90,1369,2781,829,F
2780,CGJ,807,18,1329,90,1359,2781,522,J
2780,CGK,383,365,1694,795,2164,2781,1311,G
2780,CHK,437,72,1766,800,2159,2781,1329,K
2780,CHL,1657,217,1983,1560,2066,2781,326,C
2780,BHL,745,528,2511,3780,5939,2781,1766,L
2780,BH,1089,272,2783,3780,5944,2781,1694,H
2780,B,856,56,2839,795,2861,2781,1983,B
2780,C,930,930,3769,1250,4111,2781,2839,C
2780,D,316,316,4085,335,4446,2781,3769,D
2780,M,2155,2155,6240,2358,8302,2781,4085,M
2780,N,222,222,6462,90,8392,2781,6240,N
2780,O,478,478,6940,815,9207,2781,6462,O
2780,N,399,399,7339,45,9252,2781,6940,N
2780,O,528,528,7867,740,9992,2781,7339,O
2780,P,984,984,8851,3780,13772,2781,7867,P
2781,AEI,554,554,554,837,837,2782,0,E
2781,AFI,583,583,1137,360,1197,2782,554,F
2781,AGI,1148,1148,2285,1130,2327,2782,1137,G
2781,AFI,458,458,2743,480,2807,2782,2285,F
2781,AGI,154,154,2897,120,2927,2782,2743,G
2781,AHI,3058,161,3058,2742,2742,2782,0,A
2781,BHI,64,64,3122,500,3242,2782,3058,B
2781,CHI,810,810,3932,690,3932,2782,3122,C
2781,DHI,252,252,4184,385,4317,2782,3932,D
2781,HI,6225,2041,6225,6765,6765,2782,0,I
2781,HJ,1005,1005,7230,420,7185,2782,6225,J
2781,HK,4422,89,7319,550,3477,2782,2897,H
2781,K,1035,946,8265,975,8160,2782,7230,K
2781,L,1611,1611,9876,550,8710,2782,8265,L
2781,M,20453,20453,30329,23337,32047,2782,9876,M
2781,N,1670,1670,31999,150,32197,2782,30329,N
2781,O,3316,3316,35315,380,32577,2782,31999,O
2781,P,471,471,35786,660,33237,2782,35315,P
2782,AE,185,185,185,1011,1011,2783,0,E
2782,AF,1021,1021,1206,240,1251,2783,185,F
2782,AG,461,461,1667,760,2011,2783,1206,G
2782,AH,2432,2432,4099,3540,5551,2783,1667,H
2782,A,7348,3249,7348,8350,8350,2783,0,A
2782,B,1281,1281,8629,300,8650,2783,7348,B
2782,C,1324,1324,9953,1045,9695,2783,8629,C
2782,D,497,497,10450,1200,10895,2783,9953,D
2782,M,2014,2014,12464,2569,13464,2783,10450,M
2782,N,585,585,13049,90,13554,2783,12464,N
2782,O,474,474,13523,820,14374,2783,13049,O
2782,N,1829,1829,15352,1460,15834,2783,13523,N
2782,O,602,602,15954,920,16754,2783,15352,O
2782,P,1424,1424,17378,3780,20534,2783,15954,P
2783,AE,65,65,65,1063,1063,2784,0,E
2783,AF,128,63,128,145,145,2784,0,A
2783,BF,117,117,245,150,295,2784,128,B
2783,CF,140,140,385,130,425,2784,245,C
2783,BF,1038,718,1103,90,1153,2784,65,F
2783,BG,1562,844,1947,1545,1970,2784,385,B
2783,CG,1087,243,2190,1220,2373,2784,1103,G
2783,CH,793,550,2740,775,2745,2784,1947,C
2783,DH,1421,871,3611,3780,6153,2784,2190,H
2783,D,1527,656,4267,4230,6975,2784,2740,D
2783,M,1990,1990,6257,1860,8835,2784,4267,M
2783,N,126,126,6383,300,9135,2784,6257,N
2783,O,943,943,7326,1080,10215,2784,6383,O
2783,N,733,733,8059,610,10825,2784,7326,N
2783,O,433,433,8492,900,11725,2784,8059,O
2783,P,673,673,9165,3960,15685,2784,8492,P
2784,AE,91,91,91,113,113,2785,0,E
2784,AF,142,142,233,180,293,2785,91,F
2784,AG,215,215,448,335,628,2785,233,G
2784,AF,626,178,626,656,656,2785,0,A
2784,BF,155,155,781,180,836,2785,626,B
2784,CF,1192,859,1640,1065,1693,2785,448,F
2784,CG,1229,370,2010,1350,2186,2785,781,C
2784,BG,519,149,2159,540,2233,2785,1640,G
2784,BF,144,144,2303,130,2363,2785,2159,F
2784,BG,1301,1301,3604,1200,3563,2785,2303,G
2784,BH,2516,922,4526,2400,4586,2785,2010,B
2784,CH,1372,450,4976,5100,8663,2785,3604,H
2784,C,671,221,5197,650,5236,2785,4526,C
2784,D,1263,1263,6460,1030,6266,2785,5197,D
2784,M,11725,11725,18185,11995,20658,2785,6460,M
2784,N,380,380,18565,180,20838,2785,18185,N
2784,O,989,989,19554,1235,22073,2785,18565,O
2784,P,2081,2081,21635,6680,28753,2785,19554,P
2785,A,456,456,456,388,388,2786,0,A
2785,B,119,119,575,240,628,2786,456,B
2785,C,123,123,698,390,1018,2786,575,C
2785,B,1144,1144,1842,815,1833,2786,698,B
2785,C,477,477,2319,750,2583,2786,1842,C
2785,D,63,63,2382,3960,6543,2786,2319,D
2785,M,79,79,2461,222,6765,2786,2382,M
2785,N,447,447,2908,240,7005,2786,2461,N
2785,O,598,598,3506,695,7700,2786,2908,O
2785,N,517,517,4023,370,8070,2786,3506,N
2785,O,675,675,4698,1620,9690,2786,4023,O
2785,P,192,192,4890,3960,13650,2786,4698,P
2786,AEI,483,483,483,1188,1188,2787,0,A
2786,BEI,1122,639,1122,1405,1405,2787,0,I
2786,BEJ,907,268,1390,240,1428,2787,483,B
2786,CEJ,493,225,1615,240,1645,2787,1122,J
2786,CEK,526,301,1916,809,2237,2787,1390,C
2786,DEK,1943,27,1943,2878,2878,2787,0,E
2786,DFK,171,144,2087,3840,6077,2787,1916,D
2786,FK,485,13,2100,815,2460,2787,1615,K
2786,FL,95,95,2195,3840,6300,2787,2100,L
2786,F,961,709,2904,90,2968,2787,1943,F
2786,G,572,572,3476,905,3873,2787,2904,G
2786,F,1049,1049,4525,710,4583,2787,3476,F
2786,G,864,864,5389,935,5518,2787,4525,G
2786,H,1316,1316,6705,3780,9298,2787,5389,H
2786,M,77,77,6782,242,9540,2787,6705,M
2786,N,525,525,7307,420,9960,2787,6782,N
2786,O,455,455,7762,472,10432,2787,7307,O
2786,P,512,512,8274,393,10825,2787,7762,P
2787,A,104,104,104,742,742,2788,0,A
2787,B,747,747,851,150,892,2788,104,B
2787,C,111,111,962,100,992,2788,851,C
2787,B,575,575,1537,570,1562,2788,962,B
2787,C,695,695,2232,660,2222,2788,1537,C
2787,D,1141,1141,3373,4230,6452,2788,2232,D
2787,M,670,670,4043,756,7208,2788,3373,M
2787,N,265,265,4308,180,7388,2788,4043,N
2787,O,2223,2223,6531,1385,8773,2788,4308,O
2787,N,428,428,6959,1325,10098,2788,6531,N
2787,O,338,338,7297,210,10308,2788,6959,O
2787,P,7748,7748,15045,7080,17388,2788,7297,P
2788,AE,170,170,170,440,440,2789,0,E
2788,AF,410,410,580,90,530,2789,170,F
2788,AG,1029,449,1029,1753,1753,2789,0,A
2788,BG,749,749,1778,90,1843,2789,1029,B
2788,CG,1346,148,1926,1780,2310,2789,580,G
2788,CH,45,45,1971,3780,6090,2789,1926,H
2788,C,924,731,2702,1240,3083,2789,1778,C
2788,D,533,533,3235,3780,6863,2789,2702,D
2788,M,645,645,3880,1192,8055,2789,3235,M
2788,N,594,594,4474,90,8145,2789,3880,N
2788,O,403,403,4877,815,8960,2789,4474,O
2788,P,23160,23160,28037,3780,12740,2789,4877,P
2789,AEI,116,116,116,1239,1239,2790,0,I
2789,AEJ,530,414,530,1082,1082,2790,0,E
2789,AFJ,581,581,1111,90,1172,2790,530,F
2789,AGJ,1306,311,1422,240,1479,2790,116,J
2789,AGK,396,85,1507,800,1972,2790,1111,G
2789,AHK,902,817,2324,1020,2499,2790,1422,K
2789,AHL,999,182,2506,3780,5752,2790,1507,H
2789,AL,213,31,2537,4680,7179,2790,2324,L
2789,A,17388,14851,17388,17335,17335,2790,0,A
2789,B,215,215,17603,300,17635,2790,17388,B
2789,C,825,825,18428,1005,18640,2790,17603,C
2789,D,648,648,19076,1200,19840,2790,18428,D
2789,M,1581,1581,20657,1740,21580,2790,19076,M
2789,N,201,201,20858,90,21670,2790,20657,N
2789,O,638,638,21496,820,22490,2790,20858,O
2789,N,391,391,21887,210,22700,2790,21496,N
2789,O,142,142,22029,585,23285,2790,21887,O
2789,P,4647,4647,26676,3780,27065,2790,22029,P
2790,AEI,282,282,282,581,581,2791,0,E
2790,AFI,428,146,428,789,789,2791,0,A
2790,BFI,379,233,661,90,671,2791,282,F
2790,BGI,694,33,694,1066,1066,2791,0,I
2790,BGJ,383,117,811,90,879,2791,428,B
2790,CGJ,400,283,1094,90,1156,2791,694,J
2790,CGK,570,287,1381,880,1759,2791,811,C
2790,DGK,248,248,1629,3780,5539,2791,1381,D
2790,GK,893,358,1987,1240,2396,2791,1094,K
2790,GL,1373,47,2034,1780,2451,2791,661,G
2790,HL,73,26,2060,3780,6176,2791,1987,L
2790,H,889,863,2923,3780,6231,2791,2034,H
2790,M,3975,3975,6898,4767,10998,2791,2923,M
2790,N,844,844,7742,90,11088,2791,6898,N
2790,O,288,288,8030,720,11808,2791,7742,O
2790,P,189,189,8219,3780,15588,2791,8030,P
2791,AE,112,112,112,667,667,2792,0,E
2791,AF,654,654,766,150,817,2792,112,F
2791,AG,99,99,865,95,912,2792,766,G
2791,AF,631,631,1496,590,1502,2792,865,F
2791,AG,1693,197,1693,2373,2373,2792,0,A
2791,BG,647,450,2143,590,2092,2792,1496,G
2791,BH,1130,680,2823,510,2883,2792,1693,B
2791,CH,622,622,3445,925,3808,2792,2823,C
2791,DH,1236,1236,4681,350,4158,2792,3445,D
2791,H,8923,6385,11066,4230,6322,2792,2143,H
2791,M,653,653,11719,1503,7825,2792,11066,M
2791,N,970,970,12689,180,8005,2792,11719,N
2791,O,1236,1236,13925,950,8955,2792,12689,O
2791,N,301,301,14226,600,9555,2792,13925,N
2791,O,2838,2838,17064,2826,12381,2792,14226,O
2791,P,57,57,17121,384,12765,2792,17064,P
2792,AEI,15,15,15,303,303,2793,0,E
2792,AFI,43,28,43,121,121,2793,0,I
2792,AFJ,155,155,198,135,256,2793,43,J
2792,AFK,366,183,381,135,438,2793,15,F
2792,AGK,209,26,407,295,551,2793,198,K
2792,AGL,127,127,534,5100,5651,2793,407,L
2792,AG,193,40,574,295,733,2793,381,G
2792,AH,623,49,623,563,563,2793,0,A
2792,BH,69,20,643,5100,5833,2793,574,H
2792,B,187,167,810,300,863,2793,623,B
2792,C,148,148,958,265,1128,2793,810,C
2792,B,1130,1130,2088,1015,2143,2793,958,B
2792,C,196,196,2284,295,2438,2793,2088,C
2792,D,50052,50052,52336,5100,7538,2793,2284,D
2792,M,1706,1706,54042,2361,9899,2793,52336,M
2792,N,818,818,54860,180,10079,2793,54042,N
2792,O,512,512,55372,895,10974,2793,54860,O
2792,N,1480,1480,56852,1140,12114,2793,55372,N
2792,O,6421,6421,63273,750,12864,2793,56852,O
2792,P,1,1,63274,1140,14004,2793,63273,P
2793,AE,82,82,82,303,303,2794,0,A
2793,BE,401,401,483,240,543,2794,82,B
2793,CE,489,6,489,1352,1352,2794,0,E
2793,CF,231,225,714,295,838,2794,483,C
2793,DF,1125,900,1614,240,1592,2794,489,F
2793,DG,1475,575,2189,5100,5938,2794,714,D
2793,G,1396,821,3010,1040,2632,2794,1614,G
2793,F,578,578,3588,930,3562,2794,3010,F
2793,G,1412,1412,5000,1560,5122,2794,3588,G
2793,H,193,193,5193,3960,9082,2794,5000,H
2793,M,520,520,5713,1273,10355,2794,5193,M
2793,N,843,843,6556,90,10445,2794,5713,N
2793,O,1033,1033,7589,1385,11830,2794,6556,O
2793,N,640,640,8229,345,12175,2794,7589,N
2793,O,623,623,8852,920,13095,2794,8229,O
2793,P,1184,1184,10036,3780,16875,2794,8852,P
2794,AEI,2,2,2,128,128,2795,0,E
2794,AFI,21,19,21,515,515,2795,0,A
2794,BFI,323,304,325,240,368,2795,2,F
2794,BGI,404,79,404,784,784,2795,0,I
2794,BGJ,758,375,779,300,815,2795,21,B
2794,CGJ,527,73,852,780,1148,2795,325,G
2794,CHJ,102,102,954,3960,5108,2795,852,H
2794,CJ,621,71,1025,240,1024,2795,404,J
2794,CK,600,354,1379,815,1630,2795,779,C
2794,DK,476,122,1501,785,1809,2795,1025,K
2794,DL,699,577,2078,3960,5590,2795,1379,D
2794,L,983,406,2484,3960,5769,2795,1501,L
2794,M,4573,4573,7057,4704,10473,2795,2484,M
2794,N,423,423,7480,300,10773,2795,7057,N
2794,O,837,837,8317,1910,12683,2795,7480,O
2794,P,5486,5486,13803,3180,15863,2795,8317,P
2795,AE,880,880,880,1199,1199,2796,0,A
2795,BE,1270,390,1270,1220,1220,2796,0,E
2795,BF,460,70,1340,180,1379,2796,880,B
2795,BF,70,0,1340,180,1400,2796,1270,F
2795,CG,260,260,1600,335,1735,2796,1340,G
2795,CF,602,342,1942,560,1939,2796,1340,C
2795,DF,824,824,2766,4140,6079,2796,1942,D
2795,F,1177,11,2777,1065,2800,2796,1600,F
2795,G,620,620,3397,610,3410,2796,2777,G
2795,H,2276,2276,5673,5160,8570,2796,3397,H
2795,M,1324,1324,6997,1575,10145,2796,5673,M
2795,N,452,452,7449,240,10385,2796,6997,N
2795,O,389,389,7838,695,11080,2796,7449,O
2795,N,787,787,8625,370,11450,2796,7838,N
2795,O,898,898,9523,1620,13070,2796,8625,O
2795,P,1528,1528,11051,3960,17030,2796,9523,P
2796,AE,770,770,770,1115,1115,2797,0,A
2796,BE,860,90,860,1160,1160,2797,0,E
2796,BF,388,298,1158,90,1205,2797,770,B
2796,CF,335,37,1195,90,1250,2797,860,F
2796,CG,904,867,2062,1250,2455,2797,1158,C
2796,DG,58,58,2120,3780,6235,2797,2062,D
2796,G,985,60,2180,1250,2500,2797,1195,G
2796,H,17,17,2197,3780,6280,2797,2180,H
2796,M,2861,2861,5058,3052,9332,2797,2197,M
2796,N,230,230,5288,90,9422,2797,5058,N
2796,O,416,416,5704,815,10237,2797,5288,O
2796,P,1005,1005,6709,3780,14017,2797,5704,P
2797,A,1125,1125,1125,1605,1605,2798,0,A
2797,B,744,744,1869,300,1905,2798,1125,B
2797,C,803,803,2672,1045,2950,2798,1869,C
2797,D,233,233,2905,1140,4090,2798,2672,D
2797,M,312,312,3217,1636,5726,2798,2905,M
2797,N,2300,2300,5517,90,5816,2798,3217,N
2797,O,1634,1634,7151,1955,7771,2798,5517,O
2797,P,19380,19380,26531,3780,11551,2798,7151,P
2798,AEI,1387,1387,1387,1517,1517,2799,0,I
2798,AEJ,1421,34,1421,25,25,2799,0,E
2798,AFJ,1483,62,1483,1510,1510,2799,0,A
2798,BFJ,150,54,1537,120,1637,2799,1387,J
2798,BFK,216,216,1753,390,2027,2799,1537,K
2798,BFJ,287,17,1770,300,1810,2799,1483,B
2798,CFJ,431,82,1852,300,325,2799,1421,F
2798,CGJ,670,571,2423,455,2482,2799,1753,J
2798,CGK,715,62,2485,840,2650,2799,1770,C
2798,DGK,757,124,2609,1240,1565,2799,1852,G
2798,DHK,647,461,3070,665,3147,2799,2423,K
2798,DHL,666,205,3275,3480,5045,2799,2609,H
2798,DL,1163,958,4233,5370,8517,2799,3070,L
2798,D,2995,1247,5480,1140,3790,2799,2485,D
2798,M,277,277,5757,1455,9972,2799,5480,M
2798,N,1438,1438,7195,300,10272,2799,5757,N
2798,O,395,395,7590,865,11137,2799,7195,O
2798,N,576,576,8166,95,11232,2799,7590,N
2798,O,508,508,8674,1230,12462,2799,8166,O
2798,P,826,826,9500,1920,14382,2799,8674,P
2799,A,1277,1277,1277,1545,1545,2800,0,A
2799,B,332,332,1609,90,1635,2800,1277,B
2799,C,469,469,2078,860,2495,2800,1609,C
2799,D,509,509,2587,3780,6275,2800,2078,D
2799,M,656,656,3243,1131,7406,2800,2587,M
2799,N,506,506,3749,90,7496,2800,3243,N
2799,O,187,187,3936,585,8081,2800,3749,O
2799,P,16157,16157,20093,3780,11861,2800,3936,P
2800,A,72,72,72,623,623,2801,0,A
2800,B,746,746,818,240,863,2801,72,B
2800,C,733,733,1551,825,1688,2801,818,C
2800,D,156,156,1707,3960,5648,2801,1551,D
2800,M,256,256,1963,260,5908,2801,1707,M
2800,N,421,421,2384,300,6208,2801,1963,N
2800,O,593,593,2977,665,6873,2801,2384,O
2800,P,1,1,2978,2580,9453,2801,2977,P
2801,AEI,24,24,24,453,453,2802,0,E
2801,AFI,111,87,111,68,68,2802,0,A
2801,BFI,186,186,297,240,308,2802,111,B
2801,CFI,123,123,420,380,688,2802,297,C
2801,BFI,470,50,470,417,417,2802,0,I
2801,BFJ,661,215,685,240,693,2802,24,F
2801,BGJ,224,9,694,240,657,2802,470,J
2801,BGK,81,81,775,390,1047,2802,694,K
2801,BGJ,682,327,1102,460,1148,2802,420,B
2801,CGJ,515,98,1200,790,1483,2802,685,G
2801,CHJ,108,108,1308,3960,5443,2802,1200,H
2801,CJ,526,320,1628,790,1938,2802,1102,C
2801,DJ,940,87,1715,700,1747,2802,775,J
2801,DK,520,520,2235,785,2532,2802,1715,K
2801,DL,1319,712,2947,3960,5898,2802,1628,D
2801,L,1019,307,3254,3960,6492,2802,2235,L
2801,M,3161,3161,6415,3175,9667,2802,3254,M
2801,N,594,594,7009,610,10277,2802,6415,N
2801,O,292,292,7301,435,10712,2802,7009,O
2801,N,1349,1349,8650,1220,11932,2802,7301,N
2801,O,360,360,9010,1635,13567,2802,8650,O
2801,P,14137,14137,23147,2745,16312,2802,9010,P
2802,AE,149,149,149,434,434,2803,0,A
2802,BE,317,168,317,2224,2224,2803,0,E
2802,BF,617,449,766,360,794,2803,149,B
2802,CF,587,587,1353,725,1519,2803,766,C
2802,DF,1987,951,2304,90,2314,2803,317,F
2802,DG,1016,65,2369,1140,2659,2803,1353,D
2802,G,1422,1357,3726,1935,4249,2803,2304,G
2802,H,2740,2740,6466,3780,8029,2803,3726,H
2802,M,432,432,6898,1802,9831,2803,6466,M
2802,N,1510,1510,8408,90,9921,2803,6898,N
2802,O,1331,1331,9739,1780,11701,2803,8408,O
2802,P,169,169,9908,3780,15481,2803,9739,P
2803,A,15022,15022,15022,15866,15866,2804,0,A
2803,B,872,872,15894,90,15956,2804,15022,B
2803,C,1177,1177,17071,1340,17296,2804,15894,C
2803,D,368,368,17439,3780,21076,2804,17071,D
2803,M,2559,2559,19998,2763,23839,2804,17439,M
2803,N,236,236,20234,90,23929,2804,19998,N
2803,O,936,936,21170,1080,25009,2804,20234,O
2803,P,261,261,21431,3780,28789,2804,21170,P
2804,AE,147,147,147,444,444,2805,0,A
2804,BE,362,362,509,90,534,2805,147,B
2804,CE,970,461,970,1191,1191,2805,0,E
2804,CF,253,253,1223,90,1281,2805,970,F
2804,CG,1398,684,1907,1745,2279,2805,509,C
2804,DG,29,29,1936,3780,6059,2805,1907,D
2804,G,884,171,2107,1250,2531,2805,1223,G
2804,H,149,149,2256,3780,6311,2805,2107,H
2804,M,160,160,2416,1601,7912,2805,2256,M
2804,N,1483,1483,3899,90,8002,2805,2416,N
2804,O,723,723,4622,1155,9157,2805,3899,O
2804,P,60,60,4682,3780,12937,2805,4622,P
2805,AEI,20,20,20,82,82,2806,0,E
2805,AFI,145,125,145,163,163,2806,0,A
2805,BFI,78,78,223,120,283,2806,145,B
2805,CFI,263,60,283,240,322,2806,20,F
2805,CGI,132,72,355,120,403,2806,223,C
2805,BGI,159,87,442,218,540,2806,283,G
2805,BHI,657,570,1012,670,1073,2806,355,B
2805,CHI,603,33,1045,682,1222,2806,442,H
2805,CI,167,134,1179,260,1333,2806,1012,C
2805,DI,93,93,1272,5100,6433,2806,1179,D
2805,I,1510,238,1510,1445,1445,2806,0,I
2805,J,111,111,1621,240,1685,2806,1510,J
2805,K,153,153,1774,265,1950,2806,1621,K
2805,J,526,526,2300,410,2360,2806,1774,J
2805,K,206,206,2506,260,2620,2806,2300,K
2805,L,1312,1312,3818,5100,7720,2806,2506,L
2805,M,338,338,4156,410,8130,2806,3818,M
2805,N,177,177,4333,160,8290,2806,4156,N
2805,O,107,107,4440,75,8365,2806,4333,O
2805,N,922,922,5362,945,9310,2806,4440,N
2805,O,689,689,6051,505,9815,2806,5362,O
2805,P,5421,5421,11472,6000,15815,2806,6051,P
2806,AEI,194,194,194,1680,1680,2807,0,E
2806,AFI,246,52,246,1242,1242,2807,0,I
2806,AFJ,645,593,839,90,1770,2807,194,F
2806,AGJ,237,237,1076,575,2345,2807,839,G
2806,AHJ,1163,87,1163,1273,1273,2807,0,A
2806,BHJ,1026,109,1272,90,1332,2807,246,J
2806,BHK,144,35,1307,90,1363,2807,1163,B
2806,CHK,785,785,2092,1130,2493,2807,1307,C
2806,DHK,997,177,2269,1240,2572,2807,1272,K
2806,DHL,688,511,2780,3780,6273,2807,2092,D
2806,HL,2054,350,3130,3780,6125,2807,1076,H
2806,L,2870,2009,5139,3780,6352,2807,2269,L
2806,M,241,241,5380,492,6844,2807,5139,M
2806,N,325,325,5705,90,6934,2807,5380,N
2806,O,1354,1354,7059,1865,8799,2807,5705,O
2806,P,1422,1422,8481,3780,12579,2807,7059,P
2807,A,246,246,246,400,400,2808,0,A
2807,B,159,159,405,150,550,2808,246,B
2807,C,64,64,469,690,1240,2808,405,C
2807,B,1406,1406,1875,695,1935,2808,469,B
2807,C,916,916,2791,835,2770,2808,1875,C
2807,D,2955,2955,5746,4020,6790,2808,2791,D
2807,M,1069,1069,6815,1478,8268,2808,5746,M
2807,N,656,656,7471,315,8583,2808,6815,N
2807,O,930,930,8401,705,9288,2808,7471,O
2807,N,80,80,8481,60,9348,2808,8401,N
2807,O,174,174,8655,300,9648,2808,8481,O
2807,P,1306,1306,9961,2705,12353,2808,8655,P
2808,A,9796,9796,9796,9687,9687,2809,0,A
2808,B,626,626,10422,804,10491,2809,9796,B
2808,C,1407,1407,11829,1175,11666,2809,10422,C
2808,D,667,667,12496,680,12346,2809,11829,D
2808,M,1390,1390,13886,2387,14733,2809,12496,M
2808,N,1267,1267,15153,300,15033,2809,13886,N
2808,O,702,702,15855,970,16003,2809,15153,O
2808,N,512,512,16367,350,16353,2809,15855,N
2808,O,233,233,16600,390,16743,2809,16367,O
2808,P,413,413,17013,3960,20703,2809,16600,P
2809,A,14510,14510,14510,14854,14854,2810,0,A
2809,B,633,633,15143,300,15154,2810,14510,B
2809,C,589,589,15732,735,15889,2810,15143,C
2809,D,102,102,15834,1560,17449,2810,15732,D
2809,M,1505,1505,17339,1720,19169,2810,15834,M
2809,N,491,491,17830,300,19469,2810,17339,N
2809,O,784,784,18614,855,20324,2810,17830,O
2809,N,251,251,18865,200,20524,2810,18614,N
2809,O,249,249,19114,410,20934,2810,18865,O
2809,P,825,825,19939,2070,23004,2810,19114,P
2810,AE,19,19,19,21,21,2811,0,A
2810,BE,27,8,27,51,51,2811,0,E
2810,BF,76,68,95,135,156,2811,19,B
2810,CF,218,150,245,240,291,2811,27,F
2810,CG,202,52,297,280,436,2811,95,C
2810,DG,193,141,438,285,576,2811,245,G
2810,DH,1168,1027,1465,5160,5596,2811,297,D
2810,H,2177,1150,2615,5160,5736,2811,438,H
2810,M,2218,2218,4833,2900,8636,2811,2615,M
2810,N,952,952,5785,300,8936,2811,4833,N
2810,O,652,652,6437,900,9836,2811,5785,O
2810,P,921,921,7358,3960,13796,2811,6437,P
2811,AE,86,86,86,700,700,2812,0,A
2811,BE,635,549,635,930,930,2812,0,E
2811,BF,704,155,790,150,850,2812,86,B
2811,CF,442,287,1077,180,1110,2812,635,F
2811,CG,519,232,1309,500,1350,2812,790,C
2811,DG,358,358,1667,385,1735,2812,1309,D
2811,G,913,323,1990,930,2040,2812,1077,G
2811,H,1265,1265,3255,550,2590,2812,1990,H
2811,M,33,33,3288,239,2829,2812,3255,M
2811,N,566,566,3854,420,3249,2812,3288,N
2811,O,469,469,4323,790,4039,2812,3854,O
2811,P,1651,1651,5974,1315,5354,2812,4323,P
2812,AEI,253,253,253,456,456,2813,0,A
2812,BEI,292,292,545,150,606,2813,253,B
2812,CEI,794,794,1339,920,1526,2813,545,C
2812,DEI,1064,1064,2403,1175,2701,2813,1339,D
2812,EI,3190,787,3190,3535,3535,2813,0,E
2812,FI,450,450,3640,180,3715,2813,3190,F
2812,GI,1047,1047,4687,1240,4955,2813,3640,G
2812,FI,2005,2005,6692,1715,6670,2813,4687,F
2812,GI,674,674,7366,725,7395,2813,6692,G
2812,HI,1049,1049,8415,1140,8535,2813,7366,H
2812,I,8471,56,8471,8653,8653,2813,0,I
2812,J,272,272,8743,120,8773,2813,8471,J
2812,K,688,688,9431,810,9583,2813,8743,K
2812,L,388,388,9819,5040,14623,2813,9431,L
2812,M,533,533,10352,3362,17985,2813,9819,M
2812,N,2964,2964,13316,195,18180,2813,10352,N
2812,O,748,748,14064,670,18850,2813,13316,O
2812,N,3112,3112,17176,3170,22020,2813,14064,N
2812,O,1351,1351,18527,602,22622,2813,17176,O
2812,P,1530,1530,20057,1263,23885,2813,18527,P
2813,AEI,365,365,365,1806,1806,2814,0,A
2813,BEI,752,387,752,1212,1212,2814,0,I
2813,BEJ,495,495,1247,90,1302,2814,752,J
2813,BEK,1686,804,2051,90,1896,2814,365,B
2813,CEK,940,136,2187,1250,2552,2814,1247,K
2813,CEL,2,2,2189,3780,6332,2814,2187,L
2813,CE,2933,744,2933,4158,4158,2814,0,E
2813,CF,1294,412,3345,1360,3256,2814,2051,C
2813,DF,265,265,3610,3780,7036,2814,3345,D
2813,F,1256,579,4189,90,4248,2814,2933,F
2813,G,1015,1015,5204,1225,5473,2814,4189,G
2813,H,16,16,5220,3780,9253,2814,5204,H
2813,M,909,909,6129,1310,10563,2814,5220,M
2813,N,436,436,6565,90,10653,2814,6129,N
2813,O,204,204,6769,605,11258,2814,6565,O
2813,P,3094,3094,9863,3780,15038,2814,6769,P
2814,A,156,156,156,325,325,2815,0,A
2814,B,319,319,475,180,505,2815,156,B
2814,C,351,351,826,660,1165,2815,475,C
2814,D,3187,3187,4013,3960,5125,2815,826,D
2814,M,1002,1002,5015,1034,6159,2815,4013,M
2814,N,135,135,5150,150,6309,2815,5015,N
2814,O,400,400,5550,255,6564,2815,5150,O
2814,P,100,100,5650,2880,9444,2815,5550,P
2815,AE,2721,2721,2721,3120,3120,2816,0,A
2815,BE,504,504,3225,270,3390,2816,2721,B
2815,CE,4476,1251,4476,4640,4640,2816,0,E
2815,CF,154,154,4630,120,4760,2816,4476,F
2815,CG,53,53,4683,120,4880,2816,4630,G
2815,CF,307,307,4990,165,5045,2816,4683,F
2815,CG,688,688,5678,810,5855,2816,4990,G
2815,CH,118,118,5796,5040,10895,2816,5678,H
2815,C,2967,396,6192,3030,6420,2816,3225,C
2815,B,2102,2102,8294,1915,8335,2816,6192,B
2815,C,773,773,9067,1329,9664,2816,8294,C
2815,D,969,969,10036,621,10285,2816,9067,D
2815,M,1739,1739,11775,1797,12692,2816,10036,M
2815,N,256,256,12031,240,12932,2816,11775,N
2815,O,850,850,12881,970,13902,2816,12031,O
2815,N,4140,4140,17021,4010,17912,2816,12881,N
2815,O,6402,6402,23423,925,18837,2816,17021,O
2815,P,3730,3730,27153,3960,22797,2816,23423,P
2816,A,699,699,699,1350,1350,2817,0,A
2816,B,921,921,1620,300,1650,2817,699,B
2816,C,363,363,1983,830,2480,2817,1620,C
2816,B,766,766,2749,320,2800,2817,1983,B
2816,C,327,327,3076,1530,4330,2817,2749,C
2816,D,1142,1142,4218,2700,7030,2817,3076,D
2816,M,1140,1140,5358,1246,8276,2817,4218,M
2816,N,211,211,5569,150,8426,2817,5358,N
2816,O,145,145,5714,130,8556,2817,5569,O
2816,P,1827,1827,7541,550,9106,2817,5714,P
2817,AE,102,102,102,330,330,2818,0,A
2817,BE,239,137,239,318,318,2818,0,E
2817,BF,269,269,508,180,498,2818,239,F
2817,BG,407,1,509,245,575,2818,102,B
2817,CG,260,259,768,660,1158,2818,508,G
2817,CH,277,277,1045,3960,5118,2818,768,H
2817,C,573,37,1082,525,1100,2818,509,C
2817,D,129,129,1211,2880,3980,2818,1082,D
2817,M,4192,4192,5403,4929,10047,2818,1211,M
2817,N,962,962,6365,90,10137,2818,5403,N
2817,O,1018,1018,7383,1360,11497,2818,6365,O
2817,N,2300,2300,9683,2150,13647,2818,7383,N
2817,O,428,428,10111,815,14462,2818,9683,O
2817,P,1059,1059,11170,3780,18242,2818,10111,P
2818,AE,77,77,77,191,191,2819,0,E
2818,AF,109,32,109,914,914,2819,0,A
2818,BF,297,265,374,240,431,2819,77,F
2818,BG,222,222,596,285,716,2819,374,G
2818,BH,837,350,946,90,1004,2819,109,B
2818,CH,1006,1006,1952,1330,2334,2819,946,C
2818,DH,1468,112,2064,5160,5876,2819,596,H
2818,D,8122,8010,10074,3780,6114,2819,1952,D
2818,M,24,24,10098,58,6172,2819,10074,M
2818,N,174,174,10272,180,6352,2819,10098,N
2818,O,172,172,10444,150,6502,2819,10272,O
2818,P,78,78,10522,385,6887,2819,10444,P
2819,AEI,816,816,816,1109,1109,2820,0,E
2819,AFI,353,353,1169,90,1199,2820,816,F
2819,AGI,922,922,2091,1250,2449,2820,1169,G
2819,AHI,14,14,2105,3780,6229,2820,2091,H
2819,AI,2467,362,2467,2726,2726,2820,0,A
2819,BI,289,289,2756,90,2816,2820,2467,B
2819,CI,919,919,3675,1105,3921,2820,2756,C
2819,DI,1936,1936,5611,3780,7701,2820,3675,D
2819,I,19199,13588,19199,19492,19492,2820,0,I
2819,J,321,321,19520,90,19582,2820,19199,J
2819,K,730,730,20250,1130,20712,2820,19520,K
2819,L,363,363,20613,3780,24492,2820,20250,L
2819,M,120,120,20733,732,25224,2820,20613,M
2819,N,637,637,21370,90,25314,2820,20733,N
2819,O,163,163,21533,585,25899,2820,21370,O
2819,P,4739,4739,26272,3780,29679,2820,21533,P
2820,AE,932,932,932,2658,2658,2821,0,A
2820,BE,1882,950,1882,2156,2156,2821,0,E
2820,BF,291,291,2173,90,2246,2821,1882,F
2820,BG,513,513,2686,880,3126,2821,2173,G
2820,BH,1799,45,2731,90,2748,2821,932,B
2820,CH,227,182,2913,3840,6966,2821,2686,H
2820,C,992,810,3723,1250,3998,2821,2731,C
2820,D,1406,1406,5129,3780,7778,2821,3723,D
2820,M,472,472,5601,1147,8925,2821,5129,M
2820,N,734,734,6335,90,9015,2821,5601,N
2820,O,752,752,7087,1060,10075,2821,6335,O
2820,P,252,252,7339,3780,13855,2821,7087,P
2821,A,799,799,799,1233,1233,2822,0,A
2821,B,495,495,1294,90,1323,2822,799,B
2821,C,945,945,2239,1250,2573,2822,1294,C
2821,D,2,2,2241,3780,6353,2822,2239,D
2821,M,556,556,2797,1415,7768,2822,2241,M
2821,N,898,898,3695,90,7858,2822,2797,N
2821,O,469,469,4164,860,8718,2822,3695,O
2821,P,1149,1149,5313,3780,12498,2822,4164,P
2822,AEI,47,47,47,2645,2645,2823,0,E
2822,AFI,338,291,338,1024,1024,2823,0,A
2822,BFI,711,373,711,1269,1269,2823,0,I
2822,BFJ,725,352,1063,90,1114,2823,338,B
2822,CFJ,652,300,1363,90,1359,2823,711,J
2822,CFK,511,211,1574,860,1974,2823,1063,C
2822,DFK,154,154,1728,3780,5754,2823,1574,D
2822,FK,1181,816,2544,1380,2739,2823,1363,K
2822,FJ,2718,221,2765,165,2810,2823,47,F
2822,GJ,616,395,3160,475,3214,2823,2544,J
2822,GK,832,437,3597,1035,3845,2823,2765,G
2822,HK,519,82,3679,860,4074,2823,3160,K
2822,HL,30,30,3709,3780,7854,2823,3679,L
2822,H,179,67,3776,3960,7805,2823,3597,H
2822,M,2878,2878,6654,3752,11606,2823,3776,M
2822,N,939,939,7593,90,11696,2823,6654,N
2822,O,499,499,8092,855,12551,2823,7593,O
2822,N,1202,1202,9294,880,13431,2823,8092,N
2822,O,651,651,9945,915,14346,2823,9294,O
2822,P,1021,1021,10966,3780,18126,2823,9945,P
2823,AEI,18,18,18,203,203,2824,0,E
2823,AFI,256,256,274,130,333,2824,18,F
2823,AGI,276,2,276,567,567,2824,0,A
2823,BGI,392,392,668,150,717,2824,276,B
2823,CGI,1094,700,1368,1115,1448,2824,274,G
2823,CFI,835,135,1503,2169,2886,2824,668,C
2823,DFI,814,679,2182,785,2233,2824,1368,F
2823,DGI,939,260,2442,1881,4767,2824,1503,D
2823,GI,1014,754,3196,2034,4267,2824,2182,G
2823,HI,573,573,3769,891,5158,2824,3196,H
2823,I,15130,11361,15130,18601,18601,2824,0,I
2823,J,3872,3872,19002,420,19021,2824,15130,J
2823,K,767,767,19769,2049,21070,2824,19002,K
2823,L,1074,1074,20843,846,21916,2824,19769,L
2823,M,1729,1729,22572,1606,23522,2824,20843,M
2823,N,793,793,23365,780,24302,2824,22572,N
2823,O,891,891,24256,1255,25557,2824,23365,O
2823,N,2775,2775,27031,2635,28192,2824,24256,N
2823,O,441,441,27472,570,28762,2824,27031,O
2823,P,153,153,27625,350,29112,2824,27472,P
2824,AE,238,238,238,185,185,2825,0,E
2824,AF,12,12,250,120,305,2825,238,F
2824,AG,2276,2276,2526,225,530,2825,250,G
2824,AF,226,226,2752,2265,2795,2825,2526,F
2824,AG,607,607,3359,635,3430,2825,2752,G
2824,AH,3265,3265,6624,2880,6310,2825,3359,H
2824,A,7723,1099,7723,8634,8634,2825,0,A
2824,B,1050,1050,8773,180,8814,2825,7723,B
2824,C,697,697,9470,762,9576,2825,8773,C
2824,D,239,239,9709,4080,13656,2825,9470,D
2824,M,11842,11842,21551,12660,26316,2825,9709,M
2824,N,1073,1073,22624,300,26616,2825,21551,N
2824,O,1017,1017,23641,910,27526,2825,22624,O
2824,P,2563,2563,26204,2760,30286,2825,23641,P
2825,AEI,18,18,18,142,142,2826,0,I
2825,AEJ,207,189,207,275,275,2826,0,E
2825,AFJ,316,127,334,240,382,2826,18,J
2825,AFK,399,65,399,1398,1398,2826,0,A
2825,BFK,267,75,474,240,515,2826,207,F
2825,BGK,872,732,1206,1045,1427,2826,334,K
2825,BGL,833,101,1307,1035,1550,2826,474,G
2825,BHL,1036,128,1435,90,1488,2826,399,B
2825,CHL,625,396,1831,3960,5387,2826,1206,L
2825,CH,610,86,1917,3960,5510,2826,1307,H
2825,C,1009,527,2444,1220,2708,2826,1435,C
2825,D,3,3,2447,3780,6488,2826,2444,D
2825,M,681,681,3128,1335,7823,2826,2447,M
2825,N,687,687,3815,90,7913,2826,3128,N
2825,O,249,249,4064,695,8608,2826,3815,O
2825,P,4824,4824,8888,3780,12388,2826,4064,P
2826,AE,108,108,108,679,679,2827,0,E
2826,AF,750,750,858,240,919,2827,108,F
2826,AG,201,201,1059,260,1179,2827,858,G
2826,AH,262,262,1321,5160,6339,2827,1059,H
2826,A,2597,1276,2597,2964,2964,2827,0,A
2826,B,744,744,3341,420,3384,2827,2597,B
2826,C,746,746,4087,955,4339,2827,3341,C
2826,B,531,531,4618,325,4664,2827,4087,B
2826,C,193,193,4811,265,4929,2827,4618,C
2826,D,4440,4440,9251,5160,10089,2827,4811,D
2826,M,345,345,9596,1359,11448,2827,9251,M
2826,N,1098,1098,10694,155,11603,2827,9596,N
2826,O,624,624,11318,640,12243,2827,10694,O
2826,P,10467,10467,21785,2880,15123,2827,11318,P
2827,AEI,390,390,390,634,634,2828,0,A
2827,BEI,472,82,472,2927,2927,2828,0,I
2827,BEJ,275,193,665,90,724,2828,390,B
2827,CEJ,508,508,1173,825,1549,2828,665,C
2827,BEJ,662,662,1835,335,1884,2828,1173,B
2827,CEJ,1944,109,1944,2916,2916,2828,0,E
2827,CFJ,705,596,2540,1080,2964,2828,1835,C
2827,DFJ,1002,406,2946,90,3006,2828,1944,F
2827,DGJ,2485,11,2957,90,3017,2828,472,J
2827,DGK,860,443,3400,3780,6744,2828,2540,D
2827,GK,575,121,3521,905,3911,2828,2946,G
2827,FK,593,29,3550,905,3922,2828,2957,K
2827,FJ,777,777,4327,465,4387,2828,3550,J
2827,FK,1547,741,5068,1210,5121,2828,3521,F
2827,GK,769,28,5096,1080,5467,2828,4327,K
2827,GL,235,235,5331,3780,9247,2828,5096,L
2827,G,749,486,5817,1080,6201,2828,5068,G
2827,H,826,826,6643,3780,9981,2828,5817,H
2827,M,12889,12889,19532,13019,23000,2828,6643,M
2827,N,179,179,19711,90,23090,2828,19532,N
2827,O,660,660,20371,1130,24220,2828,19711,O
2827,N,1701,1701,22072,1230,25450,2828,20371,N
2827,O,1108,1108,23180,1405,26855,2828,22072,O
2827,P,5370,5370,28550,3780,30635,2828,23180,P
2828,A,57,57,57,91,91,2829,0,A
2828,B,119,119,176,135,226,2829,57,B
2828,C,227,227,403,295,521,2829,176,C
2828,D,169,169,572,5160,5681,2829,403,D
2828,M,1472,1472,2044,2125,7806,2829,572,M
2828,N,746,746,2790,150,7956,2829,2044,N
2828,O,76,76,2866,100,8056,2829,2790,O
2828,N,408,408,3274,390,8446,2829,2866,N
2828,O,153,153,3427,225,8671,2829,3274,O
2828,P,1014,1014,4441,4740,13411,2829,3427,P
2829,A,1152,1152,1152,1268,1268,2830,0,A
2829,B,1362,1362,2514,210,1478,2830,1152,B
2829,C,200,200,2714,530,2008,2830,2514,C
2829,D,113,113,2827,1350,3358,2830,2714,D
2829,M,2065,2065,4892,2289,5647,2830,2827,M
2829,N,282,282,5174,90,5737,2830,4892,N
2829,O,516,516,5690,795,6532,2830,5174,O
2829,N,1991,1991,7681,1740,8272,2830,5690,N
2829,O,710,710,8391,890,9162,2830,7681,O
2829,P,53166,53166,61557,3780,12942,2830,8391,P
2830,A,301,301,301,1528,1528,2831,0,A
2830,B,1257,1257,1558,90,1618,2831,301,B
2830,C,932,932,2490,1230,2848,2831,1558,C
2830,D,61,61,2551,3780,6628,2831,2490,D
2830,M,412,412,2963,1053,7681,2831,2551,M
2830,N,685,685,3648,90,7771,2831,2963,N
2830,O,117,117,3765,585,8356,2831,3648,O
2830,P,4277,4277,8042,3780,12136,2831,3765,P
2831,AEI,121,121,121,292,292,2832,0,I
2831,AEJ,219,98,219,1718,1718,2832,0,E
2831,AFJ,338,240,459,180,472,2832,121,J
2831,AFK,593,593,1052,683,1155,2832,459,K
2831,AFL,1470,418,1470,1825,1825,2832,0,A
2831,BFL,1662,411,1881,240,1958,2832,219,F
2831,BGL,523,112,1993,230,2055,2832,1470,B
2831,CGL,619,619,2612,575,2630,2832,1993,C
2831,DGL,1148,417,3029,1105,3063,2832,1881,G
2831,DHL,3193,3193,6222,550,3613,2832,3029,H
2831,DL,4259,649,6871,385,3015,2832,2612,D
2831,L,9799,3980,10851,4080,5235,2832,1052,L
2831,M,181,181,11032,343,5578,2832,10851,M
2831,N,374,374,11406,270,5848,2832,11032,N
2831,O,958,958,12364,1100,6948,2832,11406,O
2831,P,6965,6965,19329,695,7643,2832,12364,P
2832,A,132,132,132,316,316,2833,0,A
2832,B,336,336,468,210,526,2833,132,B
2832,C,126,126,594,255,781,2833,468,C
2832,B,969,969,1563,810,1591,2833,594,B
2832,C,869,869,2432,890,2481,2833,1563,C
2832,D,3249,3249,5681,5160,7641,2833,2432,D
2832,M,155,155,5836,1106,8747,2833,5681,M
2832,N,1071,1071,6907,180,8927,2833,5836,N
2832,O,999,999,7906,1050,9977,2833,6907,O
2832,N,1616,1616,9522,1550,11527,2833,7906,N
2832,O,693,693,10215,845,12372,2833,9522,O
2832,P,3269,3269,13484,5220,17592,2833,10215,P
2833,AEI,43,43,43,420,420,2834,0,A
2833,BEI,45,2,45,124,124,2834,0,E
2833,BFI,49,4,49,254,254,2834,0,I
2833,BFJ,381,381,430,165,419,2834,49,J
2833,BFK,497,110,540,165,585,2834,43,B
2833,CFK,608,498,1038,910,1329,2834,430,K
2833,CFL,110,110,1148,3960,5289,2834,1038,L
2833,CF,1011,403,1551,1275,1860,2834,540,C
2833,DF,1844,338,1889,165,289,2834,45,F
2833,DG,1059,721,2610,3960,5820,2834,1551,D
2833,G,820,99,2709,895,1184,2834,1889,G
2833,H,1052,1052,3761,3960,5144,2834,2709,H
2833,M,496,496,4257,1255,7075,2834,3761,M
2833,N,804,804,5061,90,7165,2834,4257,N
2833,O,502,502,5563,855,8020,2834,5061,O
2833,P,570,570,6133,3780,11800,2834,5563,P
2834,A,45,45,45,610,610,2835,0,A
2834,B,664,664,709,150,760,2835,45,B
2834,C,129,129,838,110,870,2835,709,C
2834,B,272,272,1110,280,1150,2835,838,B
2834,C,502,502,1612,540,1690,2835,1110,C
2834,D,2679,2679,4291,4230,5920,2835,1612,D
2834,M,1475,1475,5766,1535,7455,2835,4291,M
2834,N,299,299,6065,300,7755,2835,5766,N
2834,O,528,528,6593,720,8475,2835,6065,O
2834,P,1958,1958,8551,4020,12495,2835,6593,P
2835,A,75,75,75,334,334,2836,0,A
2835,B,469,469,544,240,574,2836,75,B
2835,C,763,763,1307,765,1339,2836,544,C
2835,D,116,116,1423,4230,5569,2836,1307,D
2835,M,4029,4029,5452,4683,10252,2836,1423,M
2835,N,699,699,6151,90,10342,2836,5452,N
2835,O,579,579,6730,955,11297,2836,6151,O
2835,P,940,940,7670,3780,15077,2836,6730,P
2836,AE,191,191,191,439,439,2837,0,A
2836,BE,432,432,623,240,679,2837,191,B
2836,CE,936,936,1559,1005,1684,2837,623,C
2836,BE,1574,15,1574,1546,1546,2837,0,E
2836,BF,350,350,1924,420,1966,2837,1574,F
2836,BG,566,201,2125,445,2129,2837,1559,B
2836,CG,718,517,2642,675,2641,2837,1924,G
2836,CH,140,140,2782,550,3191,2837,2642,H
2836,C,869,212,2994,810,2939,2837,2125,C
2836,D,238,238,3232,3960,6899,2837,2994,D
2836,M,145,145,3377,349,7248,2837,3232,M
2836,N,343,343,3720,180,7428,2837,3377,N
2836,O,810,810,4530,830,8258,2837,3720,O
2836,P,4386,4386,8916,6680,14938,2837,4530,P
2837,AEI,447,447,447,882,882,2838,0,I
2837,AEJ,986,539,986,1308,1308,2838,0,A
2837,BEJ,818,279,1265,420,1302,2838,447,J
2837,BEK,358,79,1344,90,1398,2838,986,B
2837,CEK,384,384,1728,795,2193,2838,1344,C
2837,DEK,895,432,2160,1250,2552,2838,1265,K
2837,DEL,160,160,2320,335,2887,2838,2160,L
2837,DE,1054,462,2782,3780,5973,2838,1728,D
2837,E,3106,324,3106,3194,3194,2838,0,E
2837,F,298,298,3404,150,3344,2838,3106,F
2837,G,2690,2690,6094,3180,6524,2838,3404,G
2837,F,1253,1253,7347,855,7379,2838,6094,F
2837,G,985,985,8332,1250,8629,2838,7347,G
2837,H,12,12,8344,335,8964,2838,8332,H
2837,M,1906,1906,10250,2384,11348,2838,8344,M
2837,N,604,604,10854,180,11528,2838,10250,N
2837,O,878,878,11732,1180,12708,2838,10854,O
2837,N,1113,1113,12845,820,13528,2838,11732,N
2837,O,3164,3164,16009,590,14118,2838,12845,O
2837,P,1100,1100,17109,3760,17878,2838,16009,P
2838,AE,297,297,297,70,70,2839,0,A
2838,BE,353,56,353,483,483,2839,0,E
2838,BF,96,40,393,610,680,2839,297,B
2838,CF,134,134,527,470,1150,2839,393,C
2838,DF,302,128,655,240,723,2839,353,F
2838,DG,716,716,1371,975,1698,2839,655,G
2838,DF,972,128,1499,2455,3605,2839,527,D
2838,F,900,772,2271,615,2313,2839,1371,F
2838,G,197,197,2468,255,2568,2839,2271,G
2838,H,1377,1377,3845,5160,7728,2839,2468,H
2838,M,1577,1577,5422,1650,9378,2839,3845,M
2838,N,283,283,5705,240,9618,2839,5422,N
2838,O,1430,1430,7135,1440,11058,2839,5705,O
2838,N,3306,3306,10441,3300,14358,2839,7135,N
2838,O,2209,2209,12650,1639,15997,2839,10441,O
2838,P,5,5,12655,1901,17898,2839,12650,P
2839,AEI,160,160,160,1142,1142,2840,0,A
2839,BEI,518,358,518,660,660,2840,0,E
2839,BFI,195,195,713,90,750,2840,518,F
2839,BGI,1017,464,1177,90,1232,2840,160,B
2839,CGI,843,379,1556,820,1570,2840,713,G
2839,CHI,839,460,2016,1200,2432,2840,1177,C
2839,DHI,193,193,2209,3840,6272,2840,2016,D
2839,HI,1026,373,2582,3780,5350,2840,1556,H
2839,I,2825,243,2825,4063,4063,2840,0,I
2839,J,1274,1274,4099,90,4153,2840,2825,J
2839,K,951,951,5050,1225,5378,2840,4099,K
2839,L,16,16,5066,3780,9158,2840,5050,L
2839,M,583,583,5649,1230,10388,2840,5066,M
2839,N,678,678,6327,90,10478,2840,5649,N
2839,O,178,178,6505,585,11063,2840,6327,O
2839,P,7389,7389,13894,3780,14843,2840,6505,P
2840,A,198,198,198,239,239,2841,0,A
2840,B,258,258,456,240,479,2841,198,B
2840,C,824,824,1280,1045,1524,2841,456,C
2840,D,624,624,1904,3960,5484,2841,1280,D
2840,M,670,670,2574,858,6342,2841,1904,M
2840,N,298,298,2872,150,6492,2841,2574,N
2840,O,930,930,3802,1110,7602,2841,2872,O
2840,N,304,304,4106,105,7707,2841,3802,N
2840,O,816,816,4922,735,8442,2841,4106,O
2840,P,1446,1446,6368,4230,12672,2841,4922,P
2841,A,303,303,303,883,883,2842,0,A
2841,B,682,682,985,150,1033,2842,303,B
2841,C,234,234,1219,140,1173,2842,985,C
2841,B,534,534,1753,535,1708,2842,1219,B
2841,C,533,533,2286,635,2343,2842,1753,C
2841,D,346,346,2632,4230,6573,2842,2286,D
2841,M,1996,1996,4628,2750,9323,2842,2632,M
2841,N,830,830,5458,90,9413,2842,4628,N
2841,O,512,512,5970,885,10298,2842,5458,O
2841,N,1183,1183,7153,850,11148,2842,5970,N
2841,O,697,697,7850,935,12083,2842,7153,O
2841,P,998,998,8848,3780,15863,2842,7850,P
2842,AEI,152,152,152,1250,1250,2843,0,I
2842,AEJ,190,38,190,926,926,2843,0,A
2842,BEJ,832,832,1022,150,1076,2843,190,B
2842,CEJ,201,201,1223,95,1171,2843,1022,C
2842,BEJ,1280,209,1432,240,1490,2843,152,J
2842,BEK,1721,289,1721,2298,2298,2843,0,E
2842,BFK,500,2,1723,585,1756,2843,1223,B
2842,CFK,779,488,2211,995,2485,2843,1432,K
2842,CFL,617,127,2338,90,2388,2843,1721,F
2842,CGL,710,95,2433,665,2421,2843,1723,C
2842,DGL,392,297,2730,795,3183,2843,2338,G
2842,DHL,1225,928,3658,4230,6651,2843,2433,D
2842,HL,1718,790,4448,3780,6963,2843,2730,H
2842,L,4548,2311,6759,4680,7165,2843,2211,L
2842,M,4864,4864,11623,5171,12336,2843,6759,M
2842,N,348,348,11971,90,12426,2843,11623,N
2842,O,459,459,12430,815,13241,2843,11971,O
2842,N,373,373,12803,30,13271,2843,12430,N
2842,O,193,193,12996,625,13896,2843,12803,O
2842,P,1209,1209,14205,3780,17676,2843,12996,P
2843,AEI,91,91,91,822,822,2844,0,A
2843,BEI,828,828,919,150,972,2844,91,B
2843,CEI,202,202,1121,120,1092,2844,919,C
2843,BEI,1936,815,1936,2900,2900,2844,0,I
2843,BEJ,1524,709,2645,1570,2662,2844,1121,B
2843,CEJ,991,282,2927,90,2990,2844,1936,J
2843,CEK,292,10,2937,645,3307,2844,2645,C
2843,DEK,518,508,3445,880,3870,2844,2927,K
2843,DEJ,473,473,3918,110,3980,2844,3445,J
2843,DEK,1655,1655,5573,2315,6295,2844,3918,K
2843,DEL,4205,4205,9778,3480,9775,2844,5573,L
2843,DE,14395,4617,14395,14666,14666,2844,0,E
2843,DF,271,271,14666,90,14756,2844,14395,F
2843,DG,12055,326,14992,4230,7537,2844,2937,D
2843,G,682,356,15348,1260,16016,2844,14666,G
2843,F,1629,1629,16977,990,17006,2844,15348,F
2843,G,652,652,17629,1000,18006,2844,16977,G
2843,H,7112,7112,24741,780,18786,2844,17629,H
2843,M,1671,1671,26412,1740,20526,2844,24741,M
2843,N,191,191,26603,150,20676,2844,26412,N
2843,O,616,616,27219,585,21261,2844,26603,O
2843,N,344,344,27563,385,21646,2844,27219,N
2843,O,415,415,27978,700,22346,2844,27563,O
2843,P,6778,6778,34756,3960,26306,2844,27978,P
2844,AEI,350,350,350,1016,1016,2845,0,E
2844,AFI,713,363,713,1487,1487,2845,0,A
2844,BFI,793,430,1143,150,1166,2845,350,F
2844,BGI,155,155,1298,125,1291,2845,1143,G
2844,BFI,1378,80,1378,1529,1529,2845,0,I
2844,BFJ,229,149,1527,265,1556,2845,1298,F
2844,BGJ,878,64,1591,150,1637,2845,713,B
2844,CGJ,251,38,1629,150,1679,2845,1378,J
2844,CGK,621,519,2148,690,2246,2845,1527,G
2844,CHK,704,185,2333,700,2379,2845,1629,K
2844,CHJ,776,34,2367,760,2397,2845,1591,C
2844,BHJ,1107,1073,3440,1095,3474,2845,2333,J
2844,BHK,1211,138,3578,1195,3592,2845,2367,B
2844,CHK,1437,7,3585,4230,6476,2845,2148,H
2844,CK,635,490,4075,690,4164,2845,3440,K
2844,CL,618,121,4196,705,4297,2845,3578,C
2844,DL,2691,2570,6766,4230,8394,2845,4075,L
2844,D,11642,9072,15838,4230,8527,2845,4196,D
2844,M,1130,1130,16968,710,9237,2845,15838,M
2844,N,198,198,17166,640,9877,2845,16968,N
2844,O,315,315,17481,415,10292,2845,17166,O
2844,N,356,356,17837,280,10572,2845,17481,N
2844,O,897,897,18734,2905,13477,2845,17837,O
2844,P,2884,2884,21618,1440,14917,2845,18734,P
2845,AE,64,64,64,136,136,2846,0,A
2845,BE,155,155,219,135,271,2846,64,B
2845,CE,351,132,351,375,375,2846,0,E
2845,CF,112,112,463,150,525,2846,351,F
2845,CG,282,38,501,285,556,2846,219,C
2845,DG,277,239,740,280,805,2846,463,G
2845,DH,259,20,760,5160,5716,2846,501,D
2845,H,1238,1218,1978,5160,5965,2846,740,H
2845,M,4,4,1982,45,6010,2846,1978,M
2845,N,170,170,2152,180,6190,2846,1982,N
2845,O,150,150,2302,540,6730,2846,2152,O
2845,P,23,23,2325,2850,9580,2846,2302,P
2846,A,1415,1415,1415,1592,1592,2847,0,A
2846,B,292,292,1707,180,1772,2847,1415,B
2846,C,822,822,2529,950,2722,2847,1707,C
2846,B,471,471,3000,330,3052,2847,2529,B
2846,C,526,526,3526,585,3637,2847,3000,C
2846,D,1039,1039,4565,6960,10597,2847,3526,D
2846,M,2129,2129,6694,3539,14136,2847,4565,M
2846,N,1556,1556,8250,150,14286,2847,6694,N
2846,O,982,982,9232,1110,15396,2847,8250,O
2846,P,491,491,9723,5280,20676,2847,9232,P
2847,AEI,71,71,71,236,236,2848,0,A
2847,BEI,78,7,78,935,935,2848,0,E
2847,BFI,358,351,429,240,476,2848,71,B
2847,CFI,210,210,639,295,771,2848,429,C
2847,DFI,251,251,890,5100,5871,2848,639,D
2847,FI,1076,264,1154,240,1175,2848,78,F
2847,GI,1588,434,1588,1754,1754,2848,0,I
2847,GJ,294,294,1882,180,1934,2848,1588,J
2847,GK,1540,812,2694,1040,2215,2848,1154,G
2847,FK,819,7,2701,970,2904,2848,1882,K
2847,FJ,300,300,3001,145,3049,2848,2701,J
2847,FK,421,114,3115,930,3145,2848,2694,F
2847,GK,585,471,3586,605,3654,2848,3001,K
2847,GL,1059,588,4174,1560,4705,2848,3115,G
2847,HL,159,159,4333,3960,8665,2848,4174,H
2847,L,1308,561,4894,6960,10614,2848,3586,L
2847,M,848,848,5742,1239,11853,2848,4894,M
2847,N,950,950,6692,180,12033,2848,5742,N
2847,O,240,240,6932,895,12928,2848,6692,O
2847,N,1653,1653,8585,1365,14293,2848,6932,N
2847,O,552,552,9137,620,14913,2848,8585,O
2847,P,53,53,9190,6960,21873,2848,9137,P
2848,A,1223,1223,1223,1361,1361,2849,0,A
2848,B,191,191,1414,90,1451,2849,1223,B
2848,C,736,736,2150,1130,2581,2849,1414,C
2848,D,539,539,2689,3780,6361,2849,2150,D
2848,M,1751,1751,4440,2109,8470,2849,2689,M
2848,N,392,392,4832,90,8560,2849,4440,N
2848,O,516,516,5348,845,9405,2849,4832,O
2848,P,379,379,5727,3780,13185,2849,5348,P
2849,AE,54,54,54,176,176,2850,0,A
2849,BE,220,220,274,150,326,2850,54,B
2849,CE,105,105,379,125,451,2850,274,C
2849,BE,807,807,1186,745,1196,2850,379,B
2849,CE,1451,265,1451,2475,2475,2850,0,E
2849,CF,1121,856,2307,1295,2491,2850,1186,C
2849,DF,1070,214,2521,90,2565,2850,1451,F
2849,DG,641,641,3162,970,3535,2850,2521,G
2849,DF,500,500,3662,170,3705,2850,3162,F
2849,DG,1009,1009,4671,1325,5030,2850,3662,G
2849,DH,1228,1228,5899,3780,8810,2850,4671,H
2849,D,4749,1157,7056,3660,6151,2850,2307,D
2849,M,243,243,7299,516,9326,2850,7056,M
2849,N,452,452,7751,240,9566,2850,7299,N
2849,O,771,771,8522,985,10551,2850,7751,O
2849,N,452,452,8974,330,10881,2850,8522,N
2849,O,911,911,9885,1080,11961,2850,8974,O
2849,P,2819,2819,12704,3960,15921,2850,9885,P
2850,AE,28,28,28,1012,1012,2851,0,E
2850,AF,235,207,235,1106,1106,2851,0,A
2850,BF,1017,810,1045,90,1102,2851,28,F
2850,BG,907,97,1142,90,1196,2851,235,B
2850,CG,956,859,2001,1220,2322,2851,1045,G
2850,CH,17,17,2018,3780,6102,2851,2001,H
2850,C,1009,133,2151,1240,2436,2851,1142,C
2850,D,61,61,2212,3780,6216,2851,2151,D
2850,M,843,843,3055,1332,7548,2851,2212,M
2850,N,513,513,3568,90,7638,2851,3055,N
2850,O,533,533,4101,860,8498,2851,3568,O
2850,P,4320,4320,8421,3840,12338,2851,4101,P
2851,A,238,238,238,742,742,2852,0,A
2851,B,696,696,934,240,982,2852,238,B
2851,C,150,150,1084,380,1362,2852,934,C
2851,B,1642,1642,2726,1410,2772,2852,1084,B
2851,C,654,654,3380,960,3732,2852,2726,C
2851,D,1596,1596,4976,3960,7692,2852,3380,D
2851,M,368,368,5344,585,8277,2852,4976,M
2851,N,637,637,5981,480,8757,2852,5344,N
2851,O,673,673,6654,720,9477,2852,5981,O
2851,P,3425,3425,10079,550,10027,2852,6654,P
2852,AE,312,312,312,400,400,2853,0,E
2852,AF,362,362,674,300,700,2853,312,F
2852,AG,623,623,1297,735,1435,2853,674,G
2852,AH,118,118,1415,1560,2995,2853,1297,H
2852,A,14489,13074,14489,14854,14854,2853,0,A
2852,B,672,672,15161,300,15154,2853,14489,B
2852,C,640,640,15801,735,15889,2853,15161,C
2852,D,76,76,15877,1560,17449,2853,15801,D
2852,M,1600,1600,17477,1580,19029,2853,15877,M
2852,N,240,240,17717,300,19329,2853,17477,N
2852,O,757,757,18474,855,20184,2853,17717,O
2852,N,253,253,18727,165,20349,2853,18474,N
2852,O,205,205,18932,344,20693,2853,18727,O
2852,P,2365,2365,21297,1440,22133,2853,18932,P
2853,AE,239,239,239,260,260,2854,0,E
2853,AF,285,285,524,300,560,2854,239,F
2853,AG,443,443,967,640,1200,2854,524,G
2853,AH,1123,1123,2090,1140,2340,2854,967,H
2853,A,4731,2641,4731,6074,6074,2854,0,A
2853,B,1554,1554,6285,240,6314,2854,4731,B
2853,C,771,771,7056,725,7039,2854,6285,C
2853,B,1501,1501,8557,95,7134,2854,7056,B
2853,C,873,873,9430,1260,8394,2854,8557,C
2853,D,16169,16169,25599,3960,12354,2854,9430,D
2853,M,68,68,25667,270,12624,2854,25599,M
2853,N,354,354,26021,180,12804,2854,25667,N
2853,O,701,701,26722,885,13689,2854,26021,O
2853,P,32,32,26754,6680,20369,2854,26722,P
2854,A,900,900,900,1564,1564,2855,0,A
2854,B,689,689,1589,90,1654,2855,900,B
2854,C,858,858,2447,1240,2894,2855,1589,C
2854,D,19,19,2466,3780,6674,2855,2447,D
2854,M,1320,1320,3786,2658,9332,2855,2466,M
2854,N,1388,1388,5174,90,9422,2855,3786,N
2854,O,604,604,5778,925,10347,2855,5174,O
2854,P,1109,1109,6887,3780,14127,2855,5778,P
2855,AEI,54,54,54,1008,1008,2856,0,A
2855,BEI,65,11,65,1005,1005,2856,0,E
2855,BFI,357,292,357,1083,1083,2856,0,I
2855,BFJ,1126,834,1191,240,1245,2856,65,F
2855,BGJ,1157,20,1211,240,1248,2856,54,B
2855,CGJ,920,66,1277,240,1323,2856,357,J
2855,CGK,861,775,2052,1020,2265,2856,1191,G
2855,CHK,910,135,2187,995,2318,2856,1277,K
2855,CHL,1043,67,2254,1020,2268,2856,1211,C
2855,DHL,317,115,2369,4680,6945,2856,2052,H
2855,DL,278,163,2532,4680,6948,2856,2254,D
2855,L,7337,6992,9524,4680,6998,2856,2187,L
2855,M,738,738,10262,914,7912,2856,9524,M
2855,N,197,197,10459,90,8002,2856,10262,N
2855,O,471,471,10930,795,8797,2856,10459,O
2855,N,1074,1074,12004,735,9532,2856,10930,N
2855,O,537,537,12541,735,10267,2856,12004,O
2855,P,297,297,12838,3780,14047,2856,12541,P
2856,AEI,33,33,33,703,703,2857,0,A
2856,BEI,618,618,651,90,793,2857,33,B
2856,CEI,231,231,882,535,1328,2857,651,C
2856,BEI,1809,927,1809,2333,2333,2857,0,I
2856,BEJ,1231,304,2113,710,2038,2857,882,B
2856,CEJ,553,249,2362,90,2423,2857,1809,J
2856,CEK,339,90,2452,735,2773,2857,2113,C
2856,DEK,2472,20,2472,3800,3800,2857,0,E
2856,DFK,631,521,2993,815,3238,2857,2362,K
2856,DFJ,233,233,3226,45,3283,2857,2993,J
2856,DFK,478,478,3704,740,4023,2857,3226,K
2856,DFL,1465,233,3937,180,3980,2857,2472,F
2856,DGL,924,691,4628,3780,7803,2857,3704,L
2856,DG,1077,386,5014,1030,5010,2857,3937,G
2856,DF,3206,644,5658,3780,6553,2857,2452,D
2856,F,3236,2592,8250,3300,8310,2857,5014,F
2856,G,521,521,8771,830,9140,2857,8250,G
2856,H,1464,1464,10235,6720,15860,2857,8771,H
2856,M,1656,1656,11891,1725,17585,2857,10235,M
2856,N,369,369,12260,360,17945,2857,11891,N
2856,O,685,685,12945,835,18780,2857,12260,O
2856,N,1183,1183,14128,1035,19815,2857,12945,N
2856,O,2877,2877,17005,2347,22162,2857,14128,O
2856,P,3275,3275,20280,843,23005,2857,17005,P
2857,AEI,296,296,296,739,739,2858,0,A
2857,BEI,643,643,939,240,979,2858,296,B
2857,CEI,236,236,1175,395,1374,2858,939,C
2857,BEI,1509,334,1509,1490,1490,2858,0,E
2857,BFI,221,221,1730,300,1790,2858,1509,F
2857,BGI,312,312,2042,820,2610,2858,1730,G
2857,BFI,2705,663,2705,2895,2895,2858,0,I
2857,BFJ,1700,170,2875,1500,2874,2858,1175,B
2857,CFJ,834,1,2876,315,2925,2858,2042,F
2857,CGJ,328,157,3033,180,3075,2858,2705,J
2857,CGK,280,123,3156,425,3350,2858,2876,G
2857,CHK,475,194,3350,785,3659,2858,2875,C
2857,DHK,703,386,3736,625,3700,2858,3033,K
2857,DHL,298,298,4034,4140,7840,2858,3736,L
2857,DH,1006,128,4162,1590,4940,2858,3156,H
2857,D,985,173,4335,3960,7619,2858,3350,D
2857,M,1648,1648,5983,2012,9852,2858,4335,M
2857,N,469,469,6452,180,10032,2858,5983,N
2857,O,1521,1521,7973,1240,11272,2858,6452,O
2857,N,129,129,8102,395,11667,2858,7973,N
2857,O,508,508,8610,630,12297,2858,8102,O
2857,P,927,927,9537,6660,18957,2858,8610,P
2858,AE,86,86,86,794,794,2859,0,E
2858,AF,944,944,1030,270,1064,2859,86,F
2858,AG,1631,601,1631,1861,1861,2859,0,A
2858,BG,204,204,1835,90,1951,2859,1631,B
2858,CG,323,323,2158,715,2666,2859,1835,C
2858,DG,1140,12,2170,1042,2106,2859,1030,G
2858,DH,6,6,2176,333,2439,2859,2170,H
2858,D,1673,1655,3831,3780,6446,2859,2158,D
2858,M,6989,6989,10820,7165,13611,2859,3831,M
2858,N,237,237,11057,90,13701,2859,10820,N
2858,O,502,502,11559,800,14501,2859,11057,O
2858,N,494,494,12053,210,14711,2859,11559,N
2858,O,142,142,12195,585,15296,2859,12053,O
2858,P,3185,3185,15380,3780,19076,2859,12195,P
2859,AE,183,183,183,800,800,2860,0,E
2859,AF,397,214,397,793,793,2860,0,A
2859,BF,986,772,1169,400,1200,2860,183,F
2859,BG,801,29,1198,420,1213,2860,397,B
2859,CG,1010,1010,2208,970,2183,2860,1198,C
2859,DG,1479,440,2648,1210,2410,2860,1169,G
2859,DH,1184,744,3392,460,2643,2860,2208,D
2859,H,1066,322,3714,550,2960,2860,2648,H
2859,M,5024,5024,8738,14137,17097,2860,3714,M
2859,N,9514,9514,18252,420,17517,2860,8738,N
2859,O,582,582,18834,676,18193,2860,18252,O
2859,P,6424,6424,25258,3639,21832,2860,18834,P
2860,AEI,383,383,383,1713,1713,2861,0,I
2860,AEJ,1570,1570,1953,300,2013,2861,383,J
2860,AEK,2673,720,2673,2934,2934,2861,0,E
2860,AFK,351,351,3024,150,3084,2861,2673,F
2860,AGK,90,90,3114,115,3199,2861,3024,G
2860,AFK,3316,202,3316,2996,2996,2861,0,A
2860,BFK,60,60,3376,500,3496,2861,3316,B
2860,CFK,277,15,3391,225,3424,2861,3114,F
2860,CGK,1627,189,3580,1560,3573,2861,1953,K
2860,CGJ,753,549,4129,690,4186,2861,3376,C
2860,DGJ,786,48,4177,765,4189,2861,3391,G
2860,DHJ,261,213,4390,385,4571,2861,4129,D
2860,HJ,1866,1056,5446,1945,5518,2861,3580,J
2860,HK,1590,321,5767,550,4739,2861,4177,H
2860,K,548,227,5994,575,6093,2861,5446,K
2860,L,3527,3527,9521,550,6643,2861,5994,L
2860,M,2061,2061,11582,2315,8958,2861,9521,M
2860,N,394,394,11976,180,9138,2861,11582,N
2860,O,527,527,12503,742,9880,2861,11976,O
2860,N,443,443,12946,388,10268,2861,12503,N
2860,O,995,995,13941,900,11168,2861,12946,O
2860,P,30,30,13971,4080,15248,2861,13941,P
2861,AE,115,115,115,292,292,2862,0,A
2861,BE,344,344,459,180,472,2862,115,B
2861,CE,591,591,1050,683,1155,2862,459,C
2861,DE,3205,2155,3205,6433,6433,2862,0,E
2861,DF,3588,3588,6793,420,6853,2862,3205,F
2861,DG,1040,1040,7833,985,7838,2862,6793,G
2861,DH,7538,755,8588,4080,5235,2862,1050,D
2861,H,2336,1581,10169,550,8388,2862,7833,H
2861,M,574,574,10743,889,9277,2862,10169,M
2861,N,432,432,11175,150,9427,2862,10743,N
2861,O,167,167,11342,385,9812,2862,11175,O
2861,N,485,485,11827,255,10067,2862,11342,N
2861,O,610,610,12437,590,10657,2862,11827,O
2861,P,612,612,13049,4230,14887,2862,12437,P
2862,A,337,337,337,471,471,2863,0,A
2862,B,254,254,591,210,681,2863,337,B
2862,C,663,663,1254,645,1326,2863,591,C
2862,B,1657,1657,2911,1595,2921,2863,1254,B
2862,C,902,902,3813,947,3868,2863,2911,C
2862,D,31,31,3844,348,4216,2863,3813,D
2862,M,1386,1386,5230,1556,5772,2863,3844,M
2862,N,209,209,5439,90,5862,2863,5230,N
2862,O,509,509,5948,800,6662,2863,5439,O
2862,N,1128,1128,7076,850,7512,2863,5948,N
2862,O,380,380,7456,735,8247,2863,7076,O
2862,P,1057,1057,8513,3780,12027,2863,7456,P
2863,AEI,2,2,2,201,201,2864,0,E
2863,AFI,444,442,444,265,265,2864,0,A
2863,BFI,487,45,489,330,531,2864,2,F
2863,BGI,547,502,991,730,995,2864,444,B
2863,CGI,1144,153,1144,1519,1519,2864,0,I
2863,CGJ,1048,393,1537,980,1511,2864,489,G
2863,CHJ,473,80,1617,150,1669,2864,1144,J
2863,CHK,176,176,1793,125,1794,2864,1617,K
2863,CHJ,897,95,1888,925,1920,2864,991,C
2863,DHJ,861,510,2398,350,1861,2864,1537,H
2863,DJ,1122,517,2915,1140,2934,2864,1793,J
2863,DK,774,774,3689,690,3624,2864,2915,K
2863,DL,2608,807,4496,2760,4680,2864,1888,D
2863,L,3263,2456,6952,4230,7854,2864,3689,L
2863,M,1545,1545,8497,1788,9642,2864,6952,M
2863,N,271,271,8768,90,9732,2864,8497,N
2863,O,819,819,9587,1145,10877,2864,8768,O
2863,N,578,578,10165,235,11112,2864,9587,N
2863,O,422,422,10587,790,11902,2864,10165,O
2863,P,3164,3164,13751,3780,15682,2864,10587,P
2864,AE,93,93,93,92,92,2865,0,E
2864,AF,114,114,207,150,242,2865,93,F
2864,AG,121,121,328,395,637,2865,207,G
2864,AF,278,278,606,10,647,2865,328,F
2864,AG,844,238,844,1167,1167,2865,0,A
2864,BG,378,378,1222,90,1257,2865,844,B
2864,CG,832,216,1438,765,1412,2865,606,G
2864,CH,264,264,1702,4230,5642,2865,1438,H
2864,C,899,419,2121,1250,2507,2865,1222,C
2864,D,87,87,2208,3780,6287,2865,2121,D
2864,M,447,447,2655,908,7195,2865,2208,M
2864,N,504,504,3159,90,7285,2865,2655,N
2864,O,226,226,3385,585,7870,2865,3159,O
2864,P,8676,8676,12061,3780,11650,2865,3385,P
2865,AE,2405,2405,2405,3397,3397,2866,0,A
2865,BE,2426,21,2426,2543,2543,2866,0,E
2865,BF,274,274,2700,90,2633,2866,2426,F
2865,BG,641,641,3341,795,3428,2866,2700,G
2865,BH,1024,88,3429,90,3487,2866,2405,B
2865,CH,283,195,3624,3840,7268,2866,3341,H
2865,C,915,720,4344,1250,4737,2866,3429,C
2865,D,768,768,5112,3780,8517,2866,4344,D
2865,M,850,850,5962,1428,9945,2866,5112,M
2865,N,616,616,6578,90,10035,2866,5962,N
2865,O,240,240,6818,695,10730,2866,6578,O
2865,P,2002,2002,8820,3780,14510,2866,6818,P
2866,AE,45,45,45,27,27,2867,0,A
2866,BE,80,80,125,150,177,2867,45,B
2866,CE,131,6,131,139,139,2867,0,E
2866,CF,101,101,232,150,289,2867,131,F
2866,CG,243,136,368,125,302,2867,125,C
2866,BG,146,10,378,400,689,2867,232,G
2866,BF,924,924,1302,630,1319,2867,378,F
2866,BG,988,54,1356,1085,1387,2867,368,B
2866,CG,391,337,1693,650,1969,2867,1302,G
2866,CH,371,34,1727,650,2037,2867,1356,C
2866,DH,4501,4501,6228,4230,6267,2867,1727,D
2866,H,6071,1536,7764,4230,6199,2867,1693,H
2866,M,1393,1393,9157,2989,9256,2867,7764,M
2866,N,1716,1716,10873,180,9436,2867,9157,N
2866,O,1181,1181,12054,885,10321,2867,10873,O
2866,P,1030,1030,13084,660,10981,2867,12054,P
2867,A,7805,7805,7805,8513,8513,2868,0,A
2867,B,756,756,8561,90,8603,2868,7805,B
2867,C,842,842,9403,1230,9833,2868,8561,C
2867,D,374,374,9777,3780,13613,2868,9403,D
2867,M,660,660,10437,1331,14944,2868,9777,M
2867,N,736,736,11173,90,15034,2868,10437,N
2867,O,227,227,11400,695,15729,2868,11173,O
2867,P,17855,17855,29255,3780,19509,2868,11400,P
2868,AE,963,963,963,1640,1640,2869,0,E
2868,AF,1063,100,1063,1583,1583,2869,0,A
2868,BF,568,568,1631,90,1673,2869,1063,B
2868,CF,739,71,1702,90,1730,2869,963,F
2868,CG,885,814,2516,1250,2923,2869,1631,C
2868,DG,843,29,2545,1250,2980,2869,1702,G
2868,DH,433,433,2978,3780,6760,2869,2545,H
2868,D,1749,1287,4265,3780,6703,2869,2516,D
2868,M,4098,4098,8363,5013,11773,2869,4265,M
2868,N,958,958,9321,90,11863,2869,8363,N
2868,O,752,752,10073,1195,13058,2869,9321,O
2868,P,70,70,10143,3780,16838,2869,10073,P
2869,AE,296,296,296,1357,1357,2870,0,E
2869,AF,1240,1240,1536,240,1597,2870,296,F
2869,AG,2290,754,2290,2770,2770,2870,0,A
2869,BG,849,95,2385,780,2377,2870,1536,G
2869,BH,728,633,3018,300,3070,2870,2290,B
2869,CH,877,877,3895,1045,4115,2870,3018,C
2869,DH,2559,1049,4944,7680,10057,2870,2385,H
2869,D,1115,66,5010,1140,5255,2870,3895,D
2869,M,285,285,5295,317,10374,2870,5010,M
2869,N,270,270,5565,300,10674,2870,5295,N
2869,O,670,670,6235,820,11494,2870,5565,O
2869,N,1374,1374,7609,1245,12739,2870,6235,N
2869,O,337,337,7946,430,13169,2870,7609,O
2869,P,5733,5733,13679,5100,18269,2870,7946,P
2870,A,1689,1689,1689,2568,2568,2871,0,A
2870,B,915,915,2604,90,2658,2871,1689,B
2870,C,494,494,3098,905,3563,2871,2604,C
2870,B,488,488,3586,90,3653,2871,3098,B
2870,C,1479,1479,5065,2380,6033,2871,3586,C
2870,D,244,244,5309,3420,9453,2871,5065,D
2870,M,1647,1647,6956,2956,12409,2871,5309,M
2870,N,1355,1355,8311,90,12499,2871,6956,N
2870,O,1706,1706,10017,1935,14434,2871,8311,O
2870,N,577,577,10594,350,14784,2871,10017,N
2870,O,435,435,11029,790,15574,2871,10594,O
2870,P,282,282,11311,3780,19354,2871,11029,P
2871,A,1976,1976,1976,2189,2189,2872,0,A
2871,B,270,270,2246,90,2279,2872,1976,B
2871,C,484,484,2730,820,3099,2872,2246,C
2871,D,102,102,2832,3780,6879,2872,2730,D
2871,M,187,187,3019,484,7363,2872,2832,M
2871,N,330,330,3349,90,7453,2872,3019,N
2871,O,551,551,3900,845,8298,2872,3349,O
2871,P,391,391,4291,3780,12078,2872,3900,P
2872,AEI,115,115,115,1056,1056,2873,0,A
2872,BEI,362,247,362,1895,1895,2873,0,E
2872,BFI,664,302,664,1245,1245,2873,0,I
2872,BFJ,1114,565,1229,90,1146,2873,115,B
2872,CFJ,612,47,1276,90,1335,2873,664,J
2872,CFK,178,178,1454,585,1920,2873,1276,K
2872,CFL,1598,506,1960,90,1985,2873,362,F
2872,CGL,983,252,2212,1220,2366,2873,1229,C
2872,BGL,166,166,2378,75,2441,2873,2212,B
2872,CGL,174,174,2552,585,3026,2873,2378,C
2872,DGL,1403,811,3363,1745,3730,2873,1960,G
2872,DFL,360,360,3723,50,3780,2873,3363,F
2872,DGL,184,184,3907,585,4365,2873,3723,G
2872,DHL,3062,609,4516,3780,5700,2873,1454,L
2872,DH,2756,2147,6663,3780,8145,2873,3907,H
2872,D,5332,1221,7884,3780,6806,2873,2552,D
2872,M,1412,1412,9296,1523,9668,2873,7884,M
2872,N,475,475,9771,390,10058,2873,9296,N
2872,O,999,999,10770,1175,11233,2873,9771,O
2872,N,1347,1347,12117,1190,12423,2873,10770,N
2872,O,306,306,12423,385,12808,2873,12117,O
2872,P,445,445,12868,370,13178,2873,12423,P
2873,AEI,391,391,391,4462,4462,2874,0,I
2873,AEJ,4181,4181,4572,90,4552,2874,391,J
2873,AEK,1242,1242,5814,1675,6227,2874,4572,K
2873,AEJ,1279,1279,7093,930,7157,2874,5814,J
2873,AEK,194,194,7287,585,7742,2874,7093,K
2873,AEL,2253,2253,9540,3780,11522,2874,7287,L
2873,AE,36167,26627,36167,37228,37228,2874,0,E
2873,AF,37018,851,37018,37328,37328,2874,0,A
2873,BF,1083,232,37250,90,37318,2874,36167,F
2873,BG,350,118,37368,90,37418,2874,37018,B
2873,CG,1111,993,38361,1365,38683,2874,37250,G
2873,CF,1032,39,38400,1240,38658,2874,37368,C
2873,BF,265,265,38665,40,38698,2874,38400,B
2873,CF,154,154,38819,585,39283,2874,38665,C
2873,DF,205,205,39024,3780,43063,2874,38819,D
2873,F,3901,3238,42262,3635,42318,2874,38361,F
2873,G,202,202,42464,585,42903,2874,42262,G
2873,H,29836,29836,72300,3780,46683,2874,42464,H
2873,M,220,220,72520,238,46921,2874,72300,M
2873,N,354,354,72874,390,47311,2874,72520,N
2873,O,1158,1158,74032,930,48241,2874,72874,O
2873,N,1081,1081,75113,1345,49586,2874,74032,N
2873,O,169,169,75282,358,49944,2874,75113,O
2873,P,554,554,75836,452,50396,2874,75282,P
2874,AEI,1946,1946,1946,2054,2054,2875,0,A
2874,BEI,131,131,2077,90,2144,2875,1946,B
2874,CEI,519,519,2596,800,2944,2875,2077,C
2874,BEI,3210,614,3210,4097,4097,2875,0,E
2874,BFI,920,920,4130,90,4187,2875,3210,F
2874,BGI,2122,588,4718,1835,4779,2875,2596,B
2874,CGI,834,246,4964,1200,5387,2875,4130,G
2874,CFI,450,204,5168,735,5514,2875,4718,C
2874,DFI,894,894,6062,3780,9294,2875,5168,D
2874,FI,2207,1109,7171,1845,7232,2875,4964,F
2874,GI,7184,13,7184,7841,7841,2875,0,I
2874,GJ,447,434,7618,735,7967,2875,7171,G
2874,HJ,687,253,7871,90,7931,2875,7184,J
2874,HK,1021,768,8639,3780,11747,2875,7618,H
2874,K,1497,729,9368,1680,9611,2875,7871,K
2874,L,4593,4593,13961,3780,13391,2875,9368,L
2874,M,5506,5506,19467,6005,19396,2875,13961,M
2874,N,537,537,20004,90,19486,2875,19467,N
2874,O,413,413,20417,750,20236,2875,20004,O
2874,N,936,936,21353,585,20821,2875,20417,N
2874,O,1353,1353,22706,1865,22686,2875,21353,O
2874,P,1671,1671,24377,3780,26466,2875,22706,P
2875,AE,233,233,233,1290,1290,2876,0,E
2875,AF,1086,1086,1319,90,1380,2876,233,F
2875,AG,1531,212,1531,1871,1871,2876,0,A
2875,BG,361,361,1892,90,1961,2876,1531,B
2875,CG,943,370,2262,1210,2590,2876,1319,G
2875,CH,31,31,2293,3780,6370,2876,2262,H
2875,C,531,130,2423,880,2841,2876,1892,C
2875,D,199,199,2622,3780,6621,2876,2423,D
2875,M,1857,1857,4479,4320,10941,2876,2622,M
2875,N,2496,2496,6975,90,11031,2876,4479,N
2875,O,626,626,7601,935,11966,2876,6975,O
2875,P,902,902,8503,3780,15746,2876,7601,P
2876,A,1628,1628,1628,2397,2397,2877,0,A
2876,B,1048,1048,2676,240,2637,2877,1628,B
2876,C,923,923,3599,1040,3677,2877,2676,C
2876,B,764,764,4363,1730,5407,2877,3599,B
2876,C,1519,1519,5882,840,6247,2877,4363,C
2876,D,2614,2614,8496,3960,10207,2877,5882,D
2876,M,133,133,8629,946,11153,2877,8496,M
2876,N,1198,1198,9827,300,11453,2877,8629,N
2876,O,765,765,10592,810,12263,2877,9827,O
2876,P,150,150,10742,4080,16343,2877,10592,P
2877,AEI,62,62,62,1160,1160,2878,0,A
2877,BEI,207,145,207,678,678,2878,0,I
2877,BEJ,567,567,774,150,828,2878,207,J
2877,BEK,299,299,1073,125,953,2878,774,K
2877,BEJ,1129,118,1191,90,1250,2878,62,B
2877,CEJ,628,510,1701,785,1738,2878,1073,J
2877,CEK,959,449,2150,1210,2460,2878,1191,C
2877,DEK,22,22,2172,3780,6240,2878,2150,D
2877,EK,794,323,2495,765,2503,2878,1701,K
2877,EL,1519,1519,4014,4230,6733,2878,2495,L
2877,E,21709,17695,21709,21967,21967,2878,0,E
2877,F,319,319,22028,90,22057,2878,21709,F
2877,G,745,745,22773,1135,23192,2878,22028,G
2877,H,3203,3203,25976,3780,26972,2878,22773,H
2877,M,136,136,26112,488,27460,2878,25976,M
2877,N,473,473,26585,150,27610,2878,26112,N
2877,O,837,837,27422,800,28410,2878,26585,O
2877,N,410,410,27832,460,28870,2878,27422,N
2877,O,492,492,28324,470,29340,2878,27832,O
2877,P,2711,2711,31035,4230,33570,2878,28324,P
2878,AE,1968,1968,1968,2782,2782,2879,0,A
2878,BE,881,881,2849,90,2872,2879,1968,B
2878,CE,572,572,3421,820,3692,2879,2849,C
2878,BE,4275,854,4275,4627,4627,2879,0,E
2878,BF,1053,199,4474,845,4537,2879,3421,B
2878,CF,400,201,4675,90,4717,2879,4275,F
2878,CG,467,266,4941,740,5277,2879,4474,C
2878,DG,527,261,5202,735,5452,2879,4675,G
2878,DH,893,632,5834,3780,9057,2879,4941,D
2878,H,4493,3861,9695,3780,9232,2879,5202,H
2878,M,182,182,9877,1633,10865,2879,9695,M
2878,N,1651,1651,11528,180,11045,2879,9877,N
2878,O,1335,1335,12863,885,11930,2879,11528,O
2878,N,735,735,13598,1250,13180,2879,12863,N
2878,O,671,671,14269,645,13825,2879,13598,O
2878,P,363,363,14632,6960,20785,2879,14269,P
2879,AEI,191,191,191,1194,1194,2880,0,A
2879,BEI,405,214,405,1090,1090,2880,0,I
2879,BEJ,717,717,1122,90,1180,2880,405,J
2879,BEK,1033,102,1224,90,1284,2880,191,B
2879,CEK,1411,187,1411,1802,1802,2880,0,E
2879,CFK,421,421,1832,90,1892,2880,1411,F
2879,CGK,1063,353,2185,1200,2380,2880,1122,K
2879,CGL,992,31,2216,1210,2494,2880,1224,C
2879,DGL,59,59,2275,3780,6274,2880,2216,D
2879,GL,549,106,2381,820,2712,2880,1832,G
2879,HL,130,130,2511,3780,6492,2880,2381,H
2879,L,448,122,2633,3780,6160,2880,2185,L
2879,M,335,335,2968,914,7406,2880,2633,M
2879,N,609,609,3577,90,7496,2880,2968,N
2879,O,408,408,3985,705,8201,2880,3577,O
2879,P,20,20,4005,3780,11981,2880,3985,P
2880,AEI,15,15,15,1355,1355,2881,0,I
2880,AEJ,46,31,46,923,923,2881,0,A
2880,BEJ,84,38,84,194,194,2881,0,E
2880,BFJ,320,320,404,210,404,2881,84,F
2880,BGJ,515,515,919,660,1064,2881,404,G
2880,BFJ,1064,191,1110,240,1163,2881,46,B
2880,CFJ,336,145,1255,215,1279,2881,919,F
2880,CGJ,1619,379,1634,300,1655,2881,15,J
2880,CGK,848,324,1958,1020,2183,2881,1110,C
2880,DGK,855,152,2110,942,2221,2881,1255,G
2880,DHK,231,79,2189,4680,6863,2881,1958,D
2880,HK,114,35,2224,348,2569,2881,2110,H
2880,K,910,320,2544,1005,2660,2881,1634,K
2880,L,557,557,3101,1200,3860,2881,2544,L
2880,M,3664,3664,6765,4015,10878,2881,3101,M
2880,N,724,724,7489,90,10968,2881,6765,N
2880,O,681,681,8170,815,11783,2881,7489,O
2880,N,473,473,8643,675,12458,2881,8170,N
2880,O,183,183,8826,585,13043,2881,8643,O
2880,P,3052,3052,11878,3780,16823,2881,8826,P
2881,AE,154,154,154,389,389,2882,0,E
2881,AF,307,153,307,1439,1439,2882,0,A
2881,BF,264,111,418,90,479,2882,154,F
2881,BG,402,402,820,795,1274,2882,418,G
2881,BH,1327,814,1634,240,1679,2882,307,B
2881,CH,614,614,2248,780,2459,2882,1634,C
2881,DH,334,334,2582,9700,12159,2882,2248,D
2881,H,1910,148,2730,3780,5054,2882,820,H
2881,M,737,737,3467,1140,13299,2882,2730,M
2881,N,523,523,3990,180,13479,2882,3467,N
2881,O,1109,1109,5099,1045,14524,2882,3990,O
2881,P,2092,2092,7191,550,15074,2882,5099,P
2882,AEI,577,577,577,769,769,2883,0,A
2882,BEI,746,169,746,1243,1243,2883,0,E
2882,BFI,216,47,793,90,859,2883,577,B
2882,CFI,993,200,993,1066,1066,2883,0,I
2882,CFJ,527,280,1273,90,1333,2883,746,F
2882,CGJ,514,34,1307,905,1764,2883,793,C
2882,DGJ,354,354,1661,3780,5544,2883,1307,D
2882,GJ,1053,665,2326,1250,2583,2883,1273,G
2882,HJ,2,2,2328,3780,6363,2883,2326,H
2882,J,1566,231,2559,90,1156,2883,993,J
2882,K,906,906,3465,1240,2396,2883,2559,K
2882,L,798,798,4263,3780,6176,2883,3465,L
2882,M,1533,1533,5796,1824,8187,2883,4263,M
2882,N,332,332,6128,90,8277,2883,5796,N
2882,O,251,251,6379,695,8972,2883,6128,O
2882,P,4145,4145,10524,3780,12752,2883,6379,P
2883,AE,136,136,136,500,500,2884,0,E
2883,AF,1047,911,1047,1570,1570,2884,0,A
2883,BF,1204,293,1340,900,1400,2884,136,F
2883,BG,663,370,1710,150,1720,2884,1047,B
2883,CG,450,80,1790,630,2030,2884,1340,G
2883,CF,894,814,2604,2170,3890,2884,1710,C
2883,DF,1233,419,3023,1055,3085,2884,1790,F
2883,DG,1056,1056,4079,1206,4291,2884,3023,G
2883,DH,217,217,4296,414,4705,2884,4079,H
2883,D,13734,12042,16338,2880,6770,2884,2604,D
2883,M,1510,1510,17848,2657,9427,2884,16338,M
2883,N,1403,1403,19251,300,9727,2884,17848,N
2883,O,620,620,19871,730,10457,2884,19251,O
2883,P,179,179,20050,5760,16217,2884,19871,P
2884,A,119,119,119,1140,1140,2885,0,A
2884,B,1141,1141,1260,180,1320,2885,119,B
2884,C,952,952,2212,1055,2375,2885,1260,C
2884,B,746,746,2958,645,3020,2885,2212,B
2884,C,101,101,3059,90,3110,2885,2958,C
2884,D,156,156,3215,5060,8170,2885,3059,D
2884,M,131,131,3346,125,8295,2885,3215,M
2884,N,44,44,3390,110,8405,2885,3346,N
2884,O,30,30,3420,55,8460,2885,3390,O
2884,N,140,140,3560,100,8560,2885,3420,N
2884,O,156,156,3716,390,8950,2885,3560,O
2884,P,911,911,4627,6290,15240,2885,3716,P
2885,A,311,311,311,472,472,2886,0,A
2885,B,284,284,595,180,652,2886,311,B
2885,C,665,665,1260,855,1507,2886,595,C
2885,B,1281,1281,2541,1120,2627,2886,1260,B
2885,C,650,650,3191,770,3397,2886,2541,C
2885,D,4047,4047,7238,5100,8497,2886,3191,D
2885,M,590,590,7828,972,9469,2886,7238,M
2885,N,484,484,8312,150,9619,2886,7828,N
2885,O,192,192,8504,125,9744,2886,8312,O
2885,N,276,276,8780,345,10089,2886,8504,N
2885,O,149,149,8929,120,10209,2886,8780,O
2885,P,991,991,9920,4230,14439,2886,8929,P
2886,AEI,263,263,263,396,396,2887,0,A
2886,BEI,220,220,483,150,546,2887,263,B
2886,CEI,161,161,644,130,676,2887,483,C
2886,BEI,929,929,1573,930,1606,2887,644,B
2886,CEI,1929,356,1929,2837,2837,2887,0,E
2886,CFI,379,23,1952,645,2251,2887,1573,C
2886,DFI,932,909,2861,90,2927,2887,1929,F
2886,DGI,578,578,3439,880,3807,2887,2861,G
2886,DFI,3522,83,3522,4335,4335,2887,0,I
2886,DFJ,417,334,3856,110,3917,2887,3439,F
2886,DGJ,838,504,4360,90,4425,2887,3522,J
2886,DGK,2747,339,4699,4230,6481,2887,1952,D
2886,GK,566,227,4926,905,5330,2887,4360,K
2886,GJ,1483,413,5339,2315,6232,2887,3856,G
2886,HJ,430,17,5356,90,5420,2887,4926,J
2886,HK,1206,1189,6545,3420,9652,2887,5339,H
2886,K,1505,316,6861,2320,7740,2887,5356,K
2886,L,5599,5599,12460,3420,11160,2887,6861,L
2886,M,2569,2569,15029,2655,13815,2887,12460,M
2886,N,264,264,15293,240,14055,2887,15029,N
2886,O,653,653,15946,855,14910,2887,15293,O
2886,N,626,626,16572,460,15370,2887,15946,N
2886,O,541,541,17113,900,16270,2887,16572,O
2886,P,1831,1831,18944,3960,20230,2887,17113,P
2887,A,6188,6188,6188,6739,6739,2888,0,A
2887,B,976,976,7164,420,7159,2888,6188,B
2887,C,1000,1000,8164,975,8134,2888,7164,C
2887,D,862,862,9026,460,8594,2888,8164,D
2887,M,3986,3986,13012,4080,12674,2888,9026,M
2887,N,182,182,13194,150,12824,2888,13012,N
2887,O,67,67,13261,50,12874,2888,13194,O
2887,N,161,161,13422,135,13009,2888,13261,N
2887,O,159,159,13581,295,13304,2888,13422,O
2887,P,2707,2707,16288,5160,18464,2888,13581,P
2888,AEI,20,20,20,189,189,2889,0,E
2888,AFI,67,47,67,130,130,2889,0,I
2888,AFJ,134,67,134,233,233,2889,0,A
2888,BFJ,155,88,222,135,265,2889,67,J
2888,BFK,250,48,270,135,324,2889,20,F
2888,BGK,210,74,344,135,368,2889,134,B
2888,CGK,286,164,508,290,555,2889,222,K
2888,CGL,285,47,555,280,604,2889,270,G
2888,CHL,254,43,598,285,653,2889,344,C
2888,DHL,120,120,718,5160,5813,2889,598,D
2888,HL,174,11,729,5160,5764,2889,555,H
2888,L,233,12,741,5160,5715,2889,508,L
2888,M,788,788,1529,1170,6983,2889,741,M
2888,N,475,475,2004,150,7133,2889,1529,N
2888,O,53,53,2057,100,7233,2889,2004,O
2888,N,437,437,2494,390,7623,2889,2057,N
2888,O,154,154,2648,225,7848,2889,2494,O
2888,P,1252,1252,3900,4740,12588,2889,2648,P
2889,AE,210,210,210,1024,1024,2890,0,E
2889,AF,506,296,506,1415,1415,2890,0,A
2889,BF,839,543,1049,90,1114,2890,210,F
2889,BG,940,397,1446,90,1505,2890,506,B
2889,CG,567,170,1616,905,2019,2890,1049,G
2889,CF,493,323,1939,880,2385,2890,1446,C
2889,BF,429,106,2045,90,2109,2890,1616,F
2889,BG,491,385,2430,110,2495,2890,1939,B
2889,CG,1505,1120,3550,2320,4429,2890,2045,G
2889,CH,1467,1467,5017,3420,7849,2890,3550,H
2889,C,2738,151,5168,2315,4810,2890,2430,C
2889,D,1307,1307,6475,3420,8230,2890,5168,D
2889,M,1282,1282,7757,1633,9863,2890,6475,M
2889,N,381,381,8138,90,9953,2890,7757,N
2889,O,1502,1502,9640,1875,11828,2890,8138,O
2889,N,1588,1588,11228,1185,13013,2890,9640,N
2889,O,538,538,11766,790,13803,2890,11228,O
2889,P,705,705,12471,3780,17583,2890,11766,P
2890,A,57,57,57,70,70,2891,0,A
2890,B,523,523,580,570,640,2891,57,B
2890,C,54,54,634,80,720,2891,580,C
2890,B,289,289,923,240,960,2891,634,B
2890,C,107,107,1030,130,1090,2891,923,C
2890,D,44,44,1074,2850,3940,2891,1030,D
2890,M,2012,2012,3086,2576,6516,2891,1074,M
2890,N,660,660,3746,150,6666,2891,3086,N
2890,O,161,161,3907,165,6831,2891,3746,O
2890,N,1543,1543,5450,1525,8356,2891,3907,N
2890,O,339,339,5789,650,9006,2891,5450,O
2890,P,1933,1933,7722,4230,13236,2891,5789,P
2891,AE,766,766,766,970,970,2892,0,E
2891,AF,1101,335,1101,1440,1440,2892,0,A
2891,BF,470,135,1236,300,1270,2892,766,F
2891,BG,429,294,1530,300,1740,2892,1101,B
2891,CG,566,566,2096,760,2500,2892,1530,C
2891,DG,901,41,2137,830,2100,2892,1236,G
2891,DH,808,808,2945,3960,6060,2892,2137,H
2891,D,2521,1672,4617,4020,6520,2892,2096,D
2891,M,340,340,4957,400,6920,2892,4617,M
2891,N,634,634,5591,610,7530,2892,4957,N
2891,O,367,367,5958,455,7985,2892,5591,O
2891,N,1292,1292,7250,1210,9195,2892,5958,N
2891,O,4569,4569,11819,1625,10820,2892,7250,O
2891,P,560130,560130,571949,2755,13575,2892,11819,P
2892,AEI,45,45,45,816,816,2893,0,A
2892,BEI,954,954,999,240,1056,2893,45,B
2892,CEI,575,575,1574,740,1796,2893,999,C
2892,DEI,2310,736,2310,2302,2302,2893,0,E
2892,DFI,265,265,2575,180,2482,2893,2310,F
2892,DGI,75,75,2650,665,3147,2893,2575,G
2892,DHI,3719,1069,3719,3834,3834,2893,0,I
2892,DHJ,189,189,3908,90,3924,2893,3719,J
2892,DHK,619,619,4527,790,4714,2893,3908,K
2892,DHJ,889,889,5416,760,5474,2893,4527,J
2892,DHK,418,418,5834,815,6289,2893,5416,K
2892,DHL,10817,6557,12391,5100,6896,2893,1574,D
2892,HL,47700,41143,53534,3780,10069,2893,5834,L
2892,H,144407,93523,147057,6900,10047,2893,2650,H
2892,M,1622,1622,148679,4139,14208,2893,147057,M
2892,N,2550,2550,151229,90,14298,2893,148679,N
2892,O,491,491,151720,805,15103,2893,151229,O
2892,N,1101,1101,152821,795,15898,2893,151720,N
2892,O,162,162,152983,535,16433,2893,152821,O
2892,P,1214,1214,154197,3780,20213,2893,152983,P
2893,AEI,39,39,39,396,396,2894,0,E
2893,AFI,111,72,111,260,260,2894,0,I
2893,AFJ,562,490,601,270,666,2894,39,F
2893,AGJ,658,168,769,570,830,2894,111,J
2893,AGK,64,64,833,80,910,2894,769,K
2893,AGL,71,71,904,2880,3790,2894,833,L
2893,AG,662,359,1263,735,1401,2894,601,G
2893,AF,1529,266,1529,3929,3929,2894,0,A
2893,BF,997,731,2260,915,2316,2894,1263,F
2893,BG,139,139,2399,285,2601,2894,2260,G
2893,BH,319,319,2718,5100,7701,2894,2399,H
2893,B,2438,1249,3967,90,4019,2894,1529,B
2893,C,1712,1712,5679,1750,5769,2894,3967,C
2893,D,275,275,5954,3840,9609,2894,5679,D
2893,M,5994,5994,11948,7747,17356,2894,5954,M
2893,N,1978,1978,13926,90,17446,2894,11948,N
2893,O,1002,1002,14928,1360,18806,2894,13926,O
2893,N,2316,2316,17244,2150,20956,2894,14928,N
2893,O,425,425,17669,815,21771,2894,17244,O
2893,P,2322,2322,19991,3780,25551,2894,17669,P
2894,A,4609,4609,4609,5718,5718,2895,0,A
2894,B,1142,1142,5751,90,5808,2895,4609,B
2894,C,562,562,6313,935,6743,2895,5751,C
2894,B,465,465,6778,55,6798,2895,6313,B
2894,C,1664,1664,8442,1865,8663,2895,6778,C
2894,D,6944,6944,15386,3780,12443,2895,8442,D
2894,M,7631,7631,23017,9403,21846,2895,15386,M
2894,N,1852,1852,24869,90,21936,2895,23017,N
2894,O,1147,1147,26016,1360,23296,2895,24869,O
2894,N,381,381,26397,200,23496,2895,26016,N
2894,O,645,645,27042,930,24426,2895,26397,O
2894,P,1171,1171,28213,3780,28206,2895,27042,P
2895,AEI,58,58,58,119,119,2896,0,A
2895,BEI,178,120,178,269,269,2896,0,I
2895,BEJ,178,58,236,150,269,2896,58,B
2895,CEJ,197,139,375,150,419,2896,178,J
2895,CEK,185,46,421,110,379,2896,236,C
2895,DEK,14,14,435,4230,4609,2896,421,D
2895,EK,176,116,551,110,529,2896,375,K
2895,EL,620,620,1171,4230,4759,2896,551,L
2895,E,1198,27,1198,1363,1363,2896,0,E
2895,F,255,255,1453,150,1513,2896,1198,F
2895,G,219,219,1672,155,1668,2896,1453,G
2895,F,839,839,2511,905,2573,2896,1672,F
2895,G,127,127,2638,285,2858,2896,2511,G
2895,H,92,92,2730,5100,7958,2896,2638,H
2895,M,613,613,3343,2900,10858,2896,2730,M
2895,N,2324,2324,5667,90,10948,2896,3343,N
2895,O,852,852,6519,1200,12148,2896,5667,O
2895,P,290,290,6809,3780,15928,2896,6519,P
2896,A,742,742,742,1360,1360,2897,0,A
2896,B,654,654,1396,90,1450,2897,742,B
2896,C,376,376,1772,800,2250,2897,1396,C
2896,D,1474,1474,3246,3780,6030,2897,1772,D
2896,M,1575,1575,4821,1738,7768,2897,3246,M
2896,N,205,205,5026,90,7858,2897,4821,N
2896,O,638,638,5664,820,8678,2897,5026,O
2896,N,940,940,6604,765,9443,2897,5664,N
2896,O,165,165,6769,535,9978,2897,6604,O
2896,P,590,590,7359,3780,13758,2897,6769,P
2897,AEI,62,62,62,1057,1057,2898,0,E
2897,AFI,175,113,175,1359,1359,2898,0,I
2897,AFJ,510,335,510,990,990,2898,0,A
2897,BFJ,1178,730,1240,240,1297,2898,62,F
2897,BGJ,772,42,1282,300,1290,2898,510,B
2897,CGJ,1365,258,1540,240,1599,2898,175,J
2897,CGK,729,429,1969,780,2077,2898,1240,G
2897,CHK,867,180,2149,1045,2335,2898,1282,C
2897,DHK,107,107,2256,1140,3475,2898,2149,D
2897,HK,786,70,2326,760,2359,2898,1540,K
2897,HL,860,503,2829,7680,9757,2898,1969,H
2897,L,3603,3100,5929,7680,10039,2898,2326,L
2897,M,2892,2892,8821,3055,13094,2898,5929,M
2897,N,349,349,9170,240,13334,2898,8821,N
2897,O,725,725,9895,765,14099,2898,9170,O
2897,N,236,236,10131,295,14394,2898,9895,N
2897,O,721,721,10852,1260,15654,2898,10131,O
2897,P,550,550,11402,3960,19614,2898,10852,P
2898,AE,700,700,700,1082,1082,2899,0,E
2898,AF,583,583,1283,240,1322,2899,700,F
2898,AG,164,164,1447,160,1482,2899,1283,G
2898,AH,3499,2052,3499,4770,4770,2899,0,A
2898,BH,1642,1642,5141,420,5190,2899,3499,B
2898,CH,1093,1093,6234,1015,6205,2899,5141,C
2898,DH,5725,938,7172,550,2032,2899,1447,H
2898,D,1486,548,7720,460,6665,2899,6234,D
2898,M,2010,2010,9730,4351,11016,2899,7720,M
2898,N,2379,2379,12109,90,11106,2899,9730,N
2898,O,976,976,13085,1195,12301,2899,12109,O
2898,N,773,773,13858,560,12861,2899,13085,N
2898,O,620,620,14478,890,13751,2899,13858,O
2898,P,16166,16166,30644,3780,17531,2899,14478,P
2899,AE,188,188,188,829,829,2900,0,E
2899,AF,733,733,921,150,979,2900,188,F
2899,AG,107,107,1028,100,1079,2900,921,G
2899,AF,438,438,1466,420,1499,2900,1028,F
2899,AG,654,654,2120,735,2234,2900,1466,G
2899,AH,1620,1620,3740,4230,6464,2900,2120,H
2899,A,11234,7494,11234,11708,11708,2900,0,A
2899,B,679,679,11913,250,11958,2900,11234,B
2899,C,1071,1071,12984,1540,13498,2900,11913,C
2899,B,2338,2338,15322,1870,15368,2900,12984,B
2899,C,1286,1286,16608,1411,16779,2900,15322,C
2899,D,8491,8491,25099,504,17283,2900,16608,D
2899,M,14,14,25113,33,17316,2900,25099,M
2899,N,469,469,25582,510,17826,2900,25113,N
2899,O,699,699,26281,875,18701,2900,25582,O
2899,N,2918,2918,29199,2690,21391,2900,26281,N
2899,O,874,874,30073,936,22327,2900,29199,O
2899,P,1883,1883,31956,474,22801,2900,30073,P
2900,AE,368,368,368,533,533,2901,0,E
2900,AF,207,207,575,90,623,2901,368,F
2900,AG,356,356,931,740,1363,2901,575,G
2900,AH,2223,1292,2223,2364,2364,2901,0,A
2900,BH,269,269,2492,90,2454,2901,2223,B
2900,CH,663,663,3155,815,3269,2901,2492,C
2900,BH,2977,2977,6132,2925,6194,2901,3155,B
2900,CH,380,380,6512,740,6934,2901,6132,C
2900,DH,1045,1045,7557,3780,10714,2901,6512,D
2900,H,13951,7325,14882,3780,5143,2901,931,H
2900,M,1689,1689,16571,3277,13991,2901,14882,M
2900,N,1621,1621,18192,90,14081,2901,16571,N
2900,O,415,415,18607,750,14831,2901,18192,O
2900,N,979,979,19586,630,15461,2901,18607,N
2900,O,703,703,20289,945,16406,2901,19586,O
2900,P,1515,1515,21804,3780,20186,2901,20289,P
2901,A,2087,2087,2087,2182,2182,2902,0,A
2901,B,120,120,2207,90,2272,2902,2087,B
2901,C,622,622,2829,820,3092,2902,2207,C
2901,D,7,7,2836,3780,6872,2902,2829,D
2901,M,283,283,3119,869,7741,2902,2836,M
2901,N,659,659,3778,90,7831,2902,3119,N
2901,O,410,410,4188,735,8566,2902,3778,O
2901,P,6227,6227,10415,3780,12346,2902,4188,P
2902,AE,386,386,386,1816,1816,2903,0,E
2902,AF,534,148,534,692,692,2903,0,A
2902,BF,328,328,862,240,932,2903,534,B
2902,CF,562,562,1424,731,1663,2903,862,C
2902,BF,1632,594,2018,240,2056,2903,386,F
2902,BG,781,187,2205,590,2253,2903,1424,B
2902,CG,731,544,2749,670,2726,2903,2018,G
2902,CF,752,208,2957,1080,3333,2903,2205,C
2902,DF,583,375,3332,690,3416,2903,2749,F
2902,DG,370,370,3702,268,3684,2903,3332,G
2902,DH,302,302,4004,632,4316,2903,3702,H
2902,D,1629,582,4586,3960,7293,2903,2957,D
2902,M,380,380,4966,388,7681,2903,4586,M
2902,N,131,131,5097,180,7861,2903,4966,N
2902,O,103,103,5200,235,8096,2903,5097,O
2902,N,797,797,5997,665,8761,2903,5200,N
2902,O,328,328,6325,465,9226,2903,5997,O
2902,P,4302,4302,10627,5760,14986,2903,6325,P
2903,AE,1515,1515,1515,2530,2530,2904,0,E
2903,AF,2459,944,2459,4336,4336,2904,0,A
2903,BF,1385,441,2900,430,2960,2904,1515,F
2903,BG,613,613,3513,790,3750,2904,2900,G
2903,BF,941,941,4454,795,4545,2904,3513,F
2903,BG,2063,68,4522,240,4576,2904,2459,B
2903,CG,378,310,4832,388,4933,2904,4454,G
2903,CH,362,362,5194,512,5445,2904,4832,H
2903,C,724,52,5246,695,5271,2904,4522,C
2903,B,410,410,5656,430,5701,2904,5246,B
2903,C,831,831,6487,1080,6781,2904,5656,C
2903,D,1712,1712,8199,3960,10741,2904,6487,D
2903,M,310,310,8509,900,11641,2904,8199,M
2903,N,650,650,9159,120,11761,2904,8509,N
2903,O,137,137,9296,235,11996,2904,9159,O
2903,N,1488,1488,10784,1365,13361,2904,9296,N
2903,O,697,697,11481,910,14271,2904,10784,O
2903,P,10953,10953,22434,5160,19431,2904,11481,P
2904,AE,164,164,164,298,298,2905,0,E
2904,AF,360,360,524,300,598,2905,164,F
2904,AG,1118,594,1118,1469,1469,2905,0,A
2904,BG,685,91,1209,830,1428,2905,524,G
2904,BF,584,493,1702,300,1769,2905,1118,B
2904,CF,1116,623,2325,935,2363,2905,1209,F
2904,CG,94,94,2419,90,2453,2905,2325,G
2904,CH,745,28,2447,825,2594,2905,1702,C
2904,BH,1089,1089,3536,1005,3599,2905,2447,B
2904,CH,339,339,3875,280,3879,2905,3536,C
2904,DH,3267,1811,5686,5060,7513,2905,2419,H
2904,D,3887,2076,7762,5120,8999,2905,3875,D
2904,M,1121,1121,8883,1132,10131,2905,7762,M
2904,N,127,127,9010,150,10281,2905,8883,N
2904,O,162,162,9172,280,10561,2905,9010,O
2904,P,415,415,9587,5160,15721,2905,9172,P
2905,AEI,51,51,51,123,123,2906,0,E
2905,AFI,103,52,103,108,108,2906,0,A
2905,BFI,87,87,190,135,243,2906,103,B
2905,CFI,259,120,310,240,363,2906,51,F
2905,CGI,185,65,375,285,528,2906,190,C
2905,DGI,97,97,472,5160,5688,2906,375,D
2905,GI,212,50,522,290,653,2906,310,G
2905,HI,1461,939,1461,1479,1479,2906,0,I
2905,HJ,280,280,1741,300,1779,2906,1461,J
2905,HK,1411,192,1933,5160,5813,2906,522,H
2905,K,530,338,2271,710,2489,2906,1741,K
2905,L,254,254,2525,1140,3629,2906,2271,L
2905,M,132,132,2657,253,6066,2906,2525,M
2905,N,235,235,2892,150,6216,2906,2657,N
2905,O,280,280,3172,140,6356,2906,2892,O
2905,P,3721,3721,6893,2900,9256,2906,3172,P
2906,AE,638,638,638,1535,1535,2907,0,A
2906,BE,1108,1108,1746,270,1805,2907,638,B
2906,CE,767,767,2513,800,2605,2907,1746,C
2906,DE,38,38,2551,4110,6715,2907,2513,D
2906,E,3001,450,3001,4157,4157,2907,0,E
2906,F,1531,1531,4532,420,4577,2907,3001,F
2906,G,940,940,5472,1160,5737,2907,4532,G
2906,H,8049,8049,13521,635,6372,2907,5472,H
2906,M,444,444,13965,1343,8058,2907,13521,M
2906,N,1019,1019,14984,180,8238,2907,13965,N
2906,O,905,905,15889,1050,9288,2907,14984,O
2906,N,767,767,16656,620,9908,2907,15889,N
2906,O,262,262,16918,260,10168,2907,16656,O
2906,P,92,92,17010,5100,15268,2907,16918,P
2907,AEI,147,147,147,795,795,2908,0,I
2907,AEJ,167,20,167,881,881,2908,0,E
2907,AFJ,532,365,532,1705,1705,2908,0,A
2907,BFJ,962,597,1129,300,1181,2908,167,F
2907,BGJ,1017,35,1164,400,1195,2908,147,J
2907,BGK,702,667,1831,720,1901,2908,1129,G
2907,BHK,1649,350,2181,555,2260,2908,532,B
2907,CHK,1479,462,2643,1210,2405,2908,1164,K
2907,CHL,1003,191,2834,310,2211,2908,1831,H
2907,CL,1292,639,3473,1235,3495,2908,2181,C
2907,DL,2392,2392,5865,550,4045,2908,3473,D
2907,L,5385,2163,8028,550,2955,2908,2643,L
2907,M,886,886,8914,12754,16799,2908,8028,M
2907,N,12256,12256,21170,420,17219,2908,8914,N
2907,O,559,559,21729,676,17895,2908,21170,O
2907,P,3652,3652,25381,3639,21534,2908,21729,P
2908,AE,25,25,25,74,74,2909,0,A
2908,BE,57,32,57,130,130,2909,0,E
2908,BF,132,100,157,135,209,2909,25,B
2908,CF,270,170,327,240,370,2909,57,F
2908,CG,210,40,367,290,499,2909,157,C
2908,DG,38,38,405,5160,5659,2909,367,D
2908,G,285,207,612,290,660,2909,327,G
2908,H,738,738,1350,5160,5820,2909,612,H
2908,M,1039,1039,2389,1571,7391,2909,1350,M
2908,N,646,646,3035,150,7541,2909,2389,N
2908,O,786,786,3821,1235,8776,2909,3035,O
2908,P,3011,3011,6832,3600,12376,2909,3821,P
2909,AEI,301,301,301,3399,3399,2910,0,E
2909,AFI,1757,1456,1757,2790,2790,2910,0,I
2909,AFJ,1323,1323,3080,300,3090,2910,1757,J
2909,AFK,3361,582,3662,300,3699,2910,301,F
2909,AGK,760,178,3840,840,3930,2910,3080,K
2909,AGL,90,90,3930,1560,5490,2910,3840,L
2909,AG,685,417,4347,740,4439,2910,3662,G
2909,AH,67,67,4414,1560,5999,2910,4347,H
2909,A,4592,178,4592,4650,4650,2910,0,A
2909,B,349,349,4941,300,4950,2910,4592,B
2909,C,566,566,5507,745,5695,2910,4941,C
2909,D,233,233,5740,1560,7255,2910,5507,D
2909,M,1465,1465,7205,1550,8805,2910,5740,M
2909,N,356,356,7561,300,9105,2910,7205,N
2909,O,1405,1405,8966,835,9940,2910,7561,O
2909,P,2359,2359,11325,1140,11080,2910,8966,P
2910,A,2392,2392,2392,2543,2543,2911,0,A
2910,B,201,201,2593,90,2633,2911,2392,B
2910,C,413,413,3006,820,3453,2911,2593,C
2910,D,337,337,3343,3780,7233,2911,3006,D
2910,M,2282,2282,5625,2612,9845,2911,3343,M
2910,N,360,360,5985,90,9935,2911,5625,N
2910,O,420,420,6405,815,10750,2911,5985,O
2910,P,8760,8760,15165,3780,14530,2911,6405,P
2911,AEI,1740,1740,1740,2100,2100,2912,0,I
2911,AEJ,405,405,2145,90,2190,2912,1740,J
2911,AEK,2505,360,2505,4845,4845,2912,0,A
2911,BEK,916,556,3061,800,2990,2912,2145,K
2911,BEL,829,829,3890,3780,6770,2912,3061,L
2911,BE,2900,1515,5405,605,5450,2912,2505,B
2911,CE,264,264,5669,460,5910,2912,5405,C
2911,BE,416,416,6085,185,6095,2912,5669,B
2911,CE,403,403,6488,840,6935,2912,6085,C
2911,BE,961,961,7449,490,7425,2912,6488,B
2911,CE,820,820,8269,1005,8430,2912,7449,C
2911,DE,565,565,8834,1200,9630,2912,8269,D
2911,E,21490,12656,21490,21898,21898,2912,0,E
2911,F,460,460,21950,90,21988,2912,21490,F
2911,G,377,377,22327,755,22743,2912,21950,G
2911,H,2087,2087,24414,3780,26523,2912,22327,H
2911,M,2372,2372,26786,2538,29061,2912,24414,M
2911,N,216,216,27002,90,29151,2912,26786,N
2911,O,413,413,27415,820,29971,2912,27002,O
2911,P,338,338,27753,3780,33751,2912,27415,P
2912,AE,413,413,413,399,399,2913,0,A
2912,BE,113,113,526,180,579,2913,413,B
2912,CE,1098,572,1098,1822,1822,2913,0,E
2912,CF,970,398,1496,935,1514,2913,526,C
2912,DF,754,356,1852,90,1912,2913,1098,F
2912,DG,806,450,2302,385,1899,2913,1496,D
2912,G,522,72,2374,726,2638,2913,1852,G
2912,F,1642,1642,4016,1405,4043,2913,2374,F
2912,G,771,771,4787,1245,5288,2913,4016,G
2912,H,1838,1838,6625,3780,9068,2913,4787,H
2912,M,1042,1042,7667,1534,10602,2913,6625,M
2912,N,847,847,8514,420,11022,2913,7667,N
2912,O,1118,1118,9632,1099,12121,2913,8514,O
2912,P,356,356,9988,351,12472,2913,9632,P
2913,AE,877,877,877,1031,1031,2914,0,A
2913,BE,223,223,1100,90,1121,2914,877,B
2913,CE,589,589,1689,815,1936,2914,1100,C
2913,DE,437,437,2126,3780,5716,2914,1689,D
2913,E,37018,34892,37018,37994,37994,2914,0,E
2913,F,1149,1149,38167,90,38084,2914,37018,F
2913,G,974,974,39141,1220,39304,2914,38167,G
2913,H,5,5,39146,3780,43084,2914,39141,H
2913,M,79,79,39225,859,43943,2914,39146,M
2913,N,810,810,40035,90,44033,2914,39225,N
2913,O,434,434,40469,860,44893,2914,40035,O
2913,P,1833,1833,42302,3780,48673,2914,40469,P
2914,AEI,711,711,711,5502,5502,2915,0,A
2914,BEI,2708,1997,2708,2902,2902,2915,0,I
2914,BEJ,221,221,2929,90,2992,2915,2708,J
2914,BEK,805,805,3734,1105,4097,2915,2929,K
2914,BEL,22,22,3756,3780,7877,2915,3734,L
2914,BE,4835,1790,5546,90,5592,2915,711,B
2914,CE,1308,1308,6854,1355,6947,2915,5546,C
2914,DE,2,2,6856,3780,10727,2915,6854,D
2914,E,37404,30548,37404,37208,37208,2915,0,E
2914,F,351,351,37755,90,37298,2915,37404,F
2914,G,1119,1119,38874,1385,38683,2915,37755,G
2914,H,648,648,39522,3780,42463,2915,38874,H
2914,M,2702,2702,42224,5022,47485,2915,39522,M
2914,N,2360,2360,44584,90,47575,2915,42224,N
2914,O,725,725,45309,1155,48730,2915,44584,O
2914,P,60,60,45369,3780,52510,2915,45309,P
2915,AEI,602,602,602,1021,1021,2916,0,E
2915,AFI,777,175,777,1184,1184,2916,0,I
2915,AFJ,778,1,778,1142,1142,2916,0,A
2915,BFJ,602,426,1204,240,1261,2916,602,F
2915,BGJ,429,3,1207,90,1232,2916,778,B
2915,CGJ,434,4,1211,90,1274,2916,777,J
2915,CGK,141,134,1345,390,1651,2916,1204,G
2915,CFK,902,764,2109,1250,2482,2916,1207,C
2915,DFK,773,9,2118,490,2141,2916,1345,F
2915,DGK,1078,171,2289,1290,2564,2916,1211,K
2915,DGL,675,495,2784,3780,6262,2916,2109,D
2915,GL,825,159,2943,1045,3186,2916,2118,G
2915,HL,675,21,2964,3780,6344,2916,2289,L
2915,H,304,283,3247,3960,7146,2916,2943,H
2915,M,1397,1397,4644,1988,9134,2916,3247,M
2915,N,648,648,5292,90,9224,2916,4644,N
2915,O,464,464,5756,880,10104,2916,5292,O
2915,P,450,450,6206,3780,13884,2916,5756,P
2916,AE,43,43,43,541,541,2917,0,A
2916,BE,752,752,795,300,841,2917,43,B
2916,CE,798,3,798,1303,1303,2917,0,E
2916,CF,706,706,1504,120,1423,2917,798,F
2916,CG,852,143,1647,890,1731,2917,795,C
2916,DG,967,824,2471,920,2343,2917,1504,G
2916,DH,1098,274,2745,310,2041,2917,1647,D
2916,H,791,517,3262,385,2728,2917,2471,H
2916,M,1364,1364,4626,2207,4935,2917,3262,M
2916,N,1218,1218,5844,420,5355,2917,4626,N
2916,O,201,201,6045,231,5586,2917,5844,O
2916,P,11,11,6056,384,5970,2917,6045,P
2917,AEI,1,1,1,335,335,2918,0,A
2917,BEI,478,478,479,180,515,2918,1,B
2917,CEI,913,913,1392,1160,1675,2918,479,C
2917,DEI,1646,254,1646,2518,2518,2918,0,I
2917,DEJ,723,469,2115,960,2635,2918,1392,D
2917,EJ,1102,633,2748,240,2758,2918,1646,J
2917,EK,2816,68,2816,3034,3034,2918,0,E
2917,FK,411,411,3227,240,3274,2918,2816,F
2917,GK,747,747,3974,740,4014,2918,3227,G
2917,FK,1286,60,4034,1050,3808,2918,2748,K
2917,FJ,492,492,4526,720,4528,2918,4034,J
2917,FK,700,148,4674,700,4714,2918,3974,F
2917,GK,561,413,5087,780,5308,2918,4526,K
2917,GL,590,177,5264,810,5524,2918,4674,G
2917,HL,812,635,5899,3960,9268,2918,5087,L
2917,H,805,170,6069,3960,9484,2918,5264,H
2917,M,7347,7347,13416,8191,17675,2918,6069,M
2917,N,1223,1223,14639,420,18095,2918,13416,N
2917,O,1256,1256,15895,1381,19476,2918,14639,O
2917,P,454,454,16349,504,19980,2918,15895,P
2918,A,2632,2632,2632,2993,2993,2919,0,A
2918,B,364,364,2996,90,3083,2919,2632,B
2918,C,397,397,3393,725,3808,2919,2996,C
2918,D,9779,9779,13172,3780,7588,2919,3393,D
2918,M,16513,16513,29685,16620,24208,2919,13172,M
2918,N,217,217,29902,180,24388,2919,29685,N
2918,O,649,649,30551,955,25343,2919,29902,O
2918,N,721,721,31272,355,25698,2919,30551,N
2918,O,830,830,32102,1070,26768,2919,31272,O
2918,P,61,61,32163,6900,33668,2919,32102,P
2919,AE,208,208,208,626,626,2920,0,E
2919,AF,347,139,347,662,662,2920,0,A
2919,BF,406,406,753,150,812,2920,347,B
2919,CF,607,62,815,240,866,2920,208,F
2919,CG,125,125,940,380,1246,2920,815,G
2919,CF,482,295,1235,745,1557,2920,753,C
2919,BF,330,35,1270,65,1311,2920,940,F
2919,BG,309,274,1544,15,1572,2920,1235,B
2919,CG,698,424,1968,785,2096,2920,1270,G
2919,CH,671,247,2215,555,2127,2920,1544,C
2919,DH,254,7,2222,3960,6056,2920,1968,H
2919,D,2327,2320,4542,4230,6357,2920,2215,D
2919,M,140,140,4682,401,6758,2920,4542,M
2919,N,286,286,4968,90,6848,2920,4682,N
2919,O,1549,1549,6517,1780,8628,2920,4968,O
2919,P,4,4,6521,3780,12408,2920,6517,P
2920,AE,27,27,27,135,135,2921,0,A
2920,BE,186,186,213,135,270,2921,27,B
2920,CE,154,154,367,285,555,2921,213,C
2920,DE,128,128,495,5160,5715,2921,367,D
2920,E,1970,1475,1970,2202,2202,2921,0,E
2920,F,296,296,2266,90,2292,2921,1970,F
2920,G,888,888,3154,1285,3577,2921,2266,G
2920,H,528,528,3682,3780,7357,2921,3154,H
2920,M,953,953,4635,2033,9390,2921,3682,M
2920,N,896,896,5531,90,9480,2921,4635,N
2920,O,919,919,6450,1240,10720,2921,5531,O
2920,P,324,324,6774,3780,14500,2921,6450,P
2921,AE,127,127,127,340,340,2922,0,A
2921,BE,254,127,254,440,440,2922,0,E
2921,BF,293,166,420,180,520,2922,127,B
2921,CF,358,192,612,240,680,2922,254,F
2921,CG,375,183,795,660,1180,2922,420,C
2921,DG,777,594,1389,975,1655,2922,612,G
2921,DF,838,838,2227,625,2280,2922,1389,F
2921,DG,149,149,2376,285,2565,2922,2227,G
2921,DH,1493,1493,3869,5100,7665,2922,2376,H
2921,D,9065,5991,9860,3960,5140,2922,795,D
2921,M,392,392,10252,921,8586,2922,9860,M
2921,N,626,626,10878,150,8736,2922,10252,N
2921,O,135,135,11013,115,8851,2922,10878,O
2921,N,1678,1678,12691,1585,10436,2922,11013,N
2921,O,538,538,13229,570,11006,2922,12691,O
2921,P,889,889,14118,4230,15236,2922,13229,P
2922,AEI,1304,1304,1304,1417,1417,2923,0,A
2922,BEI,1399,95,1399,2500,2500,2923,0,E
2922,BFI,262,167,1566,150,1567,2923,1304,B
2922,CFI,226,226,1792,135,1702,2923,1566,C
2922,BFI,267,267,2059,350,2052,2923,1792,B
2922,CFI,1159,499,2558,90,2590,2923,1399,F
2922,CGI,876,377,2935,765,2817,2923,2059,C
2922,DGI,38,38,2973,4230,7047,2923,2935,D
2922,GI,909,494,3467,1250,3840,2923,2558,G
2922,HI,3,3,3470,3780,7620,2923,3467,H
2922,I,36405,32935,36405,39494,39494,2923,0,I
2922,J,3120,3120,39525,90,39584,2923,36405,J
2922,K,990,990,40515,1220,40804,2923,39525,K
2922,L,3,3,40518,3780,44584,2923,40515,L
2922,M,1711,1711,42229,1981,46565,2923,40518,M
2922,N,299,299,42528,90,46655,2923,42229,N
2922,O,454,454,42982,860,47515,2923,42528,O
2922,P,378,378,43360,3780,51295,2923,42982,P
2923,A,70,70,70,110,110,2924,0,A
2923,B,118,118,188,135,245,2924,70,B
2923,C,274,274,462,285,530,2924,188,C
2923,D,86,86,548,5160,5690,2924,462,D
2923,M,159,159,707,430,6120,2924,548,M
2923,N,412,412,1119,180,6300,2924,707,N
2923,O,777,777,1896,545,6845,2924,1119,O
2923,N,171,171,2067,410,7255,2924,1896,N
2923,O,178,178,2245,130,7385,2924,2067,O
2923,P,1216,1216,3461,2850,10235,2924,2245,P
2924,AE,46,46,46,658,658,2925,0,A
2924,BE,284,238,284,391,391,2925,0,E
2924,BF,302,302,586,240,631,2925,284,F
2924,BG,215,215,801,285,916,2925,586,G
2924,BH,789,34,835,240,898,2925,46,B
2924,CH,355,355,1190,285,1183,2925,835,C
2924,DH,281,281,1471,5160,6343,2925,1190,D
2924,H,1164,494,1965,5160,6076,2925,801,H
2924,M,1441,1441,3406,4389,10732,2925,1965,M
2924,N,3056,3056,6462,90,10822,2925,3406,N
2924,O,962,962,7424,1250,12072,2925,6462,O
2924,N,860,860,8284,655,12727,2925,7424,N
2924,O,376,376,8660,705,13432,2925,8284,O
2924,P,3888,3888,12548,3780,17212,2925,8660,P
2925,AEI,65,65,65,998,998,2926,0,A
2925,BEI,70,5,70,998,998,2926,0,I
2925,BEJ,133,63,133,408,408,2926,0,E
2925,BFJ,327,327,460,90,498,2926,133,F
2925,BGJ,378,378,838,800,1298,2926,460,G
2925,BHJ,1121,348,1186,240,1238,2926,65,B
2925,CHJ,1119,3,1189,240,1238,2926,70,J
2925,CHK,850,847,2036,1020,2258,2926,1186,C
2925,DHK,983,136,2172,1020,2258,2926,1189,K
2925,DHL,3,3,2175,4680,6938,2926,2172,L
2925,DH,394,255,2430,4680,6938,2926,2036,D
2925,H,1817,225,2655,3780,5078,2926,838,H
2925,M,3336,3336,5991,3495,10433,2926,2655,M
2925,N,199,199,6190,90,10523,2926,5991,N
2925,O,445,445,6635,800,11323,2926,6190,O
2925,N,666,666,7301,315,11638,2926,6635,N
2925,O,205,205,7506,535,12173,2926,7301,O
2925,P,784,784,8290,3780,15953,2926,7506,P
2926,AE,107,107,107,797,797,2927,0,E
2926,AF,295,188,295,438,438,2927,0,A
2926,BF,178,178,473,90,528,2927,295,B
2926,CF,373,373,846,795,1323,2927,473,C
2926,DF,792,53,899,150,947,2927,107,F
2926,DG,155,155,1054,370,1317,2927,899,G
2926,DF,523,523,1577,300,1617,2927,1054,F
2926,DG,1452,721,2298,3780,5103,2927,846,D
2926,DG,721,0,2298,660,2277,2927,1577,G
2926,H,1097,1097,3395,4230,6507,2927,2298,H
2926,M,378,378,3773,879,7386,2927,3395,M
2926,N,620,620,4393,180,7566,2927,3773,N
2926,O,941,941,5334,900,8466,2927,4393,O
2926,P,451,451,5785,550,9016,2927,5334,P
2927,AE,303,303,303,835,835,2928,0,A
2927,BE,127,127,430,150,985,2928,303,B
2927,CE,521,521,951,205,1190,2928,430,C
2927,DE,1596,645,1596,1878,1878,2928,0,E
2927,DF,310,310,1906,90,1968,2928,1596,F
2927,DG,1463,508,2414,550,1740,2928,951,D
2927,G,585,77,2491,905,2873,2928,1906,G
2927,F,341,341,2832,20,2893,2928,2491,F
2927,G,849,849,3681,1300,4193,2928,2832,G
2927,H,3508,3508,7189,3780,7973,2928,3681,H
2927,M,431,431,7620,690,8663,2928,7189,M
2927,N,984,984,8604,780,9443,2928,7620,N
2927,O,1159,1159,9763,1259,10702,2928,8604,O
2927,P,1309,1309,11072,351,11053,2928,9763,P
2928,AE,546,546,546,1398,1398,2929,0,E
2928,AF,943,943,1489,150,1548,2929,546,F
2928,AG,1529,40,1529,1684,1684,2929,0,A
2928,BG,270,270,1799,150,1834,2929,1529,B
2928,CG,782,472,2271,1030,2578,2929,1489,G
2928,CF,717,245,2516,730,2564,2929,1799,C
2928,BF,1206,961,3477,925,3503,2929,2271,F
2928,BG,1039,78,3555,1005,3569,2929,2516,B
2928,CG,631,553,4108,705,4208,2929,3477,G
2928,CH,618,65,4173,705,4274,2929,3555,C
2928,DH,2934,2934,7107,4230,8504,2929,4173,D
2928,H,14307,11308,18415,4230,8438,2929,4108,H
2928,M,720,720,19135,725,9229,2929,18415,M
2928,N,258,258,19393,300,9529,2929,19135,N
2928,O,279,279,19672,835,10364,2929,19393,O
2928,N,1285,1285,20957,715,11079,2929,19672,N
2928,O,954,954,21911,1180,12259,2929,20957,O
2928,P,5719,5719,27630,3060,15319,2929,21911,P
2929,AEI,94,94,94,199,199,2930,0,E
2929,AFI,140,46,140,209,209,2930,0,I
2929,AFJ,204,64,204,767,767,2930,0,A
2929,BFJ,216,106,310,150,349,2930,94,F
2929,BGJ,184,14,324,180,389,2930,140,J
2929,BGK,82,68,392,110,459,2930,310,G
2929,BHK,3,3,395,4230,4689,2930,392,H
2929,BK,177,106,501,110,499,2930,324,K
2929,BL,9,9,510,2880,3379,2930,501,L
2929,B,660,354,864,150,917,2930,204,B
2929,C,128,128,992,110,1027,2930,864,C
2929,D,35,35,1027,4230,5257,2930,992,D
2929,M,209,209,1236,919,6176,2930,1027,M
2929,N,799,799,2035,150,6326,2930,1236,N
2929,O,176,176,2211,170,6496,2930,2035,O
2929,P,151,151,2362,2880,9376,2930,2211,P
2930,AE,136,136,136,1205,1205,2931,0,A
2930,BE,1207,1207,1343,180,1385,2931,136,B
2930,CE,1603,260,1603,1178,1178,2931,0,E
2930,CF,362,362,1965,90,1268,2931,1603,F
2930,CG,1070,448,2413,1133,2518,2931,1343,C
2930,DG,567,119,2532,815,2083,2931,1965,G
2930,DF,617,617,3149,1075,3158,2931,2532,F
2930,DG,1224,1224,4373,1790,4948,2931,3149,G
2930,DH,1013,1013,5386,3780,8728,2931,4373,H
2930,D,7727,4754,10140,4080,6598,2931,2413,D
2930,M,240,240,10380,290,9018,2931,10140,M
2930,N,287,287,10667,300,9318,2931,10380,N
2930,O,717,717,11384,725,10043,2931,10667,O
2930,P,3063,3063,14447,310,10353,2931,11384,P
2931,A,34,34,34,256,256,2932,0,A
2931,B,319,319,353,150,406,2932,34,B
2931,C,1847,1847,2200,624,1030,2932,353,C
2931,D,1032,1032,3232,720,1750,2932,2200,D
2931,M,2528,2528,5760,3366,5116,2932,3232,M
2931,N,989,989,6749,180,5296,2932,5760,N
2931,O,873,873,7622,885,6181,2932,6749,O
2931,P,5991,5991,13613,6680,12861,2932,7622,P
2932,AE,333,333,333,946,946,2933,0,E
2932,AF,825,492,825,1257,1257,2933,0,A
2932,BF,1115,623,1448,600,1546,2933,333,F
2932,BG,707,84,1532,180,1437,2933,825,B
2932,CG,780,696,2228,690,2236,2933,1448,G
2932,CF,147,147,2375,155,2391,2933,2228,F
2932,CG,953,110,2485,910,2347,2933,1532,C
2932,DG,746,636,3121,740,3131,2933,2375,G
2932,DH,213,213,3334,385,3516,2933,3121,H
2932,D,1381,532,3866,550,2897,2933,2485,D
2932,M,4641,4641,8507,5288,8804,2933,3866,M
2932,N,767,767,9274,180,8984,2933,8507,N
2932,O,744,744,10018,830,9814,2933,9274,O
2932,N,156,156,10174,70,9884,2933,10018,N
2932,O,1265,1265,11439,420,10304,2933,10174,O
2932,P,9466,9466,20905,7020,17324,2933,11439,P
2933,AEI,563,563,563,1034,1034,2934,0,E
2933,AFI,794,231,794,1201,1201,2934,0,A
2933,BFI,638,407,1201,180,1214,2934,563,F
2933,BGI,607,200,1401,180,1381,2934,794,B
2933,CGI,1796,395,1796,1992,1992,2934,0,I
2933,CGJ,902,307,2103,930,2144,2934,1201,G
2933,CHJ,316,9,2112,180,2172,2934,1796,J
2933,CHK,862,151,2263,910,2291,2934,1401,C
2933,DHK,397,397,2660,550,2841,2934,2263,D
2933,HK,814,266,2926,765,2937,2934,2112,K
2933,HL,1479,656,3582,550,2694,2934,2103,H
2933,L,3460,2804,6386,550,3487,2934,2926,L
2933,M,433,433,6819,1308,4795,2934,6386,M
2933,N,991,991,7810,180,4975,2934,6819,N
2933,O,172,172,7982,235,5210,2934,7810,O
2933,N,786,786,8768,705,5915,2934,7982,N
2933,O,691,691,9459,505,6420,2934,8768,O
2933,P,2816,2816,12275,6000,12420,2934,9459,P
2934,A,2116,2116,2116,2753,2753,2935,0,A
2934,B,1040,1040,3156,90,2843,2935,2116,B
2934,C,1175,1175,4331,1430,4273,2935,3156,C
2934,D,98,98,4429,3780,8053,2935,4331,D
2934,M,123,123,4552,342,8395,2935,4429,M
2934,N,252,252,4804,90,8485,2935,4552,N
2934,O,513,513,5317,850,9335,2935,4804,O
2934,P,919,919,6236,3780,13115,2935,5317,P
2935,AE,106,106,106,758,758,2936,0,A
2935,BE,391,285,391,688,688,2936,0,E
2935,BF,725,440,831,130,888,2936,106,B
2935,CF,465,25,856,210,898,2936,391,F
2935,CG,942,917,1773,900,1788,2936,831,C
2935,BG,1341,424,2197,2205,3103,2936,856,G
2935,BH,449,25,2222,465,2253,2936,1773,B
2935,CH,400,375,2597,1780,4883,2936,2197,H
2935,C,1205,830,3427,2305,4558,2936,2222,C
2935,D,1093,1093,4520,4625,9183,2936,3427,D
2935,M,1693,1693,6213,2597,11780,2936,4520,M
2935,N,1441,1441,7654,660,12440,2936,6213,N
2935,O,1345,1345,8999,1465,13905,2936,7654,O
2935,N,635,635,9634,480,14385,2936,8999,N
2935,O,343,343,9977,385,14770,2936,9634,O
2935,P,476,476,10453,370,15140,2936,9977,P
2936,A,1757,1757,1757,1940,1940,2937,0,A
2936,B,453,453,2210,300,2240,2937,1757,B
2936,C,469,469,2679,740,2980,2937,2210,C
2936,D,1363,1363,4042,3960,6940,2937,2679,D
2936,M,1502,1502,5544,2157,9097,2937,4042,M
2936,N,748,748,6292,150,9247,2937,5544,N
2936,O,76,76,6368,100,9347,2937,6292,O
2936,N,408,408,6776,390,9737,2937,6368,N
2936,O,153,153,6929,225,9962,2937,6776,O
2936,P,1013,1013,7942,4740,14702,2937,6929,P
2937,AEI,14,14,14,56,56,2938,0,I
2937,AEJ,239,239,253,240,296,2938,14,J
2937,AEK,602,349,602,2136,2136,2938,0,E
2937,AFK,597,248,850,785,1081,2938,253,K
2937,AFL,246,246,1096,3960,5041,2938,850,L
2937,AF,1535,439,1535,1600,1600,2938,0,A
2937,BF,305,305,1840,300,1900,2938,1535,B
2937,CF,1653,415,2255,180,2316,2938,602,F
2937,CG,758,343,2598,835,2735,2938,1840,C
2937,DG,769,426,3024,835,3151,2938,2255,G
2937,DF,1428,1428,4452,1360,4511,2938,3024,F
2937,DG,673,673,5125,640,5151,2938,4452,G
2937,DH,1503,1503,6628,5370,10521,2938,5125,H
2937,D,12535,8505,15133,1140,3875,2938,2598,D
2937,M,1364,1364,16497,1746,12267,2938,15133,M
2937,N,407,407,16904,90,12357,2938,16497,N
2937,O,1618,1618,18522,1780,14137,2938,16904,O
2937,N,529,529,19051,345,14482,2938,18522,N
2937,O,649,649,19700,965,15447,2938,19051,O
2937,P,1409,1409,21109,3780,19227,2938,19700,P
2938,A,1750,1750,1750,2566,2566,2939,0,A
2938,B,841,841,2591,90,2656,2939,1750,B
2938,C,542,542,3133,880,3536,2939,2591,C
2938,B,472,472,3605,110,3646,2939,3133,B
2938,C,1415,1415,5020,2315,5961,2939,3605,C
2938,D,4083,4083,9103,3420,9381,2939,5020,D
2938,M,1562,1562,10665,1905,11286,2939,9103,M
2938,N,364,364,11029,90,11376,2939,10665,N
2938,O,1604,1604,12633,1875,13251,2939,11029,O
2938,N,346,346,12979,60,13311,2939,12633,N
2938,O,188,188,13167,610,13921,2939,12979,O
2938,P,5340,5340,18507,3780,17701,2939,13167,P
2939,AEI,156,156,156,258,258,2940,0,A
2939,BEI,295,295,451,240,498,2940,156,B
2939,CEI,674,223,674,2238,2238,2940,0,I
2939,CEJ,155,155,829,90,2328,2940,674,J
2939,CEK,697,319,1148,285,783,2940,451,C
2939,DEK,70,70,1218,5160,5943,2940,1148,D
2939,EK,579,190,1408,735,3063,2940,829,K
2939,EJ,2138,2138,3546,540,3603,2940,1408,J
2939,EK,1130,1130,4676,1340,4943,2940,3546,K
2939,EL,3037,3037,7713,3780,8723,2940,4676,L
2939,E,10624,2911,10624,12187,12187,2940,0,E
2939,F,1581,1581,12205,90,12277,2940,10624,F
2939,G,805,805,13010,1060,13337,2940,12205,G
2939,F,861,861,13871,570,13907,2940,13010,F
2939,G,1275,1275,15146,1440,15347,2940,13871,G
2939,H,5362,5362,20508,3780,19127,2940,15146,H
2939,M,1823,1823,22331,4133,23260,2940,20508,M
2939,N,2374,2374,24705,90,23350,2940,22331,N
2939,O,1155,1155,25860,1370,24720,2940,24705,O
2939,N,361,361,26221,180,24900,2940,25860,N
2939,O,133,133,26354,585,25485,2940,26221,O
2939,P,10979,10979,37333,3780,29265,2940,26354,P
2940,AE,1388,1388,1388,1491,1491,2941,0,A
2940,BE,233,233,1621,240,1731,2941,1388,B
2940,CE,1804,183,1804,1797,1797,2941,0,E
2940,CF,213,213,2017,240,2037,2941,1804,F
2940,CG,1035,1035,3052,1335,3372,2941,2017,G
2940,CF,1519,88,3140,2700,4431,2941,1621,C
2940,BF,1971,1883,5023,1745,5117,2941,3052,F
2940,BG,620,620,5643,648,5765,2941,5023,G
2940,BH,2672,169,5812,1480,5911,2941,3140,B
2940,CH,340,171,5983,372,6137,2941,5643,H
2940,C,1483,1312,7295,1270,7181,2941,5812,C
2940,B,216,216,7511,370,7551,2941,7295,B
2940,C,1455,1455,8966,1620,9171,2941,7511,C
2940,D,1310,1310,10276,3960,13131,2941,8966,D
2940,M,1503,1503,11779,1436,14567,2941,10276,M
2940,N,210,210,11989,240,14807,2941,11779,N
2940,O,81,81,12070,390,15197,2941,11989,O
2940,N,802,802,12872,575,15772,2941,12070,N
2940,O,200,200,13072,505,16277,2941,12872,O
2940,P,2579,2579,15651,3960,20237,2941,13072,P
2941,A,1685,1685,1685,1957,1957,2942,0,A
2941,B,552,552,2237,300,2257,2942,1685,B
2941,C,858,858,3095,890,3147,2942,2237,C
2941,D,1069,1069,4164,385,3532,2942,3095,D
2941,M,826,826,4990,1432,4964,2942,4164,M
2941,N,726,726,5716,180,5144,2942,4990,N
2941,O,526,526,6242,740,5884,2942,5716,O
2941,N,724,724,6966,510,6394,2942,6242,N
2941,O,422,422,7388,470,6864,2942,6966,O
2941,P,2515,2515,9903,5760,12624,2942,7388,P
2942,A,3095,3095,3095,3210,3210,2943,0,A
2942,B,695,695,3790,640,3850,2943,3095,B
2942,C,777,777,4567,830,4680,2943,3790,C
2942,D,4528,4528,9095,550,5230,2943,4567,D
2942,M,81,81,9176,323,5553,2943,9095,M
2942,N,394,394,9570,180,5733,2943,9176,N
2942,O,510,510,10080,830,6563,2943,9570,O
2942,P,124,124,10204,6680,13243,2943,10080,P
2943,AEI,378,378,378,879,879,2944,0,E
2943,AFI,485,107,485,1182,1182,2944,0,A
2943,BFI,836,351,836,920,920,2944,0,I
2943,BFJ,620,162,998,180,1059,2944,378,F
2943,BGJ,244,82,1080,180,1100,2944,836,J
2943,BGK,785,190,1270,120,1302,2944,485,B
2943,CGK,941,669,1939,900,1959,2944,998,G
2943,CHK,1004,145,2084,930,2030,2944,1080,K
2943,CHL,995,181,2265,930,2232,2944,1270,C
2943,DHL,1804,1623,3888,550,2580,2944,2084,L
2943,DH,2677,1054,4942,385,2617,2944,2265,D
2943,H,4851,1848,6790,550,2509,2944,1939,H
2943,M,13069,13069,19859,13319,15936,2944,6790,M
2943,N,394,394,20253,180,16116,2944,19859,N
2943,O,981,981,21234,840,16956,2944,20253,O
2943,N,580,580,21814,725,17681,2944,21234,N
2943,O,666,666,22480,710,18391,2944,21814,O
2943,P,20070,20070,42550,6960,25351,2944,22480,P
2944,AEI,29,29,29,124,124,2945,0,A
2944,BEI,33,4,33,127,127,2945,0,E
2944,BFI,73,40,73,257,257,2945,0,I
2944,BFJ,172,132,205,135,262,2945,33,F
2944,BGJ,206,30,235,135,259,2945,29,B
2944,CGJ,184,154,389,285,547,2945,205,G
2944,CHJ,371,55,444,240,497,2945,73,J
2944,CHK,253,44,488,285,544,2945,235,C
2944,DHK,121,121,609,5160,5704,2945,488,D
2944,HK,185,20,629,290,787,2945,444,K
2944,HL,839,599,1228,5160,5707,2945,389,H
2944,L,802,203,1431,5160,5947,2945,629,L
2944,M,1566,1566,2997,1849,7796,2945,1431,M
2944,N,435,435,3432,180,7976,2945,2997,N
2944,O,874,874,4306,885,8861,2945,3432,O
2944,N,1049,1049,5355,1070,9931,2945,4306,N
2944,O,782,782,6137,360,10291,2945,5355,O
2944,P,5147,5147,11284,7020,17311,2945,6137,P
2945,AEI,15,15,15,44,44,2946,0,I
2945,AEJ,62,47,62,82,82,2946,0,A
2945,BEJ,129,82,144,135,179,2946,15,J
2945,BEK,119,37,181,150,232,2946,62,B
2945,CEK,99,99,280,185,417,2946,181,C
2945,DEK,176,40,320,295,474,2946,144,K
2945,DEL,140,100,420,375,792,2946,280,D
2945,EL,150,50,470,5100,5574,2946,320,L
2945,E,5498,5028,5498,5977,5977,2946,0,E
2945,F,1939,1939,7437,1500,7477,2946,5498,F
2945,G,966,966,8403,995,8472,2946,7437,G
2945,F,921,921,9324,910,9382,2946,8403,F
2945,G,185,185,9509,300,9682,2946,9324,G
2945,H,990,990,10499,5100,14782,2946,9509,H
2945,M,851,851,11350,1239,16021,2946,10499,M
2945,N,947,947,12297,180,16201,2946,11350,N
2945,O,240,240,12537,895,17096,2946,12297,O
2945,N,1071,1071,13608,855,17951,2946,12537,N
2945,O,654,654,14262,270,18221,2946,13608,O
2945,P,5277,5277,19539,7020,25241,2946,14262,P
2946,A,19,19,19,785,785,2947,0,A
2946,B,945,945,964,240,1025,2947,19,B
2946,C,930,930,1894,740,1765,2947,964,C
2946,D,12190,12190,14084,5100,6865,2947,1894,D
2946,M,1034,1034,15118,2849,9714,2947,14084,M
2946,N,1870,1870,16988,90,9804,2947,15118,N
2946,O,460,460,17448,805,10609,2947,16988,O
2946,N,1593,1593,19041,1260,11869,2947,17448,N
2946,O,757,757,19798,935,12804,2947,19041,O
2946,P,784,784,20582,3780,16584,2947,19798,P
2947,AEI,91,91,91,1251,1251,2948,0,A
2947,BEI,1190,1190,1281,90,1341,2948,91,B
2947,CEI,1059,1059,2340,1210,2551,2948,1281,C
2947,DEI,323,323,2663,3780,6331,2948,2340,D
2947,EI,3432,769,3432,4562,4562,2948,0,E
2947,FI,1516,1516,4948,90,4652,2948,3432,F
2947,GI,1196,1196,6144,1405,6057,2948,4948,G
2947,HI,43,43,6187,3780,9837,2948,6144,H
2947,I,23532,17345,23532,24714,24714,2948,0,I
2947,J,1207,1207,24739,90,24804,2948,23532,J
2947,K,1567,1567,26306,1365,26169,2948,24739,K
2947,L,61,61,26367,3780,29949,2948,26306,L
2947,M,739,739,27106,1233,31182,2948,26367,M
2947,N,557,557,27663,90,31272,2948,27106,N
2947,O,458,458,28121,790,32062,2948,27663,O
2947,P,929,929,29050,3780,35842,2948,28121,P
2948,A,557,557,557,644,644,2949,0,A
2948,B,282,282,839,240,884,2949,557,B
2948,C,693,693,1532,845,1729,2949,839,C
2948,D,3270,3270,4802,5220,6949,2949,1532,D
2948,M,4495,4495,9297,4620,11569,2949,4802,M
2948,N,387,387,9684,300,11869,2949,9297,N
2948,O,930,930,10614,1015,12884,2949,9684,O
2948,N,1321,1321,11935,1235,14119,2949,10614,N
2948,O,981,981,12916,930,15049,2949,11935,O
2948,P,1373,1373,14289,2760,17809,2949,12916,P
2949,A,135,135,135,220,220,2950,0,A
2949,B,174,174,309,150,370,2950,135,B
2949,C,254,254,563,80,450,2950,309,C
2949,D,11,11,574,2880,3330,2950,563,D
2949,M,509,509,1083,1398,4728,2950,574,M
2949,N,926,926,2009,90,4818,2950,1083,N
2949,O,853,853,2862,1200,6018,2950,2009,O
2949,P,1275,1275,4137,3780,9798,2950,2862,P
2950,AEI,18,18,18,2950,2950,2951,0,E
2950,AFI,737,719,737,1140,1140,2951,0,I
2950,AFJ,523,523,1260,180,1320,2951,737,J
2950,AFK,1109,1109,2369,1045,2365,2951,1260,K
2950,AFL,3135,784,3153,250,3200,2951,18,F
2950,AGL,1199,1199,4352,1110,4310,2951,3153,G
2950,AHL,2091,108,4460,550,2915,2951,2369,L
2950,AH,392,284,4744,550,4860,2951,4352,H
2950,A,11817,7073,11817,11741,11741,2951,0,A
2950,B,188,188,12005,330,12071,2951,11817,B
2950,C,1102,1102,13107,1065,13136,2951,12005,C
2950,D,1552,1552,14659,550,13686,2951,13107,D
2950,M,593,593,15252,1125,14811,2951,14659,M
2950,N,557,557,15809,90,14901,2951,15252,N
2950,O,828,828,16637,1195,16096,2951,15809,O
2950,N,519,519,17156,150,16246,2951,16637,N
2950,O,263,263,17419,535,16781,2951,17156,O
2950,P,93,93,17512,3780,20561,2951,17419,P
2951,AEI,41,41,41,2984,2984,2952,0,E
2951,AFI,135,94,135,109,109,2952,0,A
2951,BFI,175,175,310,240,349,2952,135,B
2951,CFI,1149,839,1149,1329,1329,2952,0,I
2951,CFJ,909,70,1219,1180,1529,2952,310,C
2951,BFJ,300,230,1449,180,1509,2952,1149,J
2951,BFK,292,292,1741,260,1769,2952,1449,K
2951,BFL,1234,712,2453,1040,2569,2952,1219,B
2951,CFL,474,474,2927,575,3144,2952,2453,C
2951,DFL,3133,247,3174,240,3224,2952,41,F
2951,DGL,937,937,4111,1180,4404,2952,3174,G
2951,DFL,761,761,4872,550,4954,2952,4111,F
2951,DGL,541,541,5413,555,5509,2952,4872,G
2951,DHL,6724,3052,8465,375,2144,2952,1741,L
2951,DH,3537,485,8950,420,5929,2952,5413,H
2951,D,7261,1238,10188,450,3594,2952,2927,D
2951,M,1700,1700,11888,2046,7975,2952,10188,M
2951,N,697,697,12585,390,8365,2952,11888,N
2951,O,268,268,12853,220,8585,2952,12585,O
2951,P,3950,3950,16803,375,8960,2952,12853,P
2952,AEI,66,66,66,164,164,2953,0,E
2952,AFI,157,91,157,162,162,2953,0,I
2952,AFJ,83,83,240,135,297,2953,157,J
2952,AFK,183,9,249,135,299,2953,66,F
2952,AGK,169,169,418,285,584,2953,249,G
2952,AHK,181,3,421,280,577,2953,240,K
2952,AHL,152,149,570,5160,5744,2953,418,H
2952,AL,630,60,630,1384,1384,2953,0,A
2952,BL,781,781,1411,90,1474,2953,630,B
2952,CL,1720,730,2141,5160,5737,2953,421,L
2952,C,1115,385,2526,1330,2804,2953,1411,C
2952,D,1338,1338,3864,3780,6584,2953,2526,D
2952,M,666,666,4530,1049,7633,2953,3864,M
2952,N,412,412,4942,90,7723,2953,4530,N
2952,O,978,978,5920,1240,8963,2953,4942,O
2952,P,61,61,5981,3780,12743,2953,5920,P
2953,A,203,203,203,500,500,2954,0,A
2953,B,330,330,533,90,590,2954,203,B
2953,C,550,550,1083,845,1435,2954,533,C
2953,D,392,392,1475,3780,5215,2954,1083,D
2953,M,7628,7628,9103,9716,14931,2954,1475,M
2953,N,2248,2248,11351,180,15111,2954,9103,N
2953,O,599,599,11950,850,15961,2954,11351,O
2953,N,3264,3264,15214,3015,18976,2954,11950,N
2953,O,1057,1057,16271,2205,21181,2954,15214,O
2953,P,1387,1387,17658,810,21991,2954,16271,P
2954,AEI,130,130,130,485,485,2955,0,I
2954,AEJ,136,6,136,619,619,2955,0,E
2954,AFJ,856,850,986,600,1085,2955,130,J
2954,AFK,1103,253,1239,600,1219,2955,136,F
2954,AGK,833,580,1819,810,1895,2955,986,K
2954,AGL,1890,71,1890,2298,2298,2955,0,A
2954,BGL,1003,352,2242,935,2154,2955,1239,G
2954,BHL,664,241,2483,385,2280,2955,1819,L
2954,BH,1131,538,3021,785,3083,2955,1890,B
2954,CH,1237,458,3479,385,2539,2955,2242,H
2954,C,1255,797,4276,1200,4283,2955,3021,C
2954,D,1546,1546,5822,550,4833,2955,4276,D
2954,M,2361,2361,8183,2384,7217,2955,5822,M
2954,N,276,276,8459,300,7517,2955,8183,N
2954,O,556,556,9015,760,8277,2955,8459,O
2954,P,1686,1686,10701,4020,12297,2955,9015,P
2955,AEI,162,162,162,154,154,2956,0,E
2955,AFI,92,92,254,150,304,2956,162,F
2955,AGI,135,135,389,130,434,2956,254,G
2955,AFI,468,79,468,1405,1405,2956,0,I
2955,AFJ,509,41,509,1216,1216,2956,0,A
2955,BFJ,739,739,1248,90,1306,2956,509,B
2955,CFJ,909,50,1298,2340,2774,2956,389,F
2955,CGJ,965,135,1433,90,1495,2956,468,J
2955,CGK,308,173,1606,650,3424,2956,1298,G
2955,CHK,526,168,1774,880,2186,2956,1248,C
2955,BHK,633,292,2066,905,2400,2956,1433,K
2955,BHJ,474,182,2248,110,2296,2956,1774,B
2955,CHJ,379,197,2445,90,2490,2956,2066,J
2955,CHK,1465,1465,3910,2320,4810,2956,2445,K
2955,CHL,4861,2557,6467,4230,7654,2956,1606,H
2955,CL,4343,124,6591,2315,4611,2956,2248,C
2955,DL,1497,1497,8088,3420,8031,2956,6591,D
2955,L,5598,1420,9508,3420,8230,2956,3910,L
2955,M,5217,5217,14725,5366,13596,2956,9508,M
2955,N,269,269,14994,180,13776,2956,14725,N
2955,O,1280,1280,16274,935,14711,2956,14994,O
2955,P,396,396,16670,660,15371,2956,16274,P
2956,A,1053,1053,1053,1956,1956,2957,0,A
2956,B,2223,2223,3276,90,2046,2957,1053,B
2956,C,1134,1134,4410,1390,3436,2957,3276,C
2956,B,2341,2341,6751,3375,6811,2957,4410,B
2956,C,202,202,6953,585,7396,2957,6751,C
2956,D,82233,82233,89186,3780,11176,2957,6953,D
2956,M,3,3,89189,45,11221,2957,89186,M
2956,N,419,419,89608,390,11611,2957,89189,N
2956,O,965,965,90573,1175,12786,2957,89608,O
2956,N,1214,1214,91787,1070,13856,2957,90573,N
2956,O,223,223,92010,390,14246,2957,91787,O
2956,P,355,355,92365,485,14731,2957,92010,P
2957,A,108,108,108,210,210,2958,0,A
2957,B,156,156,264,120,330,2958,108,B
2957,C,159,159,423,105,435,2958,264,C
2957,B,836,836,1259,880,1315,2958,423,B
2957,C,340,340,1599,185,1500,2958,1259,C
2957,D,330,330,1929,2880,4380,2958,1599,D
2957,M,946,946,2875,2561,6941,2958,1929,M
2957,N,1755,1755,4630,180,7121,2958,2875,N
2957,O,689,689,5319,895,8016,2958,4630,O
2957,N,1571,1571,6890,1365,9381,2958,5319,N
2957,O,695,695,7585,620,10001,2958,6890,O
2957,P,1147,1147,8732,6960,16961,2958,7585,P
2958,AE,6,6,6,102,102,2959,0,A
2958,BE,198,198,204,150,252,2959,6,B
2958,CE,216,216,420,115,367,2959,204,C
2958,DE,574,574,994,4230,4597,2959,420,D
2958,E,4074,3080,4074,4280,4280,2959,0,E
2958,F,246,246,4320,90,4370,2959,4074,F
2958,G,966,966,5286,1270,5640,2959,4320,G
2958,H,562,562,5848,3780,9420,2959,5286,H
2958,M,167,167,6015,920,10340,2959,5848,M
2958,N,852,852,6867,150,10490,2959,6015,N
2958,O,190,190,7057,170,10660,2959,6867,O
2958,P,22,22,7079,2880,13540,2959,7057,P
2959,AE,9,9,9,150,150,2960,0,E
2959,AF,258,258,267,180,330,2960,9,F
2959,AG,350,350,617,535,865,2960,267,G
2959,AH,1198,581,1198,1337,1337,2960,0,A
2959,BH,244,244,1442,150,1487,2960,1198,B
2959,CH,644,644,2086,665,2152,2960,1442,C
2959,BH,618,618,2704,610,2762,2960,2086,B
2959,CH,170,170,2874,895,3657,2960,2704,C
2959,DH,3235,978,3852,2760,3625,2960,617,H
2959,D,1010,32,3884,3490,7147,2960,2874,D
2959,M,389,389,4273,350,7497,2960,3884,M
2959,N,56,56,4329,210,7707,2960,4273,N
2959,O,1118,1118,5447,955,8662,2960,4329,O
2959,N,313,313,5760,420,9082,2960,5447,N
2959,O,689,689,6449,755,9837,2960,5760,O
2959,P,7360,7360,13809,4140,13977,2960,6449,P
2960,A,34,34,34,1091,1091,2961,0,A
2960,B,2694,2694,2728,240,1331,2961,34,B
2960,C,799,799,3527,760,2091,2961,2728,C
2960,D,693,693,4220,7680,9771,2961,3527,D
2960,M,1545,1545,5765,1756,11527,2961,4220,M
2960,N,312,312,6077,150,11677,2961,5765,N
2960,O,513,513,6590,495,12172,2961,6077,O
2960,N,791,791,7381,790,12962,2961,6590,N
2960,O,467,467,7848,706,13668,2961,7381,O
2960,P,27789,27789,35637,3630,17298,2961,7848,P
2961,A,593,593,593,1145,1145,2962,0,A
2961,B,587,587,1180,90,1235,2962,593,B
2961,C,994,994,2174,1240,2475,2962,1180,C
2961,D,131,131,2305,3780,6255,2962,2174,D
2961,M,216,216,2521,806,7061,2962,2305,M
2961,N,626,626,3147,90,7151,2962,2521,N
2961,O,560,560,3707,705,7856,2962,3147,O
2961,P,381,381,4088,3780,11636,2962,3707,P
2962,AEI,684,684,684,1555,1555,2963,0,I
2962,AEJ,1477,793,1477,1611,1611,2963,0,E
2962,AFJ,376,376,1853,300,1911,2963,1477,F
2962,AGJ,1246,77,1930,420,1975,2963,684,J
2962,AGK,709,709,2639,888,2863,2963,1930,K
2962,AGL,895,109,2748,1075,2986,2963,1853,G
2962,AFL,502,393,3141,402,3265,2963,2639,L
2962,AF,566,173,3314,380,3366,2963,2748,F
2962,AG,177,177,3491,188,3554,2963,3314,G
2962,AH,907,907,4398,402,3956,2963,3491,H
2962,A,5759,1361,5759,4887,4887,2963,0,A
2962,B,568,568,6327,1500,6387,2963,5759,B
2962,C,756,756,7083,1000,7387,2963,6327,C
2962,B,1327,1327,8410,1130,8517,2963,7083,B
2962,C,646,646,9056,690,9207,2963,8410,C
2962,B,14,14,9070,30,9237,2963,9056,B
2962,C,523,523,9593,420,9657,2963,9070,C
2962,D,134,134,9727,5100,14757,2963,9593,D
2962,M,695,695,10422,896,15653,2963,9727,M
2962,N,403,403,10825,240,15893,2963,10422,N
2962,O,278,278,11103,397,16290,2963,10825,O
2962,P,3967,3967,15070,1228,17518,2963,11103,P
2963,AEI,14,14,14,154,154,2964,0,A
2963,BEI,404,404,418,240,394,2964,14,B
2963,CEI,614,196,614,1082,1082,2964,0,I
2963,CEJ,516,516,1130,90,1172,2964,614,J
2963,CEK,785,73,1203,1040,1434,2964,418,C
2963,DEK,520,520,1723,3960,5394,2964,1203,D
2963,EK,905,312,2035,1250,2422,2964,1130,K
2963,EL,586,586,2621,3780,6202,2964,2035,L
2963,E,37927,35306,37927,42314,42314,2964,0,E
2963,F,4421,4421,42348,90,42404,2964,37927,F
2963,G,1005,1005,43353,1210,43614,2964,42348,G
2963,H,16,16,43369,3780,47394,2964,43353,H
2963,M,503,503,43872,1113,48507,2964,43369,M
2963,N,640,640,44512,90,48597,2964,43872,N
2963,O,304,304,44816,705,49302,2964,44512,O
2963,P,82,82,44898,3780,53082,2964,44816,P
2964,A,124,124,124,260,260,2965,0,A
2964,B,556,556,680,480,740,2965,124,B
2964,C,705,705,1385,720,1460,2965,680,C
2964,D,935,935,2320,550,2010,2965,1385,D
2964,M,832,832,3152,1269,3279,2965,2320,M
2964,N,1193,1193,4345,780,4059,2965,3152,N
2964,O,1014,1014,5359,1220,5279,2965,4345,O
2964,P,5598,5598,10957,635,5914,2965,5359,P
2965,AEI,1160,1160,1160,1265,1265,2966,0,A
2965,BEI,164,164,1324,90,1355,2966,1160,B
2965,CEI,744,744,2068,1105,2460,2966,1324,C
2965,BEI,2389,321,2389,3202,3202,2966,0,E
2965,BFI,935,614,3003,605,3065,2966,2068,B
2965,CFI,63,63,3066,630,3695,2966,3003,C
2965,DFI,880,203,3269,90,3292,2966,2389,F
2965,DGI,253,50,3319,3780,7475,2966,3066,D
2965,GI,572,522,3841,820,4112,2966,3269,G
2965,FI,4028,187,4028,4710,4710,2966,0,I
2965,FJ,725,725,4753,90,4800,2966,4028,J
2965,FK,221,221,4974,625,5425,2966,4753,K
2965,FL,1818,685,5659,1580,5692,2966,3841,F
2965,GL,225,225,5884,630,6322,2966,5659,G
2965,HL,5728,5728,11612,3780,10102,2966,5884,H
2965,L,9116,2478,14090,3780,9205,2966,4974,L
2965,M,1964,1964,16054,2225,12327,2966,14090,M
2965,N,395,395,16449,180,12507,2966,16054,N
2965,O,390,390,16839,545,13052,2966,16449,O
2965,P,101,101,16940,4080,17132,2966,16839,P
2966,A,34,34,34,110,110,2967,0,A
2966,B,153,153,187,135,245,2967,34,B
2966,C,209,209,396,295,540,2967,187,C
2966,D,128,128,524,5100,5640,2967,396,D
2966,M,116,116,640,349,5989,2967,524,M
2966,N,388,388,1028,180,6169,2967,640,N
2966,O,715,715,1743,895,7064,2967,1028,O
2966,N,145,145,1888,240,7304,2967,1743,N
2966,O,651,651,2539,660,7964,2967,1888,O
2966,P,2356,2356,4895,6660,14624,2967,2539,P
2967,A,577,577,577,1070,1070,2968,0,A
2967,B,600,600,1177,150,1220,2968,577,B
2967,C,157,157,1334,125,1345,2968,1177,C
2967,B,131,131,1465,155,1500,2968,1334,B
2967,C,299,299,1764,650,2150,2968,1465,C
2967,D,3269,3269,5033,4230,6380,2968,1764,D
2967,M,1586,1586,6619,1766,8146,2968,5033,M
2967,N,276,276,6895,150,8296,2968,6619,N
2967,O,592,592,7487,580,8876,2968,6895,O
2967,N,366,366,7853,370,9246,2968,7487,N
2967,O,150,150,8003,1055,10301,2968,7853,O
2967,P,1229,1229,9232,3300,13601,2968,8003,P
2968,AE,693,693,693,1228,1228,2969,0,E
2968,AF,561,561,1254,90,1318,2969,693,F
2968,AG,416,416,1670,765,2083,2969,1254,G
2968,AH,4288,2618,4288,4767,4767,2969,0,A
2968,BH,501,501,4789,90,4857,2969,4288,B
2968,CH,412,412,5201,760,5617,2969,4789,C
2968,DH,4592,1061,6262,3780,5863,2969,1670,H
2968,D,2571,1510,7772,3780,9397,2969,5201,D
2968,M,7290,7290,15062,7303,16700,2969,7772,M
2968,N,268,268,15330,300,17000,2969,15062,N
2968,O,298,298,15628,510,17510,2969,15330,O
2968,P,1030,1030,16658,3960,21470,2969,15628,P
2969,A,7405,7405,7405,7591,7591,2970,0,A
2969,B,385,385,7790,240,7831,2970,7405,B
2969,C,980,980,8770,995,8826,2970,7790,C
2969,B,397,397,9167,410,9236,2970,8770,B
2969,C,640,640,9807,810,10046,2970,9167,C
2969,D,1441,1441,11248,3960,14006,2970,9807,D
2969,M,2198,2198,13446,3807,17813,2970,11248,M
2969,N,2011,2011,15457,420,18233,2970,13446,N
2969,O,575,575,16032,676,18909,2970,15457,O
2969,P,5029,5029,21061,759,19668,2970,16032,P
2970,AE,322,322,322,738,738,2971,0,E
2970,AF,606,606,928,240,978,2971,322,F
2970,AG,168,168,1096,405,1383,2971,928,G
2970,AF,1257,161,1257,2325,2325,2971,0,A
2970,BF,1176,1176,2433,150,2475,2971,1257,B
2970,CF,1559,222,2655,1295,2678,2971,1096,F
2970,CG,230,8,2663,180,2655,2971,2433,C
2970,BG,332,324,2987,915,3593,2971,2655,G
2970,BH,1545,1221,4208,1570,4225,2971,2663,B
2970,CH,293,293,4501,645,4870,2971,4208,C
2970,DH,3306,3306,7807,4230,9100,2971,4501,D
2970,H,9143,4323,12130,3960,7553,2971,2987,H
2970,M,1474,1474,13604,1474,10574,2971,12130,M
2970,N,350,350,13954,410,10984,2971,13604,N
2970,O,931,931,14885,1085,12069,2971,13954,O
2970,N,744,744,15629,630,12699,2971,14885,N
2970,O,315,315,15944,385,13084,2971,15629,O
2970,P,4929,4929,20873,370,13454,2971,15944,P
2971,AE,81,81,81,305,305,2972,0,A
2971,BE,344,344,425,180,485,2972,81,B
2971,CE,369,369,794,660,1145,2972,425,C
2971,DE,373,373,1167,3960,5105,2972,794,D
2971,E,11360,10193,11360,11545,11545,2972,0,E
2971,F,213,213,11573,90,11635,2972,11360,F
2971,G,879,879,12452,1240,12875,2972,11573,G
2971,H,794,794,13246,3780,16655,2972,12452,H
2971,M,1818,1818,15064,5021,21676,2972,13246,M
2971,N,3221,3221,18285,90,21766,2972,15064,N
2971,O,1258,1258,19543,1365,23131,2972,18285,O
2971,N,261,261,19804,145,23276,2972,19543,N
2971,O,232,232,20036,605,23881,2972,19804,O
2971,P,7324,7324,27360,3780,27661,2972,20036,P
2972,A,79,79,79,145,145,2973,0,A
2972,B,152,152,231,150,295,2973,79,B
2972,C,136,136,367,80,375,2973,231,C
2972,B,586,586,953,635,1010,2973,367,B
2972,C,131,131,1084,135,1145,2973,953,C
2972,D,27,27,1111,2795,3940,2973,1084,D
2972,M,149,149,1260,239,4179,2973,1111,M
2972,N,194,194,1454,150,4329,2973,1260,N
2972,O,88,88,1542,90,4419,2973,1454,O
2972,P,3695,3695,5237,2880,7299,2973,1542,P
2973,AE,270,270,270,335,335,2974,0,A
2973,BE,315,315,585,300,635,2974,270,B
2973,CE,795,795,1380,870,1505,2974,585,C
2973,DE,295,295,1675,1620,3125,2974,1380,D
2973,E,4648,2973,4648,4674,4674,2974,0,E
2973,F,322,322,4970,300,4974,2974,4648,F
2973,G,730,730,5700,880,5854,2974,4970,G
2973,H,74,74,5774,1620,7474,2974,5700,H
2973,M,1418,1418,7192,1462,8936,2974,5774,M
2973,N,295,295,7487,300,9236,2974,7192,N
2973,O,636,636,8123,805,10041,2974,7487,O
2973,P,859,859,8982,4080,14121,2974,8123,P
2974,A,1300,1300,1300,1415,1415,2975,0,A
2974,B,403,403,1703,300,1715,2975,1300,B
2974,C,851,851,2554,1040,2755,2975,1703,C
2974,D,241,241,2795,720,3475,2975,2554,D
2974,M,865,865,3660,3110,6585,2975,2795,M
2974,N,2274,2274,5934,90,6675,2975,3660,N
2974,O,896,896,6830,1250,7925,2975,5934,O
2974,P,533,533,7363,3840,11765,2975,6830,P
2975,AEI,75,75,75,1199,1199,2976,0,A
2975,BEI,87,12,87,1086,1086,2976,0,E
2975,BFI,154,67,154,1330,1330,2976,0,I
2975,BFJ,1190,1123,1277,240,1326,2976,87,F
2975,BGJ,1315,113,1390,240,1439,2976,75,B
2975,CGJ,1359,123,1513,240,1570,2976,154,J
2975,CGK,824,588,2101,780,2106,2976,1277,G
2975,CHK,753,42,2143,780,2219,2976,1390,C
2975,DHK,669,39,2182,780,2350,2976,1513,K
2975,DHL,798,798,2980,7740,10090,2976,2182,L
2975,DH,1545,708,3688,7680,9899,2976,2143,D
2975,H,2434,847,4535,7740,9846,2976,2101,H
2975,M,330,330,4865,1565,11655,2976,4535,M
2975,N,1493,1493,6358,300,11955,2976,4865,N
2975,O,479,479,6837,2045,14000,2976,6358,O
2975,P,1660,1660,8497,1860,15860,2976,6837,P
2976,A,18,18,18,203,203,2977,0,A
2976,B,279,279,297,135,338,2977,18,B
2976,C,152,152,449,285,623,2977,297,C
2976,D,193,193,642,5160,5783,2977,449,D
2976,M,2082,2082,2724,2690,8473,2977,642,M
2976,N,760,760,3484,180,8653,2977,2724,N
2976,O,661,661,4145,885,9538,2977,3484,O
2976,P,6342,6342,10487,6680,16218,2977,4145,P
2977,A,253,253,253,395,395,2978,0,A
2977,B,227,227,480,150,545,2978,253,B
2977,C,76,76,556,690,1235,2978,480,C
2977,B,1269,1269,1825,665,1900,2978,556,B
2977,C,823,823,2648,835,2735,2978,1825,C
2977,D,1378,1378,4026,4020,6755,2978,2648,D
2977,M,381,381,4407,520,7275,2978,4026,M
2977,N,255,255,4662,150,7425,2978,4407,N
2977,O,494,494,5156,555,7980,2978,4662,O
2977,N,200,200,5356,120,8100,2978,5156,N
2977,O,126,126,5482,125,8225,2978,5356,O
2977,P,1584,1584,7066,2880,11105,2978,5482,P
2978,AE,917,917,917,1347,1347,2979,0,A
2978,BE,878,878,1795,90,1437,2979,917,B
2978,CE,889,889,2684,1250,2687,2979,1795,C
2978,DE,293,293,2977,3780,6467,2979,2684,D
2978,E,3262,285,3262,4529,4529,2979,0,E
2978,F,1298,1298,4560,90,4619,2979,3262,F
2978,G,1167,1167,5727,1405,6024,2979,4560,G
2978,H,355,355,6082,3780,9804,2979,5727,H
2978,M,3974,3974,10056,4322,14126,2979,6082,M
2978,N,377,377,10433,90,14216,2979,10056,N
2978,O,510,510,10943,850,15066,2979,10433,O
2978,P,418,418,11361,3780,18846,2979,10943,P
2979,AE,588,588,588,1452,1452,2980,0,A
2979,BE,889,889,1477,90,1542,2980,588,B
2979,CE,513,513,1990,880,2422,2980,1477,C
2979,BE,2010,20,2010,2872,2872,2980,0,E
2979,BF,485,465,2475,115,2537,2980,1990,B
2979,CF,887,422,2897,90,2962,2980,2010,F
2979,CG,513,513,3410,880,3842,2980,2897,G
2979,CF,485,485,3895,115,3957,2980,3410,F
2979,CG,1602,182,4077,2440,4977,2980,2475,C
2979,DG,1602,1420,5497,2440,6397,2980,3895,G
2979,DH,4451,4451,9948,3420,9817,2980,5497,H
2979,D,17506,11635,21583,3420,8397,2980,4077,D
2979,M,2896,2896,24479,3105,12922,2980,21583,M
2979,N,411,411,24890,240,13162,2980,24479,N
2979,O,1008,1008,25898,855,14017,2980,24890,O
2979,N,2700,2700,28598,2840,16857,2980,25898,N
2979,O,578,578,29176,755,17612,2980,28598,O
2979,P,1489,1489,30665,3960,21572,2980,29176,P
2980,A,252,252,252,1197,1197,2981,0,A
2980,B,975,975,1227,90,1287,2981,252,B
2980,C,818,818,2045,1200,2487,2981,1227,C
2980,D,344,344,2389,3780,6267,2981,2045,D
2980,M,221,221,2610,1054,7321,2981,2389,M
2980,N,867,867,3477,90,7411,2981,2610,N
2980,O,141,141,3618,585,7996,2981,3477,O
2980,P,36058,36058,39676,3780,11776,2981,3618,P
2981,AE,13,13,13,32,32,2982,0,A
2981,BE,97,97,110,135,167,2982,13,B
2981,CE,173,173,283,285,452,2982,110,C
2981,DE,1142,859,1142,1369,1369,2982,0,E
2981,DF,386,386,1528,210,1579,2982,1142,F
2981,DG,140,140,1668,280,1859,2982,1528,G
2981,DH,2409,1024,2692,5160,5612,2982,283,D
2981,H,1115,91,2783,5160,7019,2982,1668,H
2981,M,10,10,2793,230,7249,2982,2783,M
2981,N,337,337,3130,180,7429,2982,2793,N
2981,O,187,187,3317,155,7584,2982,3130,O
2981,P,140,140,3457,2880,10464,2982,3317,P
2982,AEI,31,31,31,90,90,2983,0,A
2982,BEI,95,64,95,1115,1115,2983,0,I
2982,BEJ,134,70,165,135,225,2983,31,B
2982,CEJ,165,165,330,285,510,2983,165,C
2982,DEJ,174,174,504,5160,5670,2983,330,D
2982,EJ,1208,799,1303,240,1355,2983,95,J
2982,EK,1540,237,1540,1735,1735,2983,0,E
2982,FK,469,469,2009,300,2035,2983,1540,F
2982,GK,749,43,2052,915,2270,2983,1303,K
2982,GJ,273,273,2325,90,2360,2983,2052,J
2982,GK,126,126,2451,385,2745,2983,2325,K
2982,GL,544,102,2553,700,2735,2983,2009,G
2982,HL,332,332,2885,1140,3875,2983,2553,H
2982,L,1389,955,3840,3960,6705,2983,2451,L
2982,M,23486,23486,27326,24255,30960,2983,3840,M
2982,N,797,797,28123,90,31050,2983,27326,N
2982,O,941,941,29064,1240,32290,2983,28123,O
2982,N,860,860,29924,550,32840,2983,29064,N
2982,O,537,537,30461,935,33775,2983,29924,O
2982,P,1061,1061,31522,3780,37555,2983,30461,P
2983,AE,1357,1357,1357,1888,1888,2984,0,E
2983,AF,1862,505,1862,2496,2496,2984,0,A
2983,BF,558,53,1915,90,1978,2984,1357,F
2983,BG,661,608,2523,90,2586,2984,1862,B
2983,CG,916,308,2831,1240,3218,2984,1915,G
2983,CH,1006,698,3529,1225,3811,2984,2523,C
2983,DH,58,58,3587,3780,7591,2984,3529,D
2983,H,1009,253,3840,3780,6998,2984,2831,H
2983,M,475,475,4315,834,8425,2984,3840,M
2983,N,413,413,4728,90,8515,2984,4315,N
2983,O,676,676,5404,1135,9650,2984,4728,O
2983,P,6226,6226,11630,3780,13430,2984,5404,P
2984,AEI,24,24,24,2141,2141,2985,0,A
2984,BEI,232,208,232,935,935,2985,0,E
2984,BFI,606,374,606,790,790,2985,0,I
2984,BFJ,976,602,1208,240,1175,2985,232,F
2984,BGJ,675,73,1281,540,1330,2985,606,J
2984,BGK,194,194,1475,380,1710,2985,1281,K
2984,BGJ,988,721,2196,1070,2245,2985,1208,G
2984,BHJ,2386,214,2410,240,2381,2985,24,B
2984,CHJ,1242,307,2717,1040,2750,2985,1475,J
2984,CHK,198,198,2915,405,3155,2985,2717,K
2984,CHJ,883,378,3293,1070,3451,2985,2410,C
2984,DHJ,700,322,3615,485,3640,2985,2915,J
2984,DHK,943,943,4558,2250,5890,2985,3615,K
2984,DHL,1032,1032,5590,2615,8505,2985,4558,L
2984,DH,3432,38,5628,3960,6205,2985,2196,H
2984,D,8174,5839,11467,3960,7411,2985,3293,D
2984,M,3060,3060,14527,3120,11625,2985,11467,M
2984,N,331,331,14858,310,11935,2985,14527,N
2984,O,674,674,15532,830,12765,2985,14858,O
2984,N,1639,1639,17171,1470,14235,2985,15532,N
2984,O,359,359,17530,1230,15465,2985,17171,O
2984,P,1062,1062,18592,1920,17385,2985,17530,P
2985,AEI,429,429,429,370,370,2986,0,I
2985,AEJ,581,152,581,868,868,2986,0,A
2985,BEJ,190,38,619,300,670,2986,429,J
2985,BEK,334,296,915,90,958,2986,581,B
2985,CEK,1069,154,1069,1130,1130,2986,0,E
2985,CFK,681,231,1300,840,1510,2986,619,K
2985,CFL,415,184,1484,360,1490,2986,1069,F
2985,CGL,675,675,2159,720,2210,2986,1484,G
2985,CHL,1415,171,2330,1935,2893,2986,915,C
2985,DHL,339,168,2498,1140,3350,2986,2159,H
2985,DL,1323,1155,3653,3780,6673,2986,2330,D
2985,L,8265,5912,9565,1140,2650,2986,1300,L
2985,M,147,147,9712,429,7102,2986,9565,M
2985,N,366,366,10078,150,7252,2986,9712,N
2985,O,519,519,10597,475,7727,2986,10078,O
2985,N,1349,1349,11946,1385,9112,2986,10597,N
2985,O,503,503,12449,740,9852,2986,11946,O
2985,P,24106,24106,36555,5100,14952,2986,12449,P
2986,AE,97,97,97,648,648,2987,0,A
2986,BE,116,19,116,170,170,2987,0,E
2986,BF,226,226,342,240,410,2987,116,F
2986,BG,180,180,522,755,1165,2987,342,G
2986,BH,734,309,831,240,888,2987,97,B
2986,CH,237,237,1068,255,1143,2987,831,C
2986,DH,637,91,1159,3640,4805,2987,522,H
2986,D,2817,2726,3885,5160,6303,2987,1068,D
2986,M,1017,1017,4902,1150,7453,2987,3885,M
2986,N,228,228,5130,150,7603,2987,4902,N
2986,O,198,198,5328,160,7763,2987,5130,O
2986,N,1302,1302,6630,1325,9088,2987,5328,N
2986,O,340,340,6970,650,9738,2987,6630,O
2986,P,1793,1793,8763,4230,13968,2987,6970,P
2987,AEI,496,496,496,1046,1046,2988,0,I
2987,AEJ,573,573,1069,90,1136,2988,496,J
2987,AEK,349,349,1418,705,1841,2988,1069,K
2987,AEL,1876,458,1876,2105,2105,2988,0,A
2987,BEL,262,262,2138,90,2195,2988,1876,B
2987,CEL,1543,823,2961,3780,5621,2988,1418,L
2987,CE,1186,363,3324,1510,3705,2988,2138,C
2987,DE,43,43,3367,3780,7485,2988,3324,D
2987,E,6878,3511,6878,8115,8115,2988,0,E
2987,F,1297,1297,8175,120,8235,2988,6878,F
2987,G,150,150,8325,420,8655,2988,8175,G
2987,F,732,732,9057,460,9115,2988,8325,F
2987,G,830,830,9887,945,10060,2988,9057,G
2987,H,816,816,10703,5160,15220,2988,9887,H
2987,M,180,180,10883,442,15662,2988,10703,M
2987,N,318,318,11201,90,15752,2988,10883,N
2987,O,358,358,11559,700,16452,2988,11201,O
2987,P,48,48,11607,3780,20232,2988,11559,P
2988,A,36988,36988,36988,37993,37993,2989,0,A
2988,B,1068,1068,38056,90,38083,2989,36988,B
2988,C,1000,1000,39056,1210,39293,2989,38056,C
2988,D,11,11,39067,3780,43073,2989,39056,D
2988,M,1536,1536,40603,2305,45378,2989,39067,M
2988,N,795,795,41398,90,45468,2989,40603,N
2988,O,525,525,41923,845,46313,2989,41398,O
2988,P,446,446,42369,3780,50093,2989,41923,P
2989,A,1978,1978,1978,2550,2550,2990,0,A
2989,B,1281,1281,3259,780,3330,2990,1978,B
2989,C,771,771,4030,1540,4870,2990,3259,C
2989,D,4080,4080,8110,1965,6835,2990,4030,D
2989,M,421,421,8531,766,7601,2990,8110,M
2989,N,472,472,9003,150,7751,2990,8531,N
2989,O,551,551,9554,540,8291,2990,9003,O
2989,N,1650,1650,11204,1610,9901,2990,9554,N
2989,O,700,700,11904,805,10706,2990,11204,O
2989,P,2762,2762,14666,4230,14936,2990,11904,P
2990,AE,151,151,151,295,295,2991,0,A
2990,BE,247,96,247,420,420,2991,0,E
2990,BF,209,113,360,180,475,2991,151,B
2990,CF,307,194,554,185,605,2991,247,F
2990,CG,351,157,711,660,1135,2991,360,C
2990,DG,526,369,1080,525,1130,2991,554,G
2990,DH,22,22,1102,2880,4010,2991,1080,H
2990,D,461,70,1172,3960,5095,2991,711,D
2990,M,85,85,1257,917,6012,2991,1172,M
2990,N,920,920,2177,150,6162,2991,1257,N
2990,O,141,141,2318,115,6277,2991,2177,O
2990,N,529,529,2847,540,6817,2991,2318,N
2990,O,248,248,3095,515,7332,2991,2847,O
2990,P,571,571,3666,6150,13482,2991,3095,P
2991,A,2864,2864,2864,4221,4221,2992,0,A
2991,B,1387,1387,4251,90,4311,2992,2864,B
2991,C,834,834,5085,1230,5541,2992,4251,C
2991,D,177,177,5262,3780,9321,2992,5085,D
2991,M,2866,2866,8128,4562,13883,2992,5262,M
2991,N,1751,1751,9879,90,13973,2992,8128,N
2991,O,428,428,10307,815,14788,2992,9879,O
2991,P,977,977,11284,3780,18568,2992,10307,P
2992,AEI,65,65,65,530,530,2993,0,I
2992,AEJ,278,213,278,3374,3374,2993,0,E
2992,AFJ,296,18,296,340,340,2993,0,A
2992,BFJ,387,387,683,300,640,2993,296,B
2992,CFJ,647,29,712,240,770,2993,65,J
2992,CFK,633,604,1316,735,1375,2993,683,C
2992,DFK,74,74,1390,1560,2935,2993,1316,D
2992,FK,710,32,1422,845,1615,2993,712,K
2992,FL,1764,1764,3186,5220,6835,2993,1422,L
2992,F,3359,451,3637,300,3674,2993,278,F
2992,G,685,685,4322,740,4414,2993,3637,G
2992,H,67,67,4389,1560,5974,2993,4322,H
2992,M,202,202,4591,396,7231,2993,4389,M
2992,N,462,462,5053,300,7531,2993,4591,N
2992,O,718,718,5771,835,8366,2993,5053,O
2992,P,1827,1827,7598,6120,14486,2993,5771,P
2993,A,709,709,709,1066,1066,2994,0,A
2993,B,386,386,1095,90,1156,2994,709,B
2993,C,968,968,2063,1240,2396,2994,1095,C
2993,D,6,6,2069,3780,6176,2994,2063,D
2993,M,2217,2217,4286,2792,8968,2994,2069,M
2993,N,607,607,4893,90,9058,2994,4286,N
2993,O,240,240,5133,695,9753,2994,4893,O
2993,P,3105,3105,8238,3780,13533,2994,5133,P
2994,AE,32,32,32,48,48,2995,0,E
2994,AF,88,88,120,135,183,2995,32,F
2994,AG,247,127,247,1013,1013,2995,0,A
2994,BG,227,100,347,295,478,2995,120,G
2994,BH,110,110,457,5160,5638,2995,347,H
2994,B,966,756,1213,240,1253,2995,247,B
2994,C,778,778,1991,1030,2283,2995,1213,C
2994,B,894,894,2885,650,2933,2995,1991,B
2994,C,178,178,3063,385,3318,2995,2885,C
2994,D,1903,1903,4966,3960,7278,2995,3063,D
2994,M,174,174,5140,560,7838,2995,4966,M
2994,N,413,413,5553,90,7928,2995,5140,N
2994,O,880,880,6433,1240,9168,2995,5553,O
2994,N,760,760,7193,395,9563,2995,6433,N
2994,O,460,460,7653,800,10363,2995,7193,O
2994,P,881,881,8534,3780,14143,2995,7653,P
2995,AE,1831,1831,1831,2159,2159,2996,0,A
2995,BE,1269,1269,3100,785,2944,2996,1831,B
2995,CE,1208,1208,4308,1200,4144,2996,3100,C
2995,DE,1418,1418,5726,550,4694,2996,4308,D
2995,E,6266,540,6266,7208,7208,2996,0,E
2995,F,967,967,7233,90,7298,2996,6266,F
2995,G,591,591,7824,905,8203,2996,7233,G
2995,F,1089,1089,8913,770,8973,2996,7824,F
2995,G,853,853,9766,1300,10273,2996,8913,G
2995,H,372,372,10138,3780,14053,2996,9766,H
2995,M,431,431,10569,1087,15140,2996,10138,M
2995,N,746,746,11315,150,15290,2996,10569,N
2995,O,80,80,11395,50,15340,2996,11315,O
2995,N,105,105,11500,135,15475,2996,11395,N
2995,O,168,168,11668,235,15710,2996,11500,O
2995,P,72,72,11740,5280,20990,2996,11668,P
2996,AE,23,23,23,1534,1534,2997,0,E
2996,AF,128,105,128,2615,2615,2997,0,A
2996,BF,1893,1788,1916,420,1954,2997,23,F
2996,BG,968,968,2884,1015,2969,2997,1916,G
2996,BH,3063,307,3191,530,3145,2997,128,B
2996,CH,1157,1157,4348,1215,4360,2997,3191,C
2996,DH,2359,895,5243,550,3519,2997,2884,H
2996,D,2510,1615,6858,550,4910,2997,4348,D
2996,M,478,478,7336,1428,6338,2997,6858,M
2996,N,1070,1070,8406,180,6518,2997,7336,N
2996,O,834,834,9240,830,7348,2997,8406,O
2996,N,276,276,9516,280,7628,2997,9240,N
2996,O,341,341,9857,315,7943,2997,9516,O
2996,P,5614,5614,15471,6900,14843,2997,9857,P
2997,A,1973,1973,1973,2455,2455,2998,0,A
2997,B,512,512,2485,90,2545,2998,1973,B
2997,C,616,616,3101,815,3360,2998,2485,C
2997,B,3545,3545,6646,3230,6590,2998,3101,B
2997,C,324,324,6970,745,7335,2998,6646,C
2997,D,740,740,7710,3780,11115,2998,6970,D
2997,M,1554,1554,9264,1677,12792,2998,7710,M
2997,N,313,313,9577,180,12972,2998,9264,N
2997,O,1683,1683,11260,905,13877,2998,9577,O
2997,N,475,475,11735,1295,15172,2998,11260,N
2997,O,1006,1006,12741,1050,16222,2998,11735,O
2997,P,43,43,12784,7020,23242,2998,12741,P
2998,AE,443,443,443,860,860,2999,0,A
2998,BE,549,549,992,180,1040,2999,443,B
2998,CE,625,625,1617,565,1605,2999,992,C
2998,BE,2994,2994,4611,3005,4610,2999,1617,B
2998,CE,588,588,5199,870,5480,2999,4611,C
2998,DE,5299,100,5299,5374,5374,2999,0,E
2998,DF,294,194,5493,1620,7100,2999,5199,D
2998,F,465,271,5764,420,5794,2999,5299,F
2998,G,1129,1129,6893,1259,7053,2999,5764,G
2998,H,746,746,7639,351,7404,2999,6893,H
2998,M,3049,3049,10688,5027,12431,2999,7639,M
2998,N,2838,2838,13526,420,12851,2999,10688,N
2998,O,1021,1021,14547,985,13836,2999,13526,O
2998,P,4631,4631,19178,550,14386,2999,14547,P
2999,A,33049,33049,33049,33458,33458,3000,0,A
2999,B,556,556,33605,90,33548,3000,33049,B
2999,C,1181,1181,34786,1385,34933,3000,33605,C
2999,B,5023,5023,39809,4935,39868,3000,34786,B
2999,C,997,997,40806,1275,41143,3000,39809,C
2999,D,441,441,41247,3780,44923,3000,40806,D
2999,M,1157,1157,42404,1313,46236,3000,41247,M
2999,N,203,203,42607,90,46326,3000,42404,N
2999,O,736,736,43343,1130,47456,3000,42607,O
2999,P,182,182,43525,3780,51236,3000,43343,P
3000,AEI,86,86,86,180,180,3001,0,E
3000,AFI,135,49,135,415,415,3001,0,A
3000,BFI,209,160,295,180,360,3001,86,F
3000,BGI,397,237,532,185,600,3001,135,B
3000,CGI,520,520,1052,525,1125,3001,532,C
3000,DGI,58,58,1110,2880,4005,3001,1052,D
3000,GI,910,95,1205,545,905,3001,295,G
3000,HI,1,1,1206,2790,3695,3001,1205,H
3000,I,2837,1631,2837,3358,3358,3001,0,I
3000,J,560,560,3397,90,3448,3001,2837,J
3000,K,796,796,4193,1270,4718,3001,3397,K
3000,L,3516,3516,7709,3780,8498,3001,4193,L
3000,M,161,161,7870,369,8867,3001,7709,M
3000,N,388,388,8258,240,9107,3001,7870,N
3000,O,997,997,9255,1015,10122,3001,8258,O
3000,N,1758,1758,11013,1585,11707,3001,9255,N
3000,O,979,979,11992,1230,12937,3001,11013,O
3000,P,1312,1312,13304,635,13572,3001,11992,P
3001,AE,50,50,50,86,86,3002,0,E
3001,AF,79,29,79,192,192,3002,0,A
3001,BF,155,126,205,135,221,3002,50,F
3001,BG,143,143,348,295,516,3002,205,G
3001,BH,296,27,375,240,432,3002,79,B
3001,CH,193,166,541,5160,5676,3002,348,H
3001,C,223,57,598,285,717,3002,375,C
3001,D,1466,1466,2064,5160,5877,3002,598,D
3001,M,910,910,2974,1561,7438,3002,2064,M
3001,N,691,691,3665,90,7528,3002,2974,N
3001,O,937,937,4602,1250,8778,3002,3665,O
3001,P,1621,1621,6223,3840,12618,3002,4602,P
3002,AE,235,235,235,926,926,3003,0,A
3002,BE,733,733,968,90,1016,3003,235,B
3002,CE,408,408,1376,815,1831,3003,968,C
3002,DE,1440,64,1440,1513,1513,3003,0,E
3002,DF,139,139,1579,90,1603,3003,1440,F
3002,DG,547,547,2126,870,2473,3003,1579,G
3002,DF,838,838,2964,540,3013,3003,2126,F
3002,DG,549,549,3513,805,3818,3003,2964,G
3002,DH,14460,12323,15836,3780,5611,3003,1376,D
3002,H,13500,1177,17013,3780,7598,3003,3513,H
3002,M,2192,2192,19205,4765,12363,3003,17013,M
3002,N,2598,2598,21803,90,12453,3003,19205,N
3002,O,512,512,22315,805,13258,3003,21803,O
3002,N,2447,2447,24762,2145,15403,3003,22315,N
3002,O,510,510,25272,960,16363,3003,24762,O
3002,P,46,46,25318,3780,20143,3003,25272,P
3003,A,3123,3123,3123,4379,4379,3004,0,A
3003,B,1299,1299,4422,90,4469,3004,3123,B
3003,C,1139,1139,5561,1430,5899,3004,4422,C
3003,D,162,162,5723,3780,9679,3004,5561,D
3003,M,975,975,6698,1370,11049,3004,5723,M
3003,N,428,428,7126,90,11139,3004,6698,N
3003,O,602,602,7728,845,11984,3004,7126,O
3003,P,1235,1235,8963,3780,15764,3004,7728,P
3004,A,54,54,54,821,821,3005,0,A
3004,B,844,844,898,135,956,3005,54,B
3004,C,186,186,1084,300,1256,3005,898,C
3004,D,89,89,1173,5100,6356,3005,1084,D
3004,M,473,473,1646,3157,9513,3005,1173,M
3004,N,3041,3041,4687,180,9693,3005,1646,N
3004,O,638,638,5325,895,10588,3005,4687,O
3004,N,705,705,6030,685,11273,3005,5325,N
3004,O,566,566,6596,635,11908,3005,6030,O
3004,P,1332,1332,7928,6960,18868,3005,6596,P
3005,A,739,739,739,1166,1166,3006,0,A
3005,B,609,609,1348,180,1346,3006,739,B
3005,C,905,905,2253,930,2276,3006,1348,C
3005,D,3264,3264,5517,550,2826,3006,2253,D
3005,M,2210,2210,7727,2601,5427,3006,5517,M
3005,N,806,806,8533,420,5847,3006,7727,N
3005,O,537,537,9070,676,6523,3006,8533,O
3005,P,5086,5086,14156,759,7282,3006,9070,P
3006,AEI,7,7,7,671,671,3007,0,E
3006,AFI,47,40,47,355,355,3007,0,I
3006,AFJ,563,516,563,735,735,3007,0,A
3006,BFJ,519,3,566,180,535,3007,47,J
3006,BFK,775,216,782,150,821,3007,7,F
3006,BGK,253,37,819,660,1195,3007,566,K
3006,BGL,351,95,914,240,975,3007,563,B
3006,CGL,158,26,940,120,941,3007,782,G
3006,CHL,57,57,997,4230,5171,3007,940,H
3006,CL,345,167,1164,3960,5155,3007,819,L
3006,C,724,474,1638,910,1885,3007,914,C
3006,D,398,398,2036,4020,5905,3007,1638,D
3006,M,95,95,2131,752,6657,3007,2036,M
3006,N,837,837,2968,240,6897,3007,2131,N
3006,O,156,156,3124,218,7115,3007,2968,O
3006,P,298,298,3422,402,7517,3007,3124,P
3007,AEI,46,46,46,297,297,3008,0,E
3007,AFI,53,7,53,1313,1313,3008,0,I
3007,AFJ,320,267,320,832,832,3008,0,A
3007,BFJ,351,77,397,165,462,3008,46,F
3007,BGJ,1380,1036,1433,165,1478,3008,53,J
3007,BGK,1054,18,1451,1275,1737,3008,397,G
3007,BHK,1502,371,1822,1080,1912,3008,320,B
3007,CHK,535,146,1968,825,2303,3008,1433,K
3007,CHL,234,234,2202,3960,6263,3008,1968,L
3007,CH,518,138,2340,510,2422,3008,1822,C
3007,BH,996,107,2447,4020,5757,3008,1451,H
3007,B,2977,2870,5317,2390,4812,3008,2340,B
3007,C,828,828,6145,1235,6047,3008,5317,C
3007,D,674,674,6819,620,6667,3008,6145,D
3007,M,1288,1288,8107,2339,9006,3008,6819,M
3007,N,1118,1118,9225,90,9096,3008,8107,N
3007,O,488,488,9713,855,9951,3008,9225,O
3007,N,1058,1058,10771,695,10646,3008,9713,N
3007,O,177,177,10948,690,11336,3008,10771,O
3007,P,2941,2941,13889,3780,15116,3008,10948,P
3008,AE,1551,1551,1551,1565,1565,3009,0,A
3008,BE,305,305,1856,240,1805,3009,1551,B
3008,CE,577,577,2433,745,2550,3009,1856,C
3008,BE,2769,336,2769,3741,3741,3009,0,E
3008,BF,517,181,2950,455,3005,3009,2433,B
3008,CF,269,269,3219,245,3250,3009,2950,C
3008,DF,1232,782,4001,300,4041,3009,2769,F
3008,DG,1611,829,4830,5250,8500,3009,3219,D
3008,G,1080,251,5081,1050,5091,3009,4001,G
3008,F,605,605,5686,720,5811,3009,5081,F
3008,G,579,579,6265,780,6591,3009,5686,G
3008,H,2172,2172,8437,3960,10551,3009,6265,H
3008,M,5245,5245,13682,6088,16639,3009,8437,M
3008,N,1106,1106,14788,270,16909,3009,13682,N
3008,O,950,950,15738,980,17889,3009,14788,O
3008,P,1047,1047,16785,355,18244,3009,15738,P
3009,AEI,70,70,70,144,144,3010,0,A
3009,BEI,220,220,290,180,324,3010,70,B
3009,CEI,219,219,509,155,479,3010,290,C
3009,DEI,97,97,606,385,864,3010,509,D
3009,EI,1441,835,1441,4261,4261,3010,0,I
3009,EJ,3300,3300,4741,600,4861,3010,1441,J
3009,EK,921,921,5662,845,5706,3010,4741,K
3009,EL,5980,318,5980,6461,6461,3010,0,E
3009,FL,765,765,6745,360,6821,3010,5980,F
3009,GL,1294,1294,8039,1000,7821,3010,6745,G
3009,HL,3577,1200,9239,385,6091,3010,5662,L
3009,H,4124,2924,12163,550,8371,3010,8039,H
3009,M,5806,5806,17969,7192,15563,3010,12163,M
3009,N,1742,1742,19711,420,15983,3010,17969,N
3009,O,1061,1061,20772,1235,17218,3010,19711,O
3009,P,897,897,21669,620,17838,3010,20772,P
3010,A,3365,3365,3365,3305,3305,3011,0,A
3010,B,288,288,3653,385,3690,3011,3365,B
3010,C,782,782,4435,860,4550,3011,3653,C
3010,D,4730,4730,9165,1140,5690,3011,4435,D
3010,M,1646,1646,10811,1435,7125,3011,9165,M
3010,N,29,29,10840,300,7425,3011,10811,N
3010,O,897,897,11737,1020,8445,3011,10840,O
3010,P,1244,1244,12981,3960,12405,3011,11737,P
3011,AE,403,403,403,1105,1105,3012,0,A
3011,BE,743,743,1146,90,1195,3012,403,B
3011,CE,484,484,1630,855,2050,3012,1146,C
3011,DE,454,454,2084,3780,5830,3012,1630,D
3011,E,18255,16171,18255,18956,18956,3012,0,E
3011,F,1201,1201,19456,90,19046,3012,18255,F
3011,G,1101,1101,20557,1340,20386,3012,19456,G
3011,H,193,193,20750,3780,24166,3012,20557,H
3011,M,1824,1824,22574,2387,26553,3012,20750,M
3011,N,620,620,23194,90,26643,3012,22574,N
3011,O,1057,1057,24251,1285,27928,3012,23194,O
3011,P,494,494,24745,3780,31708,3012,24251,P
3012,AE,123,123,123,57,57,3013,0,E
3012,AF,190,67,190,215,215,3013,0,A
3012,BF,124,57,247,240,297,3013,123,F
3012,BG,181,124,371,180,395,3013,190,B
3012,CG,164,164,535,540,935,3013,371,C
3012,DG,655,367,902,765,1062,3013,247,G
3012,DH,123,123,1025,3600,4662,3013,902,H
3012,D,534,44,1069,2850,3785,3013,535,D
3012,M,235,235,1304,868,5530,3013,1069,M
3012,N,734,734,2038,150,5680,3013,1304,N
3012,O,230,230,2268,425,6105,3013,2038,O
3012,N,283,283,2551,55,6160,3013,2268,N
3012,O,657,657,3208,809,6969,3013,2551,O
3012,P,1949,1949,5157,3840,10809,3013,3208,P
3013,AEI,204,204,204,1440,1440,3014,0,I
3013,AEJ,368,164,368,488,488,3014,0,E
3013,AFJ,265,265,633,120,608,3014,368,F
3013,AGJ,1406,773,1406,1559,1559,3014,0,A
3013,BGJ,901,128,1534,970,1578,3014,633,G
3013,BHJ,1486,156,1690,90,1530,3014,204,J
3013,BHK,323,39,1729,230,1789,3014,1406,B
3013,CHK,337,298,2027,715,2245,3014,1690,K
3013,CHL,377,79,2106,190,1979,3014,1729,C
3013,BHL,73,73,2179,245,2224,3014,2106,B
3013,CHL,907,262,2441,5160,6738,3014,1534,H
3013,CL,762,348,2789,3780,6025,3014,2027,L
3013,C,1114,504,3293,1245,3469,3014,2179,C
3013,D,1701,1701,4994,365,3834,3014,3293,D
3013,M,381,381,5375,1515,8253,3014,4994,M
3013,N,1175,1175,6550,90,8343,3014,5375,N
3013,O,300,300,6850,710,9053,3014,6550,O
3013,N,1157,1157,8007,740,9793,3014,6850,N
3013,O,428,428,8435,815,10608,3014,8007,O
3013,P,984,984,9419,3780,14388,3014,8435,P
3014,AE,1085,1085,1085,1739,1739,3015,0,A
3014,BE,947,947,2032,240,1979,3015,1085,B
3014,CE,659,659,2691,730,2709,3015,2032,C
3014,DE,1622,1622,4313,4140,6849,3015,2691,D
3014,E,5728,1415,5728,6115,6115,3015,0,E
3014,F,649,649,6377,300,6415,3015,5728,F
3014,G,584,584,6961,760,7175,3015,6377,G
3014,H,164,164,7125,1560,8735,3015,6961,H
3014,M,75,75,7200,115,8850,3015,7125,M
3014,N,332,332,7532,300,9150,3015,7200,N
3014,O,634,634,8166,750,9900,3015,7532,O
3014,N,298,298,8464,215,10115,3015,8166,N
3014,O,177,177,8641,1345,11460,3015,8464,O
3014,P,52,52,8693,3050,14510,3015,8641,P
3015,AE,491,491,491,1230,1230,3016,0,A
3015,BE,907,416,907,1346,1346,3016,0,E
3015,BF,800,384,1291,90,1320,3016,491,B
3015,CF,476,92,1383,90,1436,3016,907,F
3015,CG,197,105,1488,605,1925,3016,1291,C
3015,DG,190,85,1573,605,2041,3016,1383,G
3015,DH,11350,11265,12838,3780,5705,3016,1488,D
3015,H,11772,507,13345,3780,5821,3016,1573,H
3015,M,251,251,13596,1764,7585,3016,13345,M
3015,N,1762,1762,15358,300,7885,3016,13596,N
3015,O,1008,1008,16366,895,8780,3016,15358,O
3015,P,1329,1329,17695,550,9330,3016,16366,P
3016,AEI,226,226,226,598,598,3017,0,A
3016,BEI,405,405,631,90,688,3017,226,B
3016,CEI,556,556,1187,845,1533,3017,631,C
3016,DEI,385,385,1572,3780,5313,3017,1187,D
3016,EI,1692,120,1692,2508,2508,3017,0,I
3016,EJ,2232,540,2232,4362,4362,3017,0,E
3016,FJ,849,309,2541,90,2598,3017,1692,J
3016,FK,521,521,3062,850,3448,3017,2541,K
3016,FL,2400,1570,4632,330,4692,3017,2232,F
3016,GL,1795,225,4857,3840,7288,3017,3062,L
3016,G,621,396,5253,804,5496,3017,4632,G
3016,H,1129,1129,6382,366,5862,3017,5253,H
3016,M,510,510,6892,1440,8728,3017,6382,M
3016,N,1061,1061,7953,150,8878,3017,6892,N
3016,O,652,652,8605,640,9518,3017,7953,O
3016,N,1085,1085,9690,1110,10628,3017,8605,N
3016,O,156,156,9846,105,10733,3017,9690,O
3016,P,1859,1859,11705,4230,14963,3017,9846,P
3017,AEI,1490,1490,1490,1555,1555,3018,0,E
3017,AFI,1705,215,1705,1690,1690,3018,0,I
3017,AFJ,368,153,1858,300,1855,3018,1490,F
3017,AGJ,298,145,2003,300,1990,3018,1705,J
3017,AGK,757,612,2615,855,2710,3018,1858,G
3017,AFK,682,70,2685,855,2845,3018,2003,K
3017,AFJ,363,363,3048,185,3030,3018,2685,J
3017,AFK,55,55,3103,300,3330,3018,3048,K
3017,AFL,713,225,3328,660,3370,3018,2615,F
3017,AGL,74,74,3402,720,4090,3018,3328,G
3017,AHL,1088,1088,4490,1620,5710,3018,3402,H
3017,AL,4655,165,4655,4580,4580,3018,0,A
3017,BL,189,189,4844,300,4880,3018,4655,B
3017,CL,705,705,5549,855,5735,3018,4844,C
3017,BL,318,318,5867,185,5920,3018,5549,B
3017,CL,100,100,5967,300,6220,3018,5867,C
3017,DL,4497,1633,7600,4020,7350,3018,3103,L
3017,D,4578,2945,10545,2100,8320,3018,5967,D
3017,M,3420,3420,13965,4935,13255,3018,10545,M
3017,N,2148,2148,16113,690,13945,3018,13965,N
3017,O,296,296,16409,405,14350,3018,16113,O
3017,N,1250,1250,17659,1110,15460,3018,16409,N
3017,O,395,395,18054,1455,16915,3018,17659,O
3017,P,966,966,19020,2700,19615,3018,18054,P
3018,AEI,147,147,147,145,145,3019,0,I
3018,AEJ,210,63,210,1648,1648,3019,0,E
3018,AFJ,219,9,219,1730,1730,3019,0,A
3018,BFJ,238,166,385,300,445,3019,147,J
3018,BFK,827,827,1212,690,1135,3019,385,K
3018,BFJ,283,283,1495,390,1525,3019,1212,J
3018,BFK,1625,340,1835,250,1898,3019,210,F
3018,BGK,704,364,2199,750,2275,3019,1495,K
3018,BGL,2406,426,2625,250,1980,3019,219,B
3018,CGL,936,146,2771,915,2813,3019,1835,G
3018,CHL,707,135,2906,3960,6235,3019,2199,L
3018,CH,766,485,3391,910,2890,3019,2625,C
3018,DH,602,602,3993,550,3440,3019,3391,D
3018,H,2276,1054,5047,550,3363,3019,2771,H
3018,M,10201,10201,15248,10913,17148,3019,5047,M
3018,N,741,741,15989,90,17238,3019,15248,N
3018,O,833,833,16822,1215,18453,3019,15989,O
3018,P,257,257,17079,3780,22233,3019,16822,P
3019,AEI,23,23,23,355,355,3020,0,A
3019,BEI,91,68,91,115,115,3020,0,I
3019,BEJ,168,77,168,180,180,3020,0,E
3019,BFJ,112,35,203,135,250,3020,91,J
3019,BFK,195,160,363,240,420,3020,168,F
3019,BGK,209,49,412,295,545,3020,203,K
3019,BGL,420,31,443,135,490,3020,23,B
3019,CGL,126,95,538,5100,5645,3020,412,L
3019,CG,179,4,542,295,715,3020,363,G
3019,CH,209,110,652,295,785,3020,443,C
3019,DH,127,127,779,5100,5885,3020,652,D
3019,H,1007,770,1549,5100,5815,3020,542,H
3019,M,665,665,2214,2387,8272,3020,1549,M
3019,N,1840,1840,4054,180,8452,3020,2214,N
3019,O,723,723,4777,895,9347,3020,4054,O
3019,N,1594,1594,6371,1390,10737,3020,4777,N
3019,O,815,815,7186,710,11447,3020,6371,O
3019,P,9866,9866,17052,6960,18407,3020,7186,P
3020,AEI,132,132,132,107,107,3021,0,A
3020,BEI,176,176,308,240,347,3021,132,B
3020,CEI,454,146,454,1979,1979,3021,0,E
3020,CFI,900,754,1208,910,1257,3021,308,C
3020,DFI,1336,128,1336,1553,1553,3021,0,I
3020,DFJ,390,390,1726,240,1793,3021,1336,J
3020,DFK,1901,629,2355,420,2399,3021,454,F
3020,DGK,1170,541,2896,1085,2878,3021,1726,K
3020,DGL,977,436,3332,985,3384,3021,2355,G
3020,DHL,1091,655,3987,550,3428,3021,2896,L
3020,DH,3908,1129,5116,550,1807,3021,1208,D
3020,H,2096,312,5428,550,3934,3021,3332,H
3020,M,3160,3160,8588,6668,10602,3021,5428,M
3020,N,3652,3652,12240,210,10812,3021,8588,N
3020,O,340,340,12580,552,11364,3021,12240,O
3020,P,7179,7179,19759,1218,12582,3021,12580,P
3021,AE,11,11,11,184,184,3022,0,A
3021,BE,128,117,128,750,750,3022,0,E
3021,BF,266,149,277,150,334,3022,11,B
3021,CF,171,171,448,135,469,3022,277,C
3021,DF,46,46,494,4230,4699,3022,448,D
3021,F,820,454,948,240,990,3022,128,F
3021,G,385,385,1333,255,1245,3022,948,G
3021,H,1122,1122,2455,5160,6405,3022,1333,H
3021,M,528,528,2983,1156,7561,3022,2455,M
3021,N,725,725,3708,150,7711,3022,2983,N
3021,O,235,235,3943,155,7866,3022,3708,O
3021,N,354,354,4297,435,8301,3022,3943,N
3021,O,1314,1314,5611,110,8411,3022,4297,O
3021,P,4123,4123,9734,4230,12641,3022,5611,P
3022,A,1265,1265,1265,1915,1915,3023,0,A
3022,B,715,715,1980,90,2005,3023,1265,B
3022,C,1422,1422,3402,1745,3750,3023,1980,C
3022,D,116,116,3518,3780,7530,3023,3402,D
3022,M,783,783,4301,1376,8906,3023,3518,M
3022,N,629,629,4930,90,8996,3023,4301,N
3022,O,239,239,5169,695,9691,3023,4930,O
3022,P,2992,2992,8161,3780,13471,3023,5169,P
3023,A,36957,36957,36957,37993,37993,3024,0,A
3023,B,1078,1078,38035,90,38083,3024,36957,B
3023,C,925,925,38960,1210,39293,3024,38035,C
3023,D,3,3,38963,3780,43073,3024,38960,D
3023,M,3529,3529,42492,4148,47221,3024,38963,M
3023,N,654,654,43146,90,47311,3024,42492,N
3023,O,220,220,43366,605,47916,3024,43146,O
3023,P,4611,4611,47977,3780,51696,3024,43366,P
3024,AEI,67,67,67,88,88,3025,0,I
3024,AEJ,113,113,180,135,223,3025,67,J
3024,AEK,182,182,362,295,518,3025,180,K
3024,AEL,112,112,474,5220,5738,3025,362,L
3024,AE,586,112,586,2083,2083,3025,0,A
3024,BE,617,31,617,562,562,3025,0,E
3024,BF,192,192,809,300,862,3025,617,F
3024,BG,149,149,958,265,1127,3025,809,G
3024,BF,387,15,973,540,2623,3025,586,B
3024,CF,1129,1114,2087,1015,2142,3025,958,F
3024,CG,196,196,2283,295,2437,3025,2087,G
3024,CH,1376,66,2349,785,3408,3025,973,C
3024,BH,1547,1481,3830,5100,7537,3025,2283,H
3024,B,3160,1679,5509,2015,5423,3025,2349,B
3024,C,1529,1529,7038,1640,7063,3025,5509,C
3024,D,13,13,7051,366,7429,3025,7038,D
3024,M,1967,1967,9018,2543,10080,3025,7051,M
3024,N,771,771,9789,180,10260,3025,9018,N
3024,O,915,915,10704,895,11155,3025,9789,O
3024,N,253,253,10957,330,11485,3025,10704,N
3024,O,459,459,11416,540,12025,3025,10957,O
3024,P,6692,6692,18108,6960,18985,3025,11416,P
3025,A,1503,1503,1503,2606,2606,3026,0,A
3025,B,1147,1147,2650,90,2696,3026,1503,B
3025,C,976,976,3626,1210,3906,3026,2650,C
3025,D,2,2,3628,3780,7686,3026,3626,D
3025,M,1397,1397,5025,2073,9759,3026,3628,M
3025,N,783,783,5808,90,9849,3026,5025,N
3025,O,508,508,6316,850,10699,3026,5808,O
3025,P,19142,19142,25458,3780,14479,3026,6316,P
3026,A,2795,2795,2795,2936,2936,3027,0,A
3026,B,327,327,3122,240,3176,3027,2795,B
3026,C,489,489,3611,765,3941,3027,3122,C
3026,B,559,559,4170,295,4236,3027,3611,B
3026,C,716,716,4886,1260,5496,3027,4170,C
3026,D,366,366,5252,3960,9456,3027,4886,D
3026,M,1080,1080,6332,1461,10917,3027,5252,M
3026,N,419,419,6751,90,11007,3027,6332,N
3026,O,972,972,7723,1250,12257,3027,6751,O
3026,N,569,569,8292,290,12547,3027,7723,N
3026,O,598,598,8890,945,13492,3027,8292,O
3026,P,1430,1430,10320,3780,17272,3027,8890,P
3027,AE,193,193,193,398,398,3028,0,A
3027,BE,305,305,498,180,578,3028,193,B
3027,CE,379,379,877,660,1238,3028,498,C
3027,DE,1281,404,1281,1332,1332,3028,0,E
3027,DF,138,138,1419,150,1482,3028,1281,F
3027,DG,31,31,1450,155,1637,3028,1419,G
3027,DF,209,209,1659,80,1717,3028,1450,F
3027,DG,160,160,1819,290,2007,3028,1659,G
3027,DH,801,801,2620,5100,7107,3028,1819,H
3027,D,3176,1433,4053,3960,5198,3028,877,D
3027,M,14579,14579,18632,16630,23737,3028,4053,M
3027,N,1921,1921,20553,90,23827,3028,18632,N
3027,O,1232,1232,21785,1360,25187,3028,20553,O
3027,N,2298,2298,24083,2005,27192,3028,21785,N
3027,O,435,435,24518,815,28007,3028,24083,O
3027,P,1050,1050,25568,3780,31787,3028,24518,P
3028,A,39488,39488,39488,39648,39648,3029,0,A
3028,B,271,271,39759,90,39738,3029,39488,B
3028,C,697,697,40456,1130,40868,3029,39759,C
3028,D,171,171,40627,3780,44648,3029,40456,D
3028,M,1162,1162,41789,1596,46244,3029,40627,M
3028,N,478,478,42267,90,46334,3029,41789,N
3028,O,671,671,42938,1060,47394,3029,42267,O
3028,P,14,14,42952,3780,51174,3029,42938,P
3029,AEI,281,281,281,1507,1507,3030,0,A
3029,BEI,1261,980,1261,2487,2487,3030,0,E
3029,BFI,1419,439,1700,240,1747,3030,281,B
3029,CFI,2516,816,2516,2845,2845,3030,0,I
3029,CFJ,1270,15,2531,90,2577,3030,1261,F
3029,CGJ,854,23,2554,1040,2787,3030,1700,C
3029,DGJ,359,321,2875,90,2935,3030,2516,J
3029,DGK,579,258,3133,3960,6747,3030,2554,D
3029,GK,1032,430,3563,1220,3797,3030,2531,G
3029,HK,76,76,3639,3780,7577,3030,3563,H
3029,K,1662,898,4537,1940,4875,3030,2875,K
3029,L,14,14,4551,3780,8655,3030,4537,L
3029,M,660,660,5211,1258,9913,3030,4551,M
3029,N,616,616,5827,90,10003,3030,5211,N
3029,O,871,871,6698,1080,11083,3030,5827,O
3029,P,3955,3955,10653,3780,14863,3030,6698,P
3030,A,14,14,14,103,103,3031,0,A
3030,B,183,183,197,150,253,3031,14,B
3030,C,194,194,391,115,368,3031,197,C
3030,D,1448,1448,1839,4230,4598,3031,391,D
3030,M,98,98,1937,214,4812,3031,1839,M
3030,N,216,216,2153,150,4962,3031,1937,N
3030,O,246,246,2399,255,5217,3031,2153,O
3030,P,824,824,3223,2880,8097,3031,2399,P
3031,AEI,42,42,42,1737,1737,3032,0,A
3031,BEI,113,71,113,63,63,3032,0,E
3031,BFI,138,138,251,240,303,3032,113,F
3031,BGI,385,134,385,1154,1154,3032,0,I
3031,BGJ,534,400,785,795,1098,3032,251,G
3031,BHJ,943,543,1328,240,1394,3032,385,J
3031,BHK,881,338,1666,3960,5058,3032,785,H
3031,BK,1871,247,1913,240,1977,3032,42,B
3031,CK,650,65,1978,665,2059,3032,1328,K
3031,CL,933,868,2846,695,2672,3032,1913,C
3031,BL,195,195,3041,405,3077,3032,2846,B
3031,CL,612,612,3653,785,3862,3032,3041,C
3031,DL,3034,1359,5012,5370,7429,3032,1978,L
3031,D,3863,2504,7516,3960,7822,3032,3653,D
3031,M,468,468,7984,1928,9750,3032,7516,M
3031,N,1525,1525,9509,90,9840,3032,7984,N
3031,O,1435,1435,10944,1745,11585,3032,9509,O
3031,N,616,616,11560,340,11925,3032,10944,N
3031,O,687,687,12247,945,12870,3032,11560,O
3031,P,2593,2593,14840,3780,16650,3032,12247,P
3032,A,1227,1227,1227,1299,1299,3033,0,A
3032,B,1565,1565,2792,90,1389,3033,1227,B
3032,C,906,906,3698,1240,2629,3033,2792,C
3032,D,797,797,4495,3780,6409,3033,3698,D
3032,M,907,907,5402,1289,7698,3033,4495,M
3032,N,412,412,5814,90,7788,3033,5402,N
3032,O,628,628,6442,860,8648,3033,5814,O
3032,P,2709,2709,9151,3780,12428,3033,6442,P
3033,AE,1192,1192,1192,1172,1172,3034,0,A
3033,BE,259,259,1451,300,1472,3034,1192,B
3033,CE,785,785,2236,1000,2472,3034,1451,C
3033,BE,2466,230,2466,2607,2607,3034,0,E
3033,BF,261,261,2727,150,2757,3034,2466,F
3033,BG,928,437,3164,735,3207,3034,2236,B
3033,CG,676,239,3403,700,3457,3034,2727,G
3033,CF,645,406,3809,975,4182,3034,3164,C
3033,DF,1096,690,4499,1095,4552,3034,3403,F
3033,DG,647,647,5146,690,5242,3034,4499,G
3033,DH,2916,1579,6725,3960,8142,3034,3809,D
3033,H,5540,3961,10686,4230,9472,3034,5146,H
3033,M,400,400,11086,40,9512,3034,10686,M
3033,N,192,192,11278,600,10112,3034,11086,N
3033,O,241,241,11519,420,10532,3034,11278,O
3033,N,1736,1736,13255,1540,12072,3034,11519,N
3033,O,1017,1017,14272,1160,13232,3034,13255,O
3033,P,8724,8724,22996,3120,16352,3034,14272,P
3034,A,75,75,75,1665,1665,3035,0,A
3034,B,1853,1853,1928,300,1965,3035,75,B
3034,C,577,577,2505,700,2665,3035,1928,C
3034,D,1332,1332,3837,1260,3925,3035,2505,D
3034,M,399,399,4236,602,4527,3035,3837,M
3034,N,328,328,4564,150,4677,3035,4236,N
3034,O,31,31,4595,100,4777,3035,4564,O
3034,N,435,435,5030,385,5162,3035,4595,N
3034,O,176,176,5206,225,5387,3035,5030,O
3034,P,4091,4091,9297,4740,10127,3035,5206,P
3035,AEI,194,194,194,534,534,3036,0,E
3035,AFI,547,353,547,1353,1353,3036,0,I
3035,AFJ,361,8,555,90,624,3036,194,F
3035,AGJ,982,427,982,1592,1592,3036,0,A
3035,BGJ,531,104,1086,880,1504,3036,555,G
3035,BHJ,198,198,1284,3780,5284,3036,1086,H
3035,BJ,857,120,1404,90,1443,3036,547,J
3035,BK,644,222,1626,90,1682,3036,982,B
3035,CK,459,237,1863,855,2298,3036,1404,K
3035,CL,397,397,2260,3780,6078,3036,1863,L
3035,C,875,241,2501,1240,2922,3036,1626,C
3035,D,1085,1085,3586,3780,6702,3036,2501,D
3035,M,243,243,3829,1064,7766,3036,3586,M
3035,N,876,876,4705,90,7856,3036,3829,N
3035,O,133,133,4838,535,8391,3036,4705,O
3035,P,151,151,4989,3780,12171,3036,4838,P
3036,AEI,217,217,217,903,903,3037,0,I
3036,AEJ,232,15,232,897,897,3037,0,E
3036,AFJ,765,765,997,150,1047,3037,232,F
3036,AGJ,799,19,1016,150,1053,3037,217,J
3036,AGK,150,131,1147,125,1172,3037,997,G
3036,AFK,177,46,1193,125,1178,3037,1016,K
3036,AFJ,197,197,1390,265,1443,3037,1193,J
3036,AFK,246,3,1393,265,1437,3037,1147,F
3036,AGK,623,623,2016,690,2127,3037,1393,G
3036,AHK,647,21,2037,690,2133,3037,1390,K
3036,AHL,3417,1380,3417,4311,4311,3037,0,A
3036,BHL,1509,129,3546,4230,6363,3037,2037,L
3036,BH,1005,876,4422,150,4461,3037,3417,B
3036,CH,773,773,5195,760,5221,3037,4422,C
3036,BH,1192,1192,6387,1195,6416,3037,5195,B
3036,CH,673,673,7060,705,7121,3037,6387,C
3036,DH,5451,407,7467,4290,6417,3037,2016,H
3036,D,8858,8451,15918,4230,11351,3037,7060,D
3036,M,885,885,16803,525,11876,3037,15918,M
3036,N,192,192,16995,600,12476,3037,16803,N
3036,O,238,238,17233,420,12896,3037,16995,O
3036,N,428,428,17661,200,13096,3037,17233,N
3036,O,893,893,18554,1060,14156,3037,17661,O
3036,P,5895,5895,24449,3360,17516,3037,18554,P
3037,AEI,14,14,14,142,142,3038,0,A
3037,BEI,160,160,174,90,232,3038,14,B
3037,CEI,826,652,826,3429,3429,3038,0,E
3037,CFI,917,265,1091,1200,1432,3038,174,C
3037,DFI,50,50,1141,3780,5212,3038,1091,D
3037,FI,1158,17,1158,1620,1620,3038,0,I
3037,FJ,488,488,1646,90,1710,3038,1158,J
3037,FK,1287,1287,2933,1435,3145,3038,1646,K
3037,FL,2617,510,3443,90,3519,3038,826,F
3037,GL,691,181,3624,3780,6925,3038,2933,L
3037,G,1268,1087,4711,1390,4909,3038,3443,G
3037,H,3,3,4714,3780,8689,3038,4711,H
3037,M,533,533,5247,788,9477,3038,4714,M
3037,N,287,287,5534,90,9567,3038,5247,N
3037,O,1416,1416,6950,1865,11432,3038,5534,O
3037,P,2884,2884,9834,3780,15212,3038,6950,P
3038,AEI,306,306,306,954,954,3039,0,I
3038,AEJ,583,277,583,579,579,3039,0,A
3038,BEJ,106,106,689,170,749,3039,583,B
3038,CEJ,683,300,989,120,1074,3039,306,J
3038,CEK,271,271,1260,315,1389,3039,989,K
3038,CEJ,709,138,1398,645,1394,3039,689,C
3038,BEJ,475,337,1735,400,1789,3039,1260,J
3038,BEK,2060,325,2060,2384,2384,3039,0,E
3038,BFK,766,104,2164,825,2219,3039,1398,B
3038,CFK,434,330,2494,150,2534,3039,2060,F
3038,CGK,813,54,2548,2049,3838,3039,1735,K
3038,CGL,830,446,2994,2174,4393,3039,2164,C
3038,DGL,796,296,3290,835,3369,3039,2494,G
3038,DFL,891,149,3439,886,4724,3039,2548,L
3038,DF,423,274,3713,395,3764,3039,3290,F
3038,DG,1200,481,4194,1781,6174,3039,2994,D
3038,G,1014,533,4727,2034,5798,3039,3713,G
3038,H,573,573,5300,891,6689,3039,4727,H
3038,M,362,362,5662,1215,7904,3039,5300,M
3038,N,1397,1397,7059,600,8504,3039,5662,N
3038,O,836,836,7895,785,9289,3039,7059,O
3038,N,1022,1022,8917,1095,10384,3039,7895,N
3038,O,203,203,9120,327,10711,3039,8917,O
3038,P,729,729,9849,353,11064,3039,9120,P
3039,A,862,862,862,1367,1367,3040,0,A
3039,B,532,532,1394,90,1457,3040,862,B
3039,C,119,119,1513,535,1992,3040,1394,C
3039,D,2875,2875,4388,3780,5772,3040,1513,D
3039,M,321,321,4709,295,6067,3040,4388,M
3039,N,99,99,4808,180,6247,3040,4709,N
3039,O,946,946,5754,935,7182,3040,4808,O
3039,P,899,899,6653,385,7567,3040,5754,P
3040,AEI,66,66,66,254,254,3041,0,A
3040,BEI,147,81,147,211,211,3041,0,E
3040,BFI,169,22,169,1004,1004,3041,0,I
3040,BFJ,308,205,374,180,434,3041,66,B
3040,CFJ,255,28,402,240,451,3041,147,F
3040,CGJ,955,722,1124,180,1184,3041,169,J
3040,CGK,970,220,1344,545,979,3041,374,C
3040,BGK,958,16,1360,1180,1631,3041,402,G
3040,BFK,815,579,1939,1050,2234,3041,1124,K
3040,BFJ,1138,559,2498,965,2596,3041,1360,F
3040,BGJ,317,317,2815,390,2986,3041,2498,G
3040,BHJ,1586,115,2930,2070,3049,3041,1344,B
3040,CHJ,1051,60,2990,830,3064,3041,1939,J
3040,CHK,332,272,3262,300,3349,3041,2930,C
3040,DHK,412,140,3402,300,3364,3041,2990,K
3040,DHL,1172,1032,4434,5100,8449,3041,3262,D
3040,HL,2983,1364,5798,485,3471,3041,2815,H
3040,L,4513,2117,7915,5100,8464,3041,3402,L
3040,M,103,103,8018,72,8536,3041,7915,M
3040,N,129,129,8147,240,8776,3041,8018,N
3040,O,331,331,8478,330,9106,3041,8147,O
3040,N,922,922,9400,880,9986,3041,8478,N
3040,O,1178,1178,10578,1160,11146,3041,9400,O
3040,P,2087,2087,12665,665,11811,3041,10578,P
3041,A,3563,3563,3563,2952,2952,3042,0,A
3041,B,410,410,3973,180,3132,3042,3563,B
3041,C,553,553,4526,840,3972,3042,3973,C
3041,B,823,823,5349,1420,5392,3042,4526,B
3041,C,463,463,5812,700,6092,3042,5349,C
3041,D,14386,14386,20198,6840,12932,3042,5812,D
3041,M,1947,1947,22145,2093,15025,3042,20198,M
3041,N,264,264,22409,180,15205,3042,22145,N
3041,O,497,497,22906,1030,16235,3042,22409,O
3041,N,2055,2055,24961,1520,17755,3042,22906,N
3041,O,549,549,25510,710,18465,3042,24961,O
3041,P,12706,12706,38216,6960,25425,3042,25510,P
3042,A,3616,3616,3616,4213,4213,3043,0,A
3042,B,691,691,4307,90,4303,3043,3616,B
3042,C,1063,1063,5370,1385,5688,3043,4307,C
3042,D,425,425,5795,3780,9468,3043,5370,D
3042,M,192,192,5987,530,9998,3043,5795,M
3042,N,445,445,6432,90,10088,3043,5987,N
3042,O,507,507,6939,850,10938,3043,6432,O
3042,P,632,632,7571,3780,14718,3043,6939,P
3043,AEI,800,800,800,3557,3557,3044,0,I
3043,AEJ,1964,1164,1964,6180,6180,3044,0,A
3043,BEJ,2791,1627,3591,90,3647,3044,800,J
3043,BEK,862,862,4453,1215,4862,3044,3591,K
3043,BEJ,363,363,4816,10,4872,3044,4453,J
3043,BEK,1114,1114,5930,920,5792,3044,4816,K
3043,BEL,4320,354,6284,90,6270,3044,1964,B
3043,CEL,483,129,6413,3780,9572,3044,5930,L
3043,CE,1179,1050,7463,1465,7735,3044,6284,C
3043,BE,713,713,8176,500,8235,3044,7463,B
3043,CE,643,643,8819,935,9170,3044,8176,C
3043,DE,348,348,9167,3780,12950,3044,8819,D
3043,E,9267,100,9267,10553,10553,3044,0,E
3043,F,1406,1406,10673,180,10733,3044,9267,F
3043,G,730,730,11403,885,11618,3044,10673,G
3043,F,2065,2065,13468,1885,13503,3044,11403,F
3043,G,925,925,14393,1070,14573,3044,13468,G
3043,H,833,833,15226,6900,21473,3044,14393,H
3043,M,226,226,15452,760,22233,3044,15226,M
3043,N,556,556,16008,90,22323,3044,15452,N
3043,O,637,637,16645,950,23273,3044,16008,O
3043,N,1504,1504,18149,1185,24458,3044,16645,N
3043,O,250,250,18399,625,25083,3044,18149,O
3043,P,8832,8832,27231,3780,28863,3044,18399,P
3044,A,49,49,49,2859,2859,3045,0,A
3044,B,2990,2990,3039,240,3099,3045,49,B
3044,C,170,170,3209,285,3384,3045,3039,C
3044,D,3303,3303,6512,5160,8544,3045,3209,D
3044,M,802,802,7314,1914,10458,3045,6512,M
3044,N,1253,1253,8567,150,10608,3045,7314,N
3044,O,1359,1359,9926,1610,12218,3045,8567,O
3044,P,271,271,10197,2520,14738,3045,9926,P
3045,A,1552,1552,1552,2039,2039,3046,0,A
3045,B,622,622,2174,150,2189,3046,1552,B
3045,C,204,204,2378,425,2614,3046,2174,C
3045,B,639,639,3017,445,3059,3046,2378,B
3045,C,795,795,3812,770,3829,3046,3017,C
3045,D,119,119,3931,4230,8059,3046,3812,D
3045,M,1822,1822,5753,2273,10332,3046,3931,M
3045,N,480,480,6233,90,10422,3046,5753,N
3045,O,585,585,6818,850,11272,3046,6233,O
3045,P,572,572,7390,3780,15052,3046,6818,P
3046,AE,4,4,4,29,29,3047,0,E
3046,AF,223,223,227,240,269,3047,4,F
3046,AG,660,433,660,878,878,3047,0,A
3046,BG,621,188,848,795,1064,3047,227,G
3046,BH,270,82,930,90,968,3047,660,B
3046,CH,637,555,1485,3960,5024,3047,848,H
3046,C,1443,888,2373,1935,2903,3047,930,C
3046,D,1621,1621,3994,3780,6683,3047,2373,D
3046,M,1510,1510,5504,1867,8550,3047,3994,M
3046,N,388,388,5892,90,8640,3047,5504,N
3046,O,1540,1540,7432,1745,10385,3047,5892,O
3046,N,560,560,7992,340,10725,3047,7432,N
3046,O,549,549,8541,945,11670,3047,7992,O
3046,P,1638,1638,10179,3780,15450,3047,8541,P
3047,AE,156,156,156,251,251,3048,0,A
3047,BE,220,220,376,180,431,3048,156,B
3047,CE,483,107,483,755,755,3048,0,E
3047,CF,432,432,915,180,935,3048,483,F
3047,CG,990,451,1366,935,1366,3048,376,C
3047,DG,1254,803,2169,1810,2745,3048,915,G
3047,DF,1087,284,2453,385,1751,3048,1366,D
3047,F,645,361,2814,235,2980,3048,2169,F
3047,G,410,410,3224,540,3520,3048,2814,G
3047,H,739,739,3963,9780,13300,3048,3224,H
3047,M,1118,1118,5081,1167,14467,3048,3963,M
3047,N,158,158,5239,150,14617,3048,5081,N
3047,O,590,590,5829,733,15350,3048,5239,O
3047,P,515,515,6344,632,15982,3048,5829,P
3048,AE,37,37,37,1261,1261,3049,0,A
3048,BE,64,27,64,83,83,3049,0,E
3048,BF,154,154,218,195,278,3049,64,F
3048,BG,732,732,950,700,978,3049,218,G
3048,BH,1444,531,1481,300,1561,3049,37,B
3048,CH,871,340,1821,385,1363,3049,950,H
3048,C,702,362,2183,720,2281,3049,1481,C
3048,D,1299,1299,3482,385,2666,3049,2183,D
3048,M,1012,1012,4494,1743,4409,3049,3482,M
3048,N,1126,1126,5620,420,4829,3049,4494,N
3048,O,946,946,6566,1114,5943,3049,5620,O
3048,P,55,55,6621,341,6284,3049,6566,P
3049,A,1034,1034,1034,1393,1393,3050,0,A
3049,B,392,392,1426,90,1483,3050,1034,B
3049,C,865,865,2291,1230,2713,3050,1426,C
3049,B,734,734,3025,375,3088,3050,2291,B
3049,C,513,513,3538,815,3903,3050,3025,C
3049,D,27960,27960,31498,3780,7683,3050,3538,D
3049,M,754,754,32252,1660,9343,3050,31498,M
3049,N,930,930,33182,90,9433,3050,32252,N
3049,O,581,581,33763,805,10238,3050,33182,O
3049,N,653,653,34416,420,10658,3050,33763,N
3049,O,650,650,35066,935,11593,3050,34416,O
3049,P,1104,1104,36170,3780,15373,3050,35066,P
3050,AE,212,212,212,1138,1138,3051,0,A
3050,BE,284,72,284,330,330,3051,0,E
3050,BF,760,760,1044,730,1060,3051,284,F
3050,BG,1068,236,1280,210,1348,3051,212,B
3050,CG,153,153,1433,265,1613,3051,1280,C
3050,BG,930,541,1974,925,1985,3051,1044,G
3050,BH,1490,949,2923,1345,2958,3051,1433,B
3050,CH,1496,547,3470,2760,4745,3051,1974,H
3050,C,803,256,3726,890,3848,3051,2923,C
3050,D,3345,3345,7071,5220,9068,3051,3726,D
3050,M,28,28,7099,848,9916,3051,7071,M
3050,N,1036,1036,8135,240,10156,3051,7099,N
3050,O,1011,1011,9146,1150,11306,3051,8135,O
3050,P,409,409,9555,720,12026,3051,9146,P
3051,A,1,1,1,47,47,3052,0,A
3051,B,394,394,395,420,467,3052,1,B
3051,C,1692,1692,2087,1740,2207,3052,395,C
3051,D,382,382,2469,420,2627,3052,2087,D
3051,M,4513,4513,6982,4595,7222,3052,2469,M
3051,N,187,187,7169,90,7312,3052,6982,N
3051,O,574,574,7743,860,8172,3052,7169,O
3051,N,2374,2374,10117,2160,10332,3052,7743,N
3051,O,512,512,10629,805,11137,3052,10117,O
3051,P,13500,13500,24129,3780,14917,3052,10629,P
3052,AE,206,206,206,1521,1521,3053,0,A
3052,BE,1536,1330,1536,3871,3871,3053,0,E
3052,BF,1435,105,1641,180,1701,3053,206,B
3052,CF,587,587,2228,585,2286,3053,1641,C
3052,DF,1845,1845,4073,6960,9246,3053,2228,D
3052,F,3109,572,4645,780,4651,3053,1536,F
3052,G,1336,1336,5981,1350,6001,3053,4645,G
3052,H,1123,1123,7104,550,6551,3053,5981,H
3052,M,279,279,7383,285,9531,3053,7104,M
3052,N,354,354,7737,420,9951,3053,7383,N
3052,O,429,429,8166,790,10741,3053,7737,O
3052,P,1775,1775,9941,1265,12006,3053,8166,P
3053,AEI,94,94,94,425,425,3054,0,I
3053,AEJ,191,97,191,1064,1064,3054,0,E
3053,AFJ,421,324,515,180,605,3054,94,J
3053,AFK,575,60,575,730,730,3054,0,A
3053,BFK,267,267,842,180,910,3054,575,B
3053,CFK,382,55,897,660,1265,3054,515,K
3053,CFL,142,87,984,140,1050,3054,842,C
3053,DFL,56,56,1040,2880,3930,3054,984,D
3053,FL,952,103,1143,150,1214,3054,191,F
3053,GL,116,116,1259,135,1349,3054,1143,G
3053,HL,1086,1086,2345,2880,4229,3054,1259,H
3053,L,1715,267,2612,3960,5225,3054,897,L
3053,M,43,43,2655,72,5297,3054,2612,M
3053,N,118,118,2773,150,5447,3054,2655,N
3053,O,302,302,3075,130,5577,3054,2773,O
3053,P,1,1,3076,2850,8427,3054,3075,P
3054,AEI,18,18,18,184,184,3055,0,I
3054,AEJ,416,416,434,240,424,3055,18,J
3054,AEK,530,96,530,1939,1939,3055,0,E
3054,AFK,585,55,585,1302,1302,3055,0,A
3054,BFK,814,663,1248,1040,1464,3055,434,K
3054,BFL,10,10,1258,3960,5424,3055,1248,L
3054,BF,747,74,1332,90,1392,3055,585,B
3054,CF,299,299,1631,704,2096,3055,1332,C
3054,DF,1437,336,1967,90,2029,3055,530,F
3054,DG,445,109,2076,3780,5876,3055,1631,D
3054,G,1070,961,3037,1370,3399,3055,1967,G
3054,H,840,840,3877,3780,7179,3055,3037,H
3054,M,175,175,4052,849,8028,3055,3877,M
3054,N,700,700,4752,90,8118,3055,4052,N
3054,O,386,386,5138,705,8823,3055,4752,O
3054,P,1138,1138,6276,3780,12603,3055,5138,P
3055,A,21,21,21,209,209,3056,0,A
3055,B,383,383,404,240,449,3056,21,B
3055,C,922,922,1326,1035,1484,3056,404,C
3055,D,854,854,2180,3960,5444,3056,1326,D
3055,M,97,97,2277,205,5649,3056,2180,M
3055,N,141,141,2418,90,5739,3056,2277,N
3055,O,267,267,2685,695,6434,3056,2418,O
3055,P,1197,1197,3882,3780,10214,3056,2685,P
3056,A,1222,1222,1222,3135,3135,3057,0,A
3056,B,2166,2166,3388,300,3435,3057,1222,B
3056,C,606,606,3994,740,4175,3057,3388,C
3056,D,71,71,4065,1560,5735,3057,3994,D
3056,M,1620,1620,5685,1610,7345,3057,4065,M
3056,N,249,249,5934,300,7645,3057,5685,N
3056,O,654,654,6588,745,8390,3057,5934,O
3056,N,386,386,6974,300,8690,3057,6588,N
3056,O,202,202,7176,405,9095,3057,6974,O
3056,P,1004,1004,8180,1140,10235,3057,7176,P
3057,AEI,107,107,107,1202,1202,3058,0,I
3057,AEJ,142,35,142,667,667,3058,0,E
3057,AFJ,754,754,896,240,907,3058,142,F
3057,AGJ,1185,289,1185,1555,1555,3058,0,A
3057,BGJ,1289,211,1396,240,1442,3058,107,J
3057,BGK,609,109,1505,810,1717,3058,896,G
3057,BHK,611,291,1796,300,1855,3058,1185,B
3057,CHK,744,344,2140,760,2202,3058,1396,K
3057,CHL,836,492,2632,1045,2900,3058,1796,C
3057,DHL,36,36,2668,1140,4040,3058,2632,D
3057,HL,746,218,2886,7680,9882,3058,2140,L
3057,H,3152,1771,4657,3960,5677,3058,1505,H
3057,M,1322,1322,5979,1564,11446,3058,4657,M
3057,N,1802,1802,7781,180,11626,3058,5979,N
3057,O,889,889,8670,1295,12921,3058,7781,O
3057,P,5491,5491,14161,6680,19601,3058,8670,P
3058,A,18,18,18,166,166,3059,0,A
3058,B,347,347,365,240,406,3059,18,B
3058,C,477,477,842,695,1101,3059,365,C
3058,B,2007,2007,2849,1810,2911,3059,842,B
3058,C,779,779,3628,1620,4531,3059,2849,C
3058,D,613,613,4241,3960,8491,3059,3628,D
3058,M,182,182,4423,758,9249,3059,4241,M
3058,N,678,678,5101,150,9399,3059,4423,N
3058,O,150,150,5251,110,9509,3059,5101,O
3058,N,300,300,5551,335,9844,3059,5251,N
3058,O,642,642,6193,605,10449,3059,5551,O
3058,P,2743,2743,8936,4200,14649,3059,6193,P
3059,AE,126,126,126,1435,1435,3060,0,E
3059,AF,1412,1286,1412,1547,1547,3060,0,A
3059,BF,1369,83,1495,90,1525,3060,126,F
3059,BG,161,78,1573,90,1637,3060,1412,B
3059,CG,531,531,2104,905,2542,3060,1573,C
3059,DG,339,339,2443,3780,6322,3060,2104,D
3059,G,958,10,2453,1230,2755,3060,1495,G
3059,H,7,7,2460,3780,6535,3060,2453,H
3059,M,698,698,3158,1337,7872,3060,2460,M
3059,N,671,671,3829,90,7962,3060,3158,N
3059,O,145,145,3974,535,8497,3060,3829,O
3059,P,1382,1382,5356,3780,12277,3060,3974,P
3060,AE,57,57,57,1545,1545,3061,0,A
3060,BE,1609,1609,1666,185,1730,3061,57,B
3060,CE,542,542,2208,525,2255,3061,1666,C
3060,DE,2735,527,2735,3280,3280,3061,0,E
3060,DF,666,666,3401,150,3430,3061,2735,F
3060,DG,1227,34,3435,2880,5135,3061,2208,D
3060,G,464,430,3865,455,3885,3061,3401,G
3060,F,204,204,4069,235,4120,3061,3865,F
3060,G,322,322,4391,115,4235,3061,4069,G
3060,H,1036,1036,5427,4230,8465,3061,4391,H
3060,M,70,70,5497,104,8569,3061,5427,M
3060,N,130,130,5627,150,8719,3061,5497,N
3060,O,115,115,5742,115,8834,3061,5627,O
3060,N,801,801,6543,790,9624,3061,5742,N
3060,O,272,272,6815,660,10284,3061,6543,O
3060,P,1520,1520,8335,4140,14424,3061,6815,P
3061,AEI,225,225,225,1826,1826,3062,0,E
3061,AFI,1654,1654,1879,90,1916,3062,225,F
3061,AGI,1109,1109,2988,1355,3271,3062,1879,G
3061,AHI,197,197,3185,3780,7051,3062,2988,H
3061,AI,23078,19893,23078,23598,23598,3062,0,A
3061,BI,568,568,23646,90,23688,3062,23078,B
3061,CI,881,881,24527,1215,24903,3062,23646,C
3061,DI,226,226,24753,3780,28683,3062,24527,D
3061,I,38980,14227,38980,39272,39272,3062,0,I
3061,J,331,331,39311,90,39362,3062,38980,J
3061,K,716,716,40027,1130,40492,3062,39311,K
3061,L,263,263,40290,3780,44272,3062,40027,L
3061,M,420,420,40710,1056,45328,3062,40290,M
3061,N,669,669,41379,90,45418,3062,40710,N
3061,O,238,238,41617,695,46113,3062,41379,O
3061,P,42211,42211,83828,3780,49893,3062,41617,P
3062,A,2,2,2,73,73,3063,0,A
3062,B,161,161,163,150,223,3063,2,B
3062,C,615,615,778,475,698,3063,163,C
3062,D,226,226,1004,475,1173,3063,778,D
3062,M,6211,6211,7215,7920,9093,3063,1004,M
3062,N,2453,2453,9668,780,9873,3063,7215,N
3062,O,1016,1016,10684,1175,11048,3063,9668,O
3062,N,2810,2810,13494,2675,13723,3063,10684,N
3062,O,5014,5014,18508,5140,18863,3063,13494,O
3062,P,366,366,18874,290,19153,3063,18508,P
3063,AEI,100,100,100,114,114,3064,0,I
3063,AEJ,115,115,215,150,264,3064,100,J
3063,AEK,143,143,358,130,394,3064,215,K
3063,AEJ,506,148,506,1341,1341,3064,0,A
3063,BEJ,901,901,1407,90,1431,3064,506,B
3063,CEJ,478,478,1885,855,2286,3064,1407,C
3063,DEJ,2267,740,2625,1545,1939,3064,358,J
3063,DEK,1010,270,2895,3780,6066,3064,1885,D
3063,EK,808,538,3433,775,2714,3064,2625,K
3063,EL,222,222,3655,4230,6944,3064,3433,L
3063,E,4521,866,4521,4679,4679,3064,0,E
3063,F,200,200,4721,90,4769,3064,4521,F
3063,G,617,617,5338,820,5589,3064,4721,G
3063,H,28,28,5366,3780,9369,3064,5338,H
3063,M,161,161,5527,301,9670,3064,5366,M
3063,N,163,163,5690,90,9760,3064,5527,N
3063,O,439,439,6129,880,10640,3064,5690,O
3063,P,60,60,6189,3780,14420,3064,6129,P
3064,AEI,250,250,250,366,366,3065,0,I
3064,AEJ,255,255,505,180,546,3065,250,J
3064,AEK,613,613,1118,704,1250,3065,505,K
3064,AEL,1627,509,1627,172,172,3065,0,E
3064,AFL,37,37,1664,120,292,3065,1627,F
3064,AGL,1704,40,1704,2114,2114,3065,0,A
3064,BGL,590,590,2294,240,2354,3065,1704,B
3064,CGL,198,198,2492,305,2659,3065,2294,C
3064,BGL,1077,249,2741,1350,1642,3065,1664,G
3064,BFL,619,370,3111,495,3154,3065,2492,B
3064,CFL,454,84,3195,1620,3262,3065,2741,F
3064,CGL,85,1,3196,220,3374,3065,3111,C
3064,DGL,682,681,3877,630,3892,3065,3195,G
3064,DFL,2962,203,4080,4080,5330,3065,1118,L
3064,DF,4245,4042,8122,2250,6142,3065,3877,F
3064,DG,554,554,8676,780,6922,3065,8122,G
3064,DH,46,46,8722,3960,10882,3065,8676,H
3064,D,7129,1603,10325,705,4079,3065,3196,D
3064,M,242,242,10567,797,11679,3065,10325,M
3064,N,661,661,11228,150,11829,3065,10567,N
3064,O,123,123,11351,125,11954,3065,11228,O
3064,N,337,337,11688,345,12299,3065,11351,N
3064,O,127,127,11815,120,12419,3065,11688,O
3064,P,1072,1072,12887,4230,16649,3065,11815,P
3065,AE,63,63,63,139,139,3066,0,A
3065,BE,255,255,318,240,379,3066,63,B
3065,CE,143,143,461,280,659,3066,318,C
3065,DE,203,203,664,5160,5819,3066,461,D
3065,E,685,21,685,1637,1637,3066,0,E
3065,F,1132,1132,1817,240,1877,3066,685,F
3065,G,176,176,1993,295,2172,3066,1817,G
3065,F,641,641,2634,515,2687,3066,1993,F
3065,G,175,175,2809,290,2977,3066,2634,G
3065,H,5860,5860,8669,5160,8137,3066,2809,H
3065,M,913,913,9582,1104,9241,3066,8669,M
3065,N,334,334,9916,180,9421,3066,9582,N
3065,O,815,815,10731,885,10306,3066,9916,O
3065,N,842,842,11573,795,11101,3066,10731,N
3065,O,602,602,12175,665,11766,3066,11573,O
3065,P,27567,27567,39742,5460,17226,3066,12175,P
3066,A,738,738,738,1165,1165,3067,0,A
3066,B,609,609,1347,180,1345,3067,738,B
3066,C,905,905,2252,930,2275,3067,1347,C
3066,D,2419,2419,4671,550,2825,3067,2252,D
3066,M,24,24,4695,776,3601,3067,4671,M
3066,N,1044,1044,5739,330,3931,3067,4695,N
3066,O,1908,1908,7647,1738,5669,3067,5739,O
3066,P,1037,1037,8684,1132,6801,3067,7647,P
3067,AE,655,655,655,1513,1513,3068,0,E
3067,AF,1127,1127,1782,90,1603,3068,655,F
3067,AG,910,910,2692,1250,2853,3068,1782,G
3067,AH,1009,1009,3701,3780,6633,3068,2692,H
3067,A,37136,33435,37136,37919,37919,3068,0,A
3067,B,1101,1101,38237,90,38009,3068,37136,B
3067,C,1045,1045,39282,1400,39409,3068,38237,C
3067,D,89,89,39371,3780,43189,3068,39282,D
3067,M,706,706,40077,1281,44470,3068,39371,M
3067,N,609,609,40686,90,44560,3068,40077,N
3067,O,140,140,40826,535,45095,3068,40686,O
3067,P,10041,10041,50867,3780,48875,3068,40826,P
3068,AE,298,298,298,280,280,3069,0,A
3068,BE,231,231,529,300,580,3069,298,B
3068,CE,1159,630,1159,1197,1197,3069,0,E
3068,CF,706,76,1235,755,1335,3069,529,C
3068,DF,321,245,1480,300,1497,3069,1159,F
3068,DG,910,910,2390,1050,2547,3069,1480,G
3068,DF,1424,1424,3814,1420,3967,3069,2390,F
3068,DG,1916,1916,5730,2460,6427,3069,3814,G
3068,DH,3326,3326,9056,3960,10387,3069,5730,H
3068,D,11675,3854,12910,1140,2475,3069,1235,D
3068,M,511,511,13421,1769,12156,3069,12910,M
3068,N,1362,1362,14783,150,12306,3069,13421,N
3068,O,195,195,14978,185,12491,3069,14783,O
3068,N,708,708,15686,720,13211,3069,14978,N
3068,O,129,129,15815,125,13336,3069,15686,O
3068,P,1457,1457,17272,4290,17626,3069,15815,P
3069,AE,33,33,33,636,636,3070,0,A
3069,BE,336,303,336,325,325,3070,0,E
3069,BF,193,193,529,240,565,3070,336,F
3069,BG,801,305,834,240,876,3070,33,B
3069,CG,717,412,1246,1005,1570,3070,529,G
3069,CH,659,247,1493,880,1756,3070,834,C
3069,DH,56,56,1549,3960,5716,3070,1493,D
3069,H,1112,809,2358,3960,5530,3070,1246,H
3069,M,187,187,2545,219,5935,3070,2358,M
3069,N,261,261,2806,240,6175,3070,2545,N
3069,O,2275,2275,5081,860,7035,3070,2806,O
3069,N,455,455,5536,1775,8810,3070,5081,N
3069,O,653,653,6189,900,9710,3070,5536,O
3069,P,116,116,6305,3960,13670,3070,6189,P
3070,A,131,131,131,370,370,3071,0,A
3070,B,379,379,510,90,460,3071,131,B
3070,C,1357,1357,1867,1780,2240,3071,510,C
3070,D,34,34,1901,3780,6020,3071,1867,D
3070,M,143,143,2044,1354,7374,3071,1901,M
3070,N,1254,1254,3298,90,7464,3071,2044,N
3070,O,349,349,3647,720,8184,3071,3298,O
3070,P,1658,1658,5305,3780,11964,3071,3647,P
3071,AE,718,718,718,1319,1319,3072,0,E
3071,AF,691,691,1409,150,1469,3072,718,F
3071,AG,62,62,1471,50,1519,3072,1409,G
3071,AF,140,140,1611,135,1654,3072,1471,F
3071,AG,131,131,1742,235,1889,3072,1611,G
3071,AH,101,101,1843,5280,7169,3072,1742,H
3071,A,6658,4815,6658,6747,6747,3072,0,A
3071,B,179,179,6837,150,6897,3072,6658,B
3071,C,63,63,6900,50,6947,3072,6837,C
3071,B,133,133,7033,135,7082,3072,6900,B
3071,C,144,144,7177,235,7317,3072,7033,C
3071,D,115,115,7292,5280,12597,3072,7177,D
3071,M,64,64,7356,230,12827,3072,7292,M
3071,N,264,264,7620,150,12977,3072,7356,N
3071,O,188,188,7808,155,13132,3072,7620,O
3071,N,803,803,8611,830,13962,3072,7808,N
3071,O,134,134,8745,125,14087,3072,8611,O
3071,P,310,310,9055,4230,18317,3072,8745,P
3072,AE,572,572,572,823,823,3073,0,E
3072,AF,886,314,886,949,949,3073,0,A
3072,BF,447,133,1019,240,1063,3073,572,F
3072,BG,444,311,1330,420,1369,3073,886,B
3072,CG,490,179,1509,790,1853,3073,1019,G
3072,CH,1018,839,2348,830,2199,3073,1330,C
3072,DH,1327,488,2836,3960,5813,3073,1509,H
3072,D,1903,1415,4251,3960,6159,3073,2348,D
3072,M,1709,1709,5960,2085,8244,3073,4251,M
3072,N,491,491,6451,180,8424,3073,5960,N
3072,O,984,984,7435,1240,9664,3073,6451,O
3072,N,660,660,8095,315,9979,3073,7435,N
3072,O,417,417,8512,565,10544,3073,8095,O
3072,P,2659,2659,11171,6960,17504,3073,8512,P
3073,A,65,65,65,1087,1087,3074,0,A
3073,B,1202,1202,1267,240,1327,3074,65,B
3073,C,732,732,1999,780,2107,3074,1267,C
3073,D,197,197,2196,7680,9787,3074,1999,D
3073,M,146,146,2342,355,10142,3074,2196,M
3073,N,446,446,2788,300,10442,3074,2342,N
3073,O,724,724,3512,820,11262,3074,2788,O
3073,N,1158,1158,4670,1050,12312,3074,3512,N
3073,O,634,634,5304,910,13222,3074,4670,O
3073,P,31192,31192,36496,5220,18442,3074,5304,P
3074,AEI,160,160,160,1136,1136,3075,0,A
3074,BEI,174,14,174,167,167,3075,0,E
3074,BFI,86,86,260,150,317,3075,174,F
3074,BGI,145,145,405,140,457,3075,260,G
3074,BFI,1168,923,1328,240,1376,3075,160,B
3074,CFI,162,162,1490,410,1786,3075,1328,C
3074,BFI,1546,461,1951,1535,1992,3075,405,F
3074,BGI,708,247,2198,460,2246,3075,1490,B
3074,CGI,780,533,2731,765,2757,3075,1951,G
3074,CHI,888,355,3086,1040,3286,3075,2198,C
3074,DHI,12,12,3098,3960,7246,3075,3086,D
3074,HI,437,70,3168,4230,6987,3075,2731,H
3074,I,36987,33819,36987,37993,37993,3075,0,I
3074,J,1036,1036,38023,90,38083,3075,36987,J
3074,K,997,997,39020,1210,39293,3075,38023,K
3074,L,40,40,39060,3780,43073,3075,39020,L
3074,M,122,122,39182,270,43343,3075,39060,M
3074,N,201,201,39383,90,43433,3075,39182,N
3074,O,1114,1114,40497,1425,44858,3075,39383,O
3074,P,116,116,40613,3780,48638,3075,40497,P
3075,AEI,370,370,370,475,475,3076,0,A
3075,BEI,450,80,450,405,405,3076,0,I
3075,BEJ,228,228,678,300,705,3076,450,J
3075,BEK,373,65,743,300,775,3076,370,B
3075,CEK,699,634,1377,855,1560,3076,678,K
3075,CEJ,694,60,1437,1015,1790,3076,743,C
3075,BEJ,1520,83,1520,1505,1505,3076,0,E
3075,BFJ,324,181,1701,185,1745,3076,1377,J
3075,BFK,309,45,1746,10,1800,3076,1437,B
3075,CFK,298,72,1818,300,1805,3076,1520,F
3075,CGK,249,132,1950,300,2045,3076,1701,K
3075,CGL,838,706,2656,855,2660,3076,1818,G
3075,CFL,207,207,2863,185,2845,3076,2656,F
3075,CGL,237,237,3100,300,3145,3076,2863,G
3075,CHL,2384,1030,4130,2630,4430,3076,1746,C
3075,DHL,2260,2260,6390,1620,6050,3076,4130,D
3075,HL,4315,1025,7415,4020,7165,3076,3100,H
3075,L,5830,365,7780,4020,6065,3076,1950,L
3075,M,135,135,7915,135,7300,3076,7780,M
3075,N,120,120,8035,180,7480,3076,7915,N
3075,O,506,506,8541,840,8320,3076,8035,O
3075,N,765,765,9306,415,8735,3076,8541,N
3075,O,777,777,10083,775,9510,3076,9306,O
3075,P,442,442,10525,1140,10650,3076,10083,P
3076,AEI,182,182,182,359,359,3077,0,A
3076,BEI,287,287,469,170,529,3077,182,B
3076,CEI,548,79,548,802,802,3077,0,E
3076,CFI,574,495,1043,650,1179,3077,469,C
3076,DFI,623,128,1171,400,1202,3077,548,F
3076,DGI,1333,162,1333,1689,1689,3077,0,I
3076,DGJ,550,550,1883,240,1929,3077,1333,J
3076,DGK,1316,604,2487,1210,2412,3077,1171,G
3076,DHK,872,268,2755,976,2905,3077,1883,K
3076,DHJ,622,622,3377,495,3400,3077,2755,J
3076,DHK,817,817,4194,810,4210,3077,3377,K
3076,DHL,2060,353,4547,550,2962,3077,2487,H
3076,DL,4503,999,5546,385,1564,3077,1043,D
3076,L,15978,14626,20172,3960,8170,3077,4194,L
3076,M,697,697,20869,1277,9447,3077,20172,M
3076,N,969,969,21838,420,9867,3077,20869,N
3076,O,1115,1115,22953,1259,11126,3077,21838,O
3076,P,883,883,23836,351,11477,3077,22953,P
3077,AE,558,558,558,1556,1556,3078,0,E
3077,AF,1025,1025,1583,90,1646,3078,558,F
3077,AG,981,981,2564,1210,2856,3078,1583,G
3077,AH,28,28,2592,3780,6636,3078,2564,H
3077,A,31379,28787,31379,32416,32416,3078,0,A
3077,B,1067,1067,32446,90,32506,3078,31379,B
3077,C,1417,1417,33863,1635,34141,3078,32446,C
3077,D,65,65,33928,3780,37921,3078,33863,D
3077,M,280,280,34208,733,38654,3078,33928,M
3077,N,734,734,34942,360,39014,3078,34208,N
3077,O,1095,1095,36037,990,40004,3078,34942,O
3077,P,4394,4394,40431,550,40554,3078,36037,P
3078,AE,167,167,167,191,191,3079,0,E
3078,AF,122,122,289,150,341,3079,167,F
3078,AG,153,153,442,120,461,3079,289,G
3078,AF,844,844,1286,865,1326,3079,442,F
3078,AG,394,394,1680,645,1971,3079,1286,G
3078,AH,5487,3807,5487,6696,6696,3079,0,A
3078,BH,1399,1399,6886,240,6936,3079,5487,B
3078,CH,378,378,7264,915,7851,3079,6886,C
3078,DH,6272,688,7952,4290,6261,3079,1680,H
3078,D,3014,2326,10278,3960,11811,3079,7264,D
3078,M,2563,2563,12841,2664,14475,3079,10278,M
3078,N,292,292,13133,240,14715,3079,12841,N
3078,O,723,723,13856,850,15565,3079,13133,O
3078,N,1688,1688,15544,1555,17120,3079,13856,N
3078,O,163,163,15707,395,17515,3079,15544,O
3078,P,1159,1159,16866,3960,21475,3079,15707,P
3079,AE,891,891,891,1193,1193,3080,0,A
3079,BE,462,462,1353,180,1373,3080,891,B
3079,CE,917,917,2270,930,2303,3080,1353,C
3079,DE,424,424,2694,610,2913,3080,2270,D
3079,E,2886,192,2886,3030,3030,3080,0,E
3079,F,408,408,3294,300,3330,3080,2886,F
3079,G,581,581,3875,765,4095,3080,3294,G
3079,H,4483,4483,8358,3960,8055,3080,3875,H
3079,M,914,914,9272,2411,10466,3080,8358,M
3079,N,1870,1870,11142,420,10886,3080,9272,N
3079,O,654,654,11796,816,11702,3080,11142,O
3079,P,326,326,12122,414,12116,3080,11796,P
3080,A,147,147,147,155,155,3081,0,A
3080,B,83,83,230,135,290,3081,147,B
3080,C,158,158,388,280,570,3081,230,C
3080,D,440,440,828,5160,5730,3081,388,D
3080,M,752,752,1580,1760,7490,3081,828,M
3080,N,1114,1114,2694,150,7640,3081,1580,N
3080,O,1394,1394,4088,1610,9250,3081,2694,O
3080,P,1480,1480,5568,2520,11770,3081,4088,P
3081,AE,126,126,126,140,140,3082,0,E
3081,AF,151,151,277,180,320,3082,126,F
3081,AG,135,135,412,156,476,3082,277,G
3081,AH,115,115,527,379,855,3082,412,H
3081,A,1838,1311,1838,3228,3228,3082,0,A
3081,B,1510,1510,3348,180,3408,3082,1838,B
3081,C,1245,1245,4593,835,4243,3082,3348,C
3081,B,685,685,5278,1095,5338,3082,4593,B
3081,C,484,484,5762,610,5948,3082,5278,C
3081,D,2371,2371,8133,6960,12908,3082,5762,D
3081,M,10098,10098,18231,10652,23560,3082,8133,M
3081,N,594,594,18825,90,23650,3082,18231,N
3081,O,825,825,19650,1215,24865,3082,18825,O
3081,P,297,297,19947,3780,28645,3082,19650,P
3082,A,25,25,25,101,101,3083,0,A
3082,B,185,185,210,135,236,3083,25,B
3082,C,217,217,427,295,531,3083,210,C
3082,D,129,129,556,5160,5691,3083,427,D
3082,M,465,465,1021,726,6417,3083,556,M
3082,N,341,341,1362,150,6567,3083,1021,N
3082,O,128,128,1490,100,6667,3083,1362,O
3082,N,442,442,1932,500,7167,3083,1490,N
3082,O,121,121,2053,300,7467,3083,1932,O
3082,P,74,74,2127,5100,12567,3083,2053,P
3083,AEI,25,25,25,624,624,3084,0,A
3083,BEI,739,714,739,1225,1225,3084,0,E
3083,BFI,802,88,827,240,864,3084,25,B
3083,CFI,666,578,1405,240,1465,3084,739,F
3083,CGI,632,54,1459,960,1824,3084,827,C
3083,DGI,100,100,1559,3960,5784,3084,1459,D
3083,GI,239,85,1644,325,1790,3084,1405,G
3083,FI,1411,1411,3055,1320,3110,3084,1644,F
3083,GI,3789,734,3789,4246,4246,3084,0,I
3083,GJ,801,67,3856,930,4040,3084,3055,G
3083,HJ,817,750,4606,420,4666,3084,3789,J
3083,HK,982,982,5588,1282,5948,3084,4606,K
3083,HL,4085,2353,7941,6990,11030,3084,3856,H
3083,L,2565,212,8153,358,6306,3084,5588,L
3083,M,314,314,8467,3387,14417,3084,8153,M
3083,N,3861,3861,12328,90,14507,3084,8467,N
3083,O,1173,1173,13501,1525,16032,3084,12328,O
3083,P,674,674,14175,3780,19812,3084,13501,P
3084,AEI,1267,1267,1267,1465,1465,3085,0,E
3084,AFI,1428,161,1428,2226,2226,3085,0,A
3084,BFI,1535,107,1535,2369,2369,3085,0,I
3084,BFJ,381,113,1648,240,1705,3085,1267,F
3084,BGJ,609,609,2257,740,2445,3085,1648,G
3084,BFJ,1044,215,2472,300,2526,3085,1428,B
3084,CFJ,1098,161,2633,240,2609,3085,1535,J
3084,CFK,453,77,2710,310,2755,3085,2257,F
3084,CGK,154,154,2864,380,3135,3085,2710,G
3084,CHK,843,612,3476,1040,3649,3085,2633,K
3084,CHJ,1526,522,3998,920,3446,3085,2472,C
3084,BHJ,219,219,4217,820,4266,3085,3998,B
3084,CHJ,390,390,4607,380,4646,3085,4217,C
3084,DHJ,33,33,4640,3960,8606,3085,4607,D
3084,HJ,2756,1592,6232,3030,6679,3085,3476,J
3084,HK,3889,521,6753,6490,9625,3085,2864,H
3084,K,820,299,7052,1200,7879,3085,6232,K
3084,L,332,332,7384,3960,11839,3085,7052,L
3084,M,202,202,7586,179,12018,3085,7384,M
3084,N,71,71,7657,150,12168,3085,7586,N
3084,O,119,119,7776,110,12278,3085,7657,O
3084,N,1029,1029,8805,1030,13308,3085,7776,N
3084,O,607,607,9412,720,14028,3085,8805,O
3084,P,6912,6912,16324,4140,18168,3085,9412,P
3085,A,945,945,945,1653,1653,3086,0,A
3085,B,744,744,1689,90,1743,3086,945,B
3085,C,1244,1244,2933,1590,3333,3086,1689,C
3085,B,2670,2670,5603,2300,5633,3086,2933,B
3085,C,172,172,5775,585,6218,3086,5603,C
3085,D,3934,3934,9709,3780,9998,3086,5775,D
3085,M,312,312,10021,176,10174,3086,9709,M
3085,N,263,263,10284,390,10564,3086,10021,N
3085,O,966,966,11250,1175,11739,3086,10284,O
3085,N,2413,2413,13663,2260,13999,3086,11250,N
3085,O,1124,1124,14787,2205,16204,3086,13663,O
3085,P,522,522,15309,1740,17944,3086,14787,P
3086,A,744,744,744,1167,1167,3087,0,A
3086,B,714,714,1458,180,1347,3087,744,B
3086,C,494,494,1952,895,2242,3087,1458,C
3086,B,570,570,2522,340,2582,3087,1952,B
3086,C,456,456,2978,360,2942,3087,2522,C
3086,D,3124,3124,6102,7020,9962,3087,2978,D
3086,M,394,394,6496,1072,11034,3087,6102,M
3086,N,706,706,7202,90,11124,3087,6496,N
3086,O,970,970,8172,935,12059,3087,7202,O
3086,P,1284,1284,9456,3780,15839,3087,8172,P
3087,A,216,216,216,1015,1015,3088,0,A
3087,B,982,982,1198,240,1255,3088,216,B
3087,C,742,742,1940,760,2015,3088,1198,C
3087,D,2248,2248,4188,7680,9695,3088,1940,D
3087,M,1158,1158,5346,1446,11141,3088,4188,M
3087,N,523,523,5869,300,11441,3088,5346,N
3087,O,625,625,6494,820,12261,3088,5869,O
3087,N,607,607,7101,410,12671,3088,6494,N
3087,O,380,380,7481,465,13136,3088,7101,O
3087,P,621,621,8102,5760,18896,3088,7481,P
3088,A,629,629,629,1137,1137,3089,0,A
3088,B,668,668,1297,180,1317,3089,629,B
3088,C,1030,1030,2327,945,2262,3089,1297,C
3088,D,1139,1139,3466,550,2812,3089,2327,D
3088,M,703,703,4169,1305,4117,3089,3466,M
3088,N,722,722,4891,180,4297,3089,4169,N
3088,O,534,534,5425,740,5037,3089,4891,O
3088,N,7913,7913,13338,7705,12742,3089,5425,N
3088,O,308,308,13646,535,13277,3089,13338,O
3088,P,44552,44552,58198,2880,16157,3089,13646,P
3089,AEI,571,571,571,789,789,3090,0,I
3089,AEJ,244,244,815,90,879,3090,571,J
3089,AEK,490,490,1305,880,1759,3090,815,K
3089,AEL,280,280,1585,3780,5539,3090,1305,L
3089,AE,37133,35548,37133,38053,38053,3090,0,A
3089,BE,37268,135,37268,37814,37814,3090,0,E
3089,BF,561,561,37829,90,37904,3090,37268,F
3089,BG,964,268,38097,90,38143,3090,37133,B
3089,CG,1263,995,39092,1385,39289,3090,37829,G
3089,CH,1060,65,39157,1220,39363,3090,38097,C
3089,DH,47,47,39204,3780,43143,3090,39157,D
3089,H,432,320,39524,3780,43069,3090,39092,H
3089,M,1910,1910,41434,2308,45451,3090,39524,M
3089,N,441,441,41875,90,45541,3090,41434,N
3089,O,234,234,42109,625,46166,3090,41875,O
3089,P,1903,1903,44012,3780,49946,3090,42109,P
3090,AEI,239,239,239,337,337,3091,0,A
3090,BEI,278,278,517,240,577,3091,239,B
3090,CEI,545,28,545,787,787,3091,0,E
3090,CFI,1053,508,1053,2878,2878,3091,0,I
3090,CFJ,595,59,1112,610,1187,3091,517,C
3090,DFJ,1238,671,1783,905,1692,3091,545,F
3090,DGJ,1257,1257,3040,1380,3072,3091,1783,G
3090,DHJ,2033,46,3086,250,3128,3091,1053,J
3090,DHK,167,121,3207,335,3407,3091,3040,H
3090,DK,1035,914,4121,1000,4128,3091,3086,K
3090,DL,3651,642,4763,385,1572,3091,1112,D
3090,L,1685,1043,5806,550,4678,3091,4121,L
3090,M,573,573,6379,2953,7631,3091,5806,M
3090,N,2739,2739,9118,420,8051,3091,6379,N
3090,O,1216,1216,10334,1417,9468,3091,9118,O
3090,P,2431,2431,12765,333,9801,3091,10334,P
3091,AEI,68,68,68,1308,1308,3092,0,A
3091,BEI,373,305,373,1622,1622,3092,0,I
3091,BEJ,1270,965,1338,90,1398,3092,68,B
3091,CEJ,1293,328,1666,90,1712,3092,373,J
3091,CEK,972,644,2310,1210,2608,3092,1338,C
3091,DEK,44,44,2354,3780,6388,3092,2310,D
3091,EK,753,65,2419,1135,2847,3092,1666,K
3091,EL,2656,2656,5075,3780,6627,3092,2419,L
3091,E,37676,32601,37676,37812,37812,3092,0,E
3091,F,169,169,37845,90,37902,3092,37676,F
3091,G,1224,1224,39069,1445,39347,3092,37845,G
3091,H,1739,1739,40808,3780,43127,3092,39069,H
3091,M,93,93,40901,625,43752,3092,40808,M
3091,N,622,622,41523,90,43842,3092,40901,N
3091,O,527,527,42050,850,44692,3092,41523,O
3091,P,623,623,42673,3780,48472,3092,42050,P
3092,A,309,309,309,561,561,3093,0,A
3092,B,287,287,596,90,651,3093,309,B
3092,C,486,486,1082,880,1531,3093,596,C
3092,D,160,160,1242,3780,5311,3093,1082,D
3092,M,538,538,1780,723,6034,3093,1242,M
3092,N,234,234,2014,90,6124,3093,1780,N
3092,O,471,471,2485,880,7004,3093,2014,O
3092,P,376,376,2861,3780,10784,3093,2485,P
3093,A,334,334,334,477,477,3094,0,A
3093,B,188,188,522,180,657,3094,334,B
3093,C,444,444,966,930,1587,3094,522,C
3093,B,1211,1211,2177,665,2252,3094,966,B
3093,C,1085,1085,3262,1235,3487,3094,2177,C
3093,D,823,823,4085,620,4107,3094,3262,D
3093,M,1609,1609,5694,2679,6786,3094,4085,M
3093,N,1173,1173,6867,90,6876,3094,5694,N
3093,O,643,643,7510,885,7761,3094,6867,O
3093,N,2462,2462,9972,2290,10051,3094,7510,N
3093,O,622,622,10594,935,10986,3094,9972,O
3093,P,5249,5249,15843,3780,14766,3094,10594,P
3094,A,209,209,209,605,605,3095,0,A
3094,B,423,423,632,90,695,3095,209,B
3094,C,891,891,1523,1240,1935,3095,632,C
3094,D,332,332,1855,3780,5715,3095,1523,D
3094,M,4418,4418,6273,4824,10539,3095,1855,M
3094,N,477,477,6750,90,10629,3095,6273,N
3094,O,498,498,7248,905,11534,3095,6750,O
3094,P,3738,3738,10986,3780,15314,3095,7248,P
3095,AEI,50,50,50,159,159,3096,0,I
3095,AEJ,282,282,332,240,399,3096,50,J
3095,AEK,387,55,387,547,547,3096,0,E
3095,AFK,363,363,750,240,787,3096,387,F
3095,AGK,897,479,1229,930,1329,3096,332,K
3095,AGL,658,179,1408,960,1747,3096,750,G
3095,AHL,388,388,1796,3960,5707,3096,1408,H
3095,AL,1134,567,2363,6990,8319,3096,1229,L
3095,A,10627,8264,10627,11184,11184,3096,0,A
3095,B,612,612,11239,90,11274,3096,10627,B
3095,C,467,467,11706,820,12094,3096,11239,C
3095,B,1342,1342,13048,975,13069,3096,11706,B
3095,C,972,972,14020,1470,14539,3096,13048,C
3095,D,841,841,14861,3780,18319,3096,14020,D
3095,M,234,234,15095,397,18716,3096,14861,M
3095,N,396,396,15491,300,19016,3096,15095,N
3095,O,974,974,16465,985,20001,3096,15491,O
3095,N,662,662,17127,635,20636,3096,16465,N
3095,O,4,4,17131,415,21051,3096,17127,O
3095,P,4822,4822,21953,6060,27111,3096,17131,P
3096,A,160,160,160,168,168,3097,0,A
3096,B,194,194,354,240,408,3097,160,B
3096,C,249,249,603,285,693,3097,354,C
3096,D,1401,1401,2004,5160,5853,3097,603,D
3096,M,516,516,2520,708,6561,3097,2004,M
3096,N,303,303,2823,150,6711,3097,2520,N
3096,O,34,34,2857,115,6826,3097,2823,O
3096,N,277,277,3134,210,7036,3097,2857,N
3096,O,166,166,3300,225,7261,3097,3134,O
3096,P,1001,1001,4301,4740,12001,3097,3300,P
3097,AE,505,505,505,1415,1415,3098,0,E
3097,AF,635,130,635,702,702,3098,0,A
3097,BF,808,808,1443,780,1482,3098,635,B
3097,CF,1093,155,1598,180,1595,3098,505,F
3097,CG,384,384,1982,985,2580,3098,1598,G
3097,CF,1123,584,2566,1259,2741,3098,1443,C
3097,DF,735,151,2717,145,2725,3098,1982,F
3097,DG,640,489,3206,351,3092,3098,2566,D
3097,G,522,33,3239,1255,3980,3098,2717,G
3097,H,764,764,4003,1620,5600,3098,3239,H
3097,M,1172,1172,5175,1346,6946,3098,4003,M
3097,N,434,434,5609,300,7246,3098,5175,N
3097,O,835,835,6444,805,8051,3098,5609,O
3097,P,741,741,7185,4080,12131,3098,6444,P
3098,A,17,17,17,84,84,3099,0,A
3098,B,150,150,167,135,219,3099,17,B
3098,C,209,209,376,285,504,3099,167,C
3098,D,86,86,462,5160,5664,3099,376,D
3098,M,1374,1374,1836,1800,7464,3099,462,M
3098,N,458,458,2294,90,7554,3099,1836,N
3098,O,922,922,3216,1250,8804,3099,2294,O
3098,N,1857,1857,5073,1530,10334,3099,3216,N
3098,O,651,651,5724,890,11224,3099,5073,O
3098,P,1374,1374,7098,3780,15004,3099,5724,P
3099,AEI,1396,1396,1396,1428,1428,3100,0,E
3099,AFI,212,212,1608,240,1668,3100,1396,F
3099,AGI,1882,274,1882,2151,2151,3100,0,A
3099,BGI,329,329,2211,120,2271,3100,1882,B
3099,CGI,2229,18,2229,2275,2275,3100,0,I
3099,CGJ,703,82,2311,715,2383,3100,1608,G
3099,CHJ,116,34,2345,120,2395,3100,2229,J
3099,CHK,815,681,3026,755,3026,3100,2211,C
3099,DHK,735,54,3080,755,3150,3100,2345,K
3099,DHL,1175,406,3486,385,2768,3100,2311,H
3099,DL,1607,1147,4633,550,3576,3100,3026,D
3099,L,2254,701,5334,385,3535,3100,3080,L
3099,M,36,36,5370,4824,8400,3100,5334,M
3099,N,5083,5083,10453,330,8730,3100,5370,N
3099,O,810,810,11263,2174,10904,3100,10453,O
3099,P,1192,1192,12455,886,11790,3100,11263,P
3100,AE,83,83,83,115,115,3101,0,E
3100,AF,112,29,112,197,197,3101,0,A
3100,BF,117,88,200,135,250,3101,83,F
3100,BG,175,87,287,135,332,3101,112,B
3100,CG,234,147,434,295,545,3101,200,G
3100,CH,270,123,557,285,617,3101,287,C
3100,DH,163,40,597,5160,5705,3101,434,H
3100,D,2871,2831,3428,5160,5777,3101,557,D
3100,M,2073,2073,5501,2703,8480,3101,3428,M
3100,N,659,659,6160,90,8570,3101,5501,N
3100,O,1026,1026,7186,1240,9810,3101,6160,O
3100,N,465,465,7651,240,10050,3101,7186,N
3100,O,419,419,8070,790,10840,3101,7651,O
3100,P,307,307,8377,3780,14620,3101,8070,P
3101,AE,6,6,6,160,160,3102,0,E
3101,AF,109,103,109,2377,2377,3102,0,A
3101,BF,402,299,408,300,460,3102,6,F
3101,BG,712,712,1120,825,1285,3102,408,G
3101,BF,1067,1067,2187,940,2225,3102,1120,F
3101,BG,142,142,2329,390,2615,3102,2187,G
3101,BH,222,222,2551,5400,8015,3102,2329,H
3101,B,2470,28,2579,240,2617,3102,109,B
3101,C,1447,1447,4026,1015,3632,3102,2579,C
3101,B,794,794,4820,1355,4987,3102,4026,B
3101,C,936,936,5756,1620,6607,3102,4820,C
3101,D,527,527,6283,3960,10567,3102,5756,D
3101,M,65,65,6348,41,10608,3102,6283,M
3101,N,161,161,6509,240,10848,3102,6348,N
3101,O,134,134,6643,390,11238,3102,6509,O
3101,N,1091,1091,7734,815,12053,3102,6643,N
3101,O,544,544,8278,750,12803,3102,7734,O
3101,P,807,807,9085,3960,16763,3102,8278,P
3102,A,64,64,64,97,97,3103,0,A
3102,B,93,93,157,120,217,3103,64,B
3102,C,300,300,457,295,512,3103,157,C
3102,D,1563,1563,2020,5160,5672,3103,457,D
3102,M,636,636,2656,1970,7642,3103,2020,M
3102,N,1472,1472,4128,150,7792,3103,2656,N
3102,O,1462,1462,5590,1685,9477,3103,4128,O
3102,P,41,41,5631,2520,11997,3103,5590,P
3103,AEI,165,165,165,264,264,3104,0,E
3103,AFI,219,219,384,180,444,3104,165,F
3103,AGI,452,68,452,1574,1574,3104,0,I
3103,AGJ,507,439,891,660,1104,3104,384,G
3103,AHJ,1457,566,1457,1614,1614,3104,0,A
3103,BHJ,390,390,1847,300,1914,3104,1457,B
3103,CHJ,1717,322,2169,715,2289,3104,452,J
3103,CHK,570,248,2417,715,2629,3104,1847,C
3103,DHK,913,665,3082,875,3164,3104,2169,K
3103,DHJ,1243,1243,4325,1225,4389,3104,3082,J
3103,DHK,1916,8,4333,4020,6649,3104,2417,D
3103,HK,773,765,5098,903,5292,3104,4325,K
3103,HL,1823,1823,6921,432,5724,3104,5098,L
3103,H,10470,4440,11361,4080,5184,3104,891,H
3103,M,42,42,11403,50,6699,3104,11361,M
3103,N,138,138,11541,150,6849,3104,11403,N
3103,O,281,281,11822,255,7104,3104,11541,O
3103,P,366,366,12188,2880,9984,3104,11822,P
3104,AE,1040,1040,1040,1230,1230,3105,0,A
3104,BE,377,377,1417,240,1470,3105,1040,B
3104,CE,691,691,2108,915,2385,3105,1417,C
3104,BE,833,833,2941,555,2940,3105,2108,B
3104,CE,708,708,3649,810,3750,3105,2941,C
3104,DE,5819,2170,5819,6226,6226,3105,0,E
3104,DF,2266,96,5915,3960,7710,3105,3649,D
3104,F,812,716,6631,420,6646,3105,5819,F
3104,G,967,967,7598,970,7616,3105,6631,G
3104,H,1988,1988,9586,550,8166,3105,7598,H
3104,M,342,342,9928,534,8700,3105,9586,M
3104,N,334,334,10262,180,8880,3105,9928,N
3104,O,466,466,10728,830,9710,3105,10262,O
3104,P,137,137,10865,6680,16390,3105,10728,P
3105,AEI,60,60,60,159,159,3106,0,E
3105,AFI,91,31,91,200,200,3106,0,A
3105,BFI,183,92,183,187,187,3106,0,I
3105,BFJ,181,58,241,135,294,3106,60,F
3105,BGJ,79,21,262,135,322,3106,183,J
3105,BGK,302,131,393,240,440,3106,91,B
3105,CGK,152,21,414,280,602,3106,262,K
3105,CGL,222,49,463,285,579,3106,241,G
3105,CHL,160,160,623,5160,5739,3106,463,H
3105,CL,537,307,930,765,1205,3106,393,C
3105,BL,773,773,1703,495,1700,3106,930,B
3105,CL,1642,353,2056,5160,5762,3106,414,L
3105,C,1475,1122,3178,1260,2960,3106,1703,C
3105,D,115,115,3293,3960,6920,3106,3178,D
3105,M,583,583,3876,1226,8146,3106,3293,M
3105,N,736,736,4612,150,8296,3106,3876,N
3105,O,76,76,4688,100,8396,3106,4612,O
3105,N,408,408,5096,390,8786,3106,4688,N
3105,O,153,153,5249,225,9011,3106,5096,O
3105,P,1379,1379,6628,4740,13751,3106,5249,P
3106,A,52,52,52,1013,1013,3107,0,A
3106,B,1134,1134,1186,90,1103,3107,52,B
3106,C,974,974,2160,1220,2323,3107,1186,C
3106,D,6,6,2166,3780,6103,3107,2160,D
3106,M,204,204,2370,307,6410,3107,2166,M
3106,N,130,130,2500,90,6500,3107,2370,N
3106,O,258,258,2758,695,7195,3107,2500,O
3106,P,1410,1410,4168,3780,10975,3107,2758,P
3107,A,460,460,460,1074,1074,3108,0,A
3107,B,979,979,1439,420,1494,3108,460,B
3107,C,1159,1159,2598,1259,2753,3108,1439,C
3107,D,1309,1309,3907,351,3104,3108,2598,D
3107,M,2043,2043,5950,4904,8008,3108,3907,M
3107,N,3221,3221,9171,420,8428,3108,5950,N
3107,O,1040,1040,10211,985,9413,3108,9171,O
3107,P,1924,1924,12135,550,9963,3108,10211,P
3108,AE,97,97,97,1074,1074,3109,0,A
3108,BE,1080,1080,1177,150,1224,3109,97,B
3108,CE,190,190,1367,115,1339,3109,1177,C
3108,DE,1201,1201,2568,4230,5569,3109,1367,D
3108,E,2960,392,2960,3053,3053,3109,0,E
3108,F,203,203,3163,150,3203,3109,2960,F
3108,G,751,751,3914,820,4023,3109,3163,G
3108,H,2149,2149,6063,375,4398,3109,3914,H
3108,M,1297,1297,7360,1097,6666,3109,6063,M
3108,N,3372,3372,10732,660,7326,3109,7360,N
3108,O,994,994,11726,1860,9186,3109,10732,O
3108,N,1167,1167,12893,365,9551,3109,11726,N
3108,O,1249,1249,14142,1290,10841,3109,12893,O
3108,P,1864,1864,16006,3660,14501,3109,14142,P
3109,AE,51,51,51,1356,1356,3110,0,A
3109,BE,100,49,100,5341,5341,3110,0,E
3109,BF,1504,1455,1555,240,1596,3110,51,B
3109,CF,760,760,2315,760,2356,3110,1555,C
3109,DF,2588,2588,4903,7680,10036,3110,2315,D
3109,F,5424,621,5524,240,5581,3110,100,F
3109,G,724,724,6248,760,6341,3110,5524,G
3109,H,3666,3666,9914,7680,14021,3110,6248,H
3109,M,4098,4098,14012,4207,18228,3110,9914,M
3109,N,303,303,14315,240,18468,3110,14012,N
3109,O,634,634,14949,765,19233,3110,14315,O
3109,N,544,544,15493,415,19648,3110,14949,N
3109,O,774,774,16267,1260,20908,3110,15493,O
3109,P,377,377,16644,3960,24868,3110,16267,P
3110,A,190,190,190,220,220,3111,0,A
3110,B,280,280,470,300,520,3111,190,B
3110,C,710,710,1180,805,1325,3111,470,C
3110,D,150,150,1330,1140,2465,3111,1180,D
3110,M,435,435,1765,906,3371,3111,1330,M
3110,N,600,600,2365,180,3551,3111,1765,N
3110,O,322,322,2687,275,3826,3111,2365,O
3110,N,2045,2045,4732,2085,5911,3111,2687,N
3110,O,843,843,5575,855,6766,3111,4732,O
3110,P,1030,1030,6605,4140,10906,3111,5575,P
3111,AE,52,52,52,114,114,3112,0,E
3111,AF,89,37,89,165,165,3112,0,A
3111,BF,150,113,202,150,264,3112,52,F
3111,BG,189,76,278,150,315,3112,89,B
3111,CG,143,143,421,830,1145,3112,278,C
3111,DG,821,602,1023,130,394,3112,202,G
3111,DH,851,249,1272,3490,4635,3112,421,D
3111,H,3009,2760,4032,2850,3244,3112,1023,H
3111,M,570,570,4602,1809,6444,3112,4032,M
3111,N,1416,1416,6018,180,6624,3112,4602,N
3111,O,196,196,6214,145,6769,3112,6018,O
3111,N,585,585,6799,685,7454,3112,6214,N
3111,O,675,675,7474,910,8364,3112,6799,O
3111,P,6784,6784,14258,5160,13524,3112,7474,P
3112,AEI,329,329,329,505,505,3113,0,A
3112,BEI,279,279,608,150,655,3113,329,B
3112,CEI,832,224,832,1504,1504,3113,0,E
3112,CFI,770,546,1378,765,1420,3113,608,C
3112,DFI,1408,30,1408,1583,1583,3113,0,I
3112,DFJ,196,196,1604,90,1673,3113,1408,J
3112,DFK,870,98,1702,240,1744,3113,832,F
3112,DGK,483,385,2087,880,2553,3113,1604,K
3112,DGL,796,411,2498,1040,2784,3113,1702,G
3112,DHL,78,78,2576,3960,6744,3113,2498,H
3112,DL,529,40,2616,3840,6393,3113,2087,L
3112,D,2643,1405,4021,4230,5650,3113,1378,D
3112,M,167,167,4188,505,7249,3113,4021,M
3112,N,360,360,4548,90,7339,3113,4188,N
3112,O,526,526,5074,880,8219,3113,4548,O
3112,P,3115,3115,8189,3780,11999,3113,5074,P
3113,A,120,120,120,152,152,3114,0,A
3113,B,76,76,196,240,392,3114,120,B
3113,C,2682,2682,2878,1320,1712,3114,196,C
3113,D,5420,5420,8298,6060,7772,3114,2878,D
3113,M,1829,1829,10127,2740,10512,3114,8298,M
3113,N,1057,1057,11184,180,10692,3114,10127,N
3113,O,913,913,12097,830,11522,3114,11184,O
3113,N,1100,1100,13197,1140,12662,3114,12097,N
3113,O,338,338,13535,220,12882,3114,13197,O
3113,P,7504,7504,21039,7080,19962,3114,13535,P
3114,AEI,17,17,17,29,29,3115,0,E
3114,AFI,342,342,359,240,269,3115,17,F
3114,AGI,913,554,913,1278,1278,3115,0,A
3114,BGI,1024,111,1024,3074,3074,3115,0,I
3114,BGJ,399,288,1312,90,1368,3115,913,B
3114,CGJ,1150,197,1509,1550,1819,3115,359,G
3114,CHJ,27,27,1536,3960,5779,3115,1509,H
3114,CJ,958,734,2270,1250,2618,3115,1312,C
3114,DJ,2,2,2272,3780,6398,3115,2270,D
3114,J,2098,850,3122,90,3164,3115,1024,J
3114,K,859,859,3981,1250,4414,3115,3122,K
3114,L,415,415,4396,3780,8194,3115,3981,L
3114,M,3679,3679,8075,4745,12939,3115,4396,M
3114,N,1122,1122,9197,90,13029,3115,8075,N
3114,O,138,138,9335,585,13614,3115,9197,O
3114,P,2992,2992,12327,3780,17394,3115,9335,P
3115,AEI,325,325,325,1223,1223,3116,0,A
3115,BEI,709,384,709,1012,1012,3116,0,E
3115,BFI,978,269,978,1176,1176,3116,0,I
3115,BFJ,495,226,1204,90,1102,3116,709,F
3115,BFJ,226,0,1204,90,1266,3116,978,J
3115,BGK,938,59,1263,90,1313,3116,325,B
3115,CGK,543,484,1747,815,1917,3116,1204,G
3115,CHK,965,422,2169,1240,2506,3116,1204,K
3115,CHL,1067,161,2330,1240,2553,3116,1263,C
3115,DHL,511,350,2680,3780,6286,3116,2169,L
3115,DH,1547,614,3294,3780,5697,3116,1747,H
3115,D,2795,1831,5125,3780,6333,3116,2330,D
3115,M,4149,4149,9274,4691,11024,3116,5125,M
3115,N,574,574,9848,90,11114,3116,9274,N
3115,O,235,235,10083,625,11739,3116,9848,O
3115,P,348,348,10431,3780,15519,3116,10083,P
3116,AEI,1551,1551,1551,3779,3779,3117,0,I
3116,AEJ,1595,44,1595,2051,2051,3117,0,A
3116,BEJ,503,503,2098,90,2141,3117,1595,B
3116,CEJ,462,462,2560,805,2946,3117,2098,C
3116,DEJ,847,847,3407,3780,6726,3117,2560,D
3116,EJ,2267,411,3818,90,3869,3117,1551,J
3116,EK,521,521,4339,930,4799,3117,3818,K
3116,EL,127,127,4466,3840,8639,3117,4339,L
3116,E,23491,19025,23491,23639,23639,3117,0,E
3116,F,196,196,23687,90,23729,3117,23491,F
3116,G,778,778,24465,1130,24859,3117,23687,G
3116,H,377,377,24842,3780,28639,3117,24465,H
3116,M,648,648,25490,1175,29814,3117,24842,M
3116,N,559,559,26049,90,29904,3117,25490,N
3116,O,255,255,26304,625,30529,3117,26049,O
3116,P,6105,6105,32409,3780,34309,3117,26304,P
3117,AEI,401,401,401,1477,1477,3118,0,E
3117,AFI,1106,1106,1507,90,1567,3118,401,F
3117,AGI,985,985,2492,1210,2777,3118,1507,G
3117,AHI,22,22,2514,3780,6557,3118,2492,H
3117,AI,27683,25169,27683,29022,29022,3118,0,I
3117,AJ,1959,1959,29642,90,29112,3118,27683,J
3117,AK,1054,1054,30696,1370,30482,3118,29642,K
3117,AL,190,190,30886,3780,34262,3118,30696,L
3117,A,32754,1868,32754,35342,35342,3118,0,A
3117,B,2662,2662,35416,90,35432,3118,32754,B
3117,C,1213,1213,36629,1390,36822,3118,35416,C
3117,D,98,98,36727,3780,40602,3118,36629,D
3117,M,536,536,37263,929,41531,3118,36727,M
3117,N,424,424,37687,90,41621,3118,37263,N
3117,O,528,528,38215,845,42466,3118,37687,O
3117,P,427,427,38642,3780,46246,3118,38215,P
3118,A,170,170,170,167,167,3119,0,A
3118,B,62,62,232,110,277,3119,170,B
3118,C,157,157,389,280,557,3119,232,C
3118,D,289,289,678,5160,5717,3119,389,D
3118,M,812,812,1490,897,6614,3119,678,M
3118,N,207,207,1697,180,6794,3119,1490,N
3118,O,756,756,2453,885,7679,3119,1697,O
3118,P,3637,3637,6090,6680,14359,3119,2453,P
3119,AE,47,47,47,480,480,3120,0,A
3119,BE,523,523,570,150,630,3120,47,B
3119,CE,695,695,1265,655,1285,3120,570,C
3119,DE,205,205,1470,385,1670,3120,1265,D
3119,E,2859,1389,2859,3720,3720,3120,0,E
3119,F,1136,1136,3995,300,4020,3120,2859,F
3119,G,1037,1037,5032,1050,5070,3120,3995,G
3119,F,688,688,5720,720,5790,3120,5032,F
3119,G,602,602,6322,780,6570,3120,5720,G
3119,H,501,501,6823,3960,10530,3120,6322,H
3119,M,4556,4556,11379,5139,15669,3120,6823,M
3119,N,967,967,12346,420,16089,3120,11379,N
3119,O,647,647,12993,676,16765,3120,12346,O
3119,P,537,537,13530,769,17534,3120,12993,P
3120,AE,96,96,96,49,49,3121,0,A
3120,BE,160,160,256,240,289,3121,96,B
3120,CE,192,192,448,285,574,3121,256,C
3120,DE,626,626,1074,5160,5734,3121,448,D
3120,E,2103,1029,2103,2446,2446,3121,0,E
3120,F,379,379,2482,90,2536,3121,2103,F
3120,G,555,555,3037,820,3356,3121,2482,G
3120,F,1687,1687,4724,1410,4766,3121,3037,F
3120,G,1162,1162,5886,1340,6106,3121,4724,G
3120,H,1810,1810,7696,3780,9886,3121,5886,H
3120,M,1459,1459,9155,2039,11925,3121,7696,M
3120,N,1000,1000,10155,300,12225,3121,9155,N
3120,O,283,283,10438,385,12610,3121,10155,O
3120,N,1137,1137,11575,1120,13730,3121,10438,N
3120,O,1164,1164,12739,1274,15004,3121,11575,O
3120,P,1028,1028,13767,486,15490,3121,12739,P
3121,A,1176,1176,1176,1624,1624,3122,0,A
3121,B,614,614,1790,220,1844,3122,1176,B
3121,C,1002,1002,2792,1000,2844,3122,1790,C
3121,D,164,164,2956,385,3229,3122,2792,D
3121,M,3802,3802,6758,3950,7179,3122,2956,M
3121,N,906,906,7664,780,7959,3122,6758,N
3121,O,1057,1057,8721,2205,10164,3122,7664,O
3121,P,1387,1387,10108,810,10974,3122,8721,P
3122,AE,250,250,250,1479,1479,3123,0,E
3122,AF,1259,1259,1509,90,1569,3123,250,F
3122,AG,950,950,2459,1210,2779,3123,1509,G
3122,AH,43,43,2502,3780,6559,3123,2459,H
3122,A,3029,527,3029,4247,4247,3123,0,A
3122,B,1248,1248,4277,90,4337,3123,3029,B
3122,C,924,924,5201,1230,5567,3123,4277,C
3122,D,58,58,5259,3780,9347,3123,5201,D
3122,M,468,468,5727,753,10100,3123,5259,M
3122,N,322,322,6049,90,10190,3123,5727,N
3122,O,535,535,6584,850,11040,3123,6049,O
3122,P,386,386,6970,3780,14820,3123,6584,P
3123,AEI,41,41,41,223,223,3124,0,A
3123,BEI,78,37,78,116,116,3124,0,E
3123,BFI,215,215,293,240,356,3124,78,F
3123,BGI,272,20,313,135,358,3124,41,B
3123,CGI,203,183,496,290,646,3124,293,G
3123,CHI,271,88,584,285,643,3124,313,C
3123,DHI,193,193,777,5160,5803,3124,584,D
3123,HI,1242,465,1242,1376,1376,3124,0,I
3123,HJ,246,246,1488,150,1526,3124,1242,J
3123,HK,1143,151,1639,5160,5806,3124,496,H
3123,K,210,59,1698,280,1806,3124,1488,K
3123,L,4859,4859,6557,5280,7086,3124,1698,L
3123,M,914,914,7471,1986,9072,3124,6557,M
3123,N,1228,1228,8699,150,9222,3124,7471,N
3123,O,1435,1435,10134,1685,10907,3124,8699,O
3123,P,1403,1403,11537,2520,13427,3124,10134,P
3124,AE,369,369,369,1332,1332,3125,0,E
3124,AF,1093,1093,1462,180,1512,3125,369,F
3124,AG,1688,226,1688,2283,2283,3125,0,A
3124,BG,732,506,2194,670,2182,3125,1462,G
3124,BH,1022,516,2710,420,2703,3125,1688,B
3124,CH,1114,1114,3824,1115,3818,3125,2710,C
3124,DH,770,770,4594,460,4278,3125,3824,D
3124,H,5164,2764,7358,550,2732,3125,2194,H
3124,M,276,276,7634,432,4710,3125,7358,M
3124,N,291,291,7925,180,4890,3125,7634,N
3124,O,658,658,8583,840,5730,3125,7925,O
3124,P,362,362,8945,6680,12410,3125,8583,P
3125,A,64,64,64,827,827,3126,0,A
3125,B,943,943,1007,240,1067,3126,64,B
3125,C,485,485,1492,740,1807,3126,1007,C
3125,D,2505,2505,3997,5100,6907,3126,1492,D
3125,M,773,773,4770,2153,9060,3126,3997,M
3125,N,700,700,5470,90,9150,3126,4770,N
3125,O,462,462,5932,805,9955,3126,5470,O
3125,N,1374,1374,7306,315,10270,3126,5932,N
3125,O,738,738,8044,1080,11350,3126,7306,O
3125,P,818,818,8862,3780,15130,3126,8044,P
3126,AEI,60,60,60,80,80,3127,0,A
3126,BEI,135,135,195,180,260,3127,60,B
3126,CEI,395,200,395,1459,1459,3127,0,E
3126,CFI,251,51,446,210,470,3127,195,C
3126,BFI,754,754,1200,775,1245,3127,446,B
3126,CFI,338,338,1538,735,1980,3127,1200,C
3126,DFI,1151,8,1546,150,1609,3127,395,F
3126,DGI,139,139,1685,150,1759,3127,1546,G
3126,DFI,1165,1165,2850,1140,2899,3127,1685,F
3126,DGI,3179,329,3179,8700,8700,3127,0,I
3126,DGJ,368,39,3218,650,3549,3127,2850,G
3126,DHJ,1730,50,3268,4140,6120,3127,1538,D
3126,HJ,3375,3325,6593,4230,7779,3127,3218,H
3126,J,5720,2306,8899,240,8940,3127,3179,J
3126,K,1014,1014,9913,1335,10275,3127,8899,K
3126,L,2018,2018,11931,780,11055,3127,9913,L
3126,M,192,192,12123,298,11353,3127,11931,M
3126,N,196,196,12319,150,11503,3127,12123,N
3126,O,617,617,12936,585,12088,3127,12319,O
3126,N,741,741,13677,760,12848,3127,12936,N
3126,O,118,118,13795,390,13238,3127,13677,O
3126,P,941,941,14736,3960,17198,3127,13795,P
3127,A,2640,2640,2640,3679,3679,3128,0,A
3127,B,1310,1310,3950,300,3979,3128,2640,B
3127,C,1144,1144,5094,1050,5029,3128,3950,C
3127,B,501,501,5595,720,5749,3128,5094,B
3127,C,753,753,6348,780,6529,3128,5595,C
3127,D,2127,2127,8475,3960,10489,3128,6348,D
3127,M,246,246,8721,4910,15399,3128,8475,M
3127,N,5071,5071,13792,420,15819,3128,8721,N
3127,O,488,488,14280,626,16445,3128,13792,O
3127,P,640,640,14920,939,17384,3128,14280,P
3128,A,43,43,43,383,383,3129,0,A
3128,B,415,415,458,135,518,3129,43,B
3128,C,231,231,689,295,813,3129,458,C
3128,D,52,52,741,5100,5913,3129,689,D
3128,M,406,406,1147,952,6865,3129,741,M
3128,N,687,687,1834,180,7045,3129,1147,N
3128,O,896,896,2730,895,7940,3129,1834,O
3128,N,108,108,2838,220,8160,3129,2730,N
3128,O,608,608,3446,690,8850,3129,2838,O
3128,P,2514,2514,5960,6660,15510,3129,3446,P
3129,A,174,174,174,132,132,3130,0,A
3129,B,63,63,237,150,282,3130,174,B
3129,C,163,163,400,140,422,3130,237,C
3129,B,886,886,1286,900,1322,3130,400,B
3129,C,309,309,1595,650,1972,3130,1286,C
3129,D,4523,4523,6118,4230,6202,3130,1595,D
3129,M,587,587,6705,1897,8099,3130,6118,M
3129,N,1356,1356,8061,90,8189,3130,6705,N
3129,O,1706,1706,9767,1935,10124,3130,8061,O
3129,N,819,819,10586,605,10729,3130,9767,N
3129,O,759,759,11345,900,11629,3130,10586,O
3129,P,5530,5530,16875,3780,15409,3130,11345,P
3130,A,321,321,321,711,711,3131,0,A
3130,B,420,420,741,90,801,3131,321,B
3130,C,596,596,1337,825,1626,3131,741,C
3130,D,113,113,1450,3780,5406,3131,1337,D
3130,M,4190,4190,5640,4743,10149,3131,1450,M
3130,N,604,604,6244,90,10239,3131,5640,N
3130,O,184,184,6428,585,10824,3131,6244,O
3130,P,11903,11903,18331,3780,14604,3131,6428,P
3131,A,33626,33626,33626,37601,37601,3132,0,A
3131,B,4005,4005,37631,90,37691,3132,33626,B
3131,C,945,945,38576,1210,38901,3132,37631,C
3131,D,482,482,39058,3780,42681,3132,38576,D
3131,M,560,560,39618,1250,43931,3132,39058,M
3131,N,737,737,40355,90,44021,3132,39618,N
3131,O,341,341,40696,705,44726,3132,40355,O
3131,P,73,73,40769,3780,48506,3132,40696,P
3132,AE,441,441,441,1566,1566,3133,0,E
3132,AF,820,379,820,1219,1219,3133,0,A
3132,BF,690,690,1510,180,1399,3133,820,B
3132,CF,1318,249,1759,240,1806,3133,441,F
3132,CG,494,245,2004,895,2294,3133,1510,C
3132,BG,210,210,2214,130,2424,3133,2004,B
3132,CG,502,47,2261,810,2616,3133,1759,G
3132,CH,765,718,2979,660,3084,3133,2214,C
3132,DH,788,70,3049,3840,6456,3133,2261,H
3132,D,1152,1082,4131,6660,9744,3133,2979,D
3132,M,8610,8610,12741,10548,20292,3133,4131,M
3132,N,2160,2160,14901,240,20532,3133,12741,N
3132,O,940,940,15841,735,21267,3133,14901,O
3132,N,144,144,15985,520,21787,3133,15841,N
3132,O,967,967,16952,1220,23007,3133,15985,O
3132,P,185,185,17137,3960,26967,3133,16952,P
3133,AEI,61,61,61,147,147,3134,0,A
3133,BEI,78,17,78,238,238,3134,0,I
3133,BEJ,229,151,229,290,290,3134,0,E
3133,BFJ,189,21,250,135,282,3134,61,B
3133,CFJ,238,66,316,135,373,3134,78,J
3133,CFK,141,54,370,135,425,3134,229,F
3133,CGK,172,52,422,290,572,3134,250,C
3133,DGK,188,82,504,285,658,3134,316,K
3133,DGL,95,13,517,5160,5732,3134,422,D
3133,GL,251,104,621,290,715,3134,370,G
3133,HL,128,11,632,5160,5818,3134,504,L
3133,H,137,126,758,5160,5875,3134,621,H
3133,M,17074,17074,17832,17379,23254,3134,758,M
3133,N,428,428,18260,180,23434,3134,17832,N
3133,O,926,926,19186,885,24319,3134,18260,O
3133,N,378,378,19564,405,24724,3134,19186,N
3133,O,842,842,20406,565,25289,3134,19564,O
3133,P,130,130,20536,6960,32249,3134,20406,P
3134,AEI,548,548,548,768,768,3135,0,E
3134,AFI,239,239,787,90,858,3135,548,F
3134,AGI,923,136,923,1201,1201,3135,0,I
3134,AGJ,304,304,1227,90,1291,3135,923,J
3134,AGK,557,117,1344,905,1763,3135,787,G
3134,AHK,590,590,1934,3780,5543,3135,1344,H
3134,AK,950,243,2177,1240,2531,3135,1227,K
3134,AL,49,49,2226,3780,6311,3135,2177,L
3134,A,3980,1754,3980,4070,4070,3135,0,A
3134,B,133,133,4113,90,4160,3135,3980,B
3134,C,747,747,4860,1130,5290,3135,4113,C
3134,D,103,103,4963,3780,9070,3135,4860,D
3134,M,918,918,5881,1413,10483,3135,4963,M
3134,N,525,525,6406,90,10573,3135,5881,N
3134,O,263,263,6669,695,11268,3135,6406,O
3134,P,1766,1766,8435,3780,15048,3135,6669,P
3135,AE,83,83,83,844,844,3136,0,A
3135,BE,438,355,438,1354,1354,3136,0,E
3135,BF,865,510,948,150,994,3136,83,B
3135,CF,154,154,1102,120,1114,3136,948,C
3135,BF,941,277,1379,90,1444,3136,438,F
3135,BG,510,510,1889,880,2324,3136,1379,G
3135,BF,482,482,2371,110,2434,3136,1889,F
3135,BG,1536,267,2638,1570,2684,3136,1102,B
3135,CG,820,820,3458,645,3329,3136,2638,C
3135,DG,1596,509,3967,2315,4749,3136,2371,G
3135,DH,4259,3750,7717,4230,7559,3136,3458,D
3135,H,3894,144,7861,3420,8169,3136,3967,H
3135,M,151,151,8012,403,8572,3136,7861,M
3135,N,282,282,8294,90,8662,3136,8012,N
3135,O,1625,1625,9919,1875,10537,3136,8294,O
3135,N,570,570,10489,300,10837,3136,9919,N
3135,O,453,453,10942,790,11627,3136,10489,O
3135,P,3479,3479,14421,3780,15407,3136,10942,P
3136,A,494,494,494,1947,1947,3137,0,A
3136,B,1518,1518,2012,90,2037,3137,494,B
3136,C,1553,1553,3565,1745,3782,3137,2012,C
3136,D,72,72,3637,3780,7562,3137,3565,D
3136,M,2077,2077,5714,2649,10211,3137,3637,M
3136,N,622,622,6336,90,10301,3137,5714,N
3136,O,541,541,6877,905,11206,3137,6336,O
3136,P,6999,6999,13876,3780,14986,3137,6877,P
3137,AEI,533,533,533,1702,1702,3138,0,A
3137,BEI,819,286,819,1252,1252,3138,0,E
3137,BFI,1104,285,1104,1569,1569,3138,0,I
3137,BFJ,708,423,1527,180,1432,3138,819,F
3137,BGJ,1005,582,2109,600,2169,3138,1104,J
3137,BGK,1645,69,2178,555,2257,3138,533,B
3137,CGK,953,302,2480,910,2342,3138,1527,G
3137,CHK,616,245,2725,575,2744,3138,2109,K
3137,CHL,1292,745,3470,1235,3492,3138,2178,C
3137,DHL,1196,451,3921,550,3294,3138,2725,L
3137,DH,1677,236,4157,550,2892,3138,2480,H
3137,D,2393,1706,5863,550,4042,3138,3470,D
3137,M,1028,1028,6891,2949,6991,3138,5863,M
3137,N,2654,2654,9545,780,7771,3138,6891,N
3137,O,3242,3242,12787,1719,9490,3138,9545,O
3137,P,7410,7410,20197,336,9826,3138,12787,P
3138,AE,66,66,66,94,94,3139,0,A
3138,BE,117,117,183,150,244,3139,66,B
3138,CE,90,90,273,100,344,3139,183,C
3138,DE,1178,905,1178,1257,1257,3139,0,E
3138,DF,298,298,1476,240,1497,3139,1178,F
3138,DG,870,870,2346,835,2332,3139,1476,G
3138,DF,3199,3199,5545,3095,5427,3139,2346,F
3138,DG,961,961,6506,1210,6637,3139,5545,G
3138,DH,1852,1852,8358,3960,10597,3139,6506,H
3138,D,11104,3019,11377,2880,3224,3139,273,D
3138,M,163,163,11540,631,11228,3139,11377,M
3138,N,705,705,12245,90,11318,3139,11540,N
3138,O,1049,1049,13294,1360,12678,3139,12245,O
3138,P,375,375,13669,3780,16458,3139,13294,P
3139,A,180,180,180,424,424,3140,0,A
3139,B,289,289,469,180,604,3140,180,B
3139,C,370,370,839,660,1264,3140,469,C
3139,D,321,321,1160,3960,5224,3140,839,D
3139,M,94,94,1254,115,5339,3140,1160,M
3139,N,107,107,1361,150,5489,3140,1254,N
3139,O,563,563,1924,75,5564,3140,1361,O
3139,P,450,450,2374,2880,8444,3140,1924,P
3140,AE,122,122,122,116,116,3141,0,A
3140,BE,181,181,303,240,356,3141,122,B
3140,CE,226,226,529,245,601,3141,303,C
3140,DE,582,582,1111,5250,5851,3141,529,D
3140,E,1351,240,1351,1351,1351,3141,0,E
3140,F,350,350,1701,410,1761,3141,1351,F
3140,G,931,931,2632,815,2576,3141,1701,G
3140,H,4295,4295,6927,550,3126,3141,2632,H
3140,M,752,752,7679,1767,7618,3141,6927,M
3140,N,1391,1391,9070,420,8038,3141,7679,N
3140,O,741,741,9811,1060,9098,3141,9070,O
3140,P,7384,7384,17195,2715,11813,3141,9811,P
3141,A,58,58,58,115,115,3142,0,A
3141,B,166,166,224,135,250,3142,58,B
3141,C,176,176,400,295,545,3142,224,C
3141,D,111,111,511,5100,5645,3142,400,D
3141,M,471,471,982,1602,7247,3142,511,M
3141,N,1432,1432,2414,180,7427,3142,982,N
3141,O,527,527,2941,895,8322,3142,2414,O
3141,N,427,427,3368,240,8562,3142,2941,N
3141,O,629,629,3997,660,9222,3142,3368,O
3141,P,583,583,4580,6660,15882,3142,3997,P
3142,AEI,885,885,885,1381,1381,3143,0,A
3142,BEI,539,539,1424,90,1471,3143,885,B
3142,CEI,1971,547,1971,2656,2656,3143,0,I
3142,CEJ,863,316,2287,1240,2711,3143,1424,C
3142,DEJ,86,86,2373,3780,6491,3143,2287,D
3142,EJ,1172,770,3143,90,2746,3143,1971,J
3142,EK,1179,1179,4322,1405,4151,3143,3143,K
3142,EL,4733,411,4733,4979,4979,3143,0,E
3142,FL,272,272,5005,90,5069,3143,4733,F
3142,GL,719,36,5041,3780,7931,3143,4322,L
3142,G,494,458,5499,905,5974,3143,5005,G
3142,H,1802,1802,7301,3780,9754,3143,5499,H
3142,M,798,798,8099,1402,11156,3143,7301,M
3142,N,659,659,8758,90,11246,3143,8099,N
3142,O,447,447,9205,860,12106,3143,8758,O
3142,P,274,274,9479,3780,15886,3143,9205,P
3143,AEI,69,69,69,306,306,3144,0,I
3143,AEJ,256,187,256,467,467,3144,0,A
3143,BEJ,262,75,331,90,396,3144,69,J
3143,BEK,275,200,531,90,557,3144,256,B
3143,CEK,1140,609,1140,1307,1307,3144,0,E
3143,CFK,224,224,1364,90,1397,3144,1140,F
3143,CGK,1475,642,2006,1745,2302,3144,531,C
3143,DGK,1686,11,2017,1940,2336,3144,331,K
3143,DGL,17,6,2023,3780,6082,3144,2006,D
3143,GL,66,60,2083,3780,6116,3144,2017,L
3143,G,751,32,2115,1105,2502,3144,1364,G
3143,H,527,527,2642,3780,6282,3144,2115,H
3143,M,1959,1959,4601,2247,8529,3144,2642,M
3143,N,339,339,4940,90,8619,3144,4601,N
3143,O,399,399,5339,815,9434,3144,4940,O
3143,P,1560,1560,6899,3780,13214,3144,5339,P
3144,AE,945,945,945,1140,1140,3145,0,E
3144,AF,224,224,1169,90,1230,3145,945,F
3144,AG,1544,375,1544,1795,1795,3145,0,A
3144,BG,267,267,1811,90,1885,3145,1544,B
3144,CG,977,335,2146,1240,2470,3145,1169,G
3144,CH,42,42,2188,3780,6250,3145,2146,H
3144,C,502,125,2313,905,2790,3145,1811,C
3144,D,59,59,2372,3780,6570,3145,2313,D
3144,M,369,369,2741,986,7556,3145,2372,M
3144,N,656,656,3397,90,7646,3145,2741,N
3144,O,538,538,3935,850,8496,3145,3397,O
3144,P,384,384,4319,3780,12276,3145,3935,P
3145,AEI,27,27,27,1066,1066,3146,0,I
3145,AEJ,61,34,61,1031,1031,3146,0,E
3145,AFJ,1164,1164,1225,240,1271,3146,61,F
3145,AGJ,1241,43,1268,240,1306,3146,27,J
3145,AGK,1698,430,1698,1771,1771,3146,0,A
3145,BGK,193,193,1891,180,1951,3146,1698,B
3145,CGK,805,139,2030,940,2211,3146,1225,G
3145,CHK,792,30,2060,930,2236,3146,1268,K
3145,CHL,428,259,2319,600,2551,3146,1891,C
3145,BHL,797,797,3116,610,3161,3146,2319,B
3145,CHL,1097,41,3157,6990,9226,3146,2060,L
3145,CH,985,944,4101,1282,4443,3146,3116,C
3145,DH,3238,1167,5268,6990,9201,3146,2030,H
3145,D,2677,1510,6778,358,4801,3146,4101,D
3145,M,551,551,7329,1795,11021,3146,6778,M
3145,N,1274,1274,8603,90,11111,3146,7329,N
3145,O,2969,2969,11572,2530,13641,3146,8603,O
3145,N,3453,3453,15025,3855,17496,3146,11572,N
3145,O,780,780,15805,945,18441,3146,15025,O
3145,P,2910,2910,18715,3780,22221,3146,15805,P
3146,A,162,162,162,115,115,3147,0,A
3146,B,13,13,175,120,235,3147,162,B
3146,C,232,232,407,225,460,3147,175,C
3146,B,815,815,1222,825,1285,3147,407,B
3146,C,569,569,1791,635,1920,3147,1222,C
3146,D,4795,4795,6586,2940,4860,3147,1791,D
3146,M,493,493,7079,770,5630,3147,6586,M
3146,N,397,397,7476,180,5810,3147,7079,N
3146,O,1457,1457,8933,1000,6810,3147,7476,O
3146,P,2734,2734,11667,660,7470,3147,8933,P
3147,A,5320,5320,5320,9056,9056,3148,0,A
3147,B,3747,3747,9067,90,9146,3148,5320,B
3147,C,1189,1189,10256,1385,10531,3148,9067,C
3147,D,43,43,10299,3780,14311,3148,10256,D
3147,M,760,760,11059,1364,15675,3148,10299,M
3147,N,654,654,11713,90,15765,3148,11059,N
3147,O,489,489,12202,905,16670,3148,11713,O
3147,P,5605,5605,17807,3780,20450,3148,12202,P
3148,AEI,249,249,249,425,425,3149,0,A
3148,BEI,523,274,523,1848,1848,3149,0,I
3148,BEJ,316,42,565,90,515,3149,249,B
3148,CEJ,1839,1274,1839,2807,2807,3149,0,E
3148,CFJ,1365,49,1888,150,1998,3149,523,J
3148,CFK,1387,64,1952,1780,2295,3149,565,C
3148,DFK,106,106,2058,3780,6075,3149,1952,D
3148,FK,1013,794,2852,90,2897,3149,1839,F
3148,GK,1593,629,3481,1765,3763,3149,1888,K
3148,GL,10,10,3491,3780,7543,3149,3481,L
3148,G,717,78,3569,1135,4032,3149,2852,G
3148,H,133,133,3702,3780,7812,3149,3569,H
3148,M,360,360,4062,1278,9090,3149,3702,M
3148,N,948,948,5010,90,9180,3149,4062,N
3148,O,765,765,5775,1195,10375,3149,5010,O
3148,P,70,70,5845,3780,14155,3149,5775,P
3149,A,558,558,558,430,430,3150,0,A
3149,B,681,681,1239,150,580,3150,558,B
3149,C,258,258,1497,245,825,3150,1239,C
3149,D,715,715,2212,2881,3706,3150,1497,D
3149,M,428,428,2640,452,4158,3150,2212,M
3149,N,132,132,2772,150,4308,3150,2640,N
3149,O,138,138,2910,100,4408,3150,2772,O
3149,N,956,956,3866,980,5388,3150,2910,N
3149,O,170,170,4036,225,5613,3150,3866,O
3149,P,25,25,4061,4740,10353,3150,4036,P
3150,AEI,575,575,575,1100,1100,3151,0,E
3150,AFI,465,465,1040,300,1400,3151,575,F
3150,AGI,853,853,1893,720,2120,3151,1040,G
3150,AFI,1279,1279,3172,850,2970,3151,1893,F
3150,AGI,654,654,3826,915,3885,3151,3172,G
3150,AHI,1374,1374,5200,3960,7845,3151,3826,H
3150,AI,11716,6516,11716,11835,11835,3151,0,A
3150,BI,376,376,12092,300,12135,3151,11716,B
3150,CI,634,634,12726,735,12870,3151,12092,C
3150,DI,144,144,12870,1560,14430,3151,12726,D
3150,I,14842,1972,14842,14855,14855,3151,0,I
3150,J,264,264,15106,300,15155,3151,14842,J
3150,K,593,593,15699,735,15890,3151,15106,K
3150,L,166,166,15865,1560,17450,3151,15699,L
3150,M,11876,11876,27741,11984,29434,3151,15865,M
3150,N,316,316,28057,240,29674,3151,27741,N
3150,O,605,605,28662,995,30669,3151,28057,O
3150,N,379,379,29041,50,30719,3151,28662,N
3150,O,1086,1086,30127,1500,32219,3151,29041,O
3150,P,164,164,30291,3960,36179,3151,30127,P
3151,AE,207,207,207,478,478,3152,0,A
3151,BE,314,314,521,90,568,3152,207,B
3151,CE,444,444,965,850,1418,3152,521,C
3151,DE,943,943,1908,3780,5198,3152,965,D
3151,E,36430,34522,36430,38735,38735,3152,0,E
3151,F,2335,2335,38765,90,38825,3152,36430,F
3151,G,1031,1031,39796,1210,40035,3152,38765,G
3151,F,402,402,40198,205,40240,3152,39796,F
3151,G,428,428,40626,850,41090,3152,40198,G
3151,H,1042,1042,41668,3780,44870,3152,40626,H
3151,M,308,308,41976,890,45760,3152,41668,M
3151,N,858,858,42834,300,46060,3152,41976,N
3151,O,1159,1159,43993,920,46980,3152,42834,O
3151,N,140,140,44133,465,47445,3152,43993,N
3151,O,345,345,44478,660,48105,3152,44133,O
3151,P,5748,5748,50226,3960,52065,3152,44478,P
3152,AEI,199,199,199,214,214,3153,0,A
3152,BEI,109,109,308,150,364,3153,199,B
3152,CEI,147,147,455,410,774,3153,308,C
3152,BEI,568,113,568,826,826,3153,0,E
3152,BFI,303,303,871,90,916,3153,568,F
3152,BGI,857,441,1312,585,1359,3153,455,B
3152,CGI,127,127,1439,110,1469,3153,1312,C
3152,DGI,505,505,1944,4230,5699,3153,1439,D
3152,GI,1192,119,2063,1465,2381,3153,871,G
3152,HI,30,30,2093,3780,6161,3153,2063,H
3152,I,2946,853,2946,3213,3213,3153,0,I
3152,J,1727,1727,4673,1500,4713,3153,2946,J
3152,K,810,810,5483,995,5708,3153,4673,K
3152,J,1693,1693,7176,1520,7228,3153,5483,J
3152,K,233,233,7409,295,7523,3153,7176,K
3152,L,1587,1587,8996,5100,12623,3153,7409,L
3152,M,1873,1873,10869,2375,14998,3153,8996,M
3152,N,1058,1058,11927,180,15178,3153,10869,N
3152,O,483,483,12410,895,16073,3153,11927,O
3152,N,1341,1341,13751,1365,17438,3153,12410,N
3152,O,599,599,14350,620,18058,3153,13751,O
3152,P,1266,1266,15616,6960,25018,3153,14350,P
3153,AEI,50,50,50,2036,2036,3154,0,A
3153,BEI,853,803,853,2032,2032,3154,0,I
3153,BEJ,1202,1202,2055,90,2122,3154,853,J
3153,BEK,2016,11,2066,90,2126,3154,50,B
3153,CEK,577,577,2643,575,2701,3154,2066,C
3153,DEK,908,320,2963,1215,3337,3154,2055,K
3153,DEL,430,110,3073,3780,6481,3154,2643,D
3153,EL,3251,178,3251,6027,6027,3154,0,E
3153,FL,1385,1097,4348,3780,7117,3154,2963,L
3153,F,2924,1827,6175,90,6117,3154,3251,F
3153,G,793,793,6968,1240,7357,3154,6175,G
3153,H,481,481,7449,3780,11137,3154,6968,H
3153,M,561,561,8010,941,12078,3154,7449,M
3153,N,413,413,8423,90,12168,3154,8010,N
3153,O,600,600,9023,845,13013,3154,8423,O
3153,P,622,622,9645,3780,16793,3154,9023,P
3154,AEI,97,97,97,860,860,3155,0,A
3154,BEI,370,273,370,355,355,3155,0,I
3154,BEJ,251,251,621,300,655,3155,370,J
3154,BEK,955,431,1052,240,1100,3155,97,B
3154,CEK,779,348,1400,840,1495,3155,621,K
3154,CEL,1425,25,1425,1475,1475,3155,0,E
3154,CFL,656,283,1708,640,1740,3155,1052,C
3154,DFL,309,26,1734,300,1775,3155,1425,F
3154,DGL,649,649,2383,750,2525,3155,1734,G
3154,DFL,273,273,2656,155,2680,3155,2383,F
3154,DGL,1446,498,3154,5370,7110,3155,1708,D
3154,GL,778,280,3434,415,3095,3155,2656,G
3154,HL,3640,3640,7074,1140,4235,3155,3434,H
3154,L,7700,2026,9100,1140,2635,3155,1400,L
3154,M,1643,1643,10743,3137,10247,3155,9100,M
3154,N,1524,1524,12267,90,10337,3155,10743,N
3154,O,1537,1537,13804,1780,12117,3155,12267,O
3154,N,2333,2333,16137,2080,14197,3155,13804,N
3154,O,1787,1787,17924,1220,15417,3155,16137,O
3154,P,10238,10238,28162,3780,19197,3155,17924,P
3155,AEI,130,130,130,391,391,3156,0,I
3155,AEJ,231,101,231,473,473,3156,0,E
3155,AFJ,646,415,646,1655,1655,3156,0,A
3155,BFJ,543,27,673,360,751,3156,130,J
3155,BFK,536,94,767,360,833,3156,231,F
3155,BGK,399,305,1072,952,1703,3156,673,K
3155,BGL,377,72,1144,947,1780,3156,767,G
3155,BHL,1288,790,1934,300,1955,3156,646,B
3155,CHL,1323,1323,3257,1045,3000,3156,1934,C
3155,DHL,2479,366,3623,948,2728,3156,1144,H
3155,DL,473,107,3730,1200,4200,3156,3257,D
3155,L,2665,7,3737,2308,4011,3156,1072,L
3155,M,206,206,3943,1769,5969,3156,3737,M
3155,N,1768,1768,5711,240,6209,3156,3943,N
3155,O,609,609,6320,810,7019,3156,5711,O
3155,N,1054,1054,7374,1040,8059,3156,6320,N
3155,O,645,645,8019,780,8839,3156,7374,O
3155,P,1409,1409,9428,3960,12799,3156,8019,P
3156,AE,437,437,437,657,657,3157,0,A
3156,BE,327,327,764,150,807,3157,437,B
3156,CE,921,157,921,1343,1343,3157,0,E
3156,CF,501,501,1422,120,1463,3157,921,F
3156,CG,861,203,1625,810,1617,3157,764,C
3156,BG,453,453,2078,490,2107,3157,1625,B
3156,CG,920,264,2342,870,2333,3157,1422,G
3156,CF,254,254,2596,320,2653,3157,2342,F
3156,CG,660,142,2738,710,2817,3157,2078,C
3156,DG,1476,1334,4072,1300,3953,3157,2596,G
3156,DH,1620,286,4358,4230,7047,3157,2738,D
3156,H,1967,1681,6039,360,4313,3157,4072,H
3156,M,1716,1716,7755,3516,10563,3157,6039,M
3156,N,2160,2160,9915,420,10983,3157,7755,N
3156,O,895,895,10810,1125,12108,3157,9915,O
3156,N,1010,1010,11820,795,12903,3157,10810,N
3156,O,658,658,12478,888,13791,3157,11820,O
3156,P,709,709,13187,402,14193,3157,12478,P
3157,AE,70,70,70,69,69,3158,0,E
3157,AF,112,42,112,180,180,3158,0,A
3157,BF,99,57,169,150,219,3158,70,F
3157,BG,190,133,302,180,360,3158,112,B
3157,CG,178,45,347,135,354,3158,169,G
3157,CH,6,6,353,4230,4584,3158,347,H
3157,C,171,120,473,165,525,3158,302,C
3157,D,8,8,481,4090,4615,3158,473,D
3157,M,660,660,1141,1186,5801,3158,481,M
3157,N,663,663,1804,180,5981,3158,1141,N
3157,O,168,168,1972,230,6211,3158,1804,O
3157,N,1493,1493,3465,1425,7636,3158,1972,N
3157,O,1250,1250,4715,1350,8986,3158,3465,O
3157,P,3386,3386,8101,3660,12646,3158,4715,P
3158,AE,11355,11355,11355,11490,11490,3159,0,A
3158,BE,173,173,11528,90,11580,3159,11355,B
3158,CE,745,745,12273,1105,12685,3159,11528,C
3158,DE,476,476,12749,3780,16465,3159,12273,D
3158,E,29391,16642,29391,30406,30406,3159,0,E
3158,F,1045,1045,30436,90,30496,3159,29391,F
3158,G,933,933,31369,1210,31706,3159,30436,G
3158,H,45,45,31414,3780,35486,3159,31369,H
3158,M,169,169,31583,831,36317,3159,31414,M
3158,N,691,691,32274,90,36407,3159,31583,N
3158,O,324,324,32598,705,37112,3159,32274,O
3158,P,79,79,32677,3780,40892,3159,32598,P
3159,A,39,39,39,1240,1240,3160,0,A
3159,B,1413,1413,1452,270,1510,3160,39,B
3159,C,156,156,1608,145,1655,3160,1452,C
3159,D,37,37,1645,2880,4535,3160,1608,D
3159,M,344,344,1989,932,5467,3160,1645,M
3159,N,687,687,2676,150,5617,3160,1989,N
3159,O,221,221,2897,140,5757,3160,2676,O
3159,N,261,261,3158,340,6097,3160,2897,N
3159,O,877,877,4035,815,6912,3160,3158,O
3159,P,5040,5040,9075,3840,10752,3160,4035,P
3160,A,1465,1465,1465,3775,3775,3161,0,A
3160,B,2444,2444,3909,180,3955,3161,1465,B
3160,C,305,305,4214,505,4460,3161,3909,C
3160,B,1122,1122,5336,880,5340,3161,4214,B
3160,C,381,381,5717,450,5790,3161,5336,C
3160,D,3923,3923,9640,4020,9810,3161,5717,D
3160,M,2834,2834,12474,3214,13024,3161,9640,M
3160,N,470,470,12944,150,13174,3161,12474,N
3160,O,106,106,13050,130,13304,3161,12944,O
3160,N,177,177,13227,155,13459,3161,13050,N
3160,O,807,807,14034,740,14199,3161,13227,O
3160,P,4447,4447,18481,550,14749,3161,14034,P
3161,AE,115,115,115,33,33,3162,0,A
3161,BE,84,84,199,225,258,3162,115,B
3161,CE,181,181,380,85,343,3162,199,C
3161,DE,888,508,888,2909,2909,3162,0,E
3161,DF,753,245,1133,2810,3153,3162,380,D
3161,F,2147,1902,3035,180,3089,3162,888,F
3161,G,775,775,3810,885,3974,3162,3035,G
3161,H,93,93,3903,3480,7454,3162,3810,H
3161,M,177,177,4080,245,7699,3162,3903,M
3161,N,161,161,4241,150,7849,3162,4080,N
3161,O,82,82,4323,590,8439,3162,4241,O
3161,N,679,679,5002,175,8614,3162,4323,N
3161,O,210,210,5212,125,8739,3162,5002,O
3161,P,223,223,5435,2880,11619,3162,5212,P
3162,A,199,199,199,340,340,3163,0,A
3162,B,445,445,644,240,580,3163,199,B
3162,C,608,608,1252,695,1275,3163,644,C
3162,B,640,640,1892,640,1915,3163,1252,B
3162,C,647,647,2539,810,2725,3163,1892,C
3162,D,307,307,2846,3960,6685,3163,2539,D
3162,M,592,592,3438,1601,8286,3163,2846,M
3162,N,2768,2768,6206,420,8706,3163,3438,N
3162,O,686,686,6892,900,9606,3163,6206,O
3162,N,1316,1316,8208,1070,10676,3163,6892,N
3162,O,168,168,8376,386,11062,3163,8208,O
3162,P,3331,3331,11707,1454,12516,3163,8376,P
3163,AE,574,574,574,1198,1198,3164,0,A
3163,BE,655,655,1229,90,1288,3164,574,B
3163,CE,183,183,1412,535,1823,3164,1229,C
3163,DE,1428,16,1428,1549,1549,3164,0,E
3163,DF,121,121,1549,120,1669,3164,1428,F
3163,DG,625,625,2174,749,2418,3164,1549,G
3163,DF,3050,2288,4462,3780,5603,3164,1412,D
3163,F,2755,467,4929,2546,4964,3164,2174,F
3163,G,975,975,5904,1159,6123,3164,4929,G
3163,H,689,689,6593,341,6464,3164,5904,H
3163,M,480,480,7073,368,6832,3164,6593,M
3163,N,18,18,7091,180,7012,3164,7073,N
3163,O,999,999,8090,935,7947,3164,7091,O
3163,P,716,716,8806,385,8332,3164,8090,P
3164,A,37888,37888,37888,39491,39491,3165,0,A
3164,B,1638,1638,39526,90,39581,3165,37888,B
3164,C,916,916,40442,1220,40801,3165,39526,C
3164,D,144,144,40586,3780,44581,3165,40442,D
3164,M,485,485,41071,1629,46210,3165,40586,M
3164,N,1175,1175,42246,90,46300,3165,41071,N
3164,O,764,764,43010,1195,47495,3165,42246,O
3164,P,30,30,43040,3780,51275,3165,43010,P
3165,AEI,869,869,869,1307,1307,3166,0,A
3165,BEI,502,502,1371,90,1397,3166,869,B
3165,CEI,1623,252,1623,1835,1835,3166,0,E
3165,CFI,269,269,1892,90,1925,3166,1623,F
3165,CGI,904,383,2275,1250,2647,3166,1371,C
3165,DGI,43,43,2318,3780,6427,3166,2275,D
3165,GI,484,58,2376,820,2745,3166,1892,G
3165,HI,102,102,2478,3780,6525,3166,2376,H
3165,I,35302,32824,35302,36075,36075,3166,0,I
3165,J,803,803,36105,90,36165,3166,35302,J
3165,K,868,868,36973,1240,37405,3166,36105,K
3165,L,502,502,37475,3780,41185,3166,36973,L
3165,M,302,302,37777,1046,42231,3166,37475,M
3165,N,791,791,38568,90,42321,3166,37777,N
3165,O,515,515,39083,845,43166,3166,38568,O
3165,P,1414,1414,40497,3780,46946,3166,39083,P
3166,AE,126,126,126,186,186,3167,0,E
3166,AF,155,155,281,135,321,3167,126,F
3166,AG,168,168,449,290,611,3167,281,G
3166,AH,1252,803,1252,2265,2265,3167,0,A
3166,BH,1103,1103,2355,150,2415,3167,1252,B
3166,CH,181,181,2536,540,2955,3167,2355,C
3166,DH,267,267,2803,720,3675,3167,2536,D
3166,H,3037,683,3486,5160,5771,3167,449,H
3166,M,301,301,3787,698,6469,3167,3486,M
3166,N,424,424,4211,90,6559,3167,3787,N
3166,O,875,875,5086,1240,7799,3167,4211,O
3166,P,134,134,5220,3780,11579,3167,5086,P
3167,AEI,308,308,308,1300,1300,3168,0,E
3167,AFI,391,83,391,1035,1035,3168,0,I
3167,AFJ,1013,1013,1404,400,1435,3168,391,J
3167,AFK,1483,387,1791,240,1540,3168,308,F
3167,AGK,2032,241,2032,2297,2297,3168,0,A
3167,BGK,279,279,2311,120,2417,3168,2032,B
3167,CGK,1145,238,2549,1210,2645,3168,1404,K
3167,CGL,865,107,2656,1495,3035,3168,1791,G
3167,CFL,826,481,3137,755,3172,3168,2311,C
3167,DFL,153,153,3290,550,3722,3168,3137,D
3167,FL,1784,1150,4440,595,3630,3168,2656,F
3167,GL,390,390,4830,540,4170,3168,4440,G
3167,HL,1636,1636,6466,9780,13950,3168,4830,H
3167,L,7216,3299,9765,550,3195,3168,2549,L
3167,M,633,633,10398,2502,16452,3168,9765,M
3167,N,2243,2243,12641,420,16872,3168,10398,N
3167,O,642,642,13283,676,17548,3168,12641,O
3167,P,5118,5118,18401,759,18307,3168,13283,P
3168,AEI,47,47,47,1106,1106,3169,0,E
3168,AFI,113,66,113,1136,1136,3169,0,I
3168,AFJ,1279,1166,1279,2125,2125,3169,0,A
3168,BFJ,1238,6,1285,240,1346,3169,47,F
3168,BGJ,1218,46,1331,240,1376,3169,113,J
3168,BGK,730,684,2015,780,2126,3169,1285,G
3168,BHK,752,68,2083,780,2156,3169,1331,K
3168,BHL,884,80,2163,90,2215,3169,1279,B
3168,CHL,567,567,2730,805,3020,3169,2163,C
3168,BHL,2703,2056,4786,7680,9836,3169,2083,L
3168,BH,3691,920,5706,7680,9806,3169,2015,H
3168,B,4474,1498,7204,4245,7265,3169,2730,B
3168,C,1419,1419,8623,1830,9095,3169,7204,C
3168,D,767,767,9390,3780,12875,3169,8623,D
3168,M,5,5,9395,379,13254,3169,9390,M
3168,N,613,613,10008,300,13554,3169,9395,N
3168,O,738,738,10746,825,14379,3169,10008,O
3168,N,1149,1149,11895,1065,15444,3169,10746,N
3168,O,331,331,12226,535,15979,3169,11895,O
3168,P,14382,14382,26608,2880,18859,3169,12226,P
3169,AEI,217,217,217,1217,1217,3170,0,E
3169,AFI,292,75,292,866,866,3170,0,A
3169,BFI,813,521,813,1251,1251,3170,0,I
3169,BFJ,668,147,960,150,1016,3170,292,B
3169,CFJ,234,234,1194,140,1156,3170,960,C
3169,BFJ,1077,100,1294,90,1307,3170,217,F
3169,BGJ,504,23,1317,90,1341,3170,813,J
3169,BGK,663,540,1857,740,1896,3170,1194,B
3169,CGK,901,361,2218,1250,2591,3170,1317,K
3169,CGL,97,97,2315,3780,6371,3170,2218,L
3169,CG,1107,86,2401,1270,2577,3170,1294,G
3169,CH,844,300,2701,765,2661,3170,1857,C
3169,DH,566,266,2967,3780,6357,3170,2401,H
3169,D,2875,2609,5576,4230,6891,3170,2701,D
3169,M,1584,1584,7160,2399,9290,3170,5576,M
3169,N,846,846,8006,150,9440,3170,7160,N
3169,O,256,256,8262,585,10025,3170,8006,O
3169,P,25893,25893,34155,3780,13805,3170,8262,P
3170,AE,95,95,95,576,576,3171,0,E
3170,AF,111,16,111,1098,1098,3171,0,A
3170,BF,694,678,789,240,816,3171,95,F
3170,BG,1191,513,1302,240,1338,3171,111,B
3170,CG,682,169,1471,810,1626,3171,789,G
3170,CH,189,189,1660,3960,5586,3171,1471,H
3170,C,700,342,2002,760,2098,3171,1302,C
3170,D,2283,2283,4285,7680,9778,3171,2002,D
3170,M,136,136,4421,347,10125,3171,4285,M
3170,N,370,370,4791,180,10305,3171,4421,N
3170,O,639,639,5430,683,10988,3171,4791,O
3170,P,12580,12580,18010,4080,15068,3171,5430,P
3171,AE,904,904,904,1401,1401,3172,0,A
3171,BE,1153,249,1153,2012,2012,3172,0,E
3171,BF,556,307,1460,90,1491,3172,904,B
3171,CF,916,609,2069,90,2102,3172,1153,F
3171,CG,965,356,2425,1240,2731,3172,1460,C
3171,DG,8,8,2433,3780,6511,3172,2425,D
3171,G,881,517,2950,1250,3352,3172,2069,G
3171,H,1440,1440,4390,3780,7132,3172,2950,H
3171,M,3736,3736,8126,4231,11363,3172,4390,M
3171,N,528,528,8654,90,11453,3172,8126,N
3171,O,511,511,9165,880,12333,3172,8654,O
3171,P,8387,8387,17552,3780,16113,3172,9165,P
3172,A,1200,1200,1200,1570,1570,3173,0,A
3172,B,617,617,1817,300,1870,3173,1200,B
3172,C,1061,1061,2878,1105,2975,3173,1817,C
3172,D,936,936,3814,1140,4115,3173,2878,D
3172,M,2,2,3816,318,4433,3173,3814,M
3172,N,577,577,4393,300,4733,3173,3816,N
3172,O,648,648,5041,820,5553,3173,4393,O
3172,N,1357,1357,6398,1245,6798,3173,5041,N
3172,O,197,197,6595,430,7228,3173,6398,O
3172,P,1203,1203,7798,8050,15278,3173,6595,P
3173,AEI,1,1,1,32,32,3174,0,I
3173,AEJ,157,157,158,180,212,3174,1,J
3173,AEK,613,613,771,855,1067,3174,158,K
3173,AEJ,1464,693,1464,1949,1949,3174,0,E
3173,AFJ,605,605,2069,180,2129,3174,1464,F
3173,AGJ,2931,1633,3702,2685,3752,3174,771,J
3173,AGK,1912,279,3981,885,3014,3174,2069,G
3173,AHK,470,191,4172,760,4512,3174,3702,K
3173,AHL,1548,1357,5529,6660,9674,3174,3981,H
3173,AL,5870,341,5870,6945,6945,3174,0,A
3173,BL,2183,485,6355,3540,8052,3174,4172,L
3173,B,1344,859,7214,300,7245,3174,5870,B
3173,C,1215,1215,8429,1045,8290,3174,7214,C
3173,D,731,731,9160,1200,9490,3174,8429,D
3173,M,100,100,9260,1201,10875,3174,9160,M
3173,N,1131,1131,10391,90,10965,3174,9260,N
3173,O,515,515,10906,820,11785,3174,10391,O
3173,N,1286,1286,12192,980,12765,3174,10906,N
3173,O,925,925,13117,1425,14190,3174,12192,O
3173,P,2722,2722,15839,3780,17970,3174,13117,P
3174,A,606,606,606,1025,1025,3175,0,A
3174,B,706,706,1312,360,1385,3175,606,B
3174,C,1029,1029,2341,990,2375,3175,1312,C
3174,D,2068,2068,4409,550,2925,3175,2341,D
3174,M,849,849,5258,2181,5106,3175,4409,M
3174,N,2063,2063,7321,780,5886,3175,5258,N
3174,O,720,720,8041,790,6676,3175,7321,O
3174,P,1032,1032,9073,1015,7691,3175,8041,P
3175,AE,238,238,238,953,953,3176,0,A
3175,BE,1020,1020,1258,300,1253,3176,238,B
3175,CE,814,814,2072,920,2173,3176,1258,C
3175,BE,3176,1104,3176,3325,3325,3176,0,E
3175,BF,1263,159,3335,1445,3618,3176,2072,B
3175,CF,269,110,3445,180,3505,3176,3176,F
3175,CG,717,717,4162,850,4355,3176,3445,G
3175,CF,253,253,4415,120,4475,3176,4162,F
3175,CG,470,470,4885,790,5265,3176,4415,G
3175,CH,2316,766,5651,2660,6278,3176,3335,C
3175,DH,1530,764,6415,2580,7845,3176,4885,H
3175,D,1983,1219,7634,3960,10238,3176,5651,D
3175,M,39046,39046,46680,39096,49334,3176,7634,M
3175,N,200,200,46880,210,49544,3176,46680,N
3175,O,264,264,47144,205,49749,3176,46880,O
3175,N,736,736,47880,775,50524,3176,47144,N
3175,O,731,731,48611,697,51221,3176,47880,O
3175,P,4167,4167,52778,1143,52364,3176,48611,P
3176,A,1989,1989,1989,2679,2679,3177,0,A
3176,B,750,750,2739,90,2769,3177,1989,B
3176,C,1089,1089,3828,1505,4274,3177,2739,C
3176,D,7,7,3835,3780,8054,3177,3828,D
3176,M,452,452,4287,584,8638,3177,3835,M
3176,N,248,248,4535,150,8788,3177,4287,N
3176,O,30,30,4565,95,8883,3177,4535,O
3176,N,437,437,5002,390,9273,3177,4565,N
3176,O,140,140,5142,225,9498,3177,5002,O
3176,P,984,984,6126,4740,14238,3177,5142,P
3177,AE,36,36,36,739,739,3178,0,A
3177,BE,902,902,938,240,979,3178,36,B
3177,CE,1215,277,1215,1695,1695,3178,0,E
3177,CF,606,329,1544,810,1789,3178,938,C
3177,DF,742,413,1957,300,1995,3178,1215,F
3177,DG,885,885,2842,1050,3045,3178,1957,G
3177,DH,8,8,2850,1140,4185,3178,2842,H
3177,D,19850,18544,21394,3960,5749,3178,1544,D
3177,M,121,121,21515,202,5951,3178,21394,M
3177,N,324,324,21839,300,6251,3178,21515,N
3177,O,755,755,22594,820,7071,3178,21839,O
3177,N,2433,2433,25027,2370,9441,3178,22594,N
3177,O,123,123,25150,385,9826,3178,25027,O
3177,P,259,259,25409,5400,15226,3178,25150,P
3178,AE,57,57,57,3199,3199,3179,0,E
3178,AF,107,50,107,436,436,3179,0,A
3178,BF,594,594,701,240,676,3179,107,B
3178,CF,718,718,1419,1015,1691,3179,701,C
3178,DF,1773,1773,3192,3960,5651,3179,1419,D
3178,F,3327,192,3384,240,3439,3179,57,F
3178,G,714,714,4098,845,4284,3179,3384,G
3178,H,3209,3209,7307,5280,9564,3179,4098,H
3178,M,1560,1560,8867,1730,11294,3179,7307,M
3178,N,459,459,9326,300,11594,3179,8867,N
3178,O,798,798,10124,835,12429,3179,9326,O
3178,P,4271,4271,14395,1140,13569,3179,10124,P
3179,AE,135,135,135,1674,1674,3180,0,A
3179,BE,142,7,142,1759,1759,3180,0,E
3179,BF,1735,1728,1870,240,1914,3180,135,B
3179,CF,1790,62,1932,240,1999,3180,142,F
3179,CG,918,856,2788,1170,3084,3180,1870,C
3179,BG,1208,352,3140,1410,3409,3180,1932,G
3179,BF,748,396,3536,560,3644,3180,2788,B
3179,CF,850,454,3990,670,4079,3180,3140,F
3179,CG,517,63,4053,555,4199,3180,3536,C
3179,DG,497,434,4487,585,4664,3180,3990,G
3179,DH,3045,3045,7532,475,5139,3180,4487,H
3179,D,3562,83,7615,420,4619,3180,4053,D
3179,M,1755,1755,9370,3288,8427,3180,7615,M
3179,N,1682,1682,11052,180,8607,3180,9370,N
3179,O,943,943,11995,820,9427,3180,11052,O
3179,N,253,253,12248,405,9832,3180,11995,N
3179,O,530,530,12778,665,10497,3180,12248,O
3179,P,399,399,13177,5460,15957,3180,12778,P
3180,A,322,322,322,952,952,3181,0,A
3180,B,909,909,1231,300,1252,3181,322,B
3180,C,840,840,2071,910,2162,3181,1231,C
3180,B,1410,1410,3481,1385,3547,3181,2071,B
3180,C,2529,2529,6010,2460,6007,3181,3481,C
3180,D,2569,2569,8579,3960,9967,3181,6010,D
3180,M,1870,1870,10449,2847,12814,3181,8579,M
3180,N,1288,1288,11737,90,12904,3181,10449,N
3180,O,860,860,12597,1375,14279,3181,11737,O
3180,N,592,592,13189,355,14634,3181,12597,N
3180,O,733,733,13922,1060,15694,3181,13189,O
3180,P,935,935,14857,3780,19474,3181,13922,P
3181,A,109,109,109,857,857,3182,0,A
3181,B,926,926,1035,240,1097,3182,109,B
3181,C,579,579,1614,740,1837,3182,1035,C
3181,D,7920,7920,9534,5100,6937,3182,1614,D
3181,M,698,698,10232,2188,9125,3182,9534,M
3181,N,1622,1622,11854,180,9305,3182,10232,N
3181,O,738,738,12592,865,10170,3182,11854,O
3181,N,463,463,13055,345,10515,3182,12592,N
3181,O,52,52,13107,405,10920,3182,13055,O
3181,P,19634,19634,32741,6060,16980,3182,13107,P
3182,AE,582,582,582,1095,1095,3183,0,A
3182,BE,713,713,1295,240,1335,3183,582,B
3182,CE,1482,187,1482,1510,1510,3183,0,E
3182,CF,288,288,1770,300,1810,3183,1482,F
3182,CG,499,24,1794,825,2160,3183,1295,C
3182,DG,197,197,1991,3960,6120,3183,1794,D
3182,G,716,495,2486,840,2650,3183,1770,G
3182,H,6089,6089,8575,1140,3790,3183,2486,H
3182,M,1410,1410,9985,1840,7960,3183,8575,M
3182,N,461,461,10446,90,8050,3183,9985,N
3182,O,1467,1467,11913,1745,9795,3183,10446,O
3182,N,639,639,12552,340,10135,3183,11913,N
3182,O,578,578,13130,945,11080,3183,12552,O
3182,P,1663,1663,14793,3780,14860,3183,13130,P
3183,AE,2967,2967,2967,3480,3480,3184,0,E
3183,AF,3722,755,3722,4312,4312,3184,0,A
3183,BF,873,118,3840,420,3900,3184,2967,F
3183,BG,622,504,4344,90,4402,3184,3722,B
3183,CG,995,491,4835,985,4885,3184,3840,G
3183,CH,886,395,5230,1300,5702,3184,4344,C
3183,DH,740,345,5575,460,5345,3184,4835,H
3183,D,938,593,6168,3780,9482,3184,5230,D
3183,M,2337,2337,8505,2578,12060,3184,6168,M
3183,N,273,273,8778,90,12150,3184,8505,N
3183,O,848,848,9626,1200,13350,3184,8778,O
3183,N,2091,2091,11717,1735,15085,3184,9626,N
3183,O,714,714,12431,1070,16155,3184,11717,O
3183,P,17,17,12448,3780,19935,3184,12431,P
3184,AEI,319,319,319,977,977,3185,0,I
3184,AEJ,693,374,693,1584,1584,3185,0,E
3184,AFJ,784,410,1103,180,1157,3185,319,J
3184,AFK,896,896,1999,910,2067,3185,1103,K
3184,AFL,1358,52,2051,600,2184,3185,693,F
3184,AGL,2757,706,2757,3646,3646,3185,0,A
3184,BGL,987,229,2986,550,2617,3185,1999,L
3184,BG,1392,457,3443,1285,3469,3185,2051,G
3184,BH,1034,348,3791,180,3826,3185,2757,B
3184,CH,1023,675,4466,385,3854,3185,3443,H
3184,C,971,296,4762,945,4771,3185,3791,C
3184,D,106,106,4868,550,5321,3185,4762,D
3184,M,753,753,5621,2673,7994,3185,4868,M
3184,N,2629,2629,8250,780,8774,3185,5621,N
3184,O,1281,1281,9531,1774,10548,3185,8250,O
3184,P,15191,15191,24722,336,10884,3185,9531,P
3185,AEI,48,48,48,747,747,3186,0,A
3185,BEI,243,195,243,631,631,3186,0,E
3185,BFI,584,584,827,240,871,3186,243,F
3185,BGI,904,125,952,240,987,3186,48,B
3185,CGI,725,600,1552,895,1766,3186,827,G
3185,CHI,611,11,1563,895,1882,3186,952,C
3185,DHI,194,194,1757,3960,5842,3186,1563,D
3185,HI,1772,15,1772,2617,2617,3186,0,I
3185,HJ,1104,884,2656,3960,5726,3186,1552,H
3185,J,947,63,2719,150,2767,3186,1772,J
3185,K,750,750,3469,1030,3797,3186,2719,K
3185,J,1321,1321,4790,1015,4812,3186,3469,J
3185,K,666,666,5456,625,5437,3186,4790,K
3185,L,3973,3973,9429,4230,9667,3186,5456,L
3185,M,1405,1405,10834,1712,11379,3186,9429,M
3185,N,442,442,11276,150,11529,3186,10834,N
3185,O,615,615,11891,590,12119,3186,11276,O
3185,N,184,184,12075,240,12359,3186,11891,N
3185,O,691,691,12766,690,13049,3186,12075,O
3185,P,3292,3292,16058,4230,17279,3186,12766,P
3186,A,505,505,505,1339,1339,3187,0,A
3186,B,944,944,1449,90,1429,3187,505,B
3186,C,422,422,1871,855,2284,3187,1449,C
3186,D,1407,1407,3278,3780,6064,3187,1871,D
3186,M,766,766,4044,1368,7432,3187,3278,M
3186,N,641,641,4685,90,7522,3187,4044,N
3186,O,170,170,4855,535,8057,3187,4685,O
3186,P,1347,1347,6202,3780,11837,3187,4855,P
3187,AEI,53,53,53,917,917,3188,0,E
3187,AFI,81,28,81,836,836,3188,0,A
3187,BFI,933,933,1014,240,1076,3188,81,B
3187,CFI,1054,93,1107,240,1157,3188,53,F
3187,CGI,327,234,1341,540,1616,3188,1014,C
3187,DGI,326,92,1433,535,1692,3188,1107,G
3187,DHI,8483,7050,8483,9923,9923,3188,0,I
3187,DHJ,1847,1847,10330,410,10333,3188,8483,J
3187,DHK,815,815,11145,1085,11418,3188,10330,K
3187,DHJ,11456,1652,12797,2880,4496,3188,1341,D
3187,HJ,11383,19,12816,2880,4572,3188,1433,H
3187,J,3471,1800,14616,3240,14658,3188,11145,J
3187,K,486,486,15102,740,15398,3188,14616,K
3187,L,9,9,15111,1455,16853,3188,15102,L
3187,M,60,60,15171,1247,18100,3188,15111,M
3187,N,1380,1380,16551,180,18280,3188,15171,N
3187,O,337,337,16888,545,18825,3188,16551,O
3187,N,499,499,17387,630,19455,3188,16888,N
3187,O,776,776,18163,580,20035,3188,17387,O
3187,P,7488,7488,25651,5250,25285,3188,18163,P
3188,AE,45,45,45,554,554,3189,0,A
3188,BE,48,3,48,571,571,3189,0,E
3188,BF,629,626,674,165,719,3189,45,B
3188,CF,673,47,721,165,736,3189,48,F
3188,CG,643,643,1364,910,1646,3189,721,G
3188,CH,821,131,1495,1075,1794,3189,674,C
3188,DH,1180,1049,2544,3960,5606,3189,1364,H
3188,D,1213,164,2708,3960,5754,3189,1495,D
3188,M,1534,1534,4242,2316,8070,3189,2708,M
3188,N,828,828,5070,90,8160,3189,4242,N
3188,O,498,498,5568,885,9045,3189,5070,O
3188,N,1241,1241,6809,850,9895,3189,5568,N
3188,O,717,717,7526,935,10830,3189,6809,O
3188,P,2885,2885,10411,3780,14610,3189,7526,P
3189,AE,935,935,935,1430,1430,3190,0,E
3189,AF,1414,479,1414,1579,1579,3190,0,A
3189,BF,527,48,1462,90,1520,3190,935,F
3189,BG,196,148,1610,90,1669,3190,1414,B
3189,CG,857,709,2319,1230,2750,3190,1462,G
3189,CH,767,58,2377,1105,2774,3190,1610,C
3189,DH,27,27,2404,3780,6554,3190,2377,D
3189,H,392,307,2711,3780,6530,3190,2319,H
3189,M,3853,3853,6564,4329,10883,3190,2711,M
3189,N,557,557,7121,90,10973,3190,6564,N
3189,O,1547,1547,8668,1855,12828,3190,7121,O
3189,P,6703,6703,15371,3780,16608,3190,8668,P
3190,A,6744,6744,6744,7302,7302,3191,0,A
3190,B,918,918,7662,420,7722,3191,6744,B
3190,C,725,725,8387,926,8648,3191,7662,C
3190,D,6318,6318,14705,414,9062,3191,8387,D
3190,M,1422,1422,16127,1509,10571,3191,14705,M
3190,N,273,273,16400,240,10811,3191,16127,N
3190,O,977,977,17377,850,11661,3191,16400,O
3190,N,1796,1796,19173,1915,13576,3191,17377,N
3190,O,89,89,19262,600,14176,3191,19173,O
3190,P,1954,1954,21216,3750,17926,3191,19262,P
3191,AEI,1548,1548,1548,2604,2604,3192,0,E
3191,AFI,1607,59,1607,6997,6997,3192,0,A
3191,BFI,1086,1027,2634,90,2694,3192,1548,F
3191,BGI,2677,43,2677,4058,4058,3192,0,I
3191,BGJ,722,679,3356,1230,3924,3192,2634,G
3191,BHJ,1436,757,4113,90,4148,3192,2677,J
3191,BHK,1375,618,4731,3780,7704,3192,3356,H
3191,BK,995,377,5108,1230,5378,3192,4113,K
3191,BL,41,41,5149,3780,9158,3192,5108,L
3191,B,5420,1878,7027,90,7087,3192,1607,B
3191,C,958,958,7985,1220,8307,3192,7027,C
3191,D,1501,1501,9486,3780,12087,3192,7985,D
3191,M,412,412,9898,1125,13212,3192,9486,M
3191,N,806,806,10704,90,13302,3192,9898,N
3191,O,192,192,10896,675,13977,3192,10704,O
3191,P,19138,19138,30034,3780,17757,3192,10896,P
3192,AEI,83,83,83,1749,1749,3193,0,E
3192,AFI,1585,1502,1585,1615,1615,3193,0,A
3192,BFI,1900,315,1900,2329,2329,3193,0,I
3192,BFJ,1857,40,1940,240,1989,3193,83,F
3192,BGJ,483,128,2068,420,2035,3193,1585,B
3192,CGJ,557,389,2457,180,2509,3193,1900,J
3192,CGK,556,167,2624,675,2710,3193,2068,C
3192,DGK,1173,489,3113,1140,3129,3193,1940,G
3192,DHK,937,281,3394,930,3439,3193,2457,K
3192,DHL,476,195,3589,550,3679,3193,3113,H
3192,DL,2139,1174,4763,550,3260,3193,2624,D
3192,L,2225,856,5619,550,3989,3193,3394,L
3192,M,6679,6679,12298,7534,11523,3193,5619,M
3192,N,917,917,13215,90,11613,3193,12298,N
3192,O,820,820,14035,1215,12828,3193,13215,O
3192,N,406,406,14441,10,12838,3193,14035,N
3192,O,584,584,15025,920,13758,3193,14441,O
3192,P,1249,1249,16274,3780,17538,3193,15025,P
3193,AEI,54,54,54,1036,1036,3194,0,I
3193,AEJ,1165,1165,1219,240,1276,3194,54,J
3193,AEK,808,808,2027,930,2206,3194,1219,K
3193,AEL,2081,54,2081,2882,2882,3194,0,E
3193,AFL,1355,1355,3436,420,3302,3194,2081,F
3193,AGL,903,903,4339,1282,4584,3194,3436,G
3193,AHL,4604,265,4604,4747,4747,3194,0,A
3193,BHL,161,161,4765,90,4837,3194,4604,B
3193,CHL,436,436,5201,820,5657,3194,4765,C
3193,BHL,585,585,5786,160,5817,3194,5201,B
3193,CHL,952,952,6738,1425,7242,3194,5786,C
3193,DHL,5444,733,7471,6990,9196,3194,2027,L
3193,DH,1019,286,7757,3780,11022,3194,6738,D
3193,H,6972,3554,11311,358,4942,3194,4339,H
3193,M,1762,1762,13073,2067,13089,3194,11311,M
3193,N,338,338,13411,90,13179,3194,13073,N
3193,O,1183,1183,14594,1510,14689,3194,13411,O
3193,P,46,46,14640,3780,18469,3194,14594,P
3194,A,14538,14538,14538,14854,14854,3195,0,A
3194,B,595,595,15133,300,15154,3195,14538,B
3194,C,561,561,15694,735,15889,3195,15133,C
3194,D,195,195,15889,1560,17449,3195,15694,D
3194,M,2809,2809,18698,1673,19122,3195,15889,M
3194,N,314,314,19012,1500,20622,3195,18698,N
3194,O,806,806,19818,995,21617,3195,19012,O
3194,N,1097,1097,20915,910,22527,3195,19818,N
3194,O,206,206,21121,300,22827,3195,20915,O
3194,P,650,650,21771,5100,27927,3195,21121,P
3195,AE,72,72,72,67,67,3196,0,E
3195,AF,120,120,192,150,217,3196,72,F
3195,AG,158,158,350,125,342,3196,192,G
3195,AF,680,330,680,1145,1145,3196,0,A
3195,BF,836,506,1186,890,1232,3196,350,F
3195,BG,576,70,1256,150,1295,3196,680,B
3195,CG,820,750,2006,645,1877,3196,1186,G
3195,CH,1451,701,2707,400,1695,3196,1256,C
3195,BH,266,266,2973,1295,2990,3196,2707,B
3195,CH,395,395,3368,650,3640,3196,2973,C
3195,DH,1726,1726,5094,4230,7870,3196,3368,D
3195,H,4258,1170,6264,4230,6107,3196,2006,H
3195,M,54,54,6318,1853,9723,3196,6264,M
3195,N,2389,2389,8707,650,10373,3196,6318,N
3195,O,800,800,9507,825,11198,3196,8707,O
3195,P,243,243,9750,550,11748,3196,9507,P
3196,A,14,14,14,146,146,3197,0,A
3196,B,325,325,339,240,386,3197,14,B
3196,C,787,787,1126,1035,1421,3197,339,C
3196,D,4,4,1130,3960,5381,3197,1126,D
3196,M,3616,3616,4746,4743,10124,3197,1130,M
3196,N,1178,1178,5924,90,10214,3197,4746,N
3196,O,186,186,6110,585,10799,3197,5924,O
3196,P,11818,11818,17928,3780,14579,3197,6110,P
3197,AEI,82,82,82,137,137,3198,0,I
3197,AEJ,141,59,141,143,143,3198,0,E
3197,AFJ,74,74,215,135,278,3198,141,F
3197,AFJ,133,0,215,135,272,3198,82,J
3197,AGK,210,210,425,285,563,3198,215,G
3197,AGK,210,0,425,295,567,3198,215,K
3197,AHL,123,123,548,5160,5727,3198,425,L
3197,AH,262,139,687,5160,5723,3198,425,H
3197,A,1296,609,1296,1478,1478,3198,0,A
3197,B,432,432,1728,240,1718,3198,1296,B
3197,C,770,770,2498,765,2483,3198,1728,C
3197,B,169,169,2667,295,2778,3198,2498,B
3197,C,879,879,3546,1260,4038,3198,2667,C
3197,D,289,289,3835,3960,7998,3198,3546,D
3197,M,674,674,4509,755,8753,3198,3835,M
3197,N,191,191,4700,150,8903,3198,4509,N
3197,O,37,37,4737,115,9018,3198,4700,O
3197,N,269,269,5006,210,9228,3198,4737,N
3197,O,135,135,5141,225,9453,3198,5006,O
3197,P,1048,1048,6189,4740,14193,3198,5141,P
3198,A,445,445,445,815,815,3199,0,A
3198,B,626,626,1071,300,1115,3199,445,B
3198,C,1082,1082,2153,1045,2160,3199,1071,C
3198,D,62,62,2215,1140,3300,3199,2153,D
3198,M,786,786,3001,1590,4890,3199,2215,M
3198,N,1080,1080,4081,300,5190,3199,3001,N
3198,O,643,643,4724,695,5885,3199,4081,O
3198,P,1861,1861,6585,1140,7025,3199,4724,P
3199,A,160,160,160,143,143,3200,0,A
3199,B,157,157,317,240,383,3200,160,B
3199,C,278,278,595,240,623,3200,317,C
3199,D,547,547,1142,5250,5873,3200,595,D
3199,M,1056,1056,2198,1764,7637,3200,1142,M
3199,N,1098,1098,3296,420,8057,3200,2198,N
3199,O,1037,1037,4333,1275,9332,3200,3296,O
3199,P,68,68,4401,555,9887,3200,4333,P
3200,AEI,50,50,50,1053,1053,3201,0,A
3200,BEI,163,113,163,291,291,3201,0,I
3200,BEJ,226,226,389,150,441,3201,163,J
3200,BEK,167,167,556,140,581,3201,389,K
3200,BEJ,1168,612,1168,1419,1419,3201,0,E
3200,BFJ,1209,91,1259,240,1293,3201,50,B
3200,CFJ,710,7,1266,720,1301,3201,556,J
3200,CFK,396,298,1564,210,1629,3201,1168,F
3200,CGK,122,122,1686,260,1889,3201,1564,G
3200,CFK,666,246,1932,690,1991,3201,1266,K
3200,CFL,822,149,2081,930,2223,3201,1259,C
3200,DFL,229,229,2310,6990,9213,3201,2081,D
3200,FL,1225,601,2911,1085,2974,3201,1686,F
3200,GL,830,830,3741,940,3914,3201,2911,G
3200,HL,12673,12673,16414,6990,10904,3201,3741,H
3200,L,34522,20040,36454,4230,6221,3201,1932,L
3200,M,21786,21786,58240,21851,32755,3201,36454,M
3200,N,354,354,58594,90,32845,3201,58240,N
3200,O,1150,1150,59744,1545,34390,3201,58594,O
3200,P,1055,1055,60799,3780,38170,3201,59744,P
3201,AE,142,142,142,220,220,3202,0,E
3201,AF,171,171,313,150,370,3202,142,F
3201,AG,190,190,503,155,525,3202,313,G
3201,AF,1174,1174,1677,1215,1740,3202,503,F
3201,AG,134,134,1811,285,2025,3202,1677,G
3201,AH,1854,43,1854,3258,3258,3202,0,A
3201,BH,1065,1022,2876,5100,7125,3202,1811,H
3201,B,1434,412,3288,90,3348,3202,1854,B
3201,C,526,526,3814,820,4168,3202,3288,C
3201,B,868,868,4682,575,4743,3202,3814,B
3201,C,761,761,5443,1240,5983,3202,4682,C
3201,D,3242,3242,8685,3780,9763,3202,5443,D
3201,M,230,230,8915,1290,11053,3202,8685,M
3201,N,1279,1279,10194,270,11323,3202,8915,N
3201,O,296,296,10490,315,11638,3202,10194,O
3201,P,942,942,11432,4140,15778,3202,10490,P
3202,A,152,152,152,146,146,3203,0,A
3202,B,174,174,326,240,386,3203,152,B
3202,C,197,197,523,285,671,3203,326,C
3202,D,2974,2974,3497,5160,5831,3203,523,D
3202,M,3460,3460,6957,4769,10600,3203,3497,M
3202,N,1460,1460,8417,180,10780,3203,6957,N
3202,O,821,821,9238,885,11665,3203,8417,O
3202,N,743,743,9981,690,12355,3203,9238,N
3202,O,561,561,10542,635,12990,3203,9981,O
3202,P,176,176,10718,6960,19950,3203,10542,P
3203,A,12,12,12,239,239,3204,0,A
3203,B,315,315,327,135,374,3204,12,B
3203,C,160,160,487,280,654,3204,327,C
3203,D,98,98,585,5160,5814,3204,487,D
3203,M,4981,4981,5566,7353,13167,3204,585,M
3203,N,2507,2507,8073,180,13347,3204,5566,N
3203,O,842,842,8915,885,14232,3204,8073,O
3203,N,505,505,9420,445,14677,3204,8915,N
3203,O,893,893,10313,1070,15747,3204,9420,O
3203,P,554,554,10867,6900,22647,3204,10313,P
3204,A,85,85,85,115,115,3205,0,A
3204,B,429,429,514,435,550,3205,85,B
3204,C,637,637,1151,585,1135,3205,514,C
3204,B,373,373,1524,415,1550,3205,1151,B
3204,C,221,221,1745,875,2425,3205,1524,C
3204,D,729,729,2474,1620,4045,3205,1745,D
3204,M,1750,1750,4224,2910,6955,3205,2474,M
3204,N,1348,1348,5572,240,7195,3205,4224,N
3204,O,692,692,6264,725,7920,3205,5572,O
3204,N,911,911,7175,920,8840,3205,6264,N
3204,O,383,383,7558,660,9500,3205,7175,O
3204,P,1884,1884,9442,3960,13460,3205,7558,P
3205,AE,486,486,486,1518,1518,3206,0,E
3205,AF,1028,542,1028,1437,1437,3206,0,A
3205,BF,1081,539,1567,90,1608,3206,486,F
3205,BG,544,5,1572,195,1632,3206,1028,B
3205,CG,759,759,2331,695,2327,3206,1572,C
3205,DG,824,60,2391,1300,2908,3206,1567,G
3205,DH,200,140,2531,385,2712,3206,2331,D
3205,H,1425,1285,3816,3780,6688,3206,2391,H
3205,M,1036,1036,4852,1908,8596,3206,3816,M
3205,N,1017,1017,5869,210,8806,3206,4852,N
3205,O,1118,1118,6987,977,9783,3206,5869,O
3205,P,355,355,7342,368,10151,3206,6987,P
3206,AEI,17,17,17,81,81,3207,0,A
3206,BEI,36,19,36,80,80,3207,0,E
3206,BFI,41,5,41,86,86,3207,0,I
3206,BFJ,140,116,157,135,216,3207,17,B
3206,CFJ,122,6,163,135,221,3207,41,J
3206,CFK,128,1,164,135,215,3207,36,F
3206,CGK,170,170,334,295,510,3207,164,G
3206,CHK,238,61,395,295,511,3207,157,C
3206,DHK,247,15,410,285,506,3207,163,K
3206,DHL,89,13,423,5160,5670,3207,334,H
3206,DL,116,88,511,5160,5671,3207,395,D
3206,L,166,65,576,5160,5666,3207,410,L
3206,M,29,29,605,778,6449,3207,576,M
3206,N,880,880,1485,180,6629,3207,605,N
3206,O,900,900,2385,885,7514,3207,1485,O
3206,N,311,311,2696,315,7829,3207,2385,N
3206,O,413,413,3109,540,8369,3207,2696,O
3206,P,2659,2659,5768,6960,15329,3207,3109,P
3207,A,471,471,471,477,477,3208,0,A
3207,B,217,217,688,240,717,3208,471,B
3207,C,531,531,1219,740,1457,3208,688,C
3207,D,820,820,2039,4020,5477,3208,1219,D
3207,M,15,15,2054,1500,6977,3208,2039,M
3207,N,1671,1671,3725,240,7217,3208,2054,N
3207,O,574,574,4299,745,7962,3208,3725,O
3207,N,538,538,4837,370,8332,3208,4299,N
3207,O,130,130,4967,90,8422,3208,4837,O
3207,P,4144,4144,9111,5060,13482,3208,4967,P
3208,A,22758,22758,22758,23234,23234,3209,0,A
3208,B,506,506,23264,90,23324,3209,22758,B
3208,C,2779,2779,26043,2354,25678,3209,23264,C
3208,D,1966,1966,28009,3780,29458,3209,26043,D
3208,M,1269,1269,29278,1849,31307,3209,28009,M
3208,N,611,611,29889,90,31397,3209,29278,N
3208,O,134,134,30023,585,31982,3209,29889,O
3208,P,3611,3611,33634,3780,35762,3209,30023,P
3209,AEI,397,397,397,645,645,3210,0,A
3209,BEI,739,342,739,1142,1142,3210,0,E
3209,BFI,368,26,765,180,825,3210,397,B
3209,CFI,523,497,1262,180,1322,3210,739,F
3209,CGI,1382,120,1382,1395,1395,3210,0,I
3209,CGJ,760,143,1525,765,1590,3210,765,C
3209,DGJ,193,50,1575,300,1695,3210,1382,J
3209,DGK,1109,796,2371,1045,2367,3210,1262,G
3209,DHK,891,95,2466,1020,2715,3210,1575,K
3209,DHJ,501,501,2967,270,2985,3210,2466,J
3209,DHK,883,287,3254,550,2917,3210,2371,H
3209,DK,601,314,3568,720,3705,3210,2967,K
3209,DL,3542,1499,5067,550,2140,3210,1525,D
3209,L,3889,2390,7457,3960,7665,3210,3568,L
3209,M,718,718,8175,1157,8822,3210,7457,M
3209,N,578,578,8753,180,9002,3210,8175,N
3209,O,179,179,8932,245,9247,3210,8753,O
3209,N,439,439,9371,380,9627,3210,8932,N
3209,O,485,485,9856,500,10127,3210,9371,O
3209,P,2275,2275,12131,6000,16127,3210,9856,P
3210,AEI,65,65,65,244,244,3211,0,A
3210,BEI,97,32,97,58,58,3211,0,E
3210,BFI,145,48,145,1005,1005,3211,0,I
3210,BFJ,141,93,238,240,298,3211,97,F
3210,BGJ,260,87,325,135,379,3211,65,B
3210,CGJ,224,137,462,290,588,3211,238,G
3210,CHJ,156,19,481,290,669,3211,325,C
3210,DHJ,202,202,683,5160,5829,3211,481,D
3210,HJ,989,451,1134,180,1185,3211,145,J
3210,HK,142,142,1276,310,1495,3211,1134,K
3210,HJ,313,313,1589,145,1640,3211,1276,J
3210,HK,1234,107,1696,5160,5748,3211,462,H
3210,K,693,586,2282,780,2420,3211,1589,K
3210,L,228,228,2510,1140,3560,3211,2282,L
3210,M,18686,18686,21196,18955,24784,3211,2510,M
3210,N,417,417,21613,180,24964,3211,21196,N
3210,O,697,697,22310,885,25849,3211,21613,O
3210,P,24310,24310,46620,6680,32529,3211,22310,P
3211,AEI,17,17,17,211,211,3212,0,A
3211,BEI,88,71,88,647,647,3212,0,I
3211,BEJ,414,343,431,240,451,3212,17,B
3211,CEJ,752,409,840,240,887,3212,88,J
3211,CEK,551,142,982,780,1231,3212,431,C
3211,DEK,148,6,988,385,1272,3212,840,K
3211,DEJ,117,111,1099,3960,5191,3212,982,D
3211,EJ,324,213,1312,65,1337,3212,988,J
3211,EK,523,523,1835,785,2122,3212,1312,K
3211,EL,937,937,2772,3960,6082,3212,1835,L
3211,E,5945,3173,5945,6005,6005,3212,0,E
3211,F,316,316,6261,300,6305,3212,5945,F
3211,G,723,723,6984,1035,7340,3212,6261,G
3211,F,351,351,7335,40,7380,3212,6984,F
3211,G,212,212,7547,1250,8630,3212,7335,G
3211,H,839,839,8386,1590,10220,3212,7547,H
3211,M,7058,7058,15444,7088,17308,3212,8386,M
3211,N,207,207,15651,240,17548,3212,15444,N
3211,O,748,748,16399,740,18288,3212,15651,O
3211,N,562,562,16961,545,18833,3212,16399,N
3211,O,236,236,17197,475,19308,3212,16961,O
3211,P,2403,2403,19600,3960,23268,3212,17197,P
3212,AEI,567,567,567,1110,1110,3213,0,I
3212,AEJ,663,663,1230,180,1290,3213,567,J
3212,AEK,1297,67,1297,1364,1364,3213,0,E
3212,AFK,367,367,1664,360,1724,3213,1297,F
3212,AGK,981,547,2211,930,2220,3213,1230,K
3212,AGL,749,202,2413,700,2424,3213,1664,G
3212,AHL,2797,384,2797,3448,3448,3213,0,A
3212,BHL,1361,977,3774,550,2974,3213,2413,H
3212,BL,1608,631,4405,1020,4468,3213,2797,B
3212,CL,2978,784,5189,550,2770,3213,2211,L
3212,C,787,3,5192,720,5188,3213,4405,C
3212,D,4033,4033,9225,550,5738,3213,5192,D
3212,M,708,708,9933,1608,7346,3213,9225,M
3212,N,1282,1282,11215,420,7766,3213,9933,N
3212,O,950,950,12165,1159,8925,3213,11215,O
3212,P,88,88,12253,341,9266,3213,12165,P
3213,AE,268,268,268,423,423,3214,0,E
3213,AF,264,264,532,180,603,3214,268,F
3213,AG,988,988,1520,935,1538,3214,532,G
3213,AH,832,832,2352,385,1923,3214,1520,H
3213,A,5614,3262,5614,5648,5648,3214,0,A
3213,B,227,227,5841,240,5888,3214,5614,B
3213,C,685,685,6526,835,6723,3214,5841,C
3213,B,666,666,7192,615,7338,3214,6526,B
3213,C,575,575,7767,810,8148,3214,7192,C
3213,D,541,541,8308,3960,12108,3214,7767,D
3213,M,922,922,9230,1150,13258,3214,8308,M
3213,N,490,490,9720,300,13558,3214,9230,N
3213,O,666,666,10386,780,14338,3214,9720,O
3213,P,1187,1187,11573,3960,18298,3214,10386,P
3214,AE,130,130,130,992,992,3215,0,E
3214,AF,397,267,397,902,902,3215,0,A
3214,BF,701,701,1098,240,1142,3215,397,B
3214,CF,1045,77,1175,240,1232,3215,130,F
3214,CG,698,621,1796,960,2102,3215,1098,C
3214,DG,783,162,1958,930,2162,3215,1175,G
3214,DH,360,198,2156,3960,6062,3215,1796,D
3214,H,28422,28224,30380,6990,9152,3215,1958,H
3214,M,125,125,30505,409,9561,3215,30380,M
3214,N,459,459,30964,240,9801,3215,30505,N
3214,O,935,935,31899,975,10776,3215,30964,O
3214,N,1142,1142,33041,1100,11876,3215,31899,N
3214,O,194,194,33235,225,12101,3215,33041,O
3214,P,4302,4302,37537,4740,16841,3215,33235,P
3215,A,3976,3976,3976,4142,4142,3216,0,A
3215,B,316,316,4292,210,4352,3216,3976,B
3215,C,391,391,4683,450,4802,3216,4292,C
3215,B,35,35,4718,89,4891,3216,4683,B
3215,C,927,927,5645,901,5792,3216,4718,C
3215,B,1409,1409,7054,1320,7112,3216,5645,B
3215,C,827,827,7881,890,8002,3216,7054,C
3215,D,202,202,8083,5160,13162,3216,7881,D
3215,M,346,346,8429,1272,14434,3216,8083,M
3215,N,1046,1046,9475,180,14614,3216,8429,N
3215,O,955,955,10430,1050,15664,3216,9475,O
3215,N,725,725,11155,625,16289,3216,10430,N
3215,O,206,206,11361,380,16669,3216,11155,O
3215,P,1257,1257,12618,5460,22129,3216,11361,P
3216,AEI,87,87,87,1086,1086,3217,0,I
3216,AEJ,113,26,113,827,827,3217,0,A
3216,BEJ,744,744,857,90,917,3217,113,B
3216,CEJ,237,237,1094,575,1492,3217,857,C
3216,DEJ,1044,37,1131,90,1176,3217,87,J
3216,DEK,185,148,1279,3780,5272,3217,1094,D
3216,EK,1061,913,2192,1210,2386,3217,1131,K
3216,EL,5,5,2197,3780,6166,3217,2192,L
3216,E,7064,4867,7064,7077,7077,3217,0,E
3216,F,196,196,7260,210,7287,3217,7064,F
3216,G,146,146,7406,215,7502,3217,7260,G
3216,F,547,547,7953,465,7967,3217,7406,F
3216,G,1134,1134,9087,1150,9117,3217,7953,G
3216,H,1055,1055,10142,370,9487,3217,9087,H
3216,M,2144,2144,12286,2732,12219,3217,10142,M
3216,N,631,631,12917,90,12309,3217,12286,N
3216,O,259,259,13176,695,13004,3217,12917,O
3216,P,4615,4615,17791,3780,16784,3217,13176,P
3217,AE,72,72,72,1024,1024,3218,0,E
3217,AF,464,392,464,656,656,3218,0,A
3217,BF,216,216,680,90,746,3218,464,B
3217,CF,985,377,1057,90,1114,3218,72,F
3217,CG,514,137,1194,905,1651,3218,680,C
3217,DG,240,240,1434,3780,5431,3218,1194,D
3217,G,906,529,1963,1220,2334,3218,1057,G
3217,H,44,44,2007,3780,6114,3218,1963,H
3217,M,4184,4184,6191,5024,11138,3218,2007,M
3217,N,871,871,7062,90,11228,3218,6191,N
3217,O,764,764,7826,1195,12423,3218,7062,O
3217,P,70,70,7896,3780,16203,3218,7826,P
3218,AE,910,910,910,2181,2181,3219,0,A
3218,BE,1546,636,1546,1604,1604,3219,0,E
3218,BF,238,238,1784,240,1844,3219,1546,F
3218,BG,841,841,2625,970,2814,3219,1784,G
3218,BF,2002,287,2912,780,2961,3219,910,B
3218,CF,582,295,3207,425,3239,3219,2625,F
3218,CG,720,425,3632,790,3751,3219,2912,C
3218,DG,512,87,3719,875,4114,3219,3207,G
3218,DH,1031,944,4663,1015,4766,3219,3632,D
3218,H,1147,203,4866,3960,8074,3219,3719,H
3218,M,2060,2060,6926,8987,17061,3219,4866,M
3218,N,2876,2876,9802,300,17361,3219,6926,N
3218,O,764,764,10566,820,18181,3219,9802,O
3218,P,109,109,10675,8355,26536,3219,10566,P
3219,A,162,162,162,164,164,3220,0,A
3219,B,239,239,401,240,404,3220,162,B
3219,C,260,260,661,245,649,3220,401,C
3219,D,458,458,1119,5250,5899,3220,661,D
3219,M,549,549,1668,2718,8617,3220,1119,M
3219,N,2537,2537,4205,420,9037,3220,1668,N
3219,O,613,613,4818,691,9728,3220,4205,O
3219,P,6566,6566,11384,609,10337,3220,4818,P
3220,AE,504,504,504,1292,1292,3221,0,E
3220,AF,529,25,529,1515,1515,3221,0,A
3220,BF,812,787,1316,90,1382,3221,504,F
3220,BG,1126,339,1655,90,1605,3221,529,B
3220,CG,395,395,2050,680,2285,3221,1655,C
3220,DG,771,37,2087,1060,2442,3221,1316,G
3220,DH,456,419,2506,3780,6065,3221,2050,D
3220,H,429,10,2516,3780,6222,3221,2087,H
3220,M,2912,2912,5428,3485,9707,3221,2516,M
3220,N,679,679,6107,90,9797,3221,5428,N
3220,O,791,791,6898,1135,10932,3221,6107,O
3220,N,678,678,7576,380,11312,3221,6898,N
3220,O,360,360,7936,790,12102,3221,7576,O
3220,P,882,882,8818,3780,15882,3221,7936,P
3221,AE,39,39,39,51,51,3222,0,E
3221,AF,106,106,145,135,186,3222,39,F
3221,AG,167,167,312,295,481,3222,145,G
3221,AH,57,57,369,5100,5581,3222,312,H
3221,A,3369,3000,3369,3686,3686,3222,0,A
3221,B,367,367,3736,90,3776,3222,3369,B
3221,C,1130,1130,4866,1425,5201,3222,3736,C
3221,D,561,561,5427,3780,8981,3222,4866,D
3221,M,1996,1996,7423,2753,11734,3222,5427,M
3221,N,848,848,8271,90,11824,3222,7423,N
3221,O,1028,1028,9299,1380,13204,3222,8271,O
3221,N,518,518,9817,220,13424,3222,9299,N
3221,O,426,426,10243,790,14214,3222,9817,O
3221,P,1762,1762,12005,3780,17994,3222,10243,P
3222,A,155,155,155,849,849,3223,0,A
3222,B,826,826,981,180,1029,3223,155,B
3222,C,197,197,1178,220,1249,3223,981,C
3222,B,688,688,1866,650,1899,3223,1178,B
3222,C,824,824,2690,860,2759,3223,1866,C
3222,D,280,280,2970,4140,6899,3223,2690,D
3222,M,355,355,3325,652,7551,3223,2970,M
3222,N,331,331,3656,90,7641,3223,3325,N
3222,O,1481,1481,5137,1935,9576,3223,3656,O
3222,P,2000,2000,7137,3780,13356,3223,5137,P
3223,A,4064,4064,4064,4175,4175,3224,0,A
3223,B,134,134,4198,90,4265,3224,4064,B
3223,C,854,854,5052,1105,5370,3224,4198,C
3223,D,121,121,5173,3780,9150,3224,5052,D
3223,M,184,184,5357,494,9644,3224,5173,M
3223,N,343,343,5700,90,9734,3224,5357,N
3223,O,600,600,6300,845,10579,3224,5700,O
3223,P,622,622,6922,3780,14359,3224,6300,P
3224,AEI,132,132,132,420,420,3225,0,E
3224,AFI,509,509,641,240,660,3225,132,F
3224,AGI,1097,456,1097,1514,1514,3225,0,A
3224,BGI,777,321,1418,785,1445,3225,641,G
3224,BHI,1485,67,1485,1595,1595,3225,0,I
3224,BHJ,537,149,1634,180,1694,3225,1097,B
3224,CHJ,359,210,1844,300,1895,3225,1485,J
3224,CHK,471,261,2105,740,2434,3225,1634,C
3224,BHK,741,54,2159,3960,5405,3225,1418,H
3224,BK,978,924,3083,700,3134,3225,2105,B
3224,CK,661,661,3744,650,3784,3225,3083,C
3224,DK,1396,1396,5140,5370,9154,3225,3744,D
3224,K,5303,2007,7147,835,2730,3225,1844,K
3224,L,21753,21753,28900,1140,3870,3225,7147,L
3224,M,1267,1267,30167,1376,10530,3225,28900,M
3224,N,380,380,30547,300,10830,3225,30167,N
3224,O,612,612,31159,775,11605,3225,30547,O
3224,P,2898,2898,34057,4080,15685,3225,31159,P
3225,AEI,61,61,61,237,237,3226,0,E
3225,AFI,85,24,85,257,257,3226,0,A
3225,BFI,102,17,102,114,114,3226,0,I
3225,BFJ,89,89,191,135,249,3226,102,J
3225,BFK,251,121,312,135,372,3226,61,F
3225,BGK,248,21,333,135,392,3226,85,B
3225,CGK,262,120,453,295,544,3226,191,K
3225,CGL,201,81,534,290,682,3226,333,C
3225,DGL,92,11,545,5160,5704,3226,453,L
3225,DG,59,48,593,5160,5842,3226,534,D
3225,G,320,39,632,280,652,3226,312,G
3225,H,120,120,752,5160,5812,3226,632,H
3225,M,619,619,1371,813,6655,3226,752,M
3225,N,287,287,1658,150,6805,3226,1371,N
3225,O,39,39,1697,100,6905,3226,1658,O
3225,N,463,463,2160,385,7290,3226,1697,N
3225,O,182,182,2342,225,7515,3226,2160,O
3225,P,930,930,3272,4740,12255,3226,2342,P
3226,A,17,17,17,971,971,3227,0,A
3226,B,989,989,1006,90,1061,3227,17,B
3226,C,818,818,1824,1220,2281,3227,1006,C
3226,D,156,156,1980,3780,6061,3227,1824,D
3226,M,3711,3711,5691,4728,10789,3227,1980,M
3226,N,1068,1068,6759,90,10879,3227,5691,N
3226,O,192,192,6951,585,11464,3227,6759,O
3226,P,7218,7218,14169,3780,15244,3227,6951,P
3227,AE,39,39,39,1042,1042,3228,0,A
3227,BE,450,411,450,1862,1862,3228,0,E
3227,BF,1033,622,1072,90,1132,3228,39,B
3227,CF,1438,816,1888,90,1952,3228,450,F
3227,CG,1009,193,2081,1210,2342,3228,1072,C
3227,DG,2,2,2083,3780,6122,3228,2081,D
3227,G,1287,1092,3175,1435,3387,3228,1888,G
3227,H,104,104,3279,3780,7167,3228,3175,H
3227,M,2799,2799,6078,3251,10418,3228,3279,M
3227,N,480,480,6558,90,10508,3228,6078,N
3227,O,210,210,6768,625,11133,3228,6558,O
3227,P,5962,5962,12730,3780,14913,3228,6768,P
3228,A,162,162,162,407,407,3229,0,A
3228,B,362,362,524,180,587,3229,162,B
3228,C,618,618,1142,855,1442,3229,524,C
3228,B,377,377,1519,240,1682,3229,1142,B
3228,C,547,547,2066,600,2282,3229,1519,C
3228,D,5045,5045,7111,5250,7532,3229,2066,D
3228,M,274,274,7385,979,8511,3229,7111,M
3228,N,1167,1167,8552,420,8931,3229,7385,N
3228,O,972,972,9524,1190,10121,3229,8552,O
3228,P,1137,1137,10661,665,10786,3229,9524,P
3229,AE,1609,1609,1609,1619,1619,3230,0,A
3229,BE,310,310,1919,360,1979,3230,1609,B
3229,CE,2262,343,2262,2441,2441,3230,0,E
3229,CF,339,339,2601,180,2621,3230,2262,F
3229,CG,699,17,2618,880,2859,3230,1919,C
3229,BG,923,906,3524,1200,3821,3230,2601,G
3229,BF,1308,1308,4832,1030,4851,3230,3524,F
3229,BG,2312,98,4930,2120,4979,3230,2618,B
3229,CG,767,669,5599,2049,6900,3230,4832,G
3229,CH,835,166,5765,2337,7316,3230,4930,C
3229,DH,1074,908,6673,846,7746,3230,5599,H
3229,D,939,31,6704,1194,8510,3230,5765,D
3229,M,1252,1252,7956,1664,10174,3230,6704,M
3229,N,892,892,8848,600,10774,3230,7956,N
3229,O,1323,1323,10171,1220,11994,3230,8848,O
3229,P,210,210,10381,385,12379,3230,10171,P
3230,AE,269,269,269,1338,1338,3231,0,A
3230,BE,1282,1013,1282,2469,2469,3231,0,E
3230,BF,1254,241,1523,240,1578,3231,269,B
3230,CF,723,723,2246,760,2338,3231,1523,C
3230,DF,1375,411,2657,240,2709,3231,1282,F
3230,DG,786,375,3032,7680,10018,3231,2246,D
3230,G,730,355,3387,780,3489,3231,2657,G
3230,H,786,786,4173,7680,11169,3231,3387,H
3230,M,635,635,4808,1205,12374,3231,4173,M
3230,N,844,844,5652,300,12674,3231,4808,N
3230,O,898,898,6550,905,13579,3231,5652,O
3230,P,3948,3948,10498,2760,16339,3231,6550,P
3231,A,134,134,134,169,169,3232,0,A
3231,B,142,142,276,150,319,3232,134,B
3231,C,639,639,915,765,1084,3232,276,C
3231,D,447,447,1362,3600,4684,3232,915,D
3231,M,449,449,1811,930,5614,3232,1362,M
3231,N,591,591,2402,150,5764,3232,1811,N
3231,O,214,214,2616,140,5904,3232,2402,O
3231,N,264,264,2880,340,6244,3232,2616,N
3231,O,550,550,3430,815,7059,3232,2880,O
3231,P,2015,2015,5445,3840,10899,3232,3430,P
3232,AE,92,92,92,1172,1172,3233,0,E
3232,AF,456,364,456,953,953,3233,0,A
3232,BF,534,534,990,90,1043,3233,456,B
3232,CF,1109,211,1201,90,1262,3233,92,F
3232,CG,397,186,1387,710,1753,3233,990,C
3232,DG,44,44,1431,3780,5533,3233,1387,D
3232,G,944,714,2145,1210,2472,3233,1201,G
3232,H,30,30,2175,3780,6252,3233,2145,H
3232,M,652,652,2827,1338,7590,3233,2175,M
3232,N,717,717,3544,90,7680,3233,2827,N
3232,O,162,162,3706,605,8285,3233,3544,O
3232,P,8909,8909,12615,3780,12065,3233,3706,P
3233,AE,75,75,75,3129,3129,3234,0,E
3233,AF,78,3,78,151,151,3234,0,A
3233,BF,433,433,511,420,571,3234,78,B
3233,CF,917,917,1428,890,1461,3234,511,C
3233,DF,506,506,1934,550,2011,3234,1428,D
3233,F,3242,1383,3317,240,3369,3234,75,F
3233,G,964,964,4281,930,4299,3234,3317,G
3233,H,2849,2849,7130,550,4849,3234,4281,H
3233,M,331,331,7461,896,5745,3234,7130,M
3233,N,924,924,8385,420,6165,3234,7461,N
3233,O,1385,1385,9770,666,6831,3234,8385,O
3233,P,4289,4289,14059,1114,7945,3234,9770,P
3234,AEI,139,139,139,196,196,3235,0,A
3234,BEI,157,157,296,150,346,3235,139,B
3234,CEI,129,129,425,135,481,3235,296,C
3234,BEI,880,455,880,1070,1070,3235,0,I
3234,BEJ,392,392,1272,240,1310,3235,880,J
3234,BEK,1108,261,1533,1075,1556,3235,425,B
3234,CEK,331,70,1603,915,2225,3235,1272,K
3234,CEL,341,271,1874,645,2201,3235,1533,C
3234,DEL,3323,1449,3323,4160,4160,3235,0,E
3234,DFL,953,953,4276,660,4820,3235,3323,F
3234,DGL,1389,1389,5665,1861,6681,3235,4276,G
3234,DFL,4738,676,6341,3960,6185,3235,1603,L
3234,DF,3122,2446,8787,704,7385,3235,5665,F
3234,DG,323,323,9110,915,8300,3235,8787,G
3234,DH,7290,54,9164,4230,6431,3235,1874,D
3234,H,3412,3358,12522,3960,12260,3235,9110,H
3234,M,1369,1369,13891,3091,15351,3235,12522,M
3234,N,2003,2003,15894,300,15651,3235,13891,N
3234,O,525,525,16419,1215,16866,3235,15894,O
3234,N,2014,2014,18433,1355,18221,3235,16419,N
3234,O,1120,1120,19553,805,19026,3235,18433,O
3234,P,1158,1158,20711,9480,28506,3235,19553,P
3235,AEI,102,102,102,209,209,3236,0,I
3235,AEJ,103,1,103,697,697,3236,0,A
3235,BEJ,118,15,118,48,48,3236,0,E
3235,BFJ,117,117,235,240,288,3236,118,F
3235,BGJ,222,89,324,150,359,3236,102,J
3235,BGK,786,565,889,240,937,3236,103,B
3235,CGK,662,8,897,765,1053,3236,235,G
3235,CHK,606,33,930,765,1124,3236,324,K
3235,CHL,135,102,1032,3600,4653,3236,897,H
3235,CL,377,234,1266,255,1192,3236,889,C
3235,DL,3002,3002,4268,5160,6352,3236,1266,D
3235,L,4449,1111,5379,3600,4724,3236,930,L
3235,M,171,171,5550,815,7167,3236,5379,M
3235,N,747,747,6297,150,7317,3236,5550,N
3235,O,168,168,6465,140,7457,3236,6297,O
3235,N,314,314,6779,340,7797,3236,6465,N
3235,O,571,571,7350,815,8612,3236,6779,O
3235,P,2478,2478,9828,3840,12452,3236,7350,P
3236,A,129,129,129,347,347,3237,0,A
3236,B,377,377,506,180,527,3237,129,B
3236,C,639,639,1145,683,1210,3237,506,C
3236,D,12580,12580,13725,4080,5290,3237,1145,D
3236,M,453,453,14178,1471,6761,3237,13725,M
3236,N,1394,1394,15572,420,7181,3237,14178,N
3236,O,743,743,16315,840,8021,3237,15572,O
3236,P,3325,3325,19640,350,8371,3237,16315,P
3237,AEI,167,167,167,156,156,3238,0,A
3237,BEI,181,14,181,1163,1163,3238,0,I
3237,BEJ,75,61,242,150,306,3238,167,B
3237,CEJ,112,112,354,100,406,3238,242,C
3237,BEJ,313,313,667,295,701,3238,354,B
3237,CEJ,1012,526,1193,90,1253,3238,181,J
3237,CEK,863,337,1530,775,1476,3238,667,C
3237,DEK,169,169,1699,4230,5706,3238,1530,D
3237,EK,1058,552,2251,1220,2473,3238,1193,K
3237,EL,194,194,2445,3780,6253,3238,2251,L
3237,E,16609,14164,16609,17927,17927,3238,0,E
3237,F,1381,1381,17990,90,18017,3238,16609,F
3237,G,1384,1384,19374,1635,19652,3238,17990,G
3237,H,412,412,19786,3780,23432,3238,19374,H
3237,M,3336,3336,23122,3896,27328,3238,19786,M
3237,N,610,610,23732,90,27418,3238,23122,N
3237,O,234,234,23966,695,28113,3238,23732,O
3237,P,4393,4393,28359,3780,31893,3238,23966,P
3238,AE,321,321,321,1925,1925,3239,0,A
3238,BE,1937,1616,1937,2663,2663,3239,0,E
3238,BF,2038,422,2359,480,2405,3239,321,B
3238,CF,855,855,3214,890,3295,3239,2359,C
3238,DF,1434,157,3371,180,2843,3239,1937,F
3238,DG,1188,1188,4559,890,3733,3239,3371,G
3238,DH,1441,1441,6000,550,4283,3239,4559,H
3238,D,4288,1502,7502,550,3845,3239,3214,D
3238,M,482,482,7984,1047,5330,3239,7502,M
3238,N,927,927,8911,420,5750,3239,7984,N
3238,O,1168,1168,10079,1220,6970,3239,8911,O
3238,P,670,670,10749,635,7605,3239,10079,P
3239,A,7,7,7,188,188,3240,0,A
3239,B,261,261,268,135,323,3240,7,B
3239,C,131,131,399,280,603,3240,268,C
3239,D,346,346,745,5160,5763,3240,399,D
3239,M,2374,2374,3119,1602,7365,3240,745,M
3239,N,434,434,3553,180,7545,3240,3119,N
3239,O,641,641,4194,885,8430,3240,3553,O
3239,P,10723,10723,14917,6680,15110,3240,4194,P
3240,AEI,487,487,487,1061,1061,3241,0,E
3240,AFI,490,3,490,1064,1064,3241,0,A
3240,BFI,1024,534,1024,1529,1529,3241,0,I
3240,BFJ,664,127,1151,150,1211,3241,487,F
3240,BGJ,664,3,1154,150,1214,3241,490,B
3240,CGJ,121,118,1272,140,1351,3241,1151,G
3240,CHJ,122,4,1276,140,1354,3241,1154,C
3240,DHJ,165,161,1437,2900,4251,3241,1272,H
3240,DJ,165,4,1441,2900,4254,3241,1276,D
3240,J,453,36,1477,180,1709,3241,1024,J
3240,K,723,723,2200,1265,2974,3241,1477,K
3240,J,955,955,3155,60,3034,3241,2200,J
3240,K,606,606,3761,1050,4084,3241,3155,K
3240,L,295,295,4056,3780,7864,3241,3761,L
3240,M,345,345,4401,483,8347,3241,4056,M
3240,N,186,186,4587,110,8457,3241,4401,N
3240,O,205,205,4792,280,8737,3241,4587,O
3240,P,62,62,4854,5160,13897,3241,4792,P
3241,A,82,82,82,300,300,3242,0,A
3241,B,300,300,382,135,435,3242,82,B
3241,C,223,223,605,285,720,3242,382,C
3241,D,158,158,763,5160,5880,3242,605,D
3241,M,879,879,1642,4021,9901,3242,763,M
3241,N,3283,3283,4925,180,10081,3242,1642,N
3241,O,875,875,5800,885,10966,3242,4925,O
3241,N,354,354,6154,365,11331,3242,5800,N
3241,O,467,467,6621,360,11691,3242,6154,O
3241,P,1512,1512,8133,7020,18711,3242,6621,P
3242,AEI,69,69,69,84,84,3243,0,E
3242,AFI,109,40,109,203,203,3243,0,I
3242,AFJ,157,48,157,336,336,3243,0,A
3242,BFJ,193,105,262,240,324,3243,69,F
3242,BGJ,284,131,393,250,453,3243,109,J
3242,BGK,289,53,446,170,506,3243,157,B
3242,CGK,492,308,754,240,564,3243,262,G
3242,CHK,385,385,1139,5250,5814,3243,754,H
3242,CK,1068,375,1514,650,1156,3243,446,C
3242,DK,1382,261,1775,1390,1843,3243,393,K
3242,DL,842,842,2617,550,2393,3243,1775,L
3242,D,4175,3072,5689,385,1541,3243,1514,D
3242,M,238,238,5927,314,6128,3243,5689,M
3242,N,303,303,6230,270,6398,3243,5927,N
3242,O,1158,1158,7388,1175,7573,3243,6230,O
3242,P,3544,3544,10932,335,7908,3243,7388,P
3243,AE,303,303,303,1092,1092,3244,0,A
3243,BE,852,852,1155,90,1182,3244,303,B
3243,CE,1386,231,1386,1770,1770,3244,0,E
3243,CF,430,430,1816,90,1860,3244,1386,F
3243,CG,891,230,2046,1230,2412,3244,1155,C
3243,BG,394,164,2210,805,2665,3244,1816,G
3243,BH,1065,1065,3275,3780,6445,3244,2210,H
3243,B,4949,3720,6995,4630,7042,3244,2046,B
3243,C,397,397,7392,805,7847,3244,6995,C
3243,D,2385,2385,9777,3780,11627,3244,7392,D
3243,M,1829,1829,11606,2044,13671,3244,9777,M
3243,N,237,237,11843,90,13761,3244,11606,N
3243,O,609,609,12452,815,14576,3244,11843,O
3243,N,901,901,13353,680,15256,3244,12452,N
3243,O,1403,1403,14756,2315,17571,3244,13353,O
3243,P,5821,5821,20577,3420,20991,3244,14756,P
3244,AE,16,16,16,158,158,3245,0,E
3244,AF,136,120,136,324,324,3245,0,A
3244,BF,232,112,248,150,308,3245,16,F
3244,BG,176,176,424,110,418,3245,248,G
3244,BH,298,10,434,180,504,3245,136,B
3244,CH,534,534,968,505,1009,3245,434,C
3244,DH,84,84,1052,2880,3889,3245,968,D
3244,H,2421,1793,2845,4230,4648,3245,424,H
3244,M,273,273,3118,886,5534,3245,2845,M
3244,N,711,711,3829,150,5684,3245,3118,N
3244,O,169,169,3998,115,5799,3245,3829,O
3244,N,761,761,4759,770,6569,3245,3998,N
3244,O,949,949,5708,960,7529,3245,4759,O
3244,P,1178,1178,6886,4230,11759,3245,5708,P
3245,AE,268,268,268,799,799,3246,0,E
3245,AF,858,858,1126,300,1099,3246,268,F
3245,AG,1727,601,1727,2204,2204,3246,0,A
3245,BG,756,155,1882,805,1904,3246,1126,G
3245,BH,580,425,2307,150,2354,3246,1727,B
3245,CH,130,130,2437,120,2474,3246,2307,C
3245,BH,539,539,2976,550,3024,3246,2437,B
3245,CH,527,527,3503,510,3534,3246,2976,C
3245,DH,2348,727,4230,3960,5864,3246,1882,H
3245,D,736,9,4239,4230,7764,3246,3503,D
3245,M,1575,1575,5814,1845,9609,3246,4239,M
3245,N,846,846,6660,610,10219,3246,5814,N
3245,O,383,383,7043,455,10674,3246,6660,O
3245,N,1316,1316,8359,1210,11884,3246,7043,N
3245,O,4595,4595,12954,1380,13264,3246,8359,O
3245,P,25620,25620,38574,3000,16264,3246,12954,P
3246,A,67,67,67,290,290,3247,0,A
3246,B,383,383,450,150,440,3247,67,B
3246,C,260,260,710,450,890,3247,450,C
3246,B,172,172,882,50,940,3247,710,B
3246,C,116,116,998,100,1040,3247,882,C
3246,D,106,106,1104,2880,3920,3247,998,D
3246,M,113,113,1217,187,4107,3247,1104,M
3246,N,181,181,1398,150,4257,3247,1217,N
3246,O,169,169,1567,150,4407,3247,1398,O
3246,N,733,733,2300,760,5167,3247,1567,N
3246,O,164,164,2464,110,5277,3247,2300,O
3246,P,203,203,2667,4230,9507,3247,2464,P
3247,AEI,51,51,51,854,854,3248,0,I
3247,AEJ,502,451,502,1371,1371,3248,0,A
3247,BEJ,1016,565,1067,240,1094,3248,51,J
3247,BEK,898,333,1400,90,1461,3248,502,B
3247,CEK,338,5,1405,915,2009,3248,1067,K
3247,CEL,700,695,2100,905,2366,3248,1400,C
3247,BEL,297,297,2397,90,2456,3248,2100,B
3247,CEL,2866,469,2866,2977,2977,3248,0,E
3247,CFL,411,411,3277,360,3337,3248,2866,F
3247,CGL,1925,53,3330,3960,5969,3248,1405,L
3247,CG,470,417,3747,695,4032,3248,3277,G
3247,CF,1514,164,3911,2320,4776,3248,2397,C
3247,DF,881,717,4628,655,4687,3248,3747,F
3247,DG,1456,739,5367,3420,8196,3248,3911,D
3247,G,757,18,5385,1016,5703,3248,4628,G
3247,H,2137,2137,7522,414,6117,3248,5385,H
3247,M,1144,1144,8666,1269,9465,3248,7522,M
3247,N,245,245,8911,180,9645,3248,8666,N
3247,O,1310,1310,10221,935,10580,3248,8911,O
3247,P,476,476,10697,660,11240,3248,10221,P
3248,AE,1183,1183,1183,1754,1754,3249,0,E
3248,AF,711,711,1894,90,1844,3249,1183,F
3248,AG,1386,1386,3280,1780,3624,3249,1894,G
3248,AH,107,107,3387,3780,7404,3249,3280,H
3248,A,4408,1021,4408,4732,4732,3249,0,A
3248,B,439,439,4847,180,4912,3249,4408,B
3248,C,985,985,5832,1240,6152,3249,4847,C
3248,B,2169,2169,8001,1855,8007,3249,5832,B
3248,C,701,701,8702,720,8727,3249,8001,C
3248,D,7,7,8709,6900,15627,3249,8702,D
3248,M,2067,2067,10776,2683,18310,3249,8709,M
3248,N,665,665,11441,90,18400,3249,10776,N
3248,O,189,189,11630,605,19005,3249,11441,O
3248,P,11685,11685,23315,3780,22785,3249,11630,P
3249,AE,900,900,900,1397,1397,3250,0,E
3249,AF,1326,426,1326,1870,1870,3250,0,A
3249,BF,758,332,1658,300,1697,3250,900,F
3249,BG,600,268,1926,90,1960,3250,1326,B
3249,CG,531,263,2189,695,2392,3250,1658,G
3249,CH,1045,1045,3234,4080,6472,3250,2189,H
3249,C,1362,54,3288,1865,3825,3250,1926,C
3249,D,3077,3077,6365,3780,7605,3250,3288,D
3249,M,320,320,6685,361,7966,3250,6365,M
3249,N,156,156,6841,180,8146,3250,6685,N
3249,O,1075,1075,7916,1250,9396,3250,6841,O
3249,P,45,45,7961,6680,16076,3250,7916,P
3250,AEI,131,131,131,1258,1258,3251,0,A
3250,BEI,413,282,413,753,753,3251,0,I
3250,BEJ,361,361,774,90,843,3251,413,J
3250,BEK,1161,518,1292,90,1348,3251,131,B
3250,CEK,531,13,1305,880,1723,3251,774,K
3250,CEL,207,207,1512,3780,5503,3251,1305,L
3250,CE,1045,825,2337,1210,2558,3251,1292,C
3250,DE,38,38,2375,3780,6338,3251,2337,D
3250,E,36959,34584,36959,37992,37992,3251,0,E
3250,F,1063,1063,38022,90,38082,3251,36959,F
3250,G,1000,1000,39022,1210,39292,3251,38022,G
3250,H,9,9,39031,3780,43072,3251,39022,H
3250,M,787,787,39818,1288,44360,3251,39031,M
3250,N,548,548,40366,90,44450,3251,39818,N
3250,O,228,228,40594,625,45075,3251,40366,O
3250,P,5925,5925,46519,3780,48855,3251,40594,P
3251,A,2082,2082,2082,2510,2510,3252,0,A
3251,B,694,694,2776,300,2810,3252,2082,B
3251,C,697,697,3473,805,3615,3252,2776,C
3251,D,706,706,4179,3960,7575,3252,3473,D
3251,M,1396,1396,5575,1459,9034,3252,4179,M
3251,N,172,172,5747,150,9184,3252,5575,N
3251,O,488,488,6235,455,9639,3252,5747,O
3251,N,351,351,6586,375,10014,3252,6235,N
3251,O,618,618,7204,770,10784,3252,6586,O
3251,P,3410,3410,10614,3960,14744,3252,7204,P
3252,A,3443,3443,3443,4006,4006,3253,0,A
3252,B,623,623,4066,120,4126,3253,3443,B
3252,C,1035,1035,5101,1020,5146,3253,4066,C
3252,D,321,321,5422,550,5696,3253,5101,D
3252,M,714,714,6136,2768,8464,3253,5422,M
3252,N,2174,2174,8310,180,8644,3253,6136,N
3252,O,934,934,9244,830,9474,3253,8310,O
3252,N,746,746,9990,850,10324,3253,9244,N
3252,O,535,535,10525,270,10594,3253,9990,O
3252,P,1823,1823,12348,7020,17614,3253,10525,P
3253,A,124,124,124,228,228,3254,0,A
3253,B,200,200,324,150,378,3254,124,B
3253,C,150,150,474,155,533,3254,324,C
3253,B,870,870,1344,830,1363,3254,474,B
3253,C,125,125,1469,125,1488,3254,1344,C
3253,D,278,278,1747,4230,5718,3254,1469,D
3253,M,201,201,1948,772,6490,3254,1747,M
3253,N,764,764,2712,240,6730,3254,1948,N
3253,O,241,241,2953,400,7130,3254,2712,O
3253,N,1662,1662,4615,1500,8630,3254,2953,N
3253,O,737,737,5352,970,9600,3254,4615,O
3253,P,1624,1624,6976,3960,13560,3254,5352,P
3254,A,99,99,99,131,131,3255,0,A
3254,B,152,152,251,180,311,3255,99,B
3254,C,754,754,1005,685,996,3255,251,C
3254,B,864,864,1869,915,1911,3255,1005,B
3254,C,385,385,2254,255,2166,3255,1869,C
3254,D,1495,1495,3749,5160,7326,3255,2254,D
3254,M,996,996,4745,984,8310,3255,3749,M
3254,N,111,111,4856,150,8460,3255,4745,N
3254,O,176,176,5032,140,8600,3255,4856,O
3254,N,1285,1285,6317,1335,9935,3255,5032,N
3254,O,1243,1243,7560,1290,11225,3255,6317,O
3254,P,8827,8827,16387,3720,14945,3255,7560,P
3255,A,138,138,138,1098,1098,3256,0,A
3255,B,993,993,1131,90,1188,3256,138,B
3255,C,1043,1043,2174,1220,2408,3256,1131,C
3255,D,5,5,2179,3780,6188,3256,2174,D
3255,M,907,907,3086,1312,7500,3256,2179,M
3255,N,474,474,3560,90,7590,3256,3086,N
3255,O,594,594,4154,930,8520,3256,3560,O
3255,P,922,922,5076,3780,12300,3256,4154,P
3256,AE,91,91,91,1012,1012,3257,0,A
3256,BE,311,220,311,488,488,3257,0,E
3256,BF,219,219,530,90,578,3257,311,F
3256,BG,950,511,1041,90,1102,3257,91,B
3256,CG,538,27,1068,880,1458,3257,530,G
3256,CH,300,300,1368,3780,5238,3257,1068,H
3256,C,1008,681,2049,1220,2322,3257,1041,C
3256,D,36,36,2085,3780,6102,3257,2049,D
3256,M,459,459,2544,1072,7174,3257,2085,M
3256,N,651,651,3195,90,7264,3257,2544,N
3256,O,263,263,3458,605,7869,3257,3195,O
3256,P,17323,17323,20781,3780,11649,3257,3458,P
3257,A,626,626,626,1169,1169,3258,0,A
3257,B,567,567,1193,90,1259,3258,626,B
3257,C,217,217,1410,625,1884,3258,1193,C
3257,D,4639,4639,6049,3780,5664,3258,1410,D
3257,M,1768,1768,7817,1990,7654,3258,6049,M
3257,N,253,253,8070,90,7744,3258,7817,N
3257,O,514,514,8584,620,8364,3258,8070,O
3257,N,2181,2181,10765,1915,10279,3258,8584,N
3257,O,603,603,11368,915,11194,3258,10765,O
3257,P,1207,1207,12575,3780,14974,3258,11368,P
3258,AEI,72,72,72,60,60,3259,0,I
3258,AEJ,126,54,126,86,86,3259,0,E
3258,AFJ,105,51,177,180,240,3259,72,J
3258,AFK,80,29,206,180,266,3259,126,F
3258,AGK,190,161,367,335,575,3259,177,K
3258,AGJ,206,45,412,335,601,3259,206,G
3258,AFJ,570,158,570,265,265,3259,0,A
3258,BFJ,609,609,1179,960,1225,3259,570,B
3258,CFJ,1223,411,1590,1065,1640,3259,367,J
3258,CFK,1197,19,1609,1065,1666,3259,412,F
3258,CGK,643,213,1822,585,1810,3259,1179,C
3258,BGK,506,274,2096,540,2180,3259,1590,K
3258,BGJ,547,60,2156,540,2206,3259,1609,G
3258,BFJ,154,94,2250,130,2310,3259,2096,J
3258,BFK,120,26,2276,130,2336,3259,2156,F
3258,BGK,999,545,2821,1055,2865,3259,1822,B
3258,CGK,218,218,3039,1480,4345,3259,2821,C
3258,DGK,965,202,3241,1200,3536,3259,2276,G
3258,DHK,1023,32,3273,1200,3510,3259,2250,K
3258,DHL,266,234,3507,5160,8696,3259,3241,H
3258,DL,1078,610,4117,1590,5935,3259,3039,D
3258,L,3092,2248,6365,5160,8670,3259,3273,L
3258,M,1709,1709,8074,1770,10466,3259,6365,M
3258,N,635,635,8709,610,11076,3259,8074,N
3258,O,365,365,9074,455,11531,3259,8709,O
3258,N,1294,1294,10368,1210,12741,3259,9074,N
3258,O,4568,4568,14936,1625,14366,3259,10368,O
3258,P,21369,21369,36305,2755,17121,3259,14936,P
3259,AEI,143,143,143,1224,1224,3260,0,E
3259,AFI,1110,1110,1253,90,1314,3260,143,F
3259,AGI,943,943,2196,1210,2524,3260,1253,G
3259,AHI,169,169,2365,3780,6304,3260,2196,H
3259,AI,3328,963,3328,3812,3812,3260,0,I
3259,AJ,3358,30,3358,4575,4575,3260,0,A
3259,BJ,514,484,3842,90,3902,3260,3328,J
3259,BK,615,615,4457,815,4717,3260,3842,K
3259,BL,1244,145,4602,90,4665,3260,3358,B
3259,CL,405,260,4862,3780,8497,3260,4457,L
3259,C,1117,857,5719,1405,6070,3260,4602,C
3259,D,632,632,6351,3780,9850,3260,5719,D
3259,M,1693,1693,8044,1972,11822,3260,6351,M
3259,N,308,308,8352,90,11912,3260,8044,N
3259,O,743,743,9095,1060,12972,3260,8352,O
3259,P,16,16,9111,3780,16752,3260,9095,P
3260,A,1302,1302,1302,1851,1851,3261,0,A
3260,B,578,578,1880,90,1941,3261,1302,B
3260,C,850,850,2730,1240,3181,3261,1880,C
3260,D,4751,4751,7481,3840,7021,3261,2730,D
3260,M,3264,3264,10745,4027,11048,3261,7481,M
3260,N,793,793,11538,90,11138,3261,10745,N
3260,O,831,831,12369,1200,12338,3261,11538,O
3260,N,777,777,13146,400,12738,3261,12369,N
3260,O,502,502,13648,815,13553,3261,13146,O
3260,P,5100,5100,18748,3780,17333,3261,13648,P
3261,AE,125,125,125,964,964,3262,0,A
3261,BE,285,160,285,1274,1274,3262,0,E
3261,BF,936,776,1061,150,1114,3262,125,B
3261,CF,159,159,1220,160,1274,3262,1061,C
3261,BF,1036,101,1321,90,1364,3262,285,F
3261,BG,535,434,1755,520,1794,3262,1220,B
3261,CG,1105,671,2426,1210,2574,3262,1321,G
3261,CH,843,172,2598,825,2619,3262,1755,C
3261,DH,377,205,2803,3780,6354,3262,2426,H
3261,D,1420,1215,4018,4170,6789,3262,2598,D
3261,M,3312,3312,7330,3930,10719,3262,4018,M
3261,N,657,657,7987,90,10809,3262,7330,N
3261,O,239,239,8226,695,11504,3262,7987,O
3261,P,3049,3049,11275,3780,15284,3262,8226,P
3262,AE,92,92,92,125,125,3263,0,A
3262,BE,137,45,137,240,240,3263,0,E
3262,BF,264,264,401,180,420,3263,137,F
3262,BG,540,231,632,570,695,3263,92,B
3262,CG,196,196,828,115,810,3263,632,C
3262,DG,658,658,1486,2880,3690,3263,828,D
3262,G,2322,1237,2723,545,965,3263,401,G
3262,H,105,105,2828,2790,3755,3263,2723,H
3262,M,39,39,2867,59,3814,3263,2828,M
3262,N,111,111,2978,150,3964,3263,2867,N
3262,O,115,115,3093,100,4064,3263,2978,O
3262,P,3,3,3096,2880,6944,3263,3093,P
3263,AE,390,390,390,300,300,3264,0,A
3263,BE,173,173,563,300,600,3264,390,B
3263,CE,638,638,1201,840,1440,3264,563,C
3263,DE,1780,579,1780,1866,1866,3264,0,E
3263,DF,204,204,1984,180,2046,3264,1780,F
3263,DG,791,791,2775,970,3016,3264,1984,G
3263,DF,1904,330,3105,1140,2580,3264,1201,D
3263,F,1792,1462,4567,1600,4616,3264,2775,F
3263,G,1403,1403,5970,1080,5696,3264,4567,G
3263,H,2190,2190,8160,6960,12656,3264,5970,H
3263,M,153,153,8313,389,13045,3264,8160,M
3263,N,351,351,8664,180,13225,3264,8313,N
3263,O,1092,1092,9756,1250,14475,3264,8664,O
3263,P,4973,4973,14729,6680,21155,3264,9756,P
3264,AEI,84,84,84,308,308,3265,0,A
3264,BEI,85,1,85,315,315,3265,0,E
3264,BFI,384,299,384,1345,1345,3265,0,I
3264,BFJ,319,19,403,135,443,3265,84,B
3264,CFJ,58,58,461,415,858,3265,403,C
3264,DFJ,415,39,500,240,555,3265,85,F
3264,DGJ,12,12,512,410,965,3265,500,G
3264,DHJ,1842,1714,2226,960,2305,3265,384,J
3264,DHK,646,646,2872,840,3145,3265,2226,K
3264,DHJ,2488,128,3000,6060,7025,3265,512,H
3264,DJ,1117,989,3989,975,4120,3265,2872,J
3264,DK,1278,1278,5267,1420,5540,3265,3989,K
3264,DL,1402,1402,6669,350,5890,3265,5267,L
3264,D,37097,30889,37558,6180,7038,3265,461,D
3264,M,218,218,37776,384,7422,3265,37558,M
3264,N,406,406,38182,300,7722,3265,37776,N
3264,O,2575,2575,40757,1560,9282,3265,38182,O
3264,N,1362,1362,42119,2350,11632,3265,40757,N
3264,O,640,640,42759,885,12517,3265,42119,O
3264,N,963,963,43722,905,13422,3265,42759,N
3264,O,1674,1674,45396,1680,15102,3265,43722,O
3264,P,2751,2751,48147,3960,19062,3265,45396,P
3265,AE,1457,1457,1457,1510,1510,3266,0,E
3265,AF,1464,7,1464,1634,1634,3266,0,A
3265,BF,316,309,1773,300,1810,3266,1457,F
3265,BG,439,130,1903,300,1934,3266,1464,B
3265,CG,704,574,2477,840,2650,3266,1773,G
3265,CH,717,143,2620,835,2769,3266,1903,C
3265,DH,1190,1047,3667,1140,3790,3266,2477,H
3265,D,1919,872,4539,1140,3909,3266,2620,D
3265,M,400,400,4939,1803,5712,3266,4539,M
3265,N,1468,1468,6407,90,5802,3266,4939,N
3265,O,1436,1436,7843,1745,7547,3266,6407,O
3265,N,882,882,8725,605,8152,3266,7843,N
3265,O,698,698,9423,945,9097,3266,8725,O
3265,P,1081,1081,10504,3840,12937,3266,9423,P
3266,A,435,435,435,660,660,3267,0,A
3266,B,340,340,775,180,840,3267,435,B
3266,C,217,217,992,155,995,3267,775,C
3266,D,2598,2598,3590,2880,3875,3267,992,D
3266,M,458,458,4048,826,4701,3267,3590,M
3266,N,500,500,4548,180,4881,3267,4048,N
3266,O,162,162,4710,245,5126,3267,4548,O
3266,N,1549,1549,6259,1440,6566,3267,4710,N
3266,O,307,307,6566,740,7306,3267,6259,O
3266,N,471,471,7037,545,7851,3267,6566,N
3266,O,655,655,7692,780,8631,3267,7037,O
3266,P,1838,1838,9530,3900,12531,3267,7692,P
3267,A,560,560,560,735,735,3268,0,A
3267,B,294,294,854,180,915,3268,560,B
3267,C,137,137,991,155,1070,3268,854,C
3267,D,92,92,1083,2880,3950,3268,991,D
3267,M,345,345,1428,469,4419,3268,1083,M
3267,N,235,235,1663,150,4569,3268,1428,N
3267,O,603,603,2266,615,5184,3268,1663,O
3267,N,1733,1733,3999,1745,6929,3268,2266,N
3267,O,149,149,4148,125,7054,3268,3999,O
3267,P,1291,1291,5439,2880,9934,3268,4148,P
3268,A,491,491,491,1386,1386,3269,0,A
3268,B,935,935,1426,90,1476,3269,491,B
3268,C,1000,1000,2426,1240,2716,3269,1426,C
3268,D,1423,1423,3849,3780,6496,3269,2426,D
3268,M,238,238,4087,512,7008,3269,3849,M
3268,N,311,311,4398,90,7098,3269,4087,N
3268,O,1379,1379,5777,1865,8963,3269,4398,O
3268,P,259,259,6036,3840,12803,3269,5777,P
3269,AE,69,69,69,4060,4060,3270,0,A
3269,BE,1416,1347,1416,1514,1514,3270,0,E
3269,BF,138,138,1554,120,1634,3270,1416,F
3269,BG,206,206,1760,390,2024,3270,1554,G
3269,BF,638,638,2398,420,2444,3270,1760,F
3269,BG,245,245,2643,255,2699,3270,2398,G
3269,BH,4111,1537,4180,180,4240,3270,69,B
3269,CH,1177,1177,5357,1495,5735,3270,4180,C
3269,BH,1493,1493,6850,1175,6910,3270,5357,B
3269,CH,4347,140,6990,5160,7859,3270,2643,H
3269,C,502,362,7352,730,7640,3270,6850,C
3269,D,108,108,7460,2580,10220,3270,7352,D
3269,M,7160,7160,14620,7190,17410,3270,7460,M
3269,N,195,195,14815,210,17620,3270,14620,N
3269,O,256,256,15071,205,17825,3270,14815,O
3269,N,1293,1293,16364,1335,19160,3270,15071,N
3269,O,283,283,16647,563,19723,3270,16364,O
3269,P,293,293,16940,512,20235,3270,16647,P
3270,AE,531,531,531,644,644,3271,0,A
3270,BE,142,142,673,90,734,3271,531,B
3270,CE,529,529,1202,740,1474,3271,673,C
3270,DE,1953,751,1953,2439,2439,3271,0,E
3270,DF,516,516,2469,90,2529,3271,1953,F
3270,DG,616,616,3085,815,3344,3271,2469,G
3270,DF,1672,1672,4757,1475,4819,3271,3085,F
3270,DG,380,380,5137,740,5559,3271,4757,G
3270,DH,1044,1044,6181,3780,9339,3271,5137,H
3270,D,6457,1478,7659,3780,5254,3271,1202,D
3270,M,497,497,8156,890,10229,3271,7659,M
3270,N,573,573,8729,240,10469,3271,8156,N
3270,O,708,708,9437,625,11094,3271,8729,O
3270,N,648,648,10085,710,11804,3271,9437,N
3270,O,1308,1308,11393,2305,14109,3271,10085,O
3270,P,1128,1128,12521,4625,18734,3271,11393,P
3271,AE,435,435,435,411,411,3272,0,E
3271,AF,99,99,534,180,591,3272,435,F
3271,AG,686,152,686,1203,1203,3272,0,A
3271,BG,637,637,1323,180,1383,3272,686,B
3271,CG,1049,260,1583,965,1556,3272,534,G
3271,CH,791,531,2114,765,2148,3272,1323,C
3271,DH,941,410,2524,385,1941,3272,1583,H
3271,D,1563,1153,3677,550,2698,3272,2114,D
3271,M,845,845,4522,1705,4403,3272,3677,M
3271,N,980,980,5502,180,4583,3272,4522,N
3271,O,842,842,6344,840,5423,3272,5502,O
3271,P,5458,5458,11802,6680,12103,3272,6344,P
3272,A,1111,1111,1111,1640,1640,3273,0,A
3272,B,842,842,1953,180,1820,3273,1111,B
3272,C,100,100,2053,760,2580,3273,1953,C
3272,B,669,669,2722,205,2785,3273,2053,B
3272,C,599,599,3321,715,3500,3273,2722,C
3272,D,2637,2637,5958,4080,7580,3273,3321,D
3272,M,308,308,6266,1916,9496,3273,5958,M
3272,N,1735,1735,8001,180,9676,3273,6266,N
3272,O,620,620,8621,609,10285,3273,8001,O
3272,P,304,304,8925,4080,14365,3273,8621,P
3273,AEI,5,5,5,667,667,3274,0,E
3273,AFI,57,52,57,728,728,3274,0,A
3273,BFI,311,254,311,479,479,3274,0,I
3273,BFJ,348,348,659,240,719,3274,311,J
3273,BFK,773,171,830,150,878,3274,57,B
3273,CFK,853,28,858,240,907,3274,5,F
3273,CGK,204,176,1034,130,1008,3274,830,C
3273,BGK,323,147,1181,915,1822,3274,858,G
3273,BHK,1439,1292,2473,1505,2513,3274,1034,B
3273,CHK,1856,42,2515,2010,2729,3274,659,K
3273,CHJ,339,297,2812,650,3163,3274,2473,C
3273,DHJ,1754,123,2935,3960,5782,3274,1181,H
3273,DJ,899,479,3414,750,3479,3274,2515,J
3273,DK,774,774,4188,956,4435,3274,3414,K
3273,DL,1944,568,4756,4230,7393,3274,2812,D
3273,L,3627,3059,7815,414,4849,3274,4188,L
3273,M,1052,1052,8867,1425,8818,3274,7815,M
3273,N,398,398,9265,90,8908,3274,8867,N
3273,O,1674,1674,10939,1940,10848,3274,9265,O
3273,N,626,626,11565,345,11193,3274,10939,N
3273,O,441,441,12006,790,11983,3274,11565,O
3273,P,311,311,12317,3780,15763,3274,12006,P
3274,AEI,205,205,205,835,835,3275,0,A
3274,BEI,405,200,405,615,615,3275,0,E
3274,BFI,526,121,526,850,850,3275,0,I
3274,BFJ,324,203,729,180,795,3275,405,F
3274,BGJ,145,145,874,140,935,3275,729,G
3274,BHJ,353,5,879,90,940,3275,526,J
3274,BHK,25,20,899,2880,3815,3275,874,H
3274,BK,720,26,925,150,985,3275,205,B
3274,CK,250,250,1175,220,1205,3275,925,C
3274,DK,49,49,1224,2880,4085,3275,1175,D
3274,K,994,649,1873,1270,2210,3275,879,K
3274,L,4377,4377,6250,3780,5990,3275,1873,L
3274,M,377,377,6627,1129,7119,3275,6250,M
3274,N,842,842,7469,150,7269,3275,6627,N
3274,O,155,155,7624,190,7459,3275,7469,O
3274,P,109,109,7733,2880,10339,3275,7624,P
3275,A,12,12,12,477,477,3276,0,A
3275,B,826,826,838,420,897,3276,12,B
3275,C,1112,1112,1950,1236,2133,3276,838,C
3275,D,85,85,2035,414,2547,3276,1950,D
3275,M,19146,19146,21181,19181,21728,3276,2035,M
3275,N,284,284,21465,300,22028,3276,21181,N
3275,O,417,417,21882,1870,23898,3276,21465,O
3275,P,1347,1347,23229,7380,31278,3276,21882,P
3276,AE,731,731,731,919,919,3277,0,E
3276,AF,288,288,1019,150,1069,3277,731,F
3276,AG,210,210,1229,180,1249,3277,1019,G
3276,AF,1268,39,1268,1408,1408,3277,0,A
3276,BF,239,239,1507,150,1558,3277,1268,B
3276,CF,284,6,1513,290,1539,3277,1229,F
3276,CG,617,617,2130,690,2229,3277,1513,G
3276,CH,696,73,2203,700,2258,3277,1507,C
3276,BH,1438,1365,3568,4230,6459,3277,2130,H
3276,B,2549,1184,4752,2535,4793,3277,2203,B
3276,C,630,630,5382,690,5483,3277,4752,C
3276,D,1410,1410,6792,4230,9713,3277,5382,D
3276,M,1115,1115,7907,1070,10783,3277,6792,M
3276,N,213,213,8120,300,11083,3277,7907,N
3276,O,222,222,8342,840,11923,3277,8120,O
3276,N,1376,1376,9718,745,12668,3277,8342,N
3276,O,974,974,10692,1160,13828,3277,9718,O
3276,P,215,215,10907,3060,16888,3277,10692,P
3277,AEI,56,56,56,215,215,3278,0,I
3277,AEJ,71,15,71,259,259,3278,0,E
3277,AFJ,237,222,293,135,350,3278,56,J
3277,AFK,374,152,445,240,499,3278,71,F
3277,AGK,166,14,459,295,645,3278,293,K
3277,AGL,201,187,646,295,794,3278,445,G
3277,AHL,1293,647,1293,1798,1798,3278,0,A
3277,BHL,951,117,1410,5100,5745,3278,459,L
3277,BH,569,452,1862,90,1888,3278,1293,B
3277,CH,1471,255,2117,5100,5894,3278,646,H
3277,C,1112,857,2974,1465,3353,3278,1862,C
3277,D,60,60,3034,3780,7133,3278,2974,D
3277,M,165,165,3199,925,8058,3278,3034,M
3277,N,999,999,4198,300,8358,3278,3199,N
3277,O,668,668,4866,755,9113,3278,4198,O
3277,N,373,373,5239,285,9398,3278,4866,N
3277,O,499,499,5738,780,10178,3278,5239,O
3277,P,401,401,6139,1470,11648,3278,5738,P
3278,A,61,61,61,1021,1021,3279,0,A
3278,B,989,989,1050,90,1111,3279,61,B
3278,C,935,935,1985,1220,2331,3279,1050,C
3278,D,191,191,2176,3780,6111,3279,1985,D
3278,M,1885,1885,4061,2508,8619,3279,2176,M
3278,N,651,651,4712,90,8709,3279,4061,N
3278,O,148,148,4860,535,9244,3279,4712,O
3278,P,1384,1384,6244,3780,13024,3279,4860,P
3279,AEI,155,155,155,451,451,3280,0,A
3279,BEI,351,351,506,90,541,3280,155,B
3279,CEI,753,247,753,615,615,3280,0,E
3279,CFI,126,126,879,300,915,3280,753,F
3279,CGI,1613,734,1613,1570,1570,3280,0,I
3279,CGJ,1361,254,1867,1865,2406,3280,506,C
3279,CGJ,254,0,1867,300,1870,3280,1613,J
3279,DGK,1227,239,2106,745,1660,3280,879,G
3279,DHK,549,549,2655,1140,2800,3280,2106,H
3279,DK,880,92,2747,840,2710,3280,1867,K
3279,DL,1314,434,3181,3780,6186,3280,1867,D
3279,L,1186,752,3933,1140,3850,3280,2747,L
3279,M,1943,1943,5876,1989,8175,3280,3933,M
3279,N,171,171,6047,180,8355,3280,5876,N
3279,O,929,929,6976,1245,9600,3280,6047,O
3279,P,2471,2471,9447,6680,16280,3280,6976,P
3280,AE,734,734,734,1292,1292,3281,0,A
3280,BE,753,19,753,1057,1057,3281,0,E
3280,BF,331,331,1084,90,1147,3281,753,F
3280,BG,620,270,1354,90,1382,3281,734,B
3280,CG,940,670,2024,1240,2387,3281,1084,G
3280,CH,863,193,2217,1200,2582,3281,1354,C
3280,DH,81,81,2298,3780,6362,3281,2217,D
3280,H,473,199,2497,3780,6167,3281,2024,H
3280,M,1229,1229,3726,2675,9037,3281,2497,M
3280,N,1486,1486,5212,90,9127,3281,3726,N
3280,O,725,725,5937,1155,10282,3281,5212,O
3280,P,60,60,5997,3780,14062,3281,5937,P
3281,AEI,439,439,439,716,716,3282,0,A
3281,BEI,417,417,856,90,806,3282,439,B
3281,CEI,1527,671,1527,3375,3375,3282,0,I
3281,CEJ,1381,710,2237,1780,2586,3282,856,C
3281,DEJ,60,60,2297,3780,6366,3282,2237,D
3281,EJ,1843,1073,3370,90,3465,3282,1527,J
3281,EK,1406,1406,4776,1655,5120,3282,3370,K
3281,EL,140,140,4916,3780,8900,3282,4776,L
3281,E,26261,21345,26261,28481,28481,3282,0,E
3281,F,2250,2250,28511,90,28571,3282,26261,F
3281,G,1017,1017,29528,1220,29791,3282,28511,G
3281,H,1217,1217,30745,4625,34416,3282,29528,H
3281,M,673,673,31418,1312,35728,3282,30745,M
3281,N,671,671,32089,90,35818,3282,31418,N
3281,O,146,146,32235,535,36353,3282,32089,O
3281,P,1381,1381,33616,3780,40133,3282,32235,P
3282,A,287,287,287,563,563,3283,0,A
3282,B,523,523,810,90,653,3283,287,B
3282,C,651,651,1461,940,1593,3283,810,C
3282,D,344,344,1805,3780,5373,3283,1461,D
3282,M,135,135,1940,937,6310,3283,1805,M
3282,N,835,835,2775,90,6400,3283,1940,N
3282,O,249,249,3024,695,7095,3283,2775,O
3282,P,11855,11855,14879,3780,10875,3283,3024,P
3283,AEI,150,150,150,137,137,3284,0,A
3283,BEI,213,213,363,240,377,3284,150,B
3283,CEI,469,106,469,660,660,3284,0,E
3283,CFI,215,215,684,90,750,3284,469,F
3283,CGI,846,162,846,1154,1154,3284,0,I
3283,CGJ,515,353,1199,905,1655,3284,684,G
3283,CHJ,358,5,1204,90,1244,3284,846,J
3283,CHK,845,4,1208,1045,1422,3284,363,C
3283,DHK,1,1,1209,3960,5382,3284,1208,D
3283,HK,239,229,1438,3780,5435,3284,1199,H
3283,K,887,653,2091,1250,2494,3284,1204,K
3283,L,72,72,2163,3780,6274,3284,2091,L
3283,M,2184,2184,4347,2661,8935,3284,2163,M
3283,N,509,509,4856,90,9025,3284,4347,N
3283,O,239,239,5095,625,9650,3284,4856,O
3283,P,292,292,5387,3780,13430,3284,5095,P
3284,AEI,32,32,32,2566,2566,3285,0,I
3284,AEJ,48,16,48,426,426,3285,0,A
3284,BEJ,175,127,175,1508,1508,3285,0,E
3284,BFJ,498,371,546,165,591,3285,48,B
3284,CFJ,1011,1011,1557,1275,1866,3285,546,C
3284,DFJ,1619,237,1794,240,1748,3285,175,F
3284,DGJ,852,615,2409,3960,5826,3285,1557,D
3284,GJ,2619,242,2651,165,2731,3285,32,J
3284,GK,830,830,3481,1035,3766,3285,2651,K
3284,GL,178,178,3659,3960,7726,3285,3481,L
3284,G,2906,1041,4700,4140,5888,3285,1794,G
3284,F,1327,1327,6027,165,6053,3285,4700,F
3284,G,579,579,6606,905,6958,3285,6027,G
3284,H,242,242,6848,3960,10918,3285,6606,H
3284,M,2700,2700,9548,2939,13857,3285,6848,M
3284,N,351,351,9899,150,14007,3285,9548,N
3284,O,696,696,10595,700,14707,3285,9899,O
3284,N,895,895,11490,895,15602,3285,10595,N
3284,O,214,214,11704,230,15832,3285,11490,O
3284,P,1488,1488,13192,4230,20062,3285,11704,P
3285,A,15,15,15,48,48,3286,0,A
3285,B,235,235,250,240,288,3286,15,B
3285,C,561,561,811,785,1073,3286,250,C
3285,D,104,104,915,3960,5033,3286,811,D
3285,M,60,60,975,330,5363,3286,915,M
3285,N,846,846,1821,610,5973,3286,975,N
3285,O,384,384,2205,455,6428,3286,1821,O
3285,N,1315,1315,3520,1210,7638,3286,2205,N
3285,O,4596,4596,8116,1380,9018,3286,3520,O
3285,P,25619,25619,33735,3000,12018,3286,8116,P
3286,A,191,191,191,481,481,3287,0,A
3286,B,465,465,656,240,721,3287,191,B
3286,C,853,853,1509,985,1706,3287,656,C
3286,B,772,772,2281,625,2331,3287,1509,B
3286,C,191,191,2472,290,2621,3287,2281,C
3286,D,169,169,2641,5100,7721,3287,2472,D
3286,M,43,43,2684,1484,9205,3287,2641,M
3286,N,1491,1491,4175,165,9370,3287,2684,N
3286,O,606,606,4781,825,10195,3287,4175,O
3286,P,1804,1804,6585,3960,14155,3287,4781,P
3287,A,891,891,891,1151,1151,3288,0,A
3287,B,297,297,1188,90,1241,3288,891,B
3287,C,969,969,2157,1240,2481,3288,1188,C
3287,D,77,77,2234,3780,6261,3288,2157,D
3287,M,1516,1516,3750,1722,7983,3288,2234,M
3287,N,251,251,4001,90,8073,3288,3750,N
3287,O,220,220,4221,695,8768,3288,4001,O
3287,P,6825,6825,11046,3780,12548,3288,4221,P
3288,AEI,1615,1615,1615,4669,4669,3289,0,I
3288,AEJ,2898,1283,2898,4143,4143,3289,0,A
3288,BEJ,1278,1278,4176,90,4233,3289,2898,B
3288,CEJ,3105,544,4720,90,4759,3289,1615,J
3288,CEK,990,446,5166,1225,5458,3289,4176,C
3288,DEK,1,1,5167,3780,9238,3289,5166,D
3288,EK,1056,609,5776,1385,6144,3289,4720,K
3288,EL,75,75,5851,3780,9924,3289,5776,L
3288,E,15865,10014,15865,16618,16618,3289,0,E
3288,F,782,782,16647,90,16708,3289,15865,F
3288,G,861,861,17508,1215,17923,3289,16647,G
3288,H,271,271,17779,3780,21703,3289,17508,H
3288,M,3124,3124,20903,3812,25515,3289,17779,M
3288,N,730,730,21633,90,25605,3289,20903,N
3288,O,233,233,21866,625,26230,3289,21633,O
3288,P,2145,2145,24011,3780,30010,3289,21866,P
3289,AE,6,6,6,221,221,3290,0,E
3289,AF,340,334,340,350,350,3290,0,A
3289,BF,408,74,414,240,461,3290,6,F
3289,BG,407,333,747,435,785,3290,340,B
3289,CG,484,151,898,780,1241,3290,414,G
3289,CH,500,349,1247,585,1370,3290,747,C
3289,BH,489,489,1736,415,1785,3290,1247,B
3289,CH,952,114,1850,3960,5201,3290,898,H
3289,C,207,93,1943,875,2660,3290,1736,C
3289,D,736,736,2679,1590,4250,3290,1943,D
3289,M,2503,2503,5182,2285,7486,3290,2679,M
3289,N,522,522,5704,780,8266,3290,5182,N
3289,O,575,575,6279,865,9131,3290,5704,O
3289,N,1065,1065,7344,835,9966,3290,6279,N
3289,O,389,389,7733,648,10614,3290,7344,O
3289,P,4492,4492,12225,492,11106,3290,7733,P
3290,AE,592,592,592,1047,1047,3291,0,A
3290,BE,549,549,1141,150,1197,3291,592,B
3290,CE,128,128,1269,130,1327,3291,1141,C
3290,BE,1435,166,1435,1448,1448,3291,0,E
3290,BF,98,98,1533,150,1598,3291,1435,F
3290,BG,189,189,1722,120,1718,3291,1533,G
3290,BF,1577,1124,2846,1565,2892,3291,1269,B
3290,CF,1206,82,2928,1245,2963,3291,1722,F
3290,CG,437,355,3283,650,3542,3291,2846,C
3290,DG,384,29,3312,645,3608,3291,2928,G
3290,DH,1928,1928,5240,4230,7838,3291,3312,H
3290,D,7256,5299,10539,4230,7772,3291,3283,D
3290,M,347,347,10886,661,8499,3291,10539,M
3290,N,554,554,11440,300,8799,3291,10886,N
3290,O,756,756,12196,1100,9899,3291,11440,O
3290,N,1248,1248,13444,895,10794,3291,12196,N
3290,O,1061,1061,14505,180,10974,3291,13444,O
3290,P,1594,1594,16099,860,11834,3291,14505,P
3291,AEI,544,544,544,1006,1006,3292,0,A
3291,BEI,557,557,1101,150,1156,3292,544,B
3291,CEI,180,180,1281,140,1296,3292,1101,C
3291,BEI,1588,307,1588,1865,1865,3292,0,I
3291,BEJ,310,310,1898,90,1955,3292,1588,J
3291,BEK,719,102,2000,730,2026,3292,1281,B
3291,CEK,645,543,2543,855,2810,3292,1898,K
3291,CEL,63,63,2606,3780,6590,3292,2543,L
3291,CE,2849,243,2849,4117,4117,3292,0,E
3291,CF,892,43,2892,775,2801,3292,2000,C
3291,DF,264,264,3156,4230,7031,3292,2892,D
3291,F,1302,995,4151,90,4207,3292,2849,F
3291,G,963,963,5114,1230,5437,3292,4151,G
3291,H,22,22,5136,3780,9217,3292,5114,H
3291,M,3977,3977,9113,4842,14059,3292,5136,M
3291,N,900,900,10013,90,14149,3292,9113,N
3291,O,204,204,10217,605,14754,3292,10013,O
3291,P,8821,8821,19038,3780,18534,3292,10217,P
3292,AEI,62,62,62,205,205,3293,0,E
3292,AFI,98,36,98,1678,1678,3293,0,A
3292,BFI,233,197,295,150,355,3293,62,F
3292,BGI,536,536,831,500,855,3293,295,G
3292,BHI,1515,684,1515,1963,1963,3293,0,I
3292,BHJ,1684,267,1782,130,1808,3293,98,B
3292,CHJ,1456,505,2287,385,1240,3293,831,H
3292,CJ,1248,476,2763,420,2383,3293,1515,J
3292,CK,1102,121,2884,1105,2913,3293,1782,C
3292,DK,114,114,2998,385,3298,3293,2884,D
3292,K,874,639,3637,865,3248,3293,2763,K
3292,L,839,839,4476,550,3798,3293,3637,L
3292,M,653,653,5129,2449,6247,3293,4476,M
3292,N,2246,2246,7375,510,6757,3293,5129,N
3292,O,929,929,8304,1258,8015,3293,7375,O
3292,P,2769,2769,11073,1142,9157,3293,8304,P
3293,A,1493,1493,1493,3720,3720,3294,0,A
3293,B,2257,2257,3750,90,3810,3294,1493,B
3293,C,2461,2461,6211,2105,5915,3294,3750,C
3293,B,2201,2201,8412,2550,8465,3294,6211,B
3293,C,419,419,8831,735,9200,3294,8412,C
3293,D,20915,20915,29746,3780,12980,3294,8831,D
3293,M,1541,1541,31287,1937,14917,3294,29746,M
3293,N,426,426,31713,90,15007,3294,31287,N
3293,O,720,720,32433,805,15812,3294,31713,O
3293,N,936,936,33369,855,16667,3294,32433,N
3293,O,294,294,33663,390,17057,3294,33369,O
3293,P,732,732,34395,365,17422,3294,33663,P
3294,A,395,395,395,530,530,3295,0,A
3294,B,277,277,672,180,710,3295,395,B
3294,C,840,840,1512,745,1455,3295,672,C
3294,B,1345,1345,2857,1700,3155,3295,1512,B
3294,C,1038,1038,3895,1080,4235,3295,2857,C
3294,D,1442,1442,5337,3960,8195,3295,3895,D
3294,M,167,167,5504,694,8889,3295,5337,M
3294,N,628,628,6132,150,9039,3295,5504,N
3294,O,122,122,6254,125,9164,3295,6132,O
3294,N,397,397,6651,380,9544,3295,6254,N
3294,O,671,671,7322,840,10384,3295,6651,O
3294,P,2168,2168,9490,4170,14554,3295,7322,P
3295,A,190,190,190,1511,1511,3296,0,A
3295,B,1526,1526,1716,240,1751,3296,190,B
3295,C,894,894,2610,1045,2796,3296,1716,C
3295,D,593,593,3203,3960,6756,3296,2610,D
3295,M,2824,2824,6027,4141,10897,3296,3203,M
3295,N,1356,1356,7383,90,10987,3296,6027,N
3295,O,789,789,8172,925,11912,3296,7383,O
3295,P,3912,3912,12084,3780,15692,3296,8172,P
3296,AEI,63,63,63,1172,1172,3297,0,I
3296,AEJ,148,85,148,158,158,3297,0,E
3296,AFJ,108,108,256,150,308,3297,148,F
3296,AGJ,164,164,420,130,438,3297,256,G
3296,AFJ,1014,594,1014,1387,1387,3297,0,A
3296,BFJ,1308,357,1371,240,1412,3297,63,J
3296,BFK,427,70,1441,90,1477,3297,1014,B
3296,CFK,1518,497,1938,1545,1983,3297,420,F
3296,CGK,845,348,2286,1240,2717,3297,1441,C
3296,DGK,936,21,2307,1040,2452,3297,1371,K
3296,DGL,2,2,2309,3960,6412,3297,2307,L
3296,DG,80,57,2366,3780,6497,3297,2286,D
3296,G,831,403,2769,775,2758,3297,1938,G
3296,H,589,589,3358,4290,7048,3297,2769,H
3296,M,4412,4412,7770,4821,11869,3297,3358,M
3296,N,471,471,8241,90,11959,3297,7770,N
3296,O,212,212,8453,695,12654,3297,8241,O
3296,P,9053,9053,17506,3780,16434,3297,8453,P
3297,A,403,403,403,930,930,3298,0,A
3297,B,800,800,1203,300,1230,3298,403,B
3297,C,762,762,1965,815,2045,3298,1203,C
3297,D,587,587,2552,3960,6005,3298,1965,D
3297,M,301,301,2853,1585,7590,3298,2552,M
3297,N,1543,1543,4396,300,7890,3298,2853,N
3297,O,747,747,5143,895,8785,3298,4396,O
3297,P,21,21,5164,3960,12745,3298,5143,P
3298,AEI,332,332,332,1103,1103,3299,0,E
3298,AFI,781,449,781,1228,1228,3299,0,A
3298,BFI,844,395,1176,90,1193,3299,332,F
3298,BGI,472,77,1253,90,1318,3299,781,B
3298,CGI,432,432,1685,805,2123,3299,1253,C
3298,DGI,858,349,2034,1250,2443,3299,1176,G
3298,DHI,554,554,2588,3780,6223,3299,2034,H
3298,DI,1363,460,3048,3780,5903,3299,1685,D
3298,I,36964,33916,36964,39434,39434,3299,0,I
3298,J,2500,2500,39464,90,39524,3299,36964,J
3298,K,1061,1061,40525,1210,40734,3299,39464,K
3298,L,1425,1425,41950,3780,44514,3299,40525,L
3298,M,738,738,42688,1291,45805,3299,41950,M
3298,N,597,597,43285,90,45895,3299,42688,N
3298,O,467,467,43752,845,46740,3299,43285,O
3298,P,456,456,44208,3780,50520,3299,43752,P
3299,A,10028,10028,10028,10218,10218,3300,0,A
3299,B,265,265,10293,90,10308,3300,10028,B
3299,C,504,504,10797,820,11128,3300,10293,C
3299,B,1114,1114,11911,845,11973,3300,10797,B
3299,C,475,475,12386,740,12713,3300,11911,C
3299,D,1040,1040,13426,3780,16493,3300,12386,D
3299,M,1573,1573,14999,1594,18087,3300,13426,M
3299,N,321,321,15320,360,18447,3300,14999,N
3299,O,1097,1097,16417,1495,19942,3300,15320,O
3299,N,915,915,17332,495,20437,3300,16417,N
3299,O,799,799,18131,831,21268,3300,17332,O
3299,P,335,335,18466,414,21682,3300,18131,P
3300,AE,6955,6955,6955,7399,7399,3301,0,E
3300,AF,474,474,7429,90,7489,3301,6955,F
3300,AG,1591,1591,9020,1935,9424,3301,7429,G
3300,AH,450,450,9470,3780,13204,3301,9020,H
3300,A,10544,1074,10544,11579,11579,3301,0,A
3300,B,1065,1065,11609,90,11669,3301,10544,B
3300,C,608,608,12217,935,12604,3301,11609,C
3300,D,596,596,12813,3780,16384,3301,12217,D
3300,M,4065,4065,16878,5083,21467,3301,12813,M
3300,N,1048,1048,17926,90,21557,3301,16878,N
3300,O,765,765,18691,1195,22752,3301,17926,O
3300,P,70,70,18761,3780,26532,3301,18691,P
3301,AE,422,422,422,691,691,3302,0,E
3301,AF,325,325,747,90,781,3302,422,F
3301,AG,1565,818,1565,1735,1735,3302,0,A
3301,BG,459,459,2024,300,2035,3302,1565,B
3301,CG,1359,82,2106,1865,2646,3302,747,G
3301,CH,801,719,2825,835,2870,3302,2024,C
3301,DH,1454,735,3560,3780,6426,3302,2106,H
3301,D,6090,5355,8915,1140,4010,3302,2825,D
3301,M,1280,1280,10195,1763,8189,3302,8915,M
3301,N,623,623,10818,90,8279,3302,10195,N
3301,O,1365,1365,12183,1780,10059,3302,10818,O
3301,N,451,451,12634,130,10189,3302,12183,N
3301,O,237,237,12871,535,10724,3302,12634,O
3301,P,613,613,13484,3780,14504,3302,12871,P
3302,AE,1,1,1,353,353,3303,0,E
3302,AF,345,344,345,3781,3781,3303,0,A
3302,BF,603,259,604,240,593,3303,1,F
3302,BG,578,578,1182,895,1488,3303,604,G
3302,BH,3692,2855,4037,300,4081,3303,345,B
3302,CH,737,737,4774,815,4896,3303,4037,C
3302,DH,237,237,5011,4080,8976,3303,4774,D
3302,H,17018,13189,18200,3960,5448,3303,1182,H
3302,M,1769,1769,19969,3131,12107,3303,18200,M
3302,N,1599,1599,21568,300,12407,3303,19969,N
3302,O,653,653,22221,805,13212,3303,21568,O
3302,P,2842,2842,25063,8355,21567,3303,22221,P
3303,AE,70,70,70,244,244,3304,0,A
3303,BE,85,15,85,315,315,3304,0,E
3303,BF,363,348,433,240,484,3304,70,B
3303,CF,350,2,435,180,495,3304,85,F
3303,CG,195,193,628,380,864,3304,433,C
3303,DG,377,184,812,840,1335,3304,435,G
3303,DF,690,506,1318,5460,6324,3304,628,D
3303,F,741,235,1553,270,1605,3304,812,F
3303,G,640,640,2193,805,2410,3304,1553,G
3303,H,222,222,2415,1140,3550,3304,2193,H
3303,M,491,491,2906,1016,7340,3304,2415,M
3303,N,654,654,3560,150,7490,3304,2906,N
3303,O,255,255,3815,185,7675,3304,3560,O
3303,N,266,266,4081,355,8030,3304,3815,N
3303,O,130,130,4211,120,8150,3304,4081,O
3303,P,1409,1409,5620,4230,12380,3304,4211,P
3304,A,3030,3030,3030,3742,3742,3305,0,A
3304,B,971,971,4001,300,4042,3305,3030,B
3304,C,1132,1132,5133,1050,5092,3305,4001,C
3304,B,559,559,5692,720,5812,3305,5133,B
3304,C,648,648,6340,780,6592,3305,5692,C
3304,D,2736,2736,9076,3960,10552,3305,6340,D
3304,M,1059,1059,10135,1375,11927,3305,9076,M
3304,N,1058,1058,11193,780,12707,3305,10135,N
3304,O,4147,4147,15340,4986,17693,3305,11193,O
3304,P,16,16,15356,2034,19727,3305,15340,P
3305,AEI,64,64,64,1568,1568,3306,0,E
3305,AFI,95,31,95,117,117,3306,0,A
3305,BFI,175,175,270,180,297,3306,95,B
3305,CFI,152,152,422,166,463,3306,270,C
3305,DFI,168,168,590,379,842,3306,422,D
3305,FI,1635,1045,1635,3476,3476,3306,0,I
3305,FJ,1747,176,1811,240,1808,3306,64,F
3305,GJ,929,929,2740,910,2718,3306,1811,G
3305,HJ,2201,1096,3836,420,3896,3306,1635,J
3305,HK,1040,1040,4876,985,4881,3306,3836,K
3305,HL,3755,1619,6495,550,3268,3306,2740,H
3305,L,3377,1758,8253,550,5431,3306,4876,L
3305,M,1130,1130,9383,1366,6797,3306,8253,M
3305,N,306,306,9689,150,6947,3306,9383,N
3305,O,733,733,10422,395,7342,3306,9689,O
3305,P,459,459,10881,660,8002,3306,10422,P
3306,AE,17,17,17,92,92,3307,0,E
3306,AF,236,219,236,957,957,3307,0,A
3306,BF,256,37,273,240,332,3307,17,F
3306,BG,1075,1075,1348,1085,1417,3307,273,G
3306,BH,1118,6,1354,480,1437,3307,236,B
3306,CH,192,186,1540,550,1967,3307,1348,H
3306,C,757,571,2111,720,2157,3307,1354,C
3306,D,419,419,2530,550,2707,3307,2111,D
3306,M,949,949,3479,1247,3954,3307,2530,M
3306,N,724,724,4203,420,4374,3307,3479,N
3306,O,585,585,4788,676,5050,3307,4203,O
3306,P,3621,3621,8409,3639,8689,3307,4788,P
3307,AE,375,375,375,674,674,3308,0,E
3307,AF,389,14,389,869,869,3308,0,A
3307,BF,325,311,700,90,764,3308,375,F
3307,BG,602,602,1302,850,1614,3308,700,G
3307,BH,747,747,2049,3840,5454,3308,1302,H
3307,B,3346,1686,3735,2876,3745,3308,389,B
3307,C,214,214,3949,665,4410,3308,3735,C
3307,B,1061,1061,5010,660,5070,3308,3949,B
3307,C,602,602,5612,715,5785,3308,5010,C
3307,D,1278,1278,6890,4080,9865,3308,5612,D
3307,M,4636,4636,11526,5746,15611,3308,6890,M
3307,N,1230,1230,12756,180,15791,3308,11526,N
3307,O,770,770,13526,748,16539,3308,12756,O
3307,P,1127,1127,14653,402,16941,3308,13526,P
3308,AEI,525,525,525,1284,1284,3309,0,A
3308,BEI,789,789,1314,90,1374,3309,525,B
3308,CEI,873,873,2187,1060,2434,3309,1314,C
3308,DEI,140,140,2327,3780,6214,3309,2187,D
3308,EI,2401,74,2401,3359,3359,3309,0,I
3308,EJ,984,984,3385,90,3449,3309,2401,J
3308,EK,955,955,4340,1250,4699,3309,3385,K
3308,EJ,935,935,5275,625,5324,3309,4340,J
3308,EK,827,827,6102,1060,6384,3309,5275,K
3308,EL,167,167,6269,3780,10164,3309,6102,L
3308,E,7265,996,7265,7625,7625,3309,0,E
3308,F,393,393,7658,90,7715,3309,7265,F
3308,G,700,700,8358,885,8600,3309,7658,G
3308,F,2060,2060,10418,1870,10470,3309,8358,F
3308,G,773,773,11191,1080,11550,3309,10418,G
3308,H,779,779,11970,3780,15330,3309,11191,H
3308,M,19695,19695,31665,19899,35229,3309,11970,M
3308,N,233,233,31898,90,35319,3309,31665,N
3308,O,745,745,32643,1105,36424,3309,31898,O
3308,N,771,771,33414,410,36834,3309,32643,N
3308,O,202,202,33616,605,37439,3309,33414,O
3308,P,194,194,33810,3780,41219,3309,33616,P
3309,AEI,29,29,29,106,106,3310,0,E
3309,AFI,70,41,70,880,880,3310,0,I
3309,AFJ,153,112,182,135,241,3310,29,F
3309,AGJ,176,176,358,385,626,3310,182,G
3309,AHJ,24,24,382,6365,6991,3310,358,H
3309,AJ,527,145,527,614,614,3310,0,A
3309,BJ,228,228,755,180,794,3310,527,B
3309,CJ,104,104,859,195,989,3310,755,C
3309,DJ,999,210,1069,240,1120,3310,70,J
3309,DK,228,18,1087,4140,5129,3310,859,D
3309,K,998,980,2067,1030,2150,3310,1069,K
3309,J,1391,1391,3458,1355,3505,3310,2067,J
3309,K,920,920,4378,1620,5125,3310,3458,K
3309,L,384,384,4762,3960,9085,3310,4378,L
3309,M,4615,4615,9377,4604,13689,3310,4762,M
3309,N,170,170,9547,240,13929,3310,9377,N
3309,O,158,158,9705,390,14319,3310,9547,O
3309,N,888,888,10593,575,14894,3310,9705,N
3309,O,234,234,10827,505,15399,3310,10593,O
3309,P,6916,6916,17743,3960,19359,3310,10827,P
3310,A,1019,1019,1019,1504,1504,3311,0,A
3310,B,538,538,1557,90,1594,3311,1019,B
3310,C,1090,1090,2647,1500,3094,3311,1557,C
3310,D,122,122,2769,3780,6874,3311,2647,D
3310,M,558,558,3327,1257,8131,3311,2769,M
3310,N,1020,1020,4347,180,8311,3311,3327,N
3310,O,632,632,4979,895,9206,3311,4347,O
3310,N,1427,1427,6406,1365,10571,3311,4979,N
3310,O,533,533,6939,620,11191,3311,6406,O
3310,P,1452,1452,8391,6960,18151,3311,6939,P
3311,A,64,64,64,144,144,3312,0,A
3311,B,258,258,322,240,384,3312,64,B
3311,C,233,233,555,285,669,3312,322,C
3311,D,1436,1436,1991,5160,5829,3312,555,D
3311,M,623,623,2614,1199,7028,3312,1991,M
3311,N,690,690,3304,150,7178,3312,2614,N
3311,O,889,889,4193,1235,8413,3312,3304,O
3311,P,2798,2798,6991,3660,12073,3312,4193,P
3312,AEI,51,51,51,93,93,3313,0,I
3312,AEJ,106,55,106,129,129,3313,0,A
3312,BEJ,132,77,183,135,228,3313,51,J
3312,BEK,216,139,322,240,369,3313,106,B
3312,CEK,272,133,455,285,513,3313,183,K
3312,CEL,569,114,569,798,798,3313,0,E
3312,CFL,192,78,647,5160,5673,3313,455,L
3312,CF,333,255,902,90,888,3313,569,F
3312,CG,876,296,1198,915,1284,3313,322,C
3312,BG,317,317,1515,165,1449,3313,1198,B
3312,CG,906,293,1808,1285,2173,3313,902,G
3312,CH,1764,1471,3279,1260,2709,3313,1515,C
3312,DH,1561,1561,4840,3960,6669,3313,3279,D
3312,H,3894,862,5702,3780,5953,3313,1808,H
3312,M,1259,1259,6961,1529,8198,3313,5702,M
3312,N,418,418,7379,180,8378,3313,6961,N
3312,O,701,701,8080,885,9263,3313,7379,O
3312,N,551,551,8631,395,9658,3313,8080,N
3312,O,743,743,9374,665,10323,3313,8631,O
3312,P,604,604,9978,5460,15783,3313,9374,P
3313,AEI,71,71,71,242,242,3314,0,A
3313,BEI,388,388,459,240,482,3314,71,B
3313,CEI,808,808,1267,915,1397,3314,459,C
3313,BEI,1610,343,1610,1752,1752,3314,0,E
3313,BFI,262,262,1872,180,1932,3314,1610,F
3313,BGI,686,81,1953,555,1952,3314,1267,B
3313,CGI,567,567,2520,810,2762,3314,1953,C
3313,DGI,676,28,2548,950,2882,3314,1872,G
3313,DFI,629,629,3177,330,3212,3314,2548,F
3313,DGI,550,550,3727,585,3797,3314,3177,G
3313,DHI,1292,85,3812,3960,6722,3314,2520,D
3313,HI,1046,961,4773,6960,10757,3314,3727,H
3313,I,8704,3931,8704,9090,9090,3314,0,I
3313,J,791,791,9495,420,9510,3314,8704,J
3313,K,961,961,10456,970,10480,3314,9495,K
3313,L,1993,1993,12449,550,11030,3314,10456,L
3313,M,34522,34522,46971,36546,47576,3314,12449,M
3313,N,1704,1704,48675,150,47726,3314,46971,N
3313,O,1488,1488,50163,380,48106,3314,48675,O
3313,P,883,883,51046,660,48766,3314,50163,P
3314,AE,41,41,41,385,385,3315,0,E
3314,AF,480,480,521,165,550,3315,41,F
3314,AG,531,10,531,1041,1041,3315,0,A
3314,BG,628,628,1159,150,1191,3315,531,B
3314,CG,94,94,1253,375,1566,3315,1159,C
3314,BG,1004,272,1525,1275,1825,3315,521,G
3314,BH,615,343,1868,335,1901,3315,1253,B
3314,CH,562,562,2430,655,2556,3315,1868,C
3314,DH,1012,107,2537,3960,5785,3315,1525,H
3314,D,265,158,2695,4230,6786,3315,2430,D
3314,M,11912,11912,14607,11836,18622,3315,2695,M
3314,N,188,188,14795,330,18952,3315,14607,N
3314,O,1170,1170,15965,1065,20017,3315,14795,O
3314,P,1485,1485,17450,550,20567,3315,15965,P
3315,AE,1961,1961,1961,2018,2018,3316,0,E
3315,AF,2054,93,2054,2139,2139,3316,0,A
3315,BF,233,140,2194,180,2198,3316,1961,F
3315,BG,292,152,2346,180,2319,3316,2054,B
3315,CG,199,47,2393,880,3078,3316,2194,G
3315,CH,138,91,2484,880,3199,3316,2346,C
3315,DH,3143,3052,5536,6660,9738,3316,2393,H
3315,D,3323,271,5807,6660,9859,3316,2484,D
3315,M,709,709,6516,727,10586,3316,5807,M
3315,N,254,254,6770,260,10846,3316,6516,N
3315,O,527,527,7297,525,11371,3316,6770,O
3315,N,2355,2355,9652,2375,13746,3316,7297,N
3315,O,1341,1341,10993,2205,15951,3316,9652,O
3315,P,400,400,11393,1780,17731,3316,10993,P
3316,AEI,711,711,711,1084,1084,3317,0,I
3316,AEJ,714,3,714,1028,1028,3317,0,A
3316,BEJ,438,438,1152,180,1208,3317,714,B
3316,CEJ,493,52,1204,180,1264,3317,711,J
3316,CEK,828,776,1980,1200,2408,3317,1152,C
3316,BEK,2043,63,2043,2179,2179,3317,0,E
3316,BFK,304,304,2347,180,2359,3317,2043,F
3316,BGK,1770,627,2974,1170,2434,3317,1204,K
3316,BGJ,871,244,3218,1200,3559,3317,2347,G
3316,BFJ,1910,672,3890,1550,3958,3317,1980,B
3316,CFJ,465,465,4355,570,4528,3317,3890,C
3316,DFJ,1311,174,4529,1030,4589,3317,3218,F
3316,DGJ,251,251,4780,340,4929,3317,4529,G
3316,DHJ,2371,565,5345,3000,5434,3317,2974,J
3316,DHK,501,501,5846,570,6004,3317,5345,K
3316,DHL,121,121,5967,350,6354,3317,5846,L
3316,DH,1795,183,6150,350,4878,3317,4355,D
3316,H,2182,812,6962,920,5849,3317,4780,H
3316,M,200,200,7162,498,6852,3317,6962,M
3316,N,658,658,7820,420,7272,3317,7162,N
3316,O,170,170,7990,660,7932,3317,7820,O
3316,N,821,821,8811,330,8262,3317,7990,N
3316,O,953,953,9764,1180,9442,3317,8811,O
3316,P,2442,2442,12206,665,10107,3317,9764,P
3317,AE,41,41,41,108,108,3318,0,A
3317,BE,247,247,288,240,348,3318,41,B
3317,CE,362,362,650,280,628,3318,288,C
3317,DE,1606,956,1606,2300,2300,3318,0,E
3317,DF,975,975,2581,300,2600,3318,1606,F
3317,DG,841,841,3422,910,3510,3318,2581,G
3317,DF,2952,180,3602,5160,5788,3318,650,D
3317,F,717,537,4139,660,4170,3318,3422,F
3317,G,282,282,4421,385,4555,3318,4139,G
3317,H,451,451,4872,3960,8515,3318,4421,H
3317,M,482,482,5354,740,9255,3318,4872,M
3317,N,477,477,5831,240,9495,3318,5354,N
3317,O,123,123,5954,390,9885,3318,5831,O
3317,N,1614,1614,7568,1360,11245,3318,5954,N
3317,O,603,603,8171,810,12055,3318,7568,O
3317,P,4615,4615,12786,3960,16015,3318,8171,P
3318,AE,11,11,11,269,269,3319,0,A
3318,BE,111,100,111,1188,1188,3319,0,E
3318,BF,452,352,463,240,509,3319,11,B
3318,CF,741,741,1204,965,1474,3319,463,C
3318,DF,134,134,1338,3960,5434,3319,1204,D
3318,F,1270,43,1381,240,1428,3319,111,F
3318,G,823,823,2204,890,2318,3319,1381,G
3318,H,19082,19082,21286,5160,7478,3319,2204,H
3318,M,1618,1618,22904,1849,9327,3319,21286,M
3318,N,1064,1064,23968,90,9417,3319,22904,N
3318,O,482,482,24450,875,10292,3319,23968,O
3318,P,540,540,24990,3780,14072,3319,24450,P
3319,A,101,101,101,1016,1016,3320,0,A
3319,B,1132,1132,1233,240,1256,3320,101,B
3319,C,326,326,1559,915,2171,3320,1233,C
3319,D,493,493,2052,3960,6131,3320,1559,D
3319,M,2695,2695,4747,2912,9043,3320,2052,M
3319,N,247,247,4994,90,9133,3320,4747,N
3319,O,1710,1710,6704,1940,11073,3320,4994,O
3319,N,561,561,7265,335,11408,3320,6704,N
3319,O,441,441,7706,790,12198,3320,7265,O
3319,P,479,479,8185,3780,15978,3320,7706,P
3320,AE,933,933,933,1196,1196,3321,0,E
3320,AF,444,444,1377,180,1376,3321,933,F
3320,AG,1472,95,1472,1818,1818,3321,0,A
3320,BG,508,508,1980,230,2048,3321,1472,B
3320,CG,923,320,2300,930,2306,3321,1377,G
3320,CH,583,263,2563,575,2623,3321,1980,C
3320,DH,1567,1567,4130,385,3008,3321,2563,D
3320,H,5086,3256,7386,550,2856,3321,2300,H
3320,M,1048,1048,8434,1336,4344,3321,7386,M
3320,N,712,712,9146,420,4764,3321,8434,N
3320,O,953,953,10099,2337,7101,3321,9146,O
3320,P,316,316,10415,918,8019,3321,10099,P
3321,AE,364,364,364,579,579,3322,0,E
3321,AF,410,410,774,240,819,3322,364,F
3321,AG,1257,483,1257,1277,1277,3322,0,A
3321,BG,140,140,1397,180,1457,3322,1257,B
3321,CG,761,138,1535,970,1789,3322,774,G
3321,CF,224,86,1621,235,1692,3322,1397,C
3321,DF,683,597,2218,480,2269,3322,1535,F
3321,DG,605,605,2823,810,3079,3322,2218,G
3321,DH,615,615,3438,4020,7099,3322,2823,H
3321,D,5373,3556,6994,550,2242,3322,1621,D
3321,M,16967,16967,23961,17444,24543,3322,6994,M
3321,N,597,597,24558,180,24723,3322,23961,N
3321,O,690,690,25248,830,25553,3322,24558,O
3321,P,4258,4258,29506,6680,32233,3322,25248,P
3322,AEI,62,62,62,1589,1589,3323,0,A
3322,BEI,1720,1720,1782,240,1829,3323,62,B
3322,CEI,691,691,2473,845,2674,3323,1782,C
3322,DEI,3101,3101,5574,5160,7834,3323,2473,D
3322,EI,5817,243,5817,5935,5935,3323,0,I
3322,EJ,402,402,6219,300,6235,3323,5817,J
3322,EK,664,664,6883,735,6970,3323,6219,K
3322,EL,212,212,7095,1560,8530,3323,6883,L
3322,E,14855,7760,14855,14855,14855,3323,0,E
3322,F,257,257,15112,300,15155,3323,14855,F
3322,G,548,548,15660,735,15890,3323,15112,G
3322,H,135,135,15795,1560,17450,3323,15660,H
3322,M,1735,1735,17530,1790,19240,3323,15795,M
3322,N,346,346,17876,300,19540,3323,17530,N
3322,O,794,794,18670,1015,20555,3323,17876,O
3322,N,190,190,18860,10,20565,3323,18670,N
3322,O,109,109,18969,2630,23195,3323,18860,O
3322,P,7131,7131,26100,1620,24815,3323,18969,P
3323,AE,100,100,100,1015,1015,3324,0,A
3323,BE,115,15,115,178,178,3324,0,E
3323,BF,160,160,275,150,328,3324,115,F
3323,BG,174,174,449,130,458,3324,275,G
3323,BF,1132,783,1232,240,1255,3324,100,B
3323,CF,899,116,1348,930,1388,3324,449,F
3323,CG,325,209,1557,915,2170,3324,1232,C
3323,DG,395,186,1743,645,2033,3324,1348,G
3323,DH,1578,1392,3135,3960,6130,3324,1557,D
3323,H,4835,3443,6578,4290,6323,3324,1743,H
3323,M,883,883,7461,1035,7358,3324,6578,M
3323,N,538,538,7999,410,7768,3324,7461,N
3323,O,817,817,8816,1085,8853,3324,7999,O
3323,N,878,878,9694,650,9503,3324,8816,N
3323,O,396,396,10090,635,10138,3324,9694,O
3323,P,7186,7186,17276,2620,12758,3324,10090,P
3324,A,768,768,768,1444,1444,3325,0,A
3324,B,796,796,1564,180,1624,3325,768,B
3324,C,782,782,2346,795,2419,3325,1564,C
3324,D,1034,1034,3380,550,2969,3325,2346,D
3324,M,2000,2000,5380,2229,5198,3325,3380,M
3324,N,632,632,6012,420,5618,3325,5380,N
3324,O,609,609,6621,831,6449,3325,6012,O
3324,P,3169,3169,9790,414,6863,3325,6621,P
3325,A,232,232,232,949,949,3326,0,A
3325,B,918,918,1150,240,1189,3326,232,B
3325,C,555,555,1705,795,1984,3326,1150,C
3325,D,28880,28880,30585,4020,6004,3326,1705,D
3325,M,212,212,30797,291,6295,3326,30585,M
3325,N,204,204,31001,180,6475,3326,30797,N
3325,O,1102,1102,32103,1245,7720,3326,31001,O
3325,P,123,123,32226,6680,14400,3326,32103,P
3326,A,349,349,349,706,706,3327,0,A
3326,B,517,517,866,180,886,3327,349,B
3326,C,916,916,1782,930,1816,3327,866,C
3326,D,4184,4184,5966,550,2366,3327,1782,D
3326,M,106,106,6072,286,2652,3327,5966,M
3326,N,536,536,6608,420,3072,3327,6072,N
3326,O,435,435,7043,790,3862,3327,6608,O
3326,P,5966,5966,13009,1315,5177,3327,7043,P
3327,AE,586,586,586,665,665,3328,0,A
3327,BE,654,654,1240,610,1275,3328,586,B
3327,CE,380,380,1620,435,1710,3328,1240,C
3327,BE,188,188,1808,150,1860,3328,1620,B
3327,CE,275,275,2083,2645,4505,3328,1808,C
3327,DE,2367,284,2367,3130,3130,3328,0,E
3327,DF,951,951,3318,240,3370,3328,2367,F
3327,DG,1136,1136,4454,1590,4960,3328,3318,G
3327,DF,1545,1545,5999,970,5930,3328,4454,F
3327,DG,650,650,6649,1005,6935,3328,5999,G
3327,DH,1522,1522,8171,3960,10895,3328,6649,H
3327,D,17102,11014,19185,1815,6320,3328,2083,D
3327,M,5921,5921,25106,7226,18121,3328,19185,M
3327,N,1665,1665,26771,420,18541,3328,25106,N
3327,O,691,691,27462,895,19436,3328,26771,O
3327,N,712,712,28174,525,19961,3328,27462,N
3327,O,232,232,28406,390,20351,3328,28174,O
3327,P,507,507,28913,485,20836,3328,28406,P
3328,AEI,562,562,562,752,752,3329,0,A
3328,BEI,392,392,954,240,992,3329,562,B
3328,CEI,330,330,1284,915,1907,3329,954,C
3328,DEI,1501,217,1501,2470,2470,3329,0,I
3328,DEJ,1527,26,1527,2476,2476,3329,0,E
3328,DFJ,991,965,2492,90,2560,3329,1501,J
3328,DFK,974,9,2501,90,2566,3329,1527,F
3328,DGK,485,485,2986,880,3446,3329,2501,G
3328,DFK,513,19,3005,880,3440,3329,2492,K
3328,DFJ,482,482,3487,110,3550,3329,3005,J
3328,DFK,536,35,3522,110,3556,3329,2986,F
3328,DGK,1521,1486,5008,2315,5865,3329,3487,K
3328,DGL,1517,31,5039,2315,5871,3329,3522,G
3328,DHL,108,108,5147,3420,9291,3329,5039,H
3328,DL,140,1,5148,3420,9285,3329,5008,L
3328,D,4738,874,6022,3960,5867,3329,1284,D
3328,M,8599,8599,14621,8578,17869,3329,6022,M
3328,N,30,30,14651,90,17959,3329,14621,N
3328,O,1635,1635,16286,1940,19899,3329,14651,O
3328,N,625,625,16911,335,20234,3329,16286,N
3328,O,396,396,17307,790,21024,3329,16911,O
3328,P,363,363,17670,3780,24804,3329,17307,P
3329,AEI,41,41,41,114,114,3330,0,A
3329,BEI,44,3,44,170,170,3330,0,E
3329,BFI,50,6,50,69,69,3330,0,I
3329,BFJ,103,103,153,135,204,3330,50,J
3329,BFK,157,45,198,135,249,3330,41,B
3329,CFK,178,24,222,90,260,3330,44,F
3329,CGK,196,127,349,295,499,3330,153,K
3329,CGL,230,79,428,295,544,3330,198,C
3329,DGL,130,51,479,5100,5599,3330,349,L
3329,DG,102,51,530,5100,5644,3330,428,D
3329,G,1013,705,1235,1425,1685,3330,222,G
3329,H,54,54,1289,3780,5465,3330,1235,H
3329,M,3487,3487,4776,4136,9780,3330,1289,M
3329,N,716,716,5492,90,9870,3330,4776,N
3329,O,1185,1185,6677,1385,11255,3330,5492,O
3329,N,285,285,6962,110,11365,3330,6677,N
3329,O,229,229,7191,695,12060,3330,6962,O
3329,P,3937,3937,11128,3780,15840,3330,7191,P
3330,AE,331,331,331,266,266,3331,0,E
3330,AF,323,323,654,390,656,3331,331,F
3330,AG,1013,1013,1667,1175,1831,3331,654,G
3330,AF,1246,1246,2913,1190,3021,3331,1667,F
3330,AG,3023,110,3023,4033,4033,3331,0,A
3330,BG,363,253,3276,385,3406,3331,2913,G
3330,BH,1205,952,4228,240,4273,3331,3023,B
3330,CH,1056,1056,5284,1050,5323,3331,4228,C
3330,BH,2903,895,6179,370,3776,3331,3276,H
3330,B,1353,458,6637,1370,6693,3331,5284,B
3330,C,792,792,7429,1080,7773,3331,6637,C
3330,D,211,211,7640,3960,11733,3331,7429,D
3330,M,429,429,8069,756,12489,3331,7640,M
3330,N,987,987,9056,720,13209,3331,8069,N
3330,O,197,197,9253,270,13479,3331,9056,O
3330,N,457,457,9710,365,13844,3331,9253,N
3330,O,1032,1032,10742,1190,15034,3331,9710,O
3330,P,1130,1130,11872,665,15699,3331,10742,P
3331,AE,82,82,82,86,86,3332,0,A
3331,BE,237,237,319,240,326,3332,82,B
3331,CE,221,221,540,245,571,3332,319,C
3331,DE,500,500,1040,5250,5821,3332,540,D
3331,E,1793,753,1793,2160,2160,3332,0,E
3331,F,1308,1308,3101,785,2945,3332,1793,F
3331,G,1208,1208,4309,1200,4145,3332,3101,G
3331,H,1420,1420,5729,550,4695,3332,4309,H
3331,M,6592,6592,12321,8749,14570,3332,5729,M
3331,N,2208,2208,14529,90,14660,3332,12321,N
3331,O,862,862,15391,1195,15855,3332,14529,O
3331,N,891,891,16282,560,16415,3332,15391,N
3331,O,557,557,16839,890,17305,3332,16282,O
3331,P,284,284,17123,3780,21085,3332,16839,P
3332,AEI,68,68,68,119,119,3333,0,I
3332,AEJ,168,100,168,163,163,3333,0,A
3332,BEJ,115,115,283,180,343,3333,168,B
3332,CEJ,245,30,313,240,359,3333,68,J
3332,CEK,251,221,534,335,678,3333,283,C
3332,BEK,501,280,814,780,1139,3333,313,K
3332,BEL,173,173,987,3960,5099,3333,814,L
3332,BE,1642,655,1642,2305,2305,3333,0,E
3332,BF,1186,78,1720,1065,1743,3333,534,B
3332,CF,565,565,2285,540,2283,3333,1720,C
3332,BF,68,68,2353,130,2413,3333,2285,B
3332,CF,831,120,2473,180,2485,3333,1642,F
3332,CG,617,617,3090,615,3100,3333,2473,G
3332,CH,190,190,3280,4140,7240,3333,3090,H
3332,C,1166,239,3519,1260,3673,3333,2353,C
3332,D,1373,1373,4892,5100,8773,3333,3519,D
3332,M,1294,1294,6186,1261,10034,3333,4892,M
3332,N,267,267,6453,360,10394,3333,6186,N
3332,O,517,517,6970,710,11104,3333,6453,O
3332,N,1305,1305,8275,1185,12289,3333,6970,N
3332,O,1668,1668,9943,1940,14229,3333,8275,O
3332,P,261,261,10204,340,14569,3333,9943,P
3333,A,925,925,925,1405,1405,3334,0,A
3333,B,748,748,1673,300,1705,3334,925,B
3333,C,905,905,2578,1045,2750,3334,1673,C
3333,D,714,714,3292,1140,3890,3334,2578,D
3333,M,114,114,3406,115,4005,3334,3292,M
3333,N,291,291,3697,300,4305,3334,3406,N
3333,O,1241,1241,4938,1045,5350,3334,3697,O
3333,P,519,519,5457,1200,6550,3334,4938,P
3334,AE,1,1,1,430,430,3335,0,A
3334,BE,240,239,240,397,397,3335,0,E
3334,BF,277,277,517,180,577,3335,240,F
3334,BG,619,103,620,240,670,3335,1,B
3334,CG,332,229,849,240,817,3335,517,G
3334,CF,1065,836,1685,1035,1705,3335,620,C
3334,BF,1153,317,2002,1245,2062,3335,849,F
3334,BG,1243,926,2928,1275,2980,3335,1685,B
3334,CG,581,581,3509,925,3905,3335,2928,C
3334,DG,1731,224,3733,1800,3862,3335,2002,G
3334,DH,235,11,3744,3960,7865,3335,3509,D
3334,H,3194,3183,6927,360,4222,3335,3733,H
3334,M,1842,1842,8769,2662,10527,3335,6927,M
3334,N,1067,1067,9836,300,10827,3335,8769,N
3334,O,827,827,10663,1000,11827,3335,9836,O
3334,N,634,634,11297,535,12362,3335,10663,N
3334,O,139,139,11436,390,12752,3335,11297,O
3334,P,3057,3057,14493,3960,16712,3335,11436,P
3335,AE,581,581,581,1020,1020,3336,0,A
3335,BE,568,568,1149,180,1200,3336,581,B
3335,CE,343,343,1492,565,1765,3336,1149,C
3335,BE,392,392,1884,125,1890,3336,1492,B
3335,CE,688,688,2572,870,2760,3336,1884,C
3335,DE,201,201,2773,1620,4380,3336,2572,D
3335,E,13402,10629,13402,13460,13460,3336,0,E
3335,F,361,361,13763,300,13760,3336,13402,F
3335,G,552,552,14315,770,14530,3336,13763,G
3335,H,527290,527290,541605,1620,16150,3336,14315,H
3335,M,5850,5850,547455,6221,22371,3336,541605,M
3335,N,776,776,548231,420,22791,3336,547455,N
3335,O,960,960,549191,970,23761,3336,548231,O
3335,P,1996,1996,551187,550,24311,3336,549191,P
3336,A,117,117,117,132,132,3337,0,A
3336,B,108,108,225,135,267,3337,117,B
3336,C,152,152,377,285,552,3337,225,C
3336,D,11843,11843,12220,5160,5712,3337,377,D
3336,M,334,334,12554,604,6316,3337,12220,M
3336,N,1119,1119,13673,180,6496,3337,12554,N
3336,O,156,156,13829,165,6661,3337,13673,O
3336,P,109,109,13938,385,7046,3337,13829,P
3337,A,51,51,51,139,139,3338,0,A
3337,B,289,289,340,240,379,3338,51,B
3337,C,93,93,433,120,499,3338,340,C
3337,D,991,991,1424,550,1049,3338,433,D
3337,M,800,800,2224,1362,2411,3338,1424,M
3337,N,682,682,2906,180,2591,3338,2224,N
3337,O,566,566,3472,740,3331,3338,2906,O
3337,N,857,857,4329,665,3996,3338,3472,N
3337,O,656,656,4985,505,4501,3338,4329,O
3337,P,4016,4016,9001,6000,10501,3338,4985,P
3338,A,2447,2447,2447,2696,2696,3339,0,A
3338,B,438,438,2885,240,2936,3339,2447,B
3338,C,619,619,3504,835,3771,3339,2885,C
3338,B,555,555,4059,215,3986,3339,3504,B
3338,C,1124,1124,5183,1210,5196,3339,4059,C
3338,D,3317,3317,8500,3960,9156,3339,5183,D
3338,M,528,528,9028,1098,10254,3339,8500,M
3338,N,750,750,9778,240,10494,3339,9028,N
3338,O,200,200,9978,295,10789,3339,9778,O
3338,N,1256,1256,11234,1155,11944,3339,9978,N
3338,O,574,574,11808,470,12414,3339,11234,O
3338,P,932,932,12740,5760,18174,3339,11808,P
3339,AE,91,91,91,1679,1679,3340,0,A
3339,BE,1648,1648,1739,300,1979,3340,91,B
3339,CE,700,700,2439,690,2669,3340,1739,C
3339,BE,580,580,3019,390,3059,3340,2439,B
3339,CE,583,583,3602,720,3779,3340,3019,C
3339,DE,2127,2127,5729,3960,7739,3340,3602,D
3339,E,18930,13201,18930,19180,19180,3340,0,E
3339,F,516,516,19446,300,19480,3340,18930,F
3339,G,847,847,20293,890,20370,3340,19446,G
3339,H,1427,1427,21720,310,20680,3340,20293,H
3339,M,64,64,21784,780,21460,3340,21720,M
3339,N,836,836,22620,180,21640,3340,21784,N
3339,O,794,794,23414,840,22480,3340,22620,O
3339,N,1141,1141,24555,1095,23575,3340,23414,N
3339,O,695,695,25250,680,24255,3340,24555,O
3339,P,544,544,25794,5460,29715,3340,25250,P
3340,A,116,116,116,453,453,3341,0,A
3340,B,510,510,626,240,693,3341,116,B
3340,C,955,955,1581,985,1678,3341,626,C
3340,B,674,674,2255,615,2293,3341,1581,B
3340,C,283,283,2538,255,2548,3341,2255,C
3340,D,42,42,2580,5160,7708,3341,2538,D
3340,M,887,887,3467,2345,10053,3341,2580,M
3340,N,1553,1553,5020,150,10203,3341,3467,N
3340,O,524,524,5544,405,10608,3341,5020,O
3340,P,2629,2629,8173,2880,13488,3341,5544,P
3341,AE,234,234,234,735,735,3342,0,A
3341,BE,629,395,629,784,784,3342,0,E
3341,BF,733,338,967,270,1005,3342,234,B
3341,CF,442,104,1071,330,1114,3342,629,F
3341,CG,802,698,1769,2169,3174,3342,967,C
3341,DG,881,183,1952,2164,3278,3342,1071,G
3341,DH,672,672,2624,2491,5769,3342,1952,H
3341,D,1415,560,3184,846,4020,3342,1769,D
3341,M,246,246,3430,441,6210,3342,3184,M
3341,N,721,721,4151,600,6810,3342,3430,N
3341,O,997,997,5148,955,7765,3342,4151,O
3341,P,641,641,5789,385,8150,3342,5148,P
3342,AE,244,244,244,1909,1909,3343,0,E
3342,AF,566,322,566,899,899,3343,0,A
3342,BF,472,472,1038,180,1079,3343,566,B
3342,CF,960,960,1998,900,1979,3343,1038,C
3342,DF,1991,237,2235,240,2149,3343,244,F
3342,DG,1158,1158,3393,1140,3289,3343,2235,G
3342,DH,1945,1945,5338,550,3839,3343,3393,H
3342,D,9574,6234,11572,550,2529,3343,1998,D
3342,M,1199,1199,12771,1393,5232,3343,11572,M
3342,N,264,264,13035,150,5382,3343,12771,N
3342,O,672,672,13707,395,5777,3343,13035,O
3342,P,475,475,14182,660,6437,3343,13707,P
3343,AEI,5,5,5,99,99,3344,0,I
3343,AEJ,33,28,33,379,379,3344,0,E
3343,AFJ,306,278,311,240,339,3344,5,J
3343,AFK,554,276,587,240,619,3344,33,F
3343,AGK,514,238,825,780,1119,3344,311,K
3343,AGL,136,136,961,4020,5139,3344,825,L
3343,AG,514,140,1101,790,1409,3344,587,G
3343,AH,1153,52,1153,1250,1250,3344,0,A
3343,BH,137,85,1238,3960,5369,3344,1101,H
3343,B,296,211,1449,240,1490,3344,1153,B
3343,C,1055,1055,2504,1180,2670,3344,1449,C
3343,D,505,505,3009,3960,6630,3344,2504,D
3343,M,1434,1434,4443,1660,8290,3344,3009,M
3343,N,475,475,4918,300,8590,3344,4443,N
3343,O,243,243,5161,895,9485,3344,4918,O
3343,N,733,733,5894,75,9560,3344,5161,N
3343,O,232,232,6126,385,9945,3344,5894,O
3343,P,7208,7208,13334,4020,13965,3344,6126,P
3344,AEI,959,959,959,1031,1031,3345,0,I
3344,AEJ,276,276,1235,240,1271,3345,959,J
3344,AEK,1456,221,1456,1442,1442,3345,0,E
3344,AFK,374,153,1609,915,2186,3345,1235,K
3344,AFL,167,14,1623,150,1592,3345,1456,F
3344,AGL,138,138,1761,400,1992,3345,1623,G
3344,AFL,1145,1145,2906,960,2952,3345,1761,F
3344,AGL,3336,430,3336,12661,12661,3345,0,A
3344,BGL,436,6,3342,650,3602,3345,2906,G
3344,BHL,3318,1585,4927,3960,6146,3345,1609,L
3344,BH,5956,4371,9298,4230,7832,3345,3342,H
3344,B,9513,3551,12849,240,12901,3345,3336,B
3344,C,1001,1001,13850,1330,14231,3345,12849,C
3344,D,8353,8353,22203,780,15011,3345,13850,D
3344,M,1324,1324,23527,1675,16686,3345,22203,M
3344,N,381,381,23908,90,16776,3345,23527,N
3344,O,1694,1694,25602,1875,18651,3345,23908,O
3344,N,648,648,26250,450,19101,3345,25602,N
3344,O,856,856,27106,940,20041,3345,26250,O
3344,P,7368,7368,34474,3780,23821,3345,27106,P
3345,AEI,45,45,45,771,771,3346,0,I
3345,AEJ,86,41,86,108,108,3346,0,A
3345,BEJ,137,137,223,180,288,3346,86,B
3345,CEJ,147,147,370,265,553,3346,223,C
3345,BEJ,438,68,438,795,795,3346,0,E
3345,BFJ,473,473,911,180,975,3346,438,F
3345,BGJ,545,4,915,415,968,3346,370,B
3345,CGJ,907,37,952,240,1011,3346,45,J
3345,CGK,146,109,1061,285,1253,3346,915,C
3345,DGK,136,27,1088,285,1296,3346,952,K
3345,DGL,77,50,1138,5100,6353,3346,1061,D
3345,GL,237,10,1148,140,1115,3346,911,G
3345,HL,38,38,1186,2880,3995,3346,1148,H
3345,L,2954,2856,4042,5100,6396,3346,1088,L
3345,M,150,150,4192,233,6629,3346,4042,M
3345,N,263,263,4455,240,6869,3346,4192,N
3345,O,827,827,5282,960,7829,3346,4455,O
3345,N,2116,2116,7398,1905,9734,3346,5282,N
3345,O,921,921,8319,1114,10848,3346,7398,O
3345,P,645,645,8964,341,11189,3346,8319,P
3346,AEI,21,21,21,64,64,3347,0,E
3346,AFI,109,88,109,724,724,3347,0,A
3346,BFI,122,13,122,865,865,3347,0,I
3346,BFJ,125,24,146,135,199,3347,21,F
3346,BGJ,802,765,911,240,964,3347,109,B
3346,CGJ,933,144,1055,240,1105,3347,122,J
3346,CGK,167,23,1078,300,1264,3347,911,C
3346,DGK,106,106,1184,5100,6364,3347,1078,D
3346,GK,309,180,1364,300,1405,3347,1055,K
3346,GL,481,481,1845,5100,6505,3347,1364,L
3346,G,3063,1364,3209,295,494,3347,146,G
3346,H,35,35,3244,5100,5594,3347,3209,H
3346,M,842,842,4086,3316,9821,3347,3244,M
3346,N,2325,2325,6411,180,10001,3347,4086,N
3346,O,461,461,6872,895,10896,3347,6411,O
3346,N,943,943,7815,240,11136,3347,6872,N
3346,O,711,711,8526,660,11796,3347,7815,O
3346,P,3234,3234,11760,6660,18456,3347,8526,P
3347,AE,59,59,59,1121,1121,3348,0,A
3347,BE,75,16,75,1133,1133,3348,0,E
3347,BF,1276,1260,1335,240,1361,3348,59,B
3347,CF,1272,12,1347,240,1373,3348,75,F
3347,CG,695,683,2030,760,2121,3348,1335,C
3347,DG,119,119,2149,7740,9861,3348,2030,D
3347,G,828,26,2175,760,2133,3348,1347,G
3347,H,3619,3619,5794,7740,9873,3348,2175,H
3347,M,1137,1137,6931,1484,11357,3348,5794,M
3347,N,577,577,7508,300,11657,3348,6931,N
3347,O,631,631,8139,820,12477,3348,7508,O
3347,N,608,608,8747,410,12887,3348,8139,N
3347,O,408,408,9155,465,13352,3348,8747,O
3347,P,2393,2393,11548,5760,19112,3348,9155,P
3348,AEI,35,35,35,112,112,3349,0,A
3348,BEI,144,109,144,153,153,3349,0,E
3348,BFI,194,85,229,150,262,3349,35,B
3348,CFI,112,27,256,150,303,3349,144,F
3348,CGI,328,72,328,479,479,3349,0,I
3348,CGJ,327,327,655,240,719,3349,328,J
3348,CGK,610,184,839,765,1027,3349,229,C
3348,DGK,408,408,1247,3600,4627,3349,839,D
3348,GK,1104,113,1360,135,438,3349,256,G
3348,HK,830,125,1485,975,1694,3349,655,K
3348,HJ,207,82,1567,4230,4668,3349,1360,H
3348,J,766,684,2251,615,2309,3349,1485,J
3348,K,197,197,2448,255,2564,3349,2251,K
3348,L,191,191,2639,5160,7724,3349,2448,L
3348,M,2514,2514,5153,2562,10286,3349,2639,M
3348,N,141,141,5294,150,10436,3349,5153,N
3348,O,141,141,5435,135,10571,3349,5294,O
3348,N,424,424,5859,415,10986,3349,5435,N
3348,O,130,130,5989,120,11106,3349,5859,O
3348,P,1031,1031,7020,4230,15336,3349,5989,P
3349,AEI,16,16,16,151,151,3350,0,E
3349,AFI,92,76,92,157,157,3350,0,I
3349,AFJ,173,81,173,177,177,3350,0,A
3349,BFJ,151,70,243,135,292,3350,92,J
3349,BFK,243,16,259,135,286,3350,16,F
3349,BGK,174,88,347,135,312,3350,173,B
3349,CGK,182,78,425,285,577,3350,243,K
3349,CGL,110,110,535,5160,5737,3350,425,L
3349,CG,289,13,548,285,571,3350,259,G
3349,CH,226,25,573,285,597,3350,347,C
3349,DH,180,180,753,5160,5757,3350,573,D
3349,H,260,55,808,5160,5731,3350,548,H
3349,M,744,744,1552,1075,6832,3350,808,M
3349,N,592,592,2144,300,7132,3350,1552,N
3349,O,602,602,2746,740,7872,3350,2144,O
3349,P,708,708,3454,3960,11832,3350,2746,P
3350,A,393,393,393,528,528,3351,0,A
3350,B,259,259,652,150,678,3351,393,B
3350,C,849,849,1501,1110,1788,3351,652,C
3350,B,361,361,1862,105,1893,3351,1501,B
3350,C,643,643,2505,735,2628,3351,1862,C
3350,D,3069,3069,5574,4230,6858,3351,2505,D
3350,M,319,319,5893,609,7467,3351,5574,M
3350,N,530,530,6423,300,7767,3351,5893,N
3350,O,887,887,7310,890,8657,3351,6423,O
3350,P,2353,2353,9663,385,9042,3351,7310,P
3351,AE,143,143,143,325,325,3352,0,A
3351,BE,433,290,433,1809,1809,3352,0,E
3351,BF,292,2,435,170,495,3352,143,B
3351,CF,543,543,978,495,990,3352,435,C
3351,DF,428,428,1406,385,1375,3352,978,D
3351,F,1894,921,2327,540,2349,3352,433,F
3351,G,800,800,3127,780,3129,3352,2327,G
3351,H,1741,1741,4868,550,3679,3352,3127,H
3351,M,817,817,5685,4342,8021,3352,4868,M
3351,N,3973,3973,9658,510,8531,3352,5685,N
3351,O,891,891,10549,1258,9789,3352,9658,O
3351,P,4417,4417,14966,887,10676,3352,10549,P
3352,AEI,83,83,83,1167,1167,3353,0,E
3352,AFI,173,90,173,1203,1203,3353,0,A
3352,BFI,189,16,189,1202,1202,3353,0,I
3352,BFJ,1276,1170,1359,240,1407,3353,83,F
3352,BGJ,1207,37,1396,240,1442,3353,189,J
3352,BGK,1224,1,1397,240,1443,3353,173,B
3352,CGK,741,741,2138,760,2203,3353,1397,C
3352,DGK,744,2,2140,760,2202,3353,1396,K
3352,DGL,794,13,2153,760,2167,3353,1359,G
3352,DHL,27,12,2165,7680,9883,3353,2138,D
3352,HL,66,54,2219,7680,9847,3353,2153,H
3352,L,1287,1208,3427,7680,9882,3353,2140,L
3352,M,1130,1130,4557,1581,11464,3353,3427,M
3352,N,688,688,5245,300,11764,3353,4557,N
3352,O,689,689,5934,825,12589,3353,5245,O
3352,N,1230,1230,7164,1080,13669,3353,5934,N
3352,O,345,345,7509,540,14209,3353,7164,O
3352,P,22774,22774,30283,2880,17089,3353,7509,P
3353,A,7,7,7,25,25,3354,0,A
3353,B,296,296,303,300,325,3354,7,B
3353,C,439,439,742,541,866,3354,303,C
3353,D,2246,2246,2988,4080,4946,3354,742,D
3353,M,1487,1487,4475,2330,7276,3354,2988,M
3353,N,1098,1098,5573,300,7576,3354,4475,N
3353,O,266,266,5839,435,8011,3354,5573,O
3353,N,562,562,6401,375,8386,3354,5839,N
3353,O,667,667,7068,870,9256,3354,6401,O
3353,P,230,230,7298,1620,10876,3354,7068,P
3354,AE,44,44,44,1360,1360,3355,0,E
3354,AF,51,7,51,2070,2070,3355,0,A
3354,BF,1422,1415,1466,150,1510,3355,44,F
3354,BG,572,572,2038,635,2145,3355,1466,G
3354,BH,2139,152,2190,165,2235,3355,51,B
3354,CH,262,110,2300,4230,6375,3355,2038,H
3354,C,858,748,3048,1075,3310,3355,2190,C
3354,D,1056,1056,4104,3960,7270,3355,3048,D
3354,M,3433,3433,7537,4229,11499,3355,4104,M
3354,N,858,858,8395,90,11589,3355,7537,N
3354,O,486,486,8881,855,12444,3355,8395,O
3354,N,1217,1217,10098,880,13324,3355,8881,N
3354,O,995,995,11093,915,14239,3355,10098,O
3354,P,550,550,11643,3780,18019,3355,11093,P
3355,AEI,138,138,138,1115,1115,3356,0,I
3355,AEJ,1010,1010,1148,90,1205,3356,138,J
3355,AEK,1892,744,1892,4167,4167,3356,0,E
3355,AFK,1024,280,2172,1220,2425,3356,1148,K
3355,AFJ,413,413,2585,195,2620,3356,2172,J
3355,AFK,258,258,2843,585,3205,3356,2585,K
3355,AFL,2311,1360,4203,90,4257,3356,1892,F
3355,AGL,162,162,4365,585,4842,3356,4203,G
3355,AHL,5387,3865,8230,3780,6985,3356,2843,L
3355,AH,11613,7748,15978,3780,8622,3356,4365,H
3355,A,32349,16371,32349,33087,33087,3356,0,A
3355,B,768,768,33117,90,33177,3356,32349,B
3355,C,957,957,34074,1240,34417,3356,33117,C
3355,B,337,337,34411,40,34457,3356,34074,B
3355,C,206,206,34617,585,35042,3356,34411,C
3355,D,133,133,34750,3780,38822,3356,34617,D
3355,M,82,82,34832,277,39099,3356,34750,M
3355,N,220,220,35052,90,39189,3356,34832,N
3355,O,264,264,35316,575,39764,3356,35052,O
3355,N,1126,1126,36442,800,40564,3356,35316,N
3355,O,852,852,37294,1285,41849,3356,36442,O
3355,P,2201,2201,39495,3780,45629,3356,37294,P
3356,AEI,455,455,455,623,623,3357,0,A
3356,BEI,198,198,653,90,713,3357,455,B
3356,CEI,590,590,1243,820,1533,3357,653,C
3356,BEI,608,608,1851,375,1908,3357,1243,B
3356,CEI,381,381,2232,740,2648,3357,1851,C
3356,DEI,3097,865,3097,3326,3326,3357,0,E
3356,DFI,3333,236,3333,3492,3492,3357,0,I
3356,DFJ,257,21,3354,90,3416,3357,3097,F
3356,DGJ,1149,27,3381,3780,6428,3357,2232,D
3356,GJ,199,151,3532,90,3582,3357,3333,J
3356,GK,511,333,3865,820,4236,3357,3354,G
3356,FK,446,113,3978,800,4382,3357,3532,K
3356,FJ,683,570,4548,375,4611,3357,3865,F
3356,GJ,455,455,5003,740,5351,3357,4548,G
3356,HJ,992,992,5995,3780,9131,3357,5003,H
3356,J,2183,166,6161,1835,6217,3357,3978,J
3356,K,413,413,6574,735,6952,3357,6161,K
3356,L,4020,4020,10594,3780,10732,3357,6574,L
3356,M,1043,1043,11637,1588,12320,3357,10594,M
3356,N,845,845,12482,360,12680,3357,11637,N
3356,O,1097,1097,13579,1495,14175,3357,12482,O
3356,N,915,915,14494,495,14670,3357,13579,N
3356,O,799,799,15293,831,15501,3357,14494,O
3356,P,2608,2608,17901,414,15915,3357,15293,P
3357,AEI,22,22,22,136,136,3358,0,I
3357,AEJ,173,151,173,1059,1059,3358,0,E
3357,AFJ,216,65,238,150,286,3358,22,J
3357,AFK,198,198,436,745,1031,3358,238,K
3357,AFL,549,113,549,3837,3837,3358,0,A
3357,BFL,972,596,1145,150,1209,3358,173,F
3357,BGL,167,167,1312,130,1339,3358,1145,G
3357,BHL,321,321,1633,2880,4219,3358,1312,H
3357,BL,1857,660,2293,3600,4631,3358,436,L
3357,B,3317,1573,3866,90,3927,3358,549,B
3357,C,761,761,4627,1240,5167,3358,3866,C
3357,D,3242,3242,7869,3780,8947,3358,4627,D
3357,M,250,250,8119,882,9829,3358,7869,M
3357,N,810,810,8929,240,10069,3358,8119,N
3357,O,179,179,9108,295,10364,3358,8929,O
3357,N,1276,1276,10384,1155,11519,3358,9108,N
3357,O,349,349,10733,465,11984,3358,10384,O
3357,P,6951,6951,17684,5760,17744,3358,10733,P
3358,AEI,4174,4174,4174,6000,6000,3359,0,A
3358,BEI,4583,409,4583,4667,4667,3359,0,I
3358,BEJ,241,241,4824,230,4897,3359,4583,J
3358,BEK,611,611,5435,575,5472,3359,4824,K
3358,BEL,2085,824,6259,300,6300,3359,4174,B
3358,CEL,1437,613,6872,385,5857,3359,5435,L
3358,CE,870,257,7129,895,7195,3359,6259,C
3358,DE,7237,108,7237,7486,7486,3359,0,E
3358,DF,453,453,7690,240,7726,3359,7237,F
3358,DG,741,741,8431,995,8721,3359,7690,G
3358,DF,724,724,9155,410,9131,3359,8431,F
3358,DG,905,905,10060,810,9941,3359,9155,G
3358,DH,4030,1099,11159,550,7745,3359,7129,D
3358,H,2182,1083,12242,3960,13901,3359,10060,H
3358,M,660,660,12902,1162,15063,3359,12242,M
3358,N,1237,1237,14139,780,15843,3359,12902,N
3358,O,980,980,15119,1220,17063,3359,14139,O
3358,P,4112,4112,19231,635,17698,3359,15119,P
3359,AE,26,26,26,99,99,3360,0,E
3359,AF,126,100,126,160,160,3360,0,A
3359,BF,167,67,193,150,249,3360,26,F
3359,BG,141,141,334,830,1079,3360,193,G
3359,BH,241,33,367,270,430,3360,126,B
3359,CH,154,154,521,640,1070,3360,367,C
3359,DH,569,382,903,3490,4569,3360,334,H
3359,D,782,400,1303,3690,4760,3360,521,D
3359,M,227,227,1530,359,5119,3360,1303,M
3359,N,236,236,1766,180,5299,3360,1530,N
3359,O,809,809,2575,960,6259,3360,1766,O
3359,N,1700,1700,4275,1520,7779,3360,2575,N
3359,O,686,686,4961,820,8599,3360,4275,O
3359,P,201,201,5162,9700,18299,3360,4961,P
3360,AE,44,44,44,197,197,3361,0,E
3360,AF,59,15,59,54,54,3361,0,A
3360,BF,86,86,145,150,204,3361,59,B
3360,CF,333,232,377,240,437,3361,44,F
3360,CG,288,56,433,380,584,3361,145,C
3360,DG,268,212,645,380,817,3361,377,G
3360,DH,617,405,1050,5460,6044,3361,433,D
3360,H,620,215,1265,5460,6277,3361,645,H
3360,M,525,525,1790,1107,7384,3361,1265,M
3360,N,678,678,2468,150,7534,3361,1790,N
3360,O,225,225,2693,185,7719,3361,2468,O
3360,N,319,319,3012,355,8074,3361,2693,N
3360,O,126,126,3138,120,8194,3361,3012,O
3360,P,1036,1036,4174,4230,12424,3361,3138,P
3361,A,83,83,83,3145,3145,3362,0,A
3361,B,3250,3250,3333,240,3385,3362,83,B
3361,C,925,925,4258,930,4315,3362,3333,C
3361,D,263,263,4521,550,4865,3362,4258,D
3361,M,1152,1152,5673,1510,6375,3362,4521,M
3361,N,1066,1066,6739,780,7155,3362,5673,N
3361,O,1245,1245,7984,1774,8929,3362,6739,O
3361,P,10681,10681,18665,336,9265,3362,7984,P
3362,AEI,140,140,140,802,802,3363,0,E
3362,AFI,342,202,342,1042,1042,3363,0,A
3362,BFI,376,34,376,866,866,3363,0,I
3362,BFJ,520,520,896,90,956,3363,376,J
3362,BFK,853,97,993,240,1042,3363,140,F
3362,BGK,798,147,1140,150,1192,3363,342,B
3362,CGK,141,141,1281,125,1317,3363,1140,C
3362,BGK,321,33,1314,915,1957,3363,993,G
3362,BHK,145,112,1426,155,1472,3363,1281,B
3362,CHK,335,335,1761,650,2122,3363,1426,C
3362,DHK,1414,549,2310,2315,3271,3363,896,K
3362,DHL,1851,855,3165,3960,5917,3363,1314,H
3362,DL,1952,548,3713,4230,6352,3363,1761,D
3362,L,7188,5785,9498,3420,6691,3363,2310,L
3362,M,1143,1143,10641,360,7051,3363,9498,M
3362,N,383,383,11024,1225,8276,3363,10641,N
3362,O,338,338,11362,805,9081,3363,11024,O
3362,N,1439,1439,12801,930,10011,3363,11362,N
3362,O,595,595,13396,760,10771,3363,12801,O
3362,P,2642,2642,16038,4020,14791,3363,13396,P
3363,AE,1699,1699,1699,2756,2756,3364,0,A
3363,BE,1090,1090,2789,90,2846,3364,1699,B
3363,CE,759,759,3548,935,3781,3364,2789,C
3363,BE,287,287,3835,50,3831,3364,3548,B
3363,CE,1512,1512,5347,2320,6151,3364,3835,C
3363,DE,5616,5616,10963,3420,9571,3364,5347,D
3363,E,26190,15227,26190,27137,27137,3364,0,E
3363,F,977,977,27167,90,27227,3364,26190,F
3363,G,570,570,27737,880,28107,3364,27167,G
3363,F,1894,1894,29631,1550,29657,3364,27737,F
3363,G,1410,1410,31041,2315,31972,3364,29631,G
3363,H,4015,4015,35056,3420,35392,3364,31041,H
3363,M,1034,1034,36090,1374,36766,3364,35056,M
3363,N,460,460,36550,180,36946,3364,36090,N
3363,O,1135,1135,37685,885,37831,3364,36550,O
3363,P,472,472,38157,660,38491,3364,37685,P
3364,AE,12,12,12,382,382,3365,0,A
3364,BE,32,20,32,369,369,3365,0,E
3364,BF,415,415,447,135,504,3365,32,F
3364,BG,475,40,487,135,517,3365,12,B
3364,CG,179,139,626,295,799,3365,447,G
3364,CH,197,58,684,295,812,3365,487,C
3364,DH,136,78,762,5100,5899,3365,626,H
3364,D,83,5,767,5100,5912,3365,684,D
3364,M,1685,1685,2452,2335,8247,3365,767,M
3364,N,813,813,3265,180,8427,3365,2452,N
3364,O,512,512,3777,895,9322,3365,3265,O
3364,N,683,683,4460,320,9642,3365,3777,N
3364,O,452,452,4912,565,10207,3365,4460,O
3364,P,5357,5357,10269,6960,17167,3365,4912,P
3365,A,1451,1451,1451,1421,1421,3366,0,A
3365,B,128,128,1579,210,1631,3366,1451,B
3365,C,138,138,1717,230,1861,3366,1579,C
3365,B,596,596,2313,515,2376,3366,1717,B
3365,C,163,163,2476,385,2761,3366,2313,C
3365,D,79,79,2555,6910,9671,3366,2476,D
3365,M,243,243,2798,163,9834,3366,2555,M
3365,N,107,107,2905,240,10074,3366,2798,N
3365,O,125,125,3030,390,10464,3366,2905,O
3365,N,974,974,4004,700,11164,3366,3030,N
3365,O,514,514,4518,785,11949,3366,4004,O
3365,P,1053,1053,5571,3960,15909,3366,4518,P
3366,AE,406,406,406,535,535,3367,0,E
3366,AF,175,175,581,240,775,3367,406,F
3366,AG,733,152,733,1339,1339,3367,0,A
3366,BG,887,887,1620,330,1669,3367,733,B
3366,CG,1512,473,2093,1680,2455,3367,581,G
3366,CF,812,339,2432,2169,3838,3367,1620,C
3366,DF,1068,729,3161,756,3211,3367,2093,F
3366,DG,1417,688,3849,886,4724,3367,2432,D
3366,G,1132,444,4293,2169,5380,3367,3161,G
3366,H,1475,1475,5768,846,6226,3367,4293,H
3366,M,1703,1703,7471,1750,7976,3367,5768,M
3366,N,3015,3015,10486,780,8756,3367,7471,N
3366,O,917,917,11403,985,9741,3367,10486,O
3366,P,2585,2585,13988,550,10291,3367,11403,P
3367,AE,239,239,239,1348,1348,3368,0,E
3367,AF,881,642,881,1071,1071,3368,0,A
3367,BF,392,392,1273,240,1311,3368,881,B
3367,CF,1326,292,1565,240,1588,3368,239,F
3367,CG,332,40,1605,915,2226,3368,1273,C
3367,DG,290,250,1855,915,2503,3368,1565,G
3367,DH,1602,1602,3457,3960,6463,3368,1855,H
3367,D,4735,2883,6340,3960,6186,3368,1605,D
3367,M,2913,2913,9253,3173,9636,3368,6340,M
3367,N,286,286,9539,90,9726,3368,9253,N
3367,O,1641,1641,11180,1940,11666,3368,9539,O
3367,N,960,960,12140,660,12326,3368,11180,N
3367,O,543,543,12683,800,13126,3368,12140,O
3367,P,2955,2955,15638,3780,16906,3368,12683,P
3368,AEI,258,258,258,1131,1131,3369,0,I
3368,AEJ,1054,1054,1312,240,1371,3369,258,J
3368,AEK,458,458,1770,750,2121,3369,1312,K
3368,AEL,2576,806,2576,5527,5527,3369,0,A
3368,BEL,3071,3071,5647,180,5707,3369,2576,B
3368,CEL,1564,1564,7211,830,6537,3369,5647,C
3368,BEL,404,404,7615,1130,7667,3369,7211,B
3368,CEL,444,444,8059,690,8357,3369,7615,C
3368,DEL,1703,1703,9762,6660,15017,3369,8059,D
3368,EL,8179,187,9949,3540,5661,3369,1770,L
3368,E,11682,1733,11682,12765,12765,3369,0,E
3368,F,1367,1367,13049,300,13065,3369,11682,F
3368,G,1089,1089,14138,1045,14110,3369,13049,G
3368,H,727,727,14865,1200,15310,3369,14138,H
3368,M,892,892,15757,2194,17504,3369,14865,M
3368,N,396,396,16153,90,17594,3369,15757,N
3368,O,498,498,16651,820,18414,3369,16153,O
3368,N,1740,1740,18391,475,18889,3369,16651,N
3368,O,1294,1294,19685,1470,20359,3369,18391,O
3368,P,1458,1458,21143,3780,24139,3369,19685,P
3369,AE,296,296,296,475,475,3370,0,E
3369,AF,377,81,377,669,669,3370,0,A
3369,BF,264,183,560,180,655,3370,296,F
3369,BG,280,97,657,630,1299,3370,377,B
3369,CG,383,286,943,660,1315,3370,560,G
3369,CF,488,202,1145,100,1399,3370,657,C
3369,DF,977,775,1920,665,1980,3370,943,F
3369,DG,916,916,2836,835,2815,3370,1920,G
3369,DH,2981,1290,4126,2880,4279,3370,1145,D
3369,H,2680,1390,5516,4020,6835,3370,2836,H
3369,M,6970,6970,12486,7059,13894,3370,5516,M
3369,N,270,270,12756,240,14134,3370,12486,N
3369,O,282,282,13038,405,14539,3370,12756,O
3369,N,1732,1732,14770,1575,16114,3370,13038,N
3369,O,1030,1030,15800,1225,17339,3370,14770,O
3369,P,116,116,15916,3960,21299,3370,15800,P
3370,AE,3325,3325,3325,4350,4350,3371,0,A
3370,BE,1328,1328,4653,300,4650,3371,3325,B
3370,CE,1221,1221,5874,1045,5695,3371,4653,C
3370,DE,6201,327,6201,7260,7260,3371,0,E
3370,DF,550,223,6424,1200,6895,3371,5874,D
3370,F,1314,1091,7515,300,7560,3371,6201,F
3370,G,1285,1285,8800,1045,8605,3371,7515,G
3370,H,600,600,9400,1200,9805,3371,8800,H
3370,M,757,757,10157,776,10581,3371,9400,M
3370,N,255,255,10412,260,10841,3371,10157,N
3370,O,527,527,10939,525,11366,3371,10412,O
3370,N,2355,2355,13294,2375,13741,3371,10939,N
3370,O,1341,1341,14635,2205,15946,3371,13294,O
3370,P,400,400,15035,1780,17726,3371,14635,P
3371,AEI,220,220,220,893,893,3372,0,I
3371,AEJ,620,400,620,1169,1169,3372,0,E
3371,AFJ,724,324,944,90,983,3372,220,J
3371,AFK,673,349,1293,180,1349,3372,620,F
3371,AGK,557,208,1501,845,1828,3372,944,K
3371,AGL,783,575,2076,885,2234,3372,1293,G
3371,AFL,605,30,2106,3780,5608,3372,1501,L
3371,AF,878,848,2954,780,3014,3372,2076,F
3371,AG,606,606,3560,680,3694,3372,2954,G
3371,AH,2071,2071,5631,5460,9154,3372,3560,H
3371,A,25346,19715,25346,26944,26944,3372,0,A
3371,B,1632,1632,26978,90,27034,3372,25346,B
3371,C,1094,1094,28072,1210,28244,3372,26978,C
3371,B,320,320,28392,205,28449,3372,28072,B
3371,C,472,472,28864,850,29299,3372,28392,C
3371,D,739,739,29603,3780,33079,3372,28864,D
3371,M,411,411,30014,889,33968,3372,29603,M
3371,N,754,754,30768,300,34268,3372,30014,N
3371,O,629,629,31397,910,35178,3372,30768,O
3371,N,224,224,31621,5,35183,3372,31397,N
3371,O,812,812,32433,1260,36443,3372,31621,O
3371,P,1486,1486,33919,3960,40403,3372,32433,P
3372,A,14279,14279,14279,14715,14715,3373,0,A
3372,B,711,711,14990,300,15015,3373,14279,B
3372,C,555,555,15545,755,15770,3373,14990,C
3372,D,110,110,15655,1560,17330,3373,15545,D
3372,M,1521,1521,17176,1613,18943,3373,15655,M
3372,N,291,291,17467,240,19183,3373,17176,N
3372,O,917,917,18384,995,20178,3373,17467,O
3372,N,672,672,19056,670,20848,3373,18384,N
3372,O,526,526,19582,660,21508,3373,19056,O
3372,P,4067,4067,23649,3960,25468,3373,19582,P
3373,AEI,200,200,200,347,347,3374,0,A
3373,BEI,580,380,580,1435,1435,3374,0,I
3373,BEJ,975,975,1555,180,1615,3374,580,J
3373,BEK,1597,242,1797,1500,1847,3374,200,B
3373,CEK,1984,187,1984,2524,2524,3374,0,E
3373,CFK,766,337,2321,945,2560,3374,1555,K
3373,CFJ,816,292,2613,995,2842,3374,1797,C
3373,BFJ,635,6,2619,155,2679,3374,1984,F
3373,BGJ,988,988,3607,1215,3894,3374,2619,G
3373,BFJ,1089,95,3702,910,3752,3374,2613,B
3373,CFJ,125,125,3827,165,3917,3374,3702,C
3373,DFJ,1874,368,4195,1705,4265,3374,2321,J
3373,DFK,693,105,4300,505,4399,3374,3607,F
3373,DGK,230,125,4425,390,4655,3374,4195,K
3373,DGL,719,121,4546,5100,9017,3374,3827,D
3373,GL,249,3,4549,385,4784,3374,4300,G
3373,HL,1918,1918,6467,1505,6289,3374,4549,H
3373,L,4942,2900,9367,485,5140,3374,4425,L
3373,M,716,716,10083,742,9759,3374,9367,M
3373,N,116,116,10199,150,9909,3374,10083,N
3373,O,412,412,10611,661,10570,3374,10199,O
3373,N,3045,3045,13656,2785,13355,3374,10611,N
3373,O,660,660,14316,910,14265,3374,13656,O
3373,P,3969,3969,18285,5160,19425,3374,14316,P
3374,AE,76,76,76,630,630,3375,0,E
3374,AF,247,171,247,334,334,3375,0,A
3374,BF,174,174,421,150,484,3375,247,B
3374,CF,62,62,483,80,564,3375,421,C
3374,DF,36,36,519,2880,3444,3375,483,D
3374,F,735,292,811,240,870,3375,76,F
3374,G,147,147,958,285,1155,3375,811,G
3374,H,1295,1295,2253,5100,6255,3375,958,H
3374,M,33,33,2286,1219,7474,3375,2253,M
3374,N,1296,1296,3582,165,7639,3375,2286,N
3374,O,555,555,4137,825,8464,3375,3582,O
3374,P,410,410,4547,3960,12424,3375,4137,P
3375,AEI,330,330,330,430,430,3376,0,A
3375,BEI,510,180,510,550,550,3376,0,I
3375,BEJ,345,165,675,300,730,3376,330,B
3375,CEJ,295,130,805,300,850,3376,510,J
3375,CEK,1190,385,1190,1560,1560,3376,0,E
3375,CFK,619,104,1294,790,1520,3376,675,C
3375,BFK,828,339,1633,750,1600,3376,805,K
3375,BFJ,406,67,1700,235,1755,3376,1294,B
3375,CFJ,617,107,1807,300,1860,3376,1190,F
3375,CGJ,320,146,1953,405,2005,3376,1633,J
3375,CGK,400,147,2100,375,2130,3376,1700,C
3375,DGK,410,263,2363,450,2455,3376,1953,K
3375,DGL,972,416,2779,1105,2965,3376,1807,G
3375,DHL,1480,801,3580,1140,3270,3376,2100,D
3375,HL,1396,179,3759,1140,3595,3376,2363,L
3375,H,2966,1986,5745,1140,4105,3376,2779,H
3375,M,290,290,6035,309,4414,3376,5745,M
3375,N,245,245,6280,300,4714,3376,6035,N
3375,O,796,796,7076,825,5539,3376,6280,O
3375,N,1084,1084,8160,1030,6569,3376,7076,N
3375,O,18,18,8178,175,6744,3376,8160,O
3375,P,101,101,8279,5280,12024,3376,8178,P
3376,AE,128,128,128,358,358,3377,0,A
3376,BE,390,390,518,240,598,3377,128,B
3376,CE,1590,1072,1590,2350,2350,3377,0,E
3376,CF,2107,1035,2625,1310,1908,3377,518,C
3376,DF,1325,290,2915,660,3010,3377,1590,F
3376,DG,625,625,3540,690,3700,3377,2915,G
3376,DF,293,293,3833,175,3875,3377,3540,F
3376,DG,781,781,4614,815,4690,3377,3833,G
3376,DH,2111,122,4736,460,2368,3377,2625,D
3376,H,1657,1535,6271,550,5240,3377,4614,H
3376,M,166,166,6437,794,6034,3377,6271,M
3376,N,1049,1049,7486,420,6454,3377,6437,N
3376,O,1077,1077,8563,1259,7713,3377,7486,O
3376,P,800,800,9363,351,8064,3377,8563,P
3377,A,3163,3163,3163,4237,4237,3378,0,A
3377,B,1349,1349,4512,240,4477,3378,3163,B
3377,C,801,801,5313,915,5392,3378,4512,C
3377,B,574,574,5887,695,6087,3378,5313,B
3377,C,331,331,6218,415,6502,3378,5887,C
3377,D,4167,4167,10385,1445,7947,3378,6218,D
3377,M,227,227,10612,751,8698,3378,10385,M
3377,N,623,623,11235,150,8848,3378,10612,N
3377,O,160,160,11395,125,8973,3378,11235,O
3377,N,366,366,11761,380,9353,3378,11395,N
3377,O,688,688,12449,780,10133,3378,11761,O
3377,P,645,645,13094,4230,14363,3378,12449,P
3378,AE,140,140,140,432,432,3379,0,E
3378,AF,392,392,532,150,582,3379,140,F
3378,AG,238,238,770,180,762,3379,532,G
3378,AH,497,497,1267,385,1147,3379,770,H
3378,A,1353,86,1353,2249,2249,3379,0,A
3378,B,2290,2290,3643,1470,3719,3379,1353,B
3378,C,538,538,4181,575,4294,3379,3643,C
3378,D,3598,3598,7779,550,4844,3379,4181,D
3378,M,1294,1294,9073,4646,9490,3379,7779,M
3378,N,3399,3399,12472,90,9580,3379,9073,N
3378,O,828,828,13300,1215,10795,3379,12472,O
3378,N,1794,1794,15094,1415,12210,3379,13300,N
3378,O,637,637,15731,890,13100,3379,15094,O
3378,P,1272,1272,17003,3780,16880,3379,15731,P
3379,AEI,57,57,57,170,170,3380,0,A
3379,BEI,200,200,257,150,320,3380,57,B
3379,CEI,75,75,332,80,400,3380,257,C
3379,DEI,95,95,427,2880,3280,3380,332,D
3379,EI,861,434,861,1019,1019,3380,0,E
3379,FI,1180,319,1180,1194,1194,3380,0,I
3379,FJ,332,13,1193,240,1259,3380,861,F
3379,GJ,167,167,1360,355,1614,3380,1193,G
3379,HJ,297,117,1477,300,1494,3380,1180,J
3379,HK,886,886,2363,1050,2544,3380,1477,K
3379,HJ,1309,306,2669,4020,5634,3380,1360,H
3379,J,2644,2338,5007,2530,5074,3380,2363,J
3379,K,884,884,5891,1210,6284,3380,5007,K
3379,L,372,372,6263,3960,10244,3380,5891,L
3379,M,24,24,6287,45,10289,3380,6263,M
3379,N,111,111,6398,150,10439,3380,6287,N
3379,O,78,78,6476,130,10569,3380,6398,O
3379,P,105,105,6581,2850,13419,3380,6476,P
3380,A,119,119,119,1334,1334,3381,0,A
3380,B,1307,1307,1426,240,1574,3381,119,B
3380,C,2201,2201,3627,300,1874,3381,1426,C
3380,D,2087,2087,5714,5100,6974,3381,3627,D
3380,M,527,527,6241,1015,7989,3381,5714,M
3380,N,583,583,6824,150,8139,3381,6241,N
3380,O,139,139,6963,395,8534,3381,6824,O
3380,N,433,433,7396,155,8689,3381,6963,N
3380,O,633,633,8029,680,9369,3381,7396,O
3380,P,6661,6661,14690,4140,13509,3381,8029,P
3381,AEI,46,46,46,1118,1118,3382,0,A
3381,BEI,197,151,197,1421,1421,3382,0,I
3381,BEJ,324,127,324,1401,1401,3382,0,E
3381,BFJ,1264,1264,1588,240,1641,3382,324,F
3381,BGJ,1404,13,1601,240,1661,3382,197,J
3381,BGK,712,712,2313,760,2421,3382,1601,K
3381,BGL,985,260,2573,780,2421,3382,1588,G
3381,BHL,2713,186,2759,240,1358,3382,46,B
3381,CHL,540,354,3113,7680,10101,3382,2573,H
3381,CL,742,388,3501,760,2118,3382,2759,C
3381,DL,128,128,3629,7680,9798,3382,3501,D
3381,L,2626,1310,4939,7680,10101,3382,2313,L
3381,M,3,3,4942,396,10497,3382,4939,M
3381,N,626,626,5568,300,10797,3382,4942,N
3381,O,779,779,6347,820,11617,3382,5568,O
3381,N,2585,2585,8932,2510,14127,3382,6347,N
3381,O,432,432,9364,535,14662,3382,8932,O
3381,P,6980,6980,16344,2880,17542,3382,9364,P
3382,A,174,174,174,482,482,3383,0,A
3382,B,483,483,657,240,722,3383,174,B
3382,C,854,854,1511,985,1707,3383,657,C
3382,B,790,790,2301,615,2322,3383,1511,B
3382,C,390,390,2691,255,2577,3383,2301,C
3382,D,433,433,3124,5160,7737,3383,2691,D
3382,M,617,617,3741,1112,8849,3383,3124,M
3382,N,625,625,4366,180,9029,3383,3741,N
3382,O,186,186,4552,230,9259,3383,4366,O
3382,N,1179,1179,5731,1150,10409,3383,4552,N
3382,O,178,178,5909,390,10799,3383,5731,O
3382,P,322,322,6231,3960,14759,3383,5909,P
3383,A,1512,1512,1512,1475,1475,3384,0,A
3383,B,68,68,1580,150,1625,3384,1512,B
3383,C,163,163,1743,140,1765,3384,1580,C
3383,B,886,886,2629,900,2665,3384,1743,B
3383,C,308,308,2937,650,3315,3384,2629,C
3383,D,4847,4847,7784,4230,7545,3384,2937,D
3383,M,5890,5890,13674,5917,13462,3384,7784,M
3383,N,59,59,13733,90,13552,3384,13674,N
3383,O,1657,1657,15390,1940,15492,3384,13733,O
3383,N,1395,1395,16785,1115,16607,3384,15390,N
3383,O,165,165,16950,535,17142,3384,16785,O
3383,P,1379,1379,18329,3780,20922,3384,16950,P
3384,AE,60,60,60,243,243,3385,0,A
3384,BE,264,264,324,135,378,3385,60,B
3384,CE,157,157,481,290,668,3385,324,C
3384,DE,1166,685,1166,1590,1590,3385,0,E
3384,DF,736,51,1217,5160,5828,3385,481,D
3384,F,461,410,1627,90,1680,3385,1166,F
3384,G,1116,1116,2743,1330,3010,3385,1627,G
3384,H,2452,2452,5195,3780,6790,3385,2743,H
3384,M,885,885,6080,1888,8678,3385,5195,M
3384,N,1119,1119,7199,150,8828,3385,6080,N
3384,O,1508,1508,8707,1680,10508,3385,7199,O
3384,P,1481,1481,10188,2580,13088,3385,8707,P
3385,AEI,43,43,43,246,246,3386,0,A
3385,BEI,45,2,45,551,551,3386,0,E
3385,BFI,54,9,54,1321,1321,3386,0,I
3385,BFJ,341,330,384,165,411,3386,43,B
3385,CFJ,626,287,671,165,716,3386,45,F
3385,CGJ,664,377,1048,910,1321,3386,384,C
3385,DGJ,76,76,1124,4020,5341,3386,1048,D
3385,GJ,1317,247,1371,165,1486,3386,54,J
3385,GK,834,134,1505,1075,1791,3386,671,G
3385,HK,663,529,2034,825,2311,3386,1371,K
3385,HL,149,149,2183,3960,6271,3386,2034,L
3385,H,1197,519,2702,4020,5811,3386,1505,H
3385,M,1686,1686,4388,1977,8248,3386,2702,M
3385,N,346,346,4734,90,8338,3386,4388,N
3385,O,601,601,5335,860,9198,3386,4734,O
3385,N,917,917,6252,675,9873,3386,5335,N
3385,O,831,831,7083,945,10818,3386,6252,O
3385,P,3189,3189,10272,3780,14598,3386,7083,P
3386,AE,347,347,347,1259,1259,3387,0,A
3386,BE,374,27,374,945,945,3387,0,E
3386,BF,667,667,1041,150,1095,3387,374,F
3386,BG,134,134,1175,400,1495,3387,1041,G
3386,BF,944,116,1291,90,1349,3387,347,B
3386,CF,531,531,1822,880,2229,3387,1291,C
3386,BF,457,457,2279,110,2339,3387,1822,B
3386,CF,1583,479,2758,1295,2790,3387,1175,F
3386,CG,397,397,3155,650,3440,3387,2758,G
3386,CH,1430,554,3709,2315,4654,3387,2279,C
3386,DH,1648,1648,5357,3480,8134,3387,3709,D
3386,H,21602,19400,24757,4230,7670,3387,3155,H
3386,M,11304,11304,36061,11594,19728,3387,24757,M
3386,N,479,479,36540,240,19968,3387,36061,N
3386,O,638,638,37178,855,20823,3387,36540,O
3386,N,1617,1617,38795,1400,22223,3387,37178,N
3386,O,487,487,39282,1140,23363,3387,38795,O
3386,P,10170,10170,49452,3480,26843,3387,39282,P
3387,AEI,139,139,139,613,613,3388,0,A
3387,BEI,228,89,228,1147,1147,3388,0,I
3387,BEJ,592,503,731,210,823,3388,139,B
3387,CEJ,1118,615,1346,240,1387,3388,228,J
3387,CEK,745,130,1476,1000,1823,3388,731,C
3387,BEK,461,331,1807,540,1927,3388,1346,K
3387,BEL,892,561,2368,605,2428,3388,1476,B
3387,CEL,538,538,2906,540,2968,3388,2368,C
3387,DEL,2991,85,2991,3314,3314,3388,0,E
3387,DFL,366,366,3357,90,3404,3388,2991,F
3387,DGL,418,418,3775,820,4224,3388,3357,G
3387,DFL,1086,1086,4861,690,4914,3388,3775,F
3387,DGL,822,822,5683,1275,6189,3388,4861,G
3387,DHL,22798,18922,24605,2880,4807,3388,1807,L
3387,DH,24246,2547,27152,2880,5848,3388,2906,D
3387,H,23200,1731,28883,3780,9969,3388,5683,H
3387,M,4423,4423,33306,4393,14362,3388,28883,M
3387,N,150,150,33456,240,14602,3388,33306,N
3387,O,446,446,33902,195,14797,3388,33456,O
3387,P,290,290,34192,660,15457,3388,33902,P
3388,AE,325,325,325,1880,1880,3389,0,E
3388,AF,1676,1676,2001,180,2060,3389,325,F
3388,AG,727,727,2728,820,2880,3389,2001,G
3388,AH,2891,163,2891,4552,4552,3389,0,A
3388,BH,1066,1066,3957,180,4732,3389,2891,B
3388,CH,1158,1158,5115,860,5592,3389,3957,C
3388,DH,9825,7438,12553,6680,9560,3389,2728,H
3388,D,17322,9884,22437,6680,12272,3389,5115,D
3388,M,271,271,22708,869,13141,3389,22437,M
3388,N,725,725,23433,180,13321,3389,22708,N
3388,O,5520,5520,28953,300,13621,3389,23433,O
3388,P,2105,2105,31058,6900,20521,3389,28953,P
3389,A,739,739,739,895,895,3390,0,A
3389,B,286,286,1025,180,1075,3390,739,B
3389,C,717,717,1742,885,1960,3390,1025,C
3389,D,837,837,2579,6680,8640,3390,1742,D
3389,M,282,282,2861,1172,9812,3390,2579,M
3389,N,1024,1024,3885,180,9992,3390,2861,N
3389,O,573,573,4458,585,10577,3390,3885,O
3389,P,3209,3209,7667,6960,17537,3390,4458,P
3390,A,566,566,566,1086,1086,3391,0,A
3390,B,644,644,1210,150,1236,3391,566,B
3390,C,130,130,1340,125,1361,3391,1210,C
3390,B,561,561,1901,580,1941,3391,1340,B
3390,C,626,626,2527,655,2596,3391,1901,C
3390,D,206,206,2733,4230,6826,3391,2527,D
3390,M,362,362,3095,1134,7960,3391,2733,M
3390,N,825,825,3920,90,8050,3391,3095,N
3390,O,490,490,4410,885,8935,3391,3920,O
3390,N,511,511,4921,135,9070,3391,4410,N
3390,O,531,531,5452,800,9870,3391,4921,O
3390,P,118,118,5570,3780,13650,3391,5452,P
3391,AE,859,859,859,1350,1350,3392,0,A
3391,BE,551,551,1410,120,1470,3392,859,B
3391,CE,2081,671,2081,2566,2566,3392,0,E
3391,CF,758,87,2168,765,2235,3392,1410,C
3391,DF,614,527,2695,210,2776,3392,2081,F
3391,DG,1343,816,3511,385,2620,3392,2168,D
3391,G,826,10,3521,790,3566,3392,2695,G
3391,H,2327,2327,5848,550,4116,3392,3521,H
3391,M,197,197,6045,342,4458,3392,5848,M
3391,N,275,275,6320,180,4638,3392,6045,N
3391,O,988,988,7308,830,5468,3392,6320,O
3391,P,2037,2037,9345,6680,12148,3392,7308,P
3392,AEI,246,246,246,2095,2095,3393,0,A
3392,BEI,386,140,386,909,909,3393,0,I
3392,BEJ,694,694,1080,180,1089,3393,386,J
3392,BEK,1665,585,1665,2377,2377,3393,0,E
3392,BFK,941,356,2021,930,2019,3393,1080,K
3392,BFL,2254,479,2500,420,2515,3393,246,B
3392,CFL,926,91,2591,240,2617,3393,1665,F
3392,CGL,961,870,3461,970,3485,3393,2500,C
3392,DGL,1620,180,3641,550,2569,3393,2021,L
3392,DG,1458,408,4049,1040,3657,3393,2591,G
3392,DF,160,160,4209,670,4327,3393,4049,F
3392,DG,547,547,4756,780,5107,3393,4209,G
3392,DH,423,423,5179,3960,9067,3393,4756,H
3392,D,1994,276,5455,550,4035,3393,3461,D
3392,M,1197,1197,6652,1993,11060,3393,5455,M
3392,N,936,936,7588,180,11240,3393,6652,N
3392,O,739,739,8327,840,12080,3393,7588,O
3392,N,565,565,8892,470,12550,3393,8327,N
3392,O,255,255,9147,405,12955,3393,8892,O
3392,P,12252,12252,21399,2580,15535,3393,9147,P
3393,A,1163,1163,1163,1122,1122,3394,0,A
3393,B,49,49,1212,150,1272,3394,1163,B
3393,C,233,233,1445,285,1557,3394,1212,C
3393,D,10595,10595,12040,5160,6717,3394,1445,D
3393,M,453,453,12493,1442,8159,3394,12040,M
3393,N,1185,1185,13678,240,8399,3394,12493,N
3393,O,111,111,13789,380,8779,3394,13678,O
3393,N,926,926,14715,645,9424,3394,13789,N
3393,O,913,913,15628,810,10234,3394,14715,O
3393,P,2770,2770,18398,3960,14194,3394,15628,P
3394,AEI,72,72,72,1005,1005,3395,0,E
3394,AFI,218,146,218,268,268,3395,0,I
3394,AFJ,272,54,272,304,304,3395,0,A
3394,BFJ,202,148,420,210,478,3395,218,J
3394,BFK,273,125,545,300,604,3395,272,B
3394,CFK,132,7,552,255,733,3395,420,K
3394,CFJ,596,589,1141,775,1379,3395,545,C
3394,BFJ,1136,67,1208,240,1245,3395,72,F
3394,BGJ,916,260,1468,795,1528,3395,552,J
3394,BGK,477,217,1685,750,1995,3395,1208,G
3394,BHK,499,282,1967,750,2278,3395,1468,K
3394,BHL,826,544,2511,3540,5535,3395,1685,H
3394,BL,1446,76,2587,1255,2634,3395,1141,B
3394,CL,940,320,2907,3540,5818,3395,1967,L
3394,C,476,156,3063,760,3394,3395,2587,C
3394,D,2282,2282,5345,3540,6934,3395,3063,D
3394,M,244,244,5589,643,7577,3395,5345,M
3394,N,592,592,6181,240,7817,3395,5589,N
3394,O,1514,1514,7695,810,8627,3395,6181,O
3394,N,3169,3169,10864,3920,12547,3395,7695,N
3394,O,747,747,11611,780,13327,3395,10864,O
3394,P,2623,2623,14234,3960,17287,3395,11611,P
3395,AE,526,526,526,939,939,3396,0,A
3395,BE,445,445,971,90,1029,3396,526,B
3395,CE,547,547,1518,845,1874,3396,971,C
3395,DE,684,684,2202,3780,5654,3396,1518,D
3395,E,3874,1672,3874,6149,6149,3396,0,E
3395,F,2468,2468,6342,240,6389,3396,3874,F
3395,G,795,795,7137,860,7249,3396,6342,G
3395,H,3366,3366,10503,3960,11209,3396,7137,H
3395,M,372,372,10875,945,12154,3396,10503,M
3395,N,867,867,11742,300,12454,3396,10875,N
3395,O,860,860,12602,920,13374,3396,11742,O
3395,N,30,30,12632,5,13379,3396,12602,N
3395,O,866,866,13498,1260,14639,3396,12632,O
3395,P,198,198,13696,3960,18599,3396,13498,P
3396,A,1111,1111,1111,1161,1161,3397,0,A
3396,B,426,426,1537,390,1551,3397,1111,B
3396,C,941,941,2478,995,2546,3397,1537,C
3396,D,3715,3715,6193,550,3096,3397,2478,D
3396,M,1171,1171,7364,1471,4567,3397,6193,M
3396,N,830,830,8194,150,4717,3397,7364,N
3396,O,212,212,8406,395,5112,3397,8194,O
3396,P,268,268,8674,660,5772,3397,8406,P
3397,AEI,11,11,11,54,54,3398,0,A
3397,BEI,101,90,101,156,156,3398,0,I
3397,BEJ,123,33,134,135,189,3398,11,B
3397,CEJ,151,17,151,241,241,3398,0,E
3397,CFJ,168,168,319,135,376,3398,151,F
3397,CGJ,253,35,354,240,396,3398,101,J
3397,CGK,310,90,444,295,484,3398,134,C
3397,DGK,176,86,530,285,681,3398,354,K
3397,DGL,162,76,606,5160,5644,3398,444,D
3397,GL,290,3,609,285,661,3398,319,G
3397,HL,118,118,727,5160,5821,3398,609,H
3397,L,1539,1342,2069,5160,5841,3398,530,L
3397,M,334,334,2403,6020,11861,3398,2069,M
3397,N,4461,4461,6864,240,12101,3398,2403,N
3397,O,465,465,7329,1140,13241,3398,6864,O
3397,N,4903,4903,12232,2605,15846,3398,7329,N
3397,O,819,819,13051,980,16826,3398,12232,O
3397,P,150,150,13201,3960,20786,3398,13051,P
3398,A,86,86,86,103,103,3399,0,A
3398,B,170,170,256,210,313,3399,86,B
3398,C,109,109,365,255,568,3399,256,C
3398,B,1536,1536,1901,1390,1958,3399,365,B
3398,C,715,715,2616,845,2803,3399,1901,C
3398,D,602,602,3218,5220,8023,3399,2616,D
3398,M,485,485,3703,570,8593,3399,3218,M
3398,N,343,343,4046,300,8893,3399,3703,N
3398,O,686,686,4732,835,9728,3399,4046,O
3398,P,6221,6221,10953,1140,10868,3399,4732,P
3399,AE,156,156,156,1347,1347,3400,0,E
3399,AF,180,24,180,1373,1373,3400,0,A
3399,BF,1386,1362,1542,240,1587,3400,156,F
3399,BG,1388,26,1568,240,1613,3400,180,B
3399,CG,713,687,2255,760,2347,3400,1542,G
3399,CH,712,25,2280,760,2373,3400,1568,C
3399,DH,789,764,3044,7680,10027,3400,2255,H
3399,D,1106,342,3386,7680,10053,3400,2280,D
3399,M,2914,2914,6300,3750,13803,3400,3386,M
3399,N,1110,1110,7410,300,14103,3400,6300,N
3399,O,932,932,8342,910,15013,3400,7410,O
3399,P,4151,4151,12493,2760,17773,3400,8342,P
3400,A,1190,1190,1190,1670,1670,3401,0,A
3400,B,726,726,1916,300,1970,3401,1190,B
3400,C,824,824,2740,1045,3015,3401,1916,C
3400,D,140,140,2880,1140,4155,3401,2740,D
3400,M,1104,1104,3984,1750,5905,3401,2880,M
3400,N,773,773,4757,90,5995,3401,3984,N
3400,O,1474,1474,6231,1795,7790,3401,4757,O
3400,P,1445,1445,7676,3780,11570,3401,6231,P
3401,AEI,43,43,43,374,374,3402,0,A
3401,BEI,453,410,453,414,414,3402,0,I
3401,BEJ,500,90,543,165,539,3402,43,B
3401,CEJ,231,141,684,330,744,3402,453,J
3401,CEK,1133,449,1133,1472,1472,3402,0,E
3401,CFK,972,382,1515,1275,1814,3402,543,C
3401,DFK,387,5,1520,90,1562,3402,1133,F
3401,DGK,1521,685,2205,1559,2303,3402,684,K
3401,DGJ,905,220,2425,1230,2792,3402,1520,G
3401,DFJ,945,35,2460,3960,5774,3402,1515,D
3401,FJ,373,338,2798,45,2837,3402,2425,F
3401,GJ,418,418,3216,875,3712,3402,2798,G
3401,HJ,1194,183,3399,1205,3508,3402,2205,J
3401,HK,367,367,3766,370,3878,3402,3399,K
3401,HJ,596,46,3812,3780,7492,3402,3216,H
3401,J,266,220,4032,220,4098,3402,3766,J
3401,K,974,974,5006,1100,5198,3402,4032,K
3401,L,1807,1807,6813,360,5558,3402,5006,L
3401,M,4080,4080,10893,4246,11738,3402,6813,M
3401,N,286,286,11179,180,11918,3402,10893,N
3401,O,860,860,12039,1060,12978,3402,11179,O
3401,N,290,290,12329,90,13068,3402,12039,N
3401,O,383,383,12712,370,13438,3402,12329,O
3401,P,14411,14411,27123,6960,20398,3402,12712,P
3402,AEI,240,240,240,517,517,3403,0,A
3402,BEI,573,573,813,360,877,3403,240,B
3402,CEI,835,22,835,1564,1564,3403,0,E
3402,CFI,1657,822,1657,1836,1836,3403,0,I
3402,CFJ,849,27,1684,180,1744,3403,835,F
3402,CGJ,1094,223,1907,1130,2007,3403,813,C
3402,BGJ,419,169,2076,300,2136,3403,1657,J
3402,BGK,520,351,2427,480,2487,3403,1907,B
3402,CGK,141,141,2568,120,2607,3403,2427,C
3402,DGK,1252,368,2936,835,2579,3403,1684,G
3402,DFK,1032,172,3108,935,3071,3403,2076,K
3402,DFL,270,270,3378,550,3621,3403,3108,L
3402,DF,877,67,3445,550,3157,3403,2568,D
3402,F,1558,1049,4494,1945,4524,3403,2936,F
3402,G,809,809,5303,615,5139,3403,4494,G
3402,F,1118,1118,6421,1464,6603,3403,5303,F
3402,G,327,327,6748,901,7504,3403,6421,G
3402,H,1167,1167,7915,6960,14464,3403,6748,H
3402,M,5292,5292,13207,5965,20429,3403,7915,M
3402,N,1185,1185,14392,420,20849,3403,13207,N
3402,O,789,789,15181,996,21845,3403,14392,O
3402,P,7375,7375,22556,2729,24574,3403,15181,P
3403,A,4,4,4,918,918,3404,0,A
3403,B,1121,1121,1125,240,1158,3404,4,B
3403,C,721,721,1846,960,2118,3404,1125,C
3403,D,196,196,2042,3960,6078,3404,1846,D
3403,M,2963,2963,5005,4053,10131,3404,2042,M
3403,N,1122,1122,6127,90,10221,3404,5005,N
3403,O,608,608,6735,915,11136,3404,6127,O
3403,N,2811,2811,9546,2470,13606,3404,6735,N
3403,O,512,512,10058,805,14411,3404,9546,O
3403,P,2247,2247,12305,3780,18191,3404,10058,P
3404,AE,100,100,100,692,692,3405,0,A
3404,BE,151,51,151,508,508,3405,0,E
3404,BF,477,477,628,180,688,3405,151,F
3404,BG,707,179,807,180,872,3405,100,B
3404,CG,127,127,934,245,1117,3405,807,C
3404,BG,484,484,1418,355,1472,3405,934,B
3404,CG,799,9,1427,700,1388,3405,628,G
3404,CF,37,28,1455,405,1877,3405,1418,C
3404,DF,1152,1152,2607,6060,7937,3405,1455,D
3404,F,2966,1786,4393,3140,4528,3405,1427,F
3404,G,875,875,5268,1320,5848,3405,4393,G
3404,H,8658,8658,13926,6060,11908,3405,5268,H
3404,M,6611,6611,20537,6907,18815,3405,13926,M
3404,N,419,419,20956,180,18995,3405,20537,N
3404,O,590,590,21546,830,19825,3405,20956,O
3404,N,646,646,22192,390,20215,3405,21546,N
3404,O,1054,1054,23246,1030,21245,3405,22192,O
3404,P,321,321,23567,6960,28205,3405,23246,P
3405,A,4200,4200,4200,4235,4235,3406,0,A
3405,B,331,331,4531,300,4535,3406,4200,B
3405,C,671,671,5202,880,5415,3406,4531,C
3405,D,308,308,5510,1620,7035,3406,5202,D
3405,M,1410,1410,6920,1430,8465,3406,5510,M
3405,N,274,274,7194,300,8765,3406,6920,N
3405,O,739,739,7933,820,9585,3406,7194,O
3405,N,1559,1559,9492,1485,11070,3406,7933,N
3405,O,449,449,9941,1480,12550,3406,9492,O
3405,P,5399,5399,15340,3000,15550,3406,9941,P
3406,AE,827,827,827,949,949,3407,0,E
3406,AF,242,242,1069,180,1129,3407,827,F
3406,AG,1921,852,1921,2822,2822,3407,0,A
3406,BG,1077,225,2146,1210,2339,3407,1069,G
3406,BF,273,273,2419,255,2594,3407,2146,F
3406,BG,394,394,2813,465,3059,3407,2419,G
3406,BH,928,36,2849,90,2912,3407,1921,B
3406,CH,865,865,3714,905,3817,3407,2849,C
3406,BH,1367,466,4180,550,3609,3407,2813,H
3406,B,812,346,4526,770,4587,3407,3714,B
3406,C,858,858,5384,1300,5887,3407,4526,C
3406,D,1541,1541,6925,3780,9667,3407,5384,D
3406,M,63,63,6988,716,10383,3407,6925,M
3406,N,743,743,7731,150,10533,3407,6988,N
3406,O,70,70,7801,50,10583,3407,7731,O
3406,N,4161,4161,11962,4160,14743,3407,7801,N
3406,O,178,178,12140,265,15008,3407,11962,O
3406,P,29,29,12169,5100,20108,3407,12140,P
3407,AEI,128,128,128,868,868,3408,0,A
3407,BEI,143,15,143,90,90,3408,0,E
3407,BFI,238,238,381,300,390,3408,143,F
3407,BGI,166,166,547,290,680,3408,381,G
3407,BFI,928,509,1056,240,1108,3408,128,B
3407,CFI,356,356,1412,540,1648,3408,1056,C
3407,DFI,2358,946,2358,2548,2548,3408,0,I
3407,DFJ,215,215,2573,90,2638,3408,2358,J
3407,DFK,2381,355,2928,2290,2970,3408,547,F
3407,DGK,576,221,3149,795,3433,3408,2573,K
3407,DGJ,224,3,3152,535,3505,3408,2928,G
3407,DHJ,3505,3502,6654,3280,6713,3408,3149,J
3407,DHK,757,757,7411,1210,7923,3408,6654,K
3407,DHL,5762,1503,8914,2940,6445,3408,3152,H
3407,DL,11104,3602,12516,2880,4528,3408,1412,D
3407,L,18962,13857,26373,3780,11703,3408,7411,L
3407,M,3171,3171,29544,3096,14799,3408,26373,M
3407,N,105,105,29649,240,15039,3408,29544,N
3407,O,680,680,30329,195,15234,3408,29649,O
3407,P,189,189,30518,660,15894,3408,30329,P
3408,AEI,67,67,67,400,400,3409,0,E
3408,AFI,74,7,74,123,123,3409,0,A
3408,BFI,134,134,208,135,258,3409,74,B
3408,CFI,192,192,400,295,553,3409,208,C
3408,DFI,41,41,441,5100,5653,3409,400,D
3408,FI,420,46,487,135,535,3409,67,F
3408,GI,593,106,593,1288,1288,3409,0,I
3408,GJ,252,146,739,295,830,3409,487,G
3408,HJ,53,53,792,5100,5930,3409,739,H
3408,J,890,691,1483,180,1468,3409,593,J
3408,K,1672,1672,3155,835,2303,3409,1483,K
3408,J,197,197,3352,1100,3403,3409,3155,J
3408,K,615,615,3967,665,4068,3409,3352,K
3408,L,1498,1498,5465,6960,11028,3409,3967,L
3408,M,1880,1880,7345,2478,13506,3409,5465,M
3408,N,692,692,8037,90,13596,3409,7345,N
3408,O,1063,1063,9100,1385,14981,3409,8037,O
3408,N,367,367,9467,110,15091,3409,9100,N
3408,O,292,292,9759,695,15786,3409,9467,O
3408,P,7204,7204,16963,3780,19566,3409,9759,P
3409,AE,1093,1093,1093,1274,1274,3410,0,E
3409,AF,1216,123,1216,1679,1679,3410,0,A
3409,BF,383,260,1476,240,1514,3410,1093,F
3409,BG,643,383,1859,240,1919,3410,1216,B
3409,CG,926,543,2402,995,2509,3410,1476,G
3409,CF,672,129,2531,570,2489,3410,1859,C
3409,DF,35,35,2566,405,2894,3410,2531,D
3409,F,363,199,2765,270,2779,3410,2402,F
3409,G,1015,1015,3780,1260,4039,3410,2765,G
3409,H,1561,1561,5341,3960,7999,3410,3780,H
3409,M,363,363,5704,739,8738,3410,5341,M
3409,N,493,493,6197,150,8888,3410,5704,N
3409,O,127,127,6324,125,9013,3410,6197,O
3409,N,336,336,6660,345,9358,3410,6324,N
3409,O,132,132,6792,120,9478,3410,6660,O
3409,P,1041,1041,7833,4230,13708,3410,6792,P
3410,A,2492,2492,2492,2600,2600,3411,0,A
3410,B,322,322,2814,240,2840,3411,2492,B
3410,C,1225,1225,4039,1290,4130,3411,2814,C
3410,D,16252,16252,20291,3660,7790,3411,4039,D
3410,M,171,171,20462,1802,9592,3411,20291,M
3410,N,1813,1813,22275,240,9832,3411,20462,N
3410,O,823,823,23098,985,10817,3411,22275,O
3410,N,4163,4163,27261,3980,14797,3411,23098,N
3410,O,904,904,28165,925,15722,3411,27261,O
3410,P,9208,9208,37373,3960,19682,3411,28165,P
3411,AE,61,61,61,88,88,3412,0,A
3411,BE,102,102,163,135,223,3412,61,B
3411,CE,306,143,306,930,930,3412,0,E
3411,CF,185,42,348,285,508,3412,163,C
3411,DF,318,318,666,5160,5668,3412,348,D
3411,F,814,454,1120,240,1170,3412,306,F
3411,G,860,860,1980,1030,2200,3412,1120,G
3411,F,834,834,2814,650,2850,3412,1980,F
3411,G,197,197,3011,385,3235,3412,2814,G
3411,H,326,326,3337,3960,7195,3412,3011,H
3411,M,651,651,3988,992,8187,3412,3337,M
3411,N,470,470,4458,180,8367,3412,3988,N
3411,O,898,898,5356,885,9252,3412,4458,O
3411,P,1958,1958,7314,6680,15932,3412,5356,P
3412,A,5846,5846,5846,6662,6662,3413,0,A
3412,B,1009,1009,6855,240,6902,3413,5846,B
3412,C,1018,1018,7873,1015,7917,3413,6855,C
3412,B,849,849,8722,820,8737,3413,7873,B
3412,C,106,106,8828,375,9112,3413,8722,C
3412,D,120,120,8948,3960,13072,3413,8828,D
3412,M,465,465,9413,405,13477,3413,8948,M
3412,N,123,123,9536,240,13717,3413,9413,N
3412,O,114,114,9650,390,14107,3413,9536,O
3412,N,1122,1122,10772,815,14922,3413,9650,N
3412,O,499,499,11271,750,15672,3413,10772,O
3412,P,1022,1022,12293,3960,19632,3413,11271,P
3413,AEI,210,210,210,430,430,3414,0,A
3413,BEI,340,340,550,180,610,3414,210,B
3413,CEI,651,101,651,1680,1680,3414,0,E
3413,CFI,294,193,844,645,1255,3414,550,C
3413,BFI,1279,1086,1930,300,1980,3414,651,F
3413,BGI,673,673,2603,880,2860,3414,1930,G
3413,BHI,242,242,2845,1620,4480,3414,2603,H
3413,BI,3818,1817,4662,3455,4710,3414,844,B
3413,CI,715,715,5377,880,5590,3414,4662,C
3413,DI,253,253,5630,1620,7210,3414,5377,D
3413,I,12921,7291,12921,12980,12980,3414,0,I
3413,J,330,330,13251,300,13280,3414,12921,J
3413,K,651,651,13902,870,14150,3414,13251,K
3413,L,141,141,14043,1620,15770,3414,13902,L
3413,M,131,131,14174,545,16315,3414,14043,M
3413,N,792,792,14966,420,16735,3414,14174,N
3413,O,1193,1193,16159,1385,18120,3414,14966,O
3413,N,1179,1179,17338,990,19110,3414,16159,N
3413,O,284,284,17622,300,19410,3414,17338,O
3413,P,7188,7188,24810,670,20080,3414,17622,P
3414,AEI,89,89,89,87,87,3415,0,A
3414,BEI,153,64,153,2768,2768,3415,0,I
3414,BEJ,190,37,190,215,215,3415,0,E
3414,BFJ,207,106,296,240,327,3415,89,B
3414,CFJ,299,193,489,300,515,3415,190,F
3414,CGJ,287,94,583,290,617,3415,296,C
3414,DGJ,766,672,1255,780,1295,3415,489,G
3414,DHJ,797,797,2052,1140,2435,3415,1255,H
3414,DJ,1861,392,2444,5160,5777,3415,583,D
3414,J,2798,507,2951,240,3008,3415,153,J
3414,K,255,255,3206,285,3293,3415,2951,K
3414,L,1136,1136,4342,5160,8453,3415,3206,L
3414,M,954,954,5296,1935,10388,3415,4342,M
3414,N,1135,1135,6431,150,10538,3415,5296,N
3414,O,1314,1314,7745,1610,12148,3415,6431,O
3414,P,68,68,7813,2520,14668,3415,7745,P
3415,AEI,319,319,319,933,933,3416,0,I
3415,AEJ,571,252,571,1112,1112,3416,0,A
3415,BEJ,661,661,1232,180,1292,3416,571,B
3415,CEJ,1116,203,1435,600,1533,3416,319,J
3415,CEK,2129,694,2129,2368,2368,3416,0,E
3415,CFK,981,84,2213,930,2222,3416,1232,C
3415,DFK,780,2,2215,690,2223,3416,1435,K
3415,DFJ,147,147,2362,155,2378,3416,2215,J
3415,DFK,299,66,2428,120,2488,3416,2129,F
3415,DGK,746,680,3108,740,3118,3416,2362,K
3415,DGL,833,153,3261,755,3243,3416,2428,G
3415,DHL,212,59,3320,385,3503,3416,3108,L
3415,DH,342,283,3603,550,3793,3416,3261,H
3415,D,2979,1589,5192,550,2772,3416,2213,D
3415,M,863,863,6055,1199,4992,3416,5192,M
3415,N,2035,2035,8090,300,5292,3416,6055,N
3415,O,669,669,8759,760,6052,3416,8090,O
3415,P,2926,2926,11685,3960,10012,3416,8759,P
3416,A,1629,1629,1629,1973,1973,3417,0,A
3416,B,463,463,2092,180,2153,3417,1629,B
3416,C,963,963,3055,1060,3213,3417,2092,C
3416,B,1322,1322,4377,1210,4423,3417,3055,B
3416,C,563,563,4940,530,4953,3417,4377,C
3416,D,1278,1278,6218,6900,11853,3417,4940,D
3416,M,60,60,6278,290,12143,3417,6218,M
3416,N,407,407,6685,180,12323,3417,6278,N
3416,O,256,256,6941,545,12868,3417,6685,O
3416,N,1006,1006,7947,760,13628,3417,6941,N
3416,O,528,528,8475,540,14168,3417,7947,O
3416,N,128,128,8603,130,14298,3417,8475,N
3416,O,987,987,9590,1200,15498,3417,8603,O
3416,P,1299,1299,10889,5100,20598,3417,9590,P
3417,AE,518,518,518,1219,1219,3418,0,A
3417,BE,554,36,554,831,831,3418,0,E
3417,BF,511,511,1065,240,1071,3418,554,F
3417,BG,916,369,1434,240,1459,3418,518,B
3417,CG,653,284,1718,880,1951,3418,1065,G
3417,CH,633,349,2067,880,2339,3418,1434,C
3417,DH,136,136,2203,3960,6299,3418,2067,D
3417,H,1010,525,2728,3960,5911,3418,1718,H
3417,M,154,154,2882,330,6629,3418,2728,M
3417,N,282,282,3164,150,6779,3418,2882,N
3417,O,640,640,3804,605,7384,3418,3164,O
3417,N,566,566,4370,590,7974,3418,3804,N
3417,O,119,119,4489,125,8099,3418,4370,O
3417,P,925,925,5414,4230,12329,3418,4489,P
3418,A,164,164,164,2804,2804,3419,0,A
3418,B,2843,2843,3007,240,3044,3419,164,B
3418,C,528,528,3535,740,3784,3419,3007,C
3418,B,1431,1431,4966,1205,4989,3419,3535,B
3418,C,102,102,5068,385,5374,3419,4966,C
3418,D,365,365,5433,5400,10774,3419,5068,D
3418,M,510,510,5943,461,11235,3419,5433,M
3418,N,133,133,6076,240,11475,3419,5943,N
3418,O,139,139,6215,380,11855,3419,6076,O
3418,N,1092,1092,7307,820,12675,3419,6215,N
3418,O,484,484,7791,740,13415,3419,7307,O
3418,P,1127,1127,8918,3960,17375,3419,7791,P
3419,AE,96,96,96,1166,1166,3420,0,A
3419,BE,143,47,143,162,162,3420,0,E
3419,BF,132,132,275,150,312,3420,143,F
3419,BG,673,673,948,765,1077,3420,275,G
3419,BH,198,198,1146,3600,4677,3420,948,H
3419,B,1256,206,1352,240,1406,3420,96,B
3419,C,645,645,1997,255,1661,3420,1352,C
3419,D,3742,3742,5739,5160,6821,3420,1997,D
3419,M,960,960,6699,914,7735,3420,5739,M
3419,N,50,50,6749,150,7885,3420,6699,N
3419,O,3370,3370,10119,405,8290,3420,6749,O
3419,P,5555,5555,15674,2880,11170,3420,10119,P
3420,AEI,47,47,47,1104,1104,3421,0,A
3420,BEI,156,109,156,1337,1337,3421,0,I
3420,BEJ,1247,1138,1294,240,1344,3421,47,B
3420,CEJ,1364,226,1520,240,1577,3421,156,J
3420,CEK,704,478,1998,760,2104,3421,1294,C
3420,DEK,669,191,2189,780,2357,3421,1520,K
3420,DEL,794,603,2792,7680,9784,3421,1998,D
3420,EL,1394,791,3583,7740,10097,3421,2189,L
3420,E,7237,3654,7237,8470,8470,3421,0,E
3420,F,1261,1261,8498,90,8560,3421,7237,F
3420,G,259,259,8757,600,9160,3421,8498,G
3420,F,5442,5442,14199,5100,14260,3421,8757,F
3420,G,1420,1420,15619,1830,16090,3421,14199,G
3420,H,782,782,16401,3780,19870,3421,15619,H
3420,M,10292,10292,26693,11210,31080,3421,16401,M
3420,N,1173,1173,27866,300,31380,3421,26693,N
3420,O,882,882,28748,905,32285,3421,27866,O
3420,P,4251,4251,32999,2760,35045,3421,28748,P
3421,A,1865,1865,1865,1878,1878,3422,0,A
3421,B,233,233,2098,240,2118,3422,1865,B
3421,C,1012,1012,3110,1335,3453,3422,2098,C
3421,B,988,988,4098,690,4143,3422,3110,B
3421,C,235,235,4333,390,4533,3422,4098,C
3421,D,9408,9408,13741,485,5018,3422,4333,D
3421,M,117,117,13858,151,5169,3422,13741,M
3421,N,124,124,13982,150,5319,3422,13858,N
3421,O,23,23,14005,45,5364,3422,13982,O
3421,N,221,221,14226,200,5564,3422,14005,N
3421,O,816,816,15042,970,6534,3422,14226,O
3421,P,2310,2310,17352,5160,11694,3422,15042,P
3422,AEI,1693,1693,1693,2597,2597,3423,0,I
3422,AEJ,1855,162,1855,2410,2410,3423,0,A
3422,BEJ,745,745,2600,180,2590,3423,1855,B
3422,CEJ,1441,534,3134,660,3257,3423,1693,J
3422,CEK,861,327,3461,930,3520,3423,2600,C
3422,DEK,1345,1018,4479,1195,4452,3423,3134,K
3422,DEL,415,415,4894,550,5002,3423,4479,L
3422,DE,3638,2205,7099,550,4070,3423,3461,D
3422,E,15832,8733,15832,15884,15884,3423,0,E
3422,F,150,150,15982,150,16034,3423,15832,F
3422,G,1086,1086,17068,1110,17144,3423,15982,G
3422,H,1363,1363,18431,385,17529,3423,17068,H
3422,M,605,605,19036,1616,19145,3423,18431,M
3422,N,1387,1387,20423,420,19565,3423,19036,N
3422,O,1339,1339,21762,2205,21770,3423,20423,O
3422,P,1104,1104,22866,1740,23510,3423,21762,P
3423,AE,49,49,49,135,135,3424,0,E
3423,AF,148,99,148,215,215,3424,0,A
3423,BF,176,77,225,135,270,3424,49,F
3423,BG,320,243,468,300,515,3424,148,B
3423,CG,268,25,493,285,555,3424,225,G
3423,CH,198,198,691,5160,5715,3424,493,H
3423,C,747,524,1215,795,1310,3424,468,C
3423,D,1779,1779,2994,1140,2450,3424,1215,D
3423,M,735,735,3729,1114,6829,3424,2994,M
3423,N,531,531,4260,180,7009,3424,3729,N
3423,O,659,659,4919,885,7894,3424,4260,O
3423,P,5173,5173,10092,6680,14574,3424,4919,P
3424,AEI,281,281,281,520,520,3425,0,A
3424,BEI,310,29,310,415,415,3425,0,E
3424,BFI,393,393,703,300,715,3425,310,F
3424,BGI,427,5,708,240,760,3425,281,B
3424,CGI,657,652,1360,895,1610,3425,703,G
3424,CHI,839,187,1547,850,1610,3425,708,C
3424,DHI,1306,1119,2666,3960,5570,3425,1360,H
3424,DI,4595,3476,6142,5220,6830,3425,1547,D
3424,I,14810,8668,14810,14854,14854,3425,0,I
3424,J,336,336,15146,300,15154,3425,14810,J
3424,K,708,708,15854,735,15889,3425,15146,K
3424,L,55,55,15909,1560,17449,3425,15854,L
3424,M,1793,1793,17702,1850,19299,3425,15909,M
3424,N,324,324,18026,300,19599,3425,17702,N
3424,O,768,768,18794,840,20439,3425,18026,O
3424,N,2190,2190,20984,2145,22584,3425,18794,N
3424,O,730,730,21714,990,23574,3425,20984,O
3424,P,4490,4490,26204,1620,25194,3425,21714,P
3425,A,1321,1321,1321,1601,1601,3426,0,A
3425,B,290,290,1611,120,1721,3426,1321,B
3425,C,115,115,1726,390,2111,3426,1611,C
3425,B,780,780,2506,455,2566,3426,1726,B
3425,C,684,684,3190,640,3206,3426,2506,C
3425,D,992,992,4182,5370,8576,3426,3190,D
3425,M,111,111,4293,227,8803,3426,4182,M
3425,N,343,343,4636,300,9103,3426,4293,N
3425,O,515,515,5151,775,9878,3426,4636,O
3425,N,1358,1358,6509,1085,10963,3426,5151,N
3425,O,498,498,7007,740,11703,3426,6509,O
3425,P,1181,1181,8188,5100,16803,3426,7007,P
3426,A,1407,1407,1407,2069,2069,3427,0,A
3426,B,841,841,2248,240,2309,3427,1407,B
3426,C,320,320,2568,255,2564,3427,2248,C
3426,D,2830,2830,5398,5160,7724,3427,2568,D
3426,M,98,98,5496,269,7993,3427,5398,M
3426,N,269,269,5765,150,8143,3427,5496,N
3426,O,154,154,5919,135,8278,3427,5765,O
3426,N,266,266,6185,270,8548,3427,5919,N
3426,O,110,110,6295,120,8668,3427,6185,O
3426,P,4,4,6299,4230,12898,3427,6295,P
3427,AEI,51,51,51,63,63,3428,0,E
3427,AFI,86,86,137,135,198,3428,51,F
3427,AGI,147,10,147,163,163,3428,0,A
3427,BGI,107,107,254,135,298,3428,147,B
3427,CGI,212,95,349,285,483,3428,137,G
3427,CHI,137,42,391,280,578,3428,254,C
3427,DHI,299,299,690,5160,5738,3428,391,D
3427,HI,467,126,816,5160,5643,3428,349,H
3427,I,838,22,838,1357,1357,3428,0,I
3427,J,576,576,1414,90,1447,3428,838,J
3427,K,935,935,2349,1285,2732,3428,1414,K
3427,L,1321,1321,3670,3780,6512,3428,2349,L
3427,M,1562,1562,5232,1850,8362,3428,3670,M
3427,N,424,424,5656,180,8542,3428,5232,N
3427,O,860,860,6516,885,9427,3428,5656,O
3427,P,1499,1499,8015,6680,16107,3428,6516,P
3428,A,518,518,518,689,689,3429,0,A
3428,B,471,471,989,360,1049,3429,518,B
3428,C,744,744,1733,655,1704,3429,989,C
3428,D,4042,4042,5775,550,2254,3429,1733,D
3428,M,614,614,6389,1729,3983,3429,5775,M
3428,N,1235,1235,7624,180,4163,3429,6389,N
3428,O,866,866,8490,840,5003,3429,7624,O
3428,N,719,719,9209,715,5718,3429,8490,N
3428,O,689,689,9898,755,6473,3429,9209,O
3428,P,3159,3159,13057,4020,10493,3429,9898,P
3429,A,70,70,70,854,854,3430,0,A
3429,B,837,837,907,110,964,3430,70,B
3429,C,199,199,1106,285,1249,3430,907,C
3429,D,102,102,1208,5160,6409,3430,1106,D
3429,M,8526,8526,9734,8863,15272,3430,1208,M
3429,N,488,488,10222,180,15452,3430,9734,N
3429,O,857,857,11079,885,16337,3430,10222,O
3429,N,423,423,11502,400,16737,3430,11079,N
3429,O,449,449,11951,540,17277,3430,11502,O
3429,P,3373,3373,15324,6960,24237,3430,11951,P
3430,AE,174,174,174,539,539,3431,0,E
3430,AF,548,548,722,240,779,3431,174,F
3430,AG,838,838,1560,945,1724,3431,722,G
3430,AH,1633,73,1633,1963,1963,3431,0,A
3430,BH,340,340,1973,120,2083,3431,1633,B
3430,CH,203,203,2176,390,2473,3431,1973,C
3430,BH,680,64,2240,5160,6884,3431,1560,H
3430,B,1467,1403,3643,1225,3698,3431,2176,B
3430,C,996,996,4639,970,4668,3431,3643,C
3430,D,884,884,5523,5160,9828,3431,4639,D
3430,M,10520,10520,16043,11848,21676,3431,5523,M
3430,N,1341,1341,17384,90,21766,3431,16043,N
3430,O,316,316,17700,700,22466,3431,17384,O
3430,N,1155,1155,18855,740,23206,3431,17700,N
3430,O,569,569,19424,940,24146,3431,18855,O
3430,P,1153,1153,20577,3780,27926,3431,19424,P
3431,A,45,45,45,3112,3112,3432,0,A
3431,B,3213,3213,3258,165,3277,3432,45,B
3431,C,651,651,3909,910,4187,3432,3258,C
3431,D,1141,1141,5050,3960,8147,3432,3909,D
3431,M,2792,2792,7842,3702,11849,3432,5050,M
3431,N,1158,1158,9000,300,12149,3432,7842,N
3431,O,826,826,9826,1000,13149,3432,9000,O
3431,N,520,520,10346,355,13504,3432,9826,N
3431,O,244,244,10590,390,13894,3432,10346,O
3431,P,247,247,10837,3960,17854,3432,10590,P
3432,A,482,482,482,391,391,3433,0,A
3432,B,91,91,573,240,631,3433,482,B
3432,C,112,112,685,380,1011,3433,573,C
3432,B,740,740,1425,460,1471,3433,685,B
3432,C,476,476,1901,790,2261,3433,1425,C
3432,D,1225,1225,3126,3960,6221,3433,1901,D
3432,M,32,32,3158,223,6444,3433,3126,M
3432,N,384,384,3542,240,6684,3433,3158,N
3432,O,722,722,4264,725,7409,3433,3542,O
3432,N,571,571,4835,650,8059,3433,4264,N
3432,O,305,305,5140,660,8719,3433,4835,O
3432,P,518,518,5658,3960,12679,3433,5140,P
3433,AEI,517,517,517,788,788,3434,0,A
3433,BEI,301,301,818,90,878,3434,517,B
3433,CEI,677,677,1495,685,1563,3434,818,C
3433,DEI,1555,60,1555,2259,2259,3434,0,E
3433,DFI,118,58,1613,385,1948,3434,1495,D
3433,FI,949,891,2504,300,2559,3434,1555,F
3433,GI,2964,460,2964,2927,2927,3434,0,I
3433,GJ,285,285,3249,300,3227,3434,2964,J
3433,GK,1657,912,4161,1050,3609,3434,2504,G
3433,FK,190,190,4351,720,4329,3434,4161,F
3433,GK,790,790,5141,780,5109,3434,4351,G
3433,HK,1984,92,5233,1275,4502,3434,3249,K
3433,HJ,474,474,5707,765,5267,3434,5233,J
3433,HK,112,112,5819,810,6077,3434,5707,K
3433,HL,1099,421,6240,3960,9069,3434,5141,H
3433,L,3090,2669,8909,3960,10037,3434,5819,L
3433,M,456,456,9365,567,10604,3434,8909,M
3433,N,221,221,9586,150,10754,3434,9365,N
3433,O,1012,1012,10598,1029,11783,3434,9586,O
3433,P,79,79,10677,351,12134,3434,10598,P
3434,A,1110,1110,1110,812,812,3435,0,A
3434,B,322,322,1432,660,1472,3435,1110,B
3434,C,690,690,2122,770,2242,3435,1432,C
3434,B,241,241,2363,190,2432,3435,2122,B
3434,C,802,802,3165,840,3272,3435,2363,C
3434,D,782,782,3947,550,3822,3435,3165,D
3434,M,300,300,4247,547,4369,3435,3947,M
3434,N,347,347,4594,270,4639,3435,4247,N
3434,O,647,647,5241,525,5164,3435,4594,O
3434,N,758,758,5999,770,5934,3435,5241,N
3434,O,853,853,6852,1110,7044,3435,5999,O
3434,P,2165,2165,9017,300,7344,3435,6852,P
3435,AEI,32,32,32,2393,2393,3436,0,A
3435,BEI,65,33,65,1023,1023,3436,0,E
3435,BFI,1139,1139,1204,240,1263,3436,65,F
3435,BGI,815,815,2019,890,2153,3436,1204,G
3435,BHI,284,284,2303,5160,7313,3436,2019,H
3435,BI,2562,291,2594,240,2633,3436,32,B
3435,CI,683,683,3277,960,3593,3436,2594,C
3435,DI,181,181,3458,3960,7553,3436,3277,D
3435,I,4286,828,4286,5174,5174,3436,0,I
3435,J,1079,1079,5365,240,5414,3436,4286,J
3435,K,252,252,5617,430,5844,3436,5365,K
3435,J,307,307,5924,90,5934,3436,5617,J
3435,K,726,726,6650,960,6894,3436,5924,K
3435,L,33162,33162,39812,3960,10854,3436,6650,L
3435,M,4410,4410,44222,5445,16299,3436,39812,M
3435,N,1064,1064,45286,90,16389,3436,44222,N
3435,O,793,793,46079,935,17324,3436,45286,O
3435,N,803,803,46882,660,17984,3436,46079,N
3435,O,765,765,47647,1195,19179,3436,46882,O
3435,P,60,60,47707,3780,22959,3436,47647,P
3436,AEI,41,41,41,196,196,3437,0,E
3436,AFI,132,91,132,476,476,3437,0,A
3436,BFI,275,184,316,180,376,3437,41,F
3436,BGI,463,279,595,180,656,3437,132,B
3436,CGI,1007,728,1323,935,1311,3437,316,G
3436,CHI,804,76,1399,855,1511,3437,595,C
3436,BHI,140,140,1539,240,1751,3437,1399,B
3436,CHI,1680,141,1680,1890,1890,3437,0,I
3436,CHJ,330,330,2010,180,2070,3437,1680,J
3436,CHK,479,8,2018,600,2351,3437,1539,C
3436,DHK,782,87,2105,385,1696,3437,1323,H
3436,DK,281,186,2291,660,2730,3437,2010,K
3436,DJ,747,747,3038,320,3050,3437,2291,J
3436,DK,1818,798,3836,5250,7601,3437,2018,D
3436,K,914,116,3952,825,3875,3437,3038,K
3436,L,788,788,4740,1140,5015,3437,3952,L
3436,M,3728,3728,8468,3918,11519,3437,4740,M
3436,N,340,340,8808,180,11699,3437,8468,N
3436,O,502,502,9310,740,12439,3437,8808,O
3436,N,2875,2875,12185,2660,15099,3437,9310,N
3436,O,788,788,12973,945,16044,3437,12185,O
3436,P,738,738,13711,5160,21204,3437,12973,P
3437,AEI,111,111,111,202,202,3438,0,E
3437,AFI,112,1,112,140,140,3438,0,I
3437,AFJ,117,5,117,186,186,3438,0,A
3437,BFJ,185,179,296,135,337,3438,111,F
3437,BGJ,246,67,363,240,426,3438,117,B
3437,CGJ,301,50,413,300,440,3438,112,J
3437,CGK,152,35,448,285,622,3438,296,G
3437,CHK,192,192,640,5160,5782,3438,448,H
3437,CK,371,94,734,285,711,3438,363,C
3437,DK,681,360,1094,790,1230,3438,413,K
3437,DL,129,129,1223,1140,2370,3438,1094,L
3437,D,2338,1849,3072,5160,5871,3438,734,D
3437,M,794,794,3866,1694,7565,3438,3072,M
3437,N,1026,1026,4892,150,7715,3438,3866,N
3437,O,1427,1427,6319,1685,9400,3438,4892,O
3437,P,1463,1463,7782,2520,11920,3438,6319,P
3438,A,51,51,51,70,70,3439,0,A
3438,B,91,91,142,120,190,3439,51,B
3438,C,175,175,317,100,290,3439,142,C
3438,D,796,796,1113,2880,3170,3439,317,D
3438,M,121,121,1234,841,4011,3439,1113,M
3438,N,845,845,2079,180,4191,3439,1234,N
3438,O,279,279,2358,220,4411,3439,2079,O
3438,N,573,573,2931,615,5026,3439,2358,N
3438,O,238,238,3169,475,5501,3439,2931,O
3438,P,401,401,3570,3960,9461,3439,3169,P
3439,AEI,487,487,487,1183,1183,3440,0,A
3439,BEI,784,784,1271,120,1303,3440,487,B
3439,CEI,1872,601,1872,2072,2072,3440,0,I
3439,CEJ,995,394,2266,930,2233,3440,1271,C
3439,DEJ,462,68,2334,300,2372,3440,1872,J
3439,DEK,849,849,3183,675,3047,3440,2334,K
3439,DEJ,258,258,3441,440,3487,3440,3183,J
3439,DEK,556,556,3997,810,4297,3440,3441,K
3439,DEL,4678,681,4678,5149,5149,3440,0,E
3439,DFL,2677,265,4943,385,2618,3440,2266,D
3439,FL,647,382,5325,180,5329,3440,4678,F
3439,GL,2066,738,6063,3960,8257,3440,3997,L
3439,G,925,187,6250,945,6274,3440,5325,G
3439,H,3098,3098,9348,550,6824,3440,6250,H
3439,M,74,74,9422,363,8620,3440,9348,M
3439,N,517,517,9939,270,8890,3440,9422,N
3439,O,979,979,10918,1120,10010,3440,9939,O
3439,P,12324,12324,23242,335,10345,3440,10918,P
3440,A,54,54,54,189,189,3441,0,A
3440,B,322,322,376,240,429,3441,54,B
3440,C,391,391,767,290,719,3441,376,C
3440,D,2004,2004,2771,5160,5879,3441,767,D
3440,M,1837,1837,4608,2904,8783,3441,2771,M
3440,N,1337,1337,5945,300,9083,3441,4608,N
3440,O,529,529,6474,900,9983,3441,5945,O
3440,N,1516,1516,7990,1175,11158,3441,6474,N
3440,O,1013,1013,9003,600,11758,3441,7990,O
3440,P,1306,1306,10309,3960,15718,3441,9003,P
3441,A,662,662,662,1299,1299,3442,0,A
3441,B,680,680,1342,90,1389,3442,662,B
3441,C,540,540,1882,850,2239,3442,1342,C
3441,D,2890,2890,4772,3780,6019,3442,1882,D
3441,M,2979,2979,7751,3291,9310,3442,4772,M
3441,N,339,339,8090,90,9400,3442,7751,N
3441,O,781,781,8871,885,10285,3442,8090,O
3441,N,471,471,9342,350,10635,3442,8871,N
3441,O,501,501,9843,805,11440,3442,9342,O
3441,P,22140,22140,31983,3780,15220,3442,9843,P
3442,AEI,56,56,56,3095,3095,3443,0,I
3442,AEJ,1549,1493,1549,2379,2379,3443,0,E
3442,AFJ,869,869,2418,90,2469,3443,1549,F
3442,AGJ,506,506,2924,860,3329,3443,2418,G
3442,AHJ,120,120,3044,3780,7109,3443,2924,H
3442,AJ,3159,171,3215,165,3260,3443,56,J
3442,AK,628,628,3843,895,4155,3443,3215,K
3442,AL,1385,1385,5228,3960,8115,3443,3843,L
3442,A,11770,6542,11770,11999,11999,3443,0,A
3442,B,437,437,12207,240,12239,3443,11770,B
3442,C,968,968,13175,1035,13274,3443,12207,C
3442,B,1335,1335,14510,1275,14549,3443,13175,B
3442,C,538,538,15048,925,15474,3443,14510,C
3442,D,269,269,15317,3960,19434,3443,15048,D
3442,M,1467,1467,16784,1714,21148,3443,15317,M
3442,N,300,300,17084,90,21238,3443,16784,N
3442,O,481,481,17565,870,22108,3443,17084,O
3442,N,380,380,17945,10,22118,3443,17565,N
3442,O,585,585,18530,800,22918,3443,17945,O
3442,P,871,871,19401,3780,26698,3443,18530,P
3443,A,133,133,133,141,141,3444,0,A
3443,B,83,83,216,135,276,3444,133,B
3443,C,201,201,417,280,556,3444,216,C
3443,D,5395,5395,5812,5160,5716,3444,417,D
3443,M,721,721,6533,1193,6909,3444,5812,M
3443,N,622,622,7155,180,7089,3444,6533,N
3443,O,627,627,7782,885,7974,3444,7155,O
3443,P,1878,1878,9660,6680,14654,3444,7782,P
3444,AE,49,49,49,237,237,3445,0,A
3444,BE,298,298,347,170,407,3445,49,B
3444,CE,535,535,882,495,902,3445,347,C
3444,DE,446,446,1328,385,1287,3445,882,D
3444,E,3039,1711,3039,3749,3749,3445,0,E
3444,F,969,969,4008,300,4049,3445,3039,F
3444,G,1132,1132,5140,1050,5099,3445,4008,G
3444,F,559,559,5699,720,5819,3445,5140,F
3444,G,647,647,6346,780,6599,3445,5699,G
3444,H,2795,2795,9141,3960,10559,3445,6346,H
3444,M,397,397,9538,1319,11878,3445,9141,M
3444,N,1282,1282,10820,420,12298,3445,9538,N
3444,O,534,534,11354,891,13189,3445,10820,O
3444,P,3982,3982,15336,569,13758,3445,11354,P
3445,A,2264,2264,2264,2759,2759,3446,0,A
3445,B,538,538,2802,90,2849,3446,2264,B
3445,C,1030,1030,3832,1225,4074,3446,2802,C
3445,B,462,462,4294,255,4329,3446,3832,B
3445,C,535,535,4829,805,5134,3446,4294,C
3445,D,17820,17820,22649,3780,8914,3446,4829,D
3445,M,2630,2630,25279,2903,11817,3446,22649,M
3445,N,299,299,25578,90,11907,3446,25279,N
3445,O,477,477,26055,805,12712,3446,25578,O
3445,N,1064,1064,27119,735,13447,3446,26055,N
3445,O,226,226,27345,625,14072,3446,27119,O
3445,P,1175,1175,28520,3780,17852,3446,27345,P
3446,A,30773,30773,30773,31617,31617,3447,0,A
3446,B,1807,1807,32580,90,31707,3447,30773,B
3446,C,952,952,33532,1430,33137,3447,32580,C
3446,B,4368,4368,37900,4825,37962,3447,33532,B
3446,C,212,212,38112,585,38547,3447,37900,C
3446,D,24871,24871,62983,3780,42327,3447,38112,D
3446,M,135,135,63118,235,42562,3447,62983,M
3446,N,476,476,63594,390,42952,3447,63118,N
3446,O,944,944,64538,1175,44127,3447,63594,O
3446,N,1128,1128,65666,920,45047,3447,64538,N
3446,O,862,862,66528,1162,46209,3447,65666,O
3446,P,1554,1554,68082,473,46682,3447,66528,P
3447,AE,341,341,341,481,481,3448,0,E
3447,AF,200,200,541,120,601,3448,341,F
3447,AG,226,226,767,390,991,3448,541,G
3447,AF,1434,667,1434,1689,1689,3448,0,A
3447,BF,823,156,1590,640,1631,3448,767,F
3447,BG,465,309,1899,270,1959,3448,1434,B
3447,CG,855,546,2445,890,2521,3448,1590,G
3447,CH,2804,2258,4703,2775,4734,3448,1899,C
3447,BH,2855,597,5300,5160,7681,3448,2445,H
3447,B,4177,3580,8880,4175,8909,3448,4703,B
3447,C,1113,1113,9993,1190,10099,3448,8880,C
3447,D,5394,5394,15387,665,10764,3448,9993,D
3447,M,1601,1601,16988,1762,12526,3448,15387,M
3447,N,204,204,17192,90,12616,3448,16988,N
3447,O,904,904,18096,1150,13766,3448,17192,O
3447,N,615,615,18711,365,14131,3448,18096,N
3447,O,609,609,19320,935,15066,3448,18711,O
3447,P,123,123,19443,3780,18846,3448,19320,P
3448,AE,8,8,8,217,217,3449,0,A
3448,BE,425,425,433,240,457,3449,8,B
3448,CE,605,172,605,1315,1315,3449,0,E
3448,CF,540,368,973,724,1181,3449,433,C
3448,BF,140,140,1113,80,1261,3449,973,B
3448,CF,892,384,1497,240,1555,3449,605,F
3448,CG,1022,638,2135,1620,2881,3449,1113,C
3448,DG,937,299,2434,1015,2570,3449,1497,G
3448,DF,1343,1343,3777,1355,3925,3449,2434,F
3448,DG,1022,1022,4799,1620,5545,3449,3777,G
3448,DH,168,168,4967,3960,9505,3449,4799,H
3448,D,5923,3091,8058,3960,6841,3449,2135,D
3448,M,177,177,8235,744,10249,3449,8058,M
3448,N,752,752,8987,240,10489,3449,8235,N
3448,O,143,143,9130,380,10869,3449,8987,O
3448,N,566,566,9696,310,11179,3449,9130,N
3448,O,487,487,10183,780,11959,3449,9696,O
3448,P,826,826,11009,3960,15919,3449,10183,P
3449,A,39,39,39,185,185,3450,0,A
3449,B,220,220,259,120,305,3450,39,B
3449,C,108,108,367,80,385,3450,259,C
3449,B,890,890,1257,930,1315,3450,367,B
3449,C,156,156,1413,190,1505,3450,1257,C
3449,D,575,575,1988,2850,4355,3450,1413,D
3449,M,1887,1887,3875,3937,8292,3450,1988,M
3449,N,2142,2142,6017,90,8382,3450,3875,N
3449,O,1051,1051,7068,1380,9762,3450,6017,O
3449,N,595,595,7663,320,10082,3450,7068,N
3449,O,773,773,8436,1080,11162,3450,7663,O
3449,P,779,779,9215,3780,14942,3450,8436,P
3450,AE,83,83,83,88,88,3451,0,A
3450,BE,92,9,92,104,104,3451,0,E
3450,BF,122,113,205,150,238,3451,83,B
3450,CF,121,8,213,150,254,3451,92,F
3450,CG,157,157,370,150,404,3451,213,G
3450,CH,253,88,458,830,1068,3451,205,C
3450,DH,720,632,1090,4230,4634,3451,370,H
3450,D,3638,3006,4096,3490,4558,3451,458,D
3450,M,272,272,4368,1455,6089,3451,4096,M
3450,N,1281,1281,5649,155,6244,3451,4368,N
3450,O,632,632,6281,750,6994,3451,5649,O
3450,P,1119,1119,7400,2820,9814,3451,6281,P
3451,AEI,22,22,22,50,50,3452,0,A
3451,BEI,89,67,89,130,130,3452,0,E
3451,BFI,93,4,93,156,156,3452,0,I
3451,BFJ,126,55,148,135,185,3452,22,B
3451,CFJ,135,76,224,135,265,3452,89,F
3451,CGJ,139,8,232,135,291,3452,93,J
3451,CGK,217,133,365,295,480,3452,148,C
3451,DGK,203,62,427,285,550,3452,224,G
3451,DHK,101,39,466,5160,5640,3452,365,D
3451,HK,238,4,470,295,586,3452,232,K
3451,HL,66,23,493,5280,5830,3452,427,H
3451,L,217,194,687,5160,5746,3452,470,L
3451,M,6663,6663,7350,6795,12625,3452,687,M
3451,N,275,275,7625,180,12805,3452,7350,N
3451,O,570,570,8195,726,13531,3452,7625,O
3451,P,502,502,8697,4080,17611,3452,8195,P
3452,AE,620,620,620,748,748,3453,0,E
3452,AF,325,325,945,240,988,3453,620,F
3452,AG,887,887,1832,976,1964,3453,945,G
3452,AF,3066,1234,3066,3391,3391,3453,0,A
3452,BF,1376,142,3208,1285,3249,3453,1832,F
3452,BG,355,213,3421,90,3481,3453,3066,B
3452,CG,649,436,3857,825,4074,3453,3208,G
3452,CH,713,277,4134,1195,4676,3453,3421,C
3452,BH,1206,1206,5340,725,5401,3453,4134,B
3452,CH,853,853,6193,831,6232,3453,5340,C
3452,DH,3128,792,6985,3960,8034,3453,3857,H
3452,D,1694,902,7887,414,6646,3453,6193,D
3452,M,90,90,7977,305,8339,3453,7887,M
3452,N,400,400,8377,245,8584,3453,7977,N
3452,O,510,510,8887,525,9109,3453,8377,O
3452,N,205,205,9092,250,9359,3453,8887,N
3452,O,467,467,9559,270,9629,3453,9092,O
3452,P,633,633,10192,2880,12509,3453,9559,P
3453,A,263,263,263,782,782,3454,0,A
3453,B,619,619,882,150,932,3454,263,B
3453,C,232,232,1114,165,1097,3454,882,C
3453,B,400,400,1514,465,1562,3454,1114,B
3453,C,621,621,2135,695,2257,3454,1514,C
3453,D,11482,11482,13617,4140,6397,3454,2135,D
3453,M,1981,1981,15598,3145,9542,3454,13617,M
3453,N,1402,1402,17000,300,9842,3454,15598,N
3453,O,853,853,17853,785,10627,3454,17000,O
3453,P,2293,2293,20146,4080,14707,3454,17853,P
3454,AE,68,68,68,115,115,3455,0,E
3454,AF,120,120,188,135,250,3455,68,F
3454,AG,106,106,294,385,635,3455,188,G
3454,AH,167,167,461,6590,7225,3455,294,H
3454,A,1121,660,1121,1221,1221,3455,0,A
3454,B,264,264,1385,180,1401,3455,1121,B
3454,C,213,213,1598,335,1736,3455,1385,C
3454,B,814,814,2412,740,2476,3455,1598,B
3454,C,104,104,2516,385,2861,3455,2412,C
3454,D,3115,3115,5631,5400,8261,3455,2516,D
3454,M,97,97,5728,89,8350,3455,5631,M
3454,N,122,122,5850,180,8530,3455,5728,N
3454,O,124,124,5974,265,8795,3455,5850,O
3454,N,708,708,6682,570,9365,3455,5974,N
3454,O,228,228,6910,520,9885,3455,6682,O
3454,P,1299,1299,8209,6150,16035,3455,6910,P
3455,AEI,126,126,126,215,215,3456,0,E
3455,AFI,313,187,313,951,951,3456,0,I
3455,AFJ,207,20,333,180,395,3456,126,F
3455,AGJ,183,183,516,260,655,3456,333,G
3455,AFJ,558,42,558,753,753,3456,0,A
3455,BFJ,345,345,903,180,933,3456,558,B
3455,CFJ,183,183,1086,265,1198,3456,903,C
3455,BFJ,895,122,1208,300,1251,3456,313,J
3455,BFK,426,304,1512,360,1558,3456,1086,B
3455,CFK,1305,309,1821,1230,1885,3456,516,F
3455,CGK,758,145,1966,920,2171,3456,1208,K
3455,CGJ,509,364,2330,200,2085,3456,1821,G
3455,CHJ,1067,249,2579,195,1753,3456,1512,C
3455,DHJ,1664,1051,3630,1485,3656,3456,1966,J
3455,DHK,484,484,4114,900,4556,3456,3630,K
3455,DHL,1889,105,4219,6240,8325,3456,2330,H
3455,DL,483,378,4597,3960,8516,3456,4114,L
3455,D,3129,1111,5708,5220,6973,3456,2579,D
3455,M,335,335,6043,492,9008,3456,5708,M
3455,N,187,187,6230,120,9128,3456,6043,N
3455,O,446,446,6676,465,9593,3456,6230,O
3455,N,401,401,7077,295,9888,3456,6676,N
3455,O,1373,1373,8450,602,10490,3456,7077,O
3455,P,5988,5988,14438,1263,11753,3456,8450,P
3456,A,1949,1949,1949,3754,3754,3457,0,A
3456,B,1939,1939,3888,180,3934,3457,1949,B
3456,C,904,904,4792,900,4834,3457,3888,C
3456,D,1539,1539,6331,550,5384,3457,4792,D
3456,M,2165,2165,8496,4073,9457,3457,6331,M
3456,N,1988,1988,10484,150,9607,3457,8496,N
3456,O,753,753,11237,395,10002,3457,10484,O
3456,P,23949,23949,35186,660,10662,3457,11237,P
3457,A,102,102,102,1710,1710,3458,0,A
3457,B,1792,1792,1894,240,1950,3458,102,B
3457,C,1204,1204,3098,1165,3115,3458,1894,C
3457,D,2242,2242,5340,550,3665,3458,3098,D
3457,M,1300,1300,6640,1747,5412,3458,5340,M
3457,N,567,567,7207,180,5592,3458,6640,N
3457,O,456,456,7663,720,6312,3458,7207,O
3457,N,982,982,8645,705,7017,3458,7663,N
3457,O,329,329,8974,465,7482,3458,8645,O
3457,P,4527,4527,13501,5760,13242,3458,8974,P
3458,A,2497,2497,2497,2571,2571,3459,0,A
3458,B,510,510,3007,300,2871,3459,2497,B
3458,C,525,525,3532,700,3571,3459,3007,C
3458,D,772,772,4304,4080,7651,3459,3532,D
3458,M,2076,2076,6380,3544,11195,3459,4304,M
3458,N,1497,1497,7877,90,11285,3459,6380,N
3458,O,1547,1547,9424,1805,13090,3459,7877,O
3458,N,2371,2371,11795,2100,15190,3459,9424,N
3458,O,836,836,12631,950,16140,3459,11795,O
3458,P,1165,1165,13796,3780,19920,3459,12631,P
3459,AEI,273,273,273,518,518,3460,0,E
3459,AFI,355,355,628,170,688,3460,273,F
3459,AGI,708,80,708,1179,1179,3460,0,A
3459,BGI,486,406,1114,495,1183,3460,628,G
3459,BHI,647,241,1355,180,1359,3460,708,B
3459,CHI,399,158,1513,385,1568,3460,1114,H
3459,CI,924,766,2279,945,2304,3460,1355,C
3459,DI,2845,566,2845,3645,3645,3460,0,I
3459,DJ,1120,554,3399,550,2854,3460,2279,D
3459,J,980,426,3825,240,3885,3460,2845,J
3459,K,746,746,4571,770,4655,3460,3825,K
3459,L,4461,4461,9032,550,5205,3460,4571,L
3459,M,600,600,9632,1345,6550,3460,9032,M
3459,N,865,865,10497,180,6730,3460,9632,N
3459,O,836,836,11333,830,7560,3460,10497,O
3459,P,645,645,11978,6680,14240,3460,11333,P
3460,AEI,81,81,81,1031,1031,3461,0,A
3460,BEI,396,315,396,335,335,3461,0,E
3460,BFI,638,638,1034,730,1065,3461,396,F
3460,BGI,1149,196,1230,240,1271,3461,81,B
3460,CGI,935,739,1969,925,1990,3461,1034,G
3460,CHI,832,93,2062,890,2161,3461,1230,C
3460,DHI,3385,1323,3385,4353,4353,3461,0,I
3460,DHJ,1517,101,3486,2760,4750,3461,1969,H
3460,DJ,1970,546,4032,5160,7321,3461,2062,D
3460,J,991,344,4376,90,4443,3461,3385,J
3460,K,552,552,4928,905,5348,3461,4376,K
3460,L,2677,2677,7605,3780,9128,3461,4928,L
3460,M,21,21,7626,1008,10136,3461,7605,M
3460,N,1107,1107,8733,180,10316,3461,7626,N
3460,O,960,960,9693,1055,11371,3461,8733,O
3460,N,718,718,10411,620,11991,3461,9693,N
3460,O,231,231,10642,385,12376,3461,10411,O
3460,P,533,533,11175,5460,17836,3461,10642,P
3461,AEI,59,59,59,487,487,3462,0,E
3461,AFI,648,589,648,1070,1070,3462,0,I
3461,AFJ,709,120,768,360,847,3462,59,F
3461,AGJ,326,326,1094,952,1799,3462,768,G
3461,AHJ,1377,283,1377,1565,1565,3462,0,A
3461,BHJ,423,423,1800,300,1865,3462,1377,B
3461,CHJ,1562,410,2210,180,1250,3462,648,J
3461,CHK,909,499,2709,795,2660,3462,1800,C
3461,BHK,1245,746,3455,880,2130,3462,2210,K
3461,BHL,2832,471,3926,2308,4107,3462,1094,H
3461,BL,1372,155,4081,1420,4080,3462,2709,B
3461,CL,473,473,4554,760,4840,3462,4081,C
3461,DL,946,946,5500,3540,8380,3462,4554,D
3461,L,2786,741,6241,6660,8790,3462,3455,L
3461,M,733,733,6974,1242,10032,3462,6241,M
3461,N,636,636,7610,90,10122,3462,6974,N
3461,O,517,517,8127,820,10942,3462,7610,O
3461,N,1466,1466,9593,1260,12202,3462,8127,N
3461,O,751,751,10344,1060,13262,3462,9593,O
3461,P,920,920,11264,3840,17102,3462,10344,P
3462,AEI,49,49,49,1793,1793,3463,0,E
3462,AFI,51,2,51,1379,1379,3463,0,A
3462,BFI,236,185,236,1059,1059,3463,0,I
3462,BFJ,919,919,1155,150,1209,3463,236,J
3462,BFK,200,200,1355,120,1329,3463,1155,K
3462,BFJ,1378,74,1429,165,1544,3463,51,B
3462,CFJ,569,495,1924,550,1879,3463,1355,J
3462,CFK,1891,16,1940,165,1958,3463,49,F
3462,CGK,614,103,2043,825,2369,3463,1429,C
3462,DGK,250,250,2293,3960,6329,3463,2043,D
3462,GK,533,164,2457,635,2514,3463,1924,K
3462,GL,656,139,2596,910,2868,3463,1940,G
3462,HL,48,48,2644,3960,6828,3463,2596,H
3462,L,345,158,2802,4230,6744,3463,2457,L
3462,M,1868,1868,4670,1971,8799,3463,2802,M
3462,N,146,146,4816,90,8889,3463,4670,N
3462,O,507,507,5323,870,9759,3463,4816,O
3462,N,362,362,5685,10,9769,3463,5323,N
3462,O,460,460,6145,800,10569,3463,5685,O
3462,P,881,881,7026,3780,14349,3463,6145,P
3463,A,159,159,159,240,240,3464,0,A
3463,B,781,781,940,730,970,3464,159,B
3463,C,921,921,1861,925,1895,3464,940,C
3463,D,1515,1515,3376,2760,4655,3464,1861,D
3463,M,1612,1612,4988,2489,7144,3464,3376,M
3463,N,968,968,5956,150,7294,3464,4988,N
3463,O,747,747,6703,725,8019,3464,5956,O
3463,N,1161,1161,7864,1180,9199,3464,6703,N
3463,O,109,109,7973,130,9329,3464,7864,O
3463,P,1625,1625,9598,4230,13559,3464,7973,P
3464,AEI,508,508,508,6686,6686,3465,0,I
3464,AEJ,780,272,780,987,987,3465,0,A
3464,BEJ,319,319,1099,150,1137,3465,780,B
3464,CEJ,260,260,1359,180,1317,3465,1099,C
3464,BEJ,2717,1358,2717,3115,3115,3465,0,E
3464,BFJ,1444,86,2803,1530,2847,3465,1359,B
3464,CFJ,420,334,3137,90,3205,3465,2717,F
3464,CGJ,528,194,3331,610,3457,3465,2803,C
3464,DGJ,330,136,3467,630,3835,3465,3137,G
3464,DFJ,436,436,3903,95,3930,3465,3467,F
3464,DGJ,670,98,4001,4230,7687,3465,3331,D
3464,GJ,382,284,4285,810,4740,3465,3903,G
3464,HJ,6223,2446,6731,90,6776,3465,508,J
3464,HK,1021,1021,7752,1225,8001,3465,6731,K
3464,HJ,553,553,8305,360,8361,3465,7752,J
3464,HK,511,511,8816,805,9166,3465,8305,K
3464,HL,20640,20640,29456,3780,12946,3465,8816,L
3464,H,27480,2309,31765,3780,8520,3465,4285,H
3464,M,2032,2032,33797,2502,15448,3465,31765,M
3464,N,500,500,34297,90,15538,3465,33797,N
3464,O,445,445,34742,810,16348,3465,34297,O
3464,N,3737,3737,38479,3130,19478,3465,34742,N
3464,O,1762,1762,40241,2035,21513,3465,38479,O
3464,P,2436,2436,42677,3780,25293,3465,40241,P
3465,AEI,29,29,29,2367,2367,3466,0,I
3465,AEJ,405,376,405,1876,1876,3466,0,E
3465,AFJ,637,232,637,1326,1326,3466,0,A
3465,BFJ,746,746,1383,90,1416,3466,637,B
3465,CFJ,432,432,1815,860,2276,3466,1383,C
3465,DFJ,90,90,1905,3780,6056,3466,1815,D
3465,FJ,1831,331,2236,420,2296,3466,405,F
3465,GJ,2564,357,2593,165,2532,3466,29,J
3465,GK,1218,861,3454,1350,3646,3466,2236,G
3465,HK,1004,143,3597,1035,3567,3466,2593,K
3465,HL,211,211,3808,3960,7527,3466,3597,L
3465,H,1818,1464,5272,360,4006,3466,3454,H
3465,M,248,248,5520,1156,8683,3466,5272,M
3465,N,1243,1243,6763,300,8983,3466,5520,N
3465,O,1096,1096,7859,970,9953,3466,6763,O
3465,N,151,151,8010,350,10303,3466,7859,N
3465,O,231,231,8241,390,10693,3466,8010,O
3465,P,1753,1753,9994,3960,14653,3466,8241,P
3466,AEI,118,118,118,288,288,3467,0,A
3466,BEI,213,95,213,356,356,3467,0,I
3466,BEJ,330,235,448,180,468,3467,118,B
3466,CEJ,249,14,462,150,506,3467,213,J
3466,CEK,119,119,581,255,761,3467,462,K
3466,CEJ,163,30,611,260,728,3467,448,C
3466,BEJ,694,664,1275,575,1336,3467,581,J
3466,BEK,676,12,1287,575,1303,3467,611,B
3466,CEK,269,269,1556,535,1838,3467,1287,C
3466,DEK,300,19,1575,535,1871,3467,1275,K
3466,DEL,1771,196,1771,2597,2597,3467,0,E
3466,DFL,1018,1018,2789,240,2837,3467,1771,F
3466,DGL,319,319,3108,540,3377,3467,2789,G
3466,DHL,4257,2724,5832,2880,4751,3467,1575,L
3466,DH,4100,1376,7208,2880,6257,3467,3108,H
3466,D,6897,1245,8453,2880,4718,3467,1556,D
3466,M,3019,3019,11472,2914,9171,3467,8453,M
3466,N,86,86,11558,240,9411,3467,11472,N
3466,O,443,443,12001,195,9606,3467,11558,O
3466,P,346,346,12347,660,10266,3467,12001,P
3467,A,784,784,784,993,993,3468,0,A
3467,B,329,329,1113,180,1173,3468,784,B
3467,C,1633,1633,2746,625,1798,3468,1113,C
3467,B,1613,1613,4359,2600,4398,3468,2746,B
3467,C,636,636,4995,470,4868,3468,4359,C
3467,D,1367,1367,6362,6900,11768,3468,4995,D
3467,M,1964,1964,8326,2323,14091,3468,6362,M
3467,N,1084,1084,9410,240,14331,3468,8326,N
3467,O,244,244,9654,195,14526,3468,9410,O
3467,N,426,426,10080,1140,15666,3468,9654,N
3467,O,199,199,10279,485,16151,3468,10080,O
3467,P,26485,26485,36764,840,16991,3468,10279,P
3468,AEI,176,176,176,338,338,3469,0,A
3468,BEI,182,6,182,396,396,3469,0,I
3468,BEJ,296,290,472,180,518,3469,176,B
3468,CEJ,334,44,516,180,576,3469,182,J
3468,CEK,683,639,1155,840,1358,3469,472,C
3468,DEK,665,26,1181,840,1416,3469,516,K
3468,DEL,161,161,1342,6680,8096,3469,1181,L
3468,DE,473,286,1628,6680,8038,3469,1155,D
3468,E,2721,1093,2721,2833,2833,3469,0,E
3468,F,169,169,2890,90,2923,3469,2721,F
3468,G,760,760,3650,925,3848,3469,2890,G
3468,H,15338,15338,18988,3780,7628,3469,3650,H
3468,M,105,105,19093,789,8885,3469,18988,M
3468,N,815,815,19908,180,9065,3469,19093,N
3468,O,341,341,20249,390,9455,3469,19908,O
3468,P,1277,1277,21526,6960,16415,3469,20249,P
3469,A,43,43,43,907,907,3470,0,A
3469,B,1063,1063,1106,240,1147,3470,43,B
3469,C,705,705,1811,880,2027,3470,1106,C
3469,D,89,89,1900,3960,5987,3470,1811,D
3469,M,24,24,1924,171,6158,3470,1900,M
3469,N,342,342,2266,240,6398,3470,1924,N
3469,O,757,757,3023,860,7258,3470,2266,O
3469,N,364,364,3387,335,7593,3470,3023,N
3469,O,573,573,3960,900,8493,3470,3387,O
3469,P,3279,3279,7239,3960,12453,3470,3960,P
3470,A,87,87,87,93,93,3471,0,A
3470,B,204,204,291,240,333,3471,87,B
3470,C,168,168,459,285,618,3471,291,C
3470,D,7206,7206,7665,5160,5778,3471,459,D
3470,M,565,565,8230,1062,6840,3471,7665,M
3470,N,527,527,8757,90,6930,3471,8230,N
3470,O,1073,1073,9830,1250,8180,3471,8757,O
3470,N,464,464,10294,290,8470,3471,9830,N
3470,O,742,742,11036,945,9415,3471,10294,O
3470,P,372,372,11408,3780,13195,3471,11036,P
3471,AEI,80,80,80,199,199,3472,0,E
3471,AFI,91,11,91,959,959,3472,0,A
3471,BFI,301,290,381,240,439,3472,80,F
3471,BGI,162,162,543,285,724,3472,381,G
3471,BHI,897,354,897,1385,1385,3472,0,I
3471,BHJ,1057,251,1148,240,1199,3472,91,B
3471,CHJ,740,489,1637,300,1685,3472,897,J
3471,CHK,766,277,1914,1030,2229,3472,1148,C
3471,BHK,1786,415,2329,5160,5884,3472,543,H
3471,BK,700,8,2337,920,2605,3472,1637,K
3471,BJ,184,184,2521,5,2610,3472,2337,J
3471,BK,922,315,2836,650,2879,3472,1914,B
3471,CK,160,160,2996,385,3264,3472,2836,C
3471,DK,1032,557,3553,1260,3870,3472,2521,K
3471,DL,863,306,3859,3960,7224,3472,2996,D
3471,L,1287,981,4840,3960,7830,3472,3553,L
3471,M,447,447,5287,1554,9384,3472,4840,M
3471,N,351,351,5638,90,9474,3472,5287,N
3471,O,813,813,6451,1250,10724,3472,5638,O
3471,N,1458,1458,7909,205,10929,3472,6451,N
3471,O,374,374,8283,790,11719,3472,7909,O
3471,P,595,595,8878,3780,15499,3472,8283,P
3472,AE,161,161,161,245,245,3473,0,A
3472,BE,149,149,310,120,365,3473,161,B
3472,CE,209,209,519,210,575,3473,310,C
3472,DE,602,83,602,628,628,3473,0,E
3472,DF,103,103,705,135,763,3473,602,F
3472,DG,155,155,860,290,1053,3473,705,G
3472,DH,133,133,993,5160,6213,3473,860,H
3472,D,1125,651,1644,2880,3455,3473,519,D
3472,M,629,629,2273,990,7203,3473,1644,M
3472,N,620,620,2893,300,7503,3473,2273,N
3472,O,590,590,3483,740,8243,3473,2893,O
3472,P,1460,1460,4943,3960,12203,3473,3483,P
3473,A,1187,1187,1187,1311,1311,3474,0,A
3473,B,242,242,1429,180,1491,3474,1187,B
3473,C,203,203,1632,335,1826,3474,1429,C
3473,B,2397,2397,4029,2265,4091,3474,1632,B
3473,C,115,115,4144,385,4476,3474,4029,C
3473,D,1539,1539,5683,5400,9876,3474,4144,D
3473,M,168,168,5851,683,10559,3474,5683,M
3473,N,646,646,6497,180,10739,3474,5851,N
3473,O,182,182,6679,200,10939,3474,6497,O
3473,N,354,354,7033,310,11249,3474,6679,N
3473,O,722,722,7755,765,12014,3474,7033,O
3473,P,3210,3210,10965,3960,15974,3474,7755,P
3474,AEI,184,184,184,191,191,3475,0,I
3474,AEJ,117,117,301,150,341,3475,184,J
3474,AEK,317,16,317,978,978,3475,0,A
3474,BEK,164,148,465,135,476,3475,301,K
3474,BEJ,689,541,1006,90,1068,3475,317,B
3474,CEJ,1496,490,1496,2463,2463,3475,0,E
3474,CFJ,1057,26,1522,1075,1551,3475,465,J
3474,CFK,354,354,1876,645,2196,3475,1522,K
3474,CFL,999,619,2495,90,2553,3475,1496,F
3474,CGL,1572,83,2578,2320,3388,3475,1006,C
3474,DGL,558,475,3053,905,3458,3475,2495,G
3474,DFL,437,437,3490,90,3548,3475,3053,F
3474,DGL,1708,94,3584,4230,6426,3475,1876,L
3474,DG,1621,615,4199,3420,6808,3475,2578,D
3474,G,1415,706,4905,2320,5868,3475,3490,G
3474,H,4077,4077,8982,3420,9288,3475,4905,H
3474,M,2644,2644,11626,5882,15170,3475,8982,M
3474,N,3268,3268,14894,90,15260,3475,11626,N
3474,O,1548,1548,16442,1875,17135,3475,14894,O
3474,N,941,941,17383,605,17740,3475,16442,N
3474,O,652,652,18035,890,18630,3475,17383,O
3474,P,137,137,18172,3780,22410,3475,18035,P
3475,A,65,65,65,439,439,3476,0,A
3475,B,599,599,664,240,679,3476,65,B
3475,C,517,517,1181,790,1469,3476,664,C
3475,D,112,112,1293,3960,5429,3476,1181,D
3475,M,4431,4431,5724,4519,9948,3476,1293,M
3475,N,278,278,6002,240,10188,3476,5724,N
3475,O,440,440,6442,725,10913,3476,6002,O
3475,N,961,961,7403,740,11653,3476,6442,N
3475,O,196,196,7599,390,12043,3476,7403,O
3475,P,263,263,7862,3960,16003,3476,7599,P
3476,AE,186,186,186,745,745,3477,0,A
3476,BE,691,691,877,180,925,3477,186,B
3476,CE,166,166,1043,225,1150,3477,877,C
3476,BE,1558,515,1558,1530,1530,3477,0,E
3476,BF,61,61,1619,150,1680,3477,1558,F
3476,BG,159,159,1778,135,1815,3477,1619,G
3476,BF,1542,807,2585,1475,2625,3477,1043,B
3476,CF,399,399,2984,735,3360,3477,2585,C
3476,DF,1246,40,3024,1235,3050,3477,1778,F
3476,DG,330,330,3354,645,3695,3477,3024,G
3476,DH,1656,1656,5010,4230,7925,3477,3354,H
3476,D,4444,2418,7428,4200,7560,3477,2984,D
3476,M,1246,1246,8674,1597,9522,3477,7428,M
3476,N,931,931,9605,640,10162,3477,8674,N
3476,O,809,809,10414,1100,11262,3477,9605,O
3476,N,1378,1378,11792,1120,12382,3477,10414,N
3476,O,590,590,12382,495,12877,3477,11792,O
3476,P,1535,1535,13917,500,13377,3477,12382,P
3477,AEI,189,189,189,1242,1242,3478,0,A
3477,BEI,328,139,328,698,698,3478,0,E
3477,BFI,419,419,747,90,788,3478,328,F
3477,BGI,1002,255,1002,1209,1209,3478,0,I
3477,BGJ,400,400,1402,240,1449,3478,1002,J
3477,BGK,1262,49,1451,240,1482,3478,189,B
3477,CGK,524,475,1926,785,2234,3478,1402,K
3477,CGL,587,112,2038,825,2307,3478,1451,C
3477,DGL,1394,103,2141,1865,2653,3478,747,G
3477,DHL,444,444,2585,3780,6433,3478,2141,H
3477,DL,785,126,2711,3960,6194,3478,1926,L
3477,D,20100,19427,22138,3960,6267,3478,2038,D
3477,M,227,227,22365,401,6834,3478,22138,M
3477,N,299,299,22664,180,7014,3478,22365,N
3477,O,1121,1121,23785,1250,8264,3478,22664,O
3477,P,694,694,24479,6680,14944,3478,23785,P
3478,AEI,58,58,58,86,86,3479,0,I
3478,AEJ,75,17,75,145,145,3479,0,E
3478,AFJ,119,44,119,2387,2387,3479,0,A
3478,BFJ,105,44,163,135,221,3479,58,J
3478,BFK,164,76,239,135,280,3479,75,F
3478,BGK,153,77,316,295,516,3479,163,K
3478,BGL,213,136,452,295,575,3479,239,G
3478,BHL,203,67,519,5160,5676,3479,316,L
3478,BH,158,91,610,5160,5735,3479,452,H
3478,B,2470,1979,2589,240,2627,3479,119,B
3478,C,1051,1051,3640,1015,3642,3479,2589,C
3478,B,605,605,4245,650,4292,3479,3640,B
3478,C,192,192,4437,385,4677,3479,4245,C
3478,D,728,728,5165,3960,8637,3479,4437,D
3478,M,316,316,5481,365,9002,3479,5165,M
3478,N,157,157,5638,180,9182,3479,5481,N
3478,O,212,212,5850,535,9717,3479,5638,O
3478,P,794,794,6644,2760,12477,3479,5850,P
3479,AE,380,380,380,335,335,3480,0,A
3479,BE,224,224,604,300,635,3480,380,B
3479,CE,1098,494,1098,1356,1356,3480,0,E
3479,CF,921,427,1525,840,1475,3480,604,C
3479,DF,522,95,1620,300,1656,3480,1098,F
3479,DG,535,535,2155,695,2351,3480,1620,G
3479,DH,836,836,2991,4080,6431,3480,2155,H
3479,D,8184,6718,9709,1140,2615,3480,1525,D
3479,M,146,146,9855,221,6652,3480,9709,M
3479,N,168,168,10023,150,6802,3480,9855,N
3479,O,549,549,10572,495,7297,3480,10023,O
3479,N,371,371,10943,420,7717,3480,10572,N
3479,O,157,157,11100,225,7942,3480,10943,O
3479,P,92,92,11192,4740,12682,3480,11100,P
3480,AEI,273,273,273,544,544,3481,0,A
3480,BEI,431,431,704,180,724,3481,273,B
3480,CEI,812,108,812,1248,1248,3481,0,E
3480,CFI,978,166,978,1653,1653,3481,0,I
3480,CFJ,540,374,1352,180,1428,3481,812,F
3480,CGJ,807,433,1785,180,1833,3481,978,J
3480,CGK,1254,173,1958,1810,2534,3481,704,C
3480,BGK,939,333,2291,920,2348,3481,1352,G
3480,BHK,519,13,2304,585,2418,3481,1785,K
3480,BHL,645,299,2603,235,2769,3481,1958,B
3480,CHL,412,412,3015,540,3309,3481,2603,C
3480,DHL,1163,452,3467,6960,9378,3481,2304,L
3480,DH,660,208,3675,9780,13089,3481,3015,D
3480,H,2098,714,4389,550,2898,3481,2291,H
3480,M,793,793,5182,3024,16113,3481,4389,M
3480,N,2329,2329,7511,90,16203,3481,5182,N
3480,O,1327,1327,8838,1340,17543,3481,7511,O
3480,N,6077,6077,14915,5880,23423,3481,8838,N
3480,O,1067,1067,15982,1280,24703,3481,14915,O
3480,P,153,153,16135,3780,28483,3481,15982,P
3481,AE,28,28,28,145,145,3482,0,A
3481,BE,189,189,217,135,280,3482,28,B
3481,CE,483,266,483,879,879,3482,0,E
3481,CF,316,50,533,290,570,3482,217,C
3481,DF,364,364,897,5160,5730,3482,533,D
3481,F,665,251,1148,300,1179,3482,483,F
3481,G,631,631,1779,910,2089,3482,1148,G
3481,F,262,262,2041,5,2094,3482,1779,F
3481,G,939,939,2980,1260,3354,3482,2041,G
3481,H,1913,1913,4893,3960,7314,3482,2980,H
3481,M,992,992,5885,1460,8774,3482,4893,M
3481,N,604,604,6489,180,8954,3482,5885,N
3481,O,609,609,7098,885,9839,3482,6489,O
3481,P,490,490,7588,6680,16519,3482,7098,P
3482,AE,470,470,470,913,913,3483,0,A
3482,BE,761,761,1231,240,1153,3483,470,B
3482,CE,251,251,1482,920,2073,3483,1231,C
3482,DE,4513,4513,5995,3960,6033,3483,1482,D
3482,E,14700,8705,14700,15514,15514,3483,0,E
3482,F,839,839,15539,90,15604,3483,14700,F
3482,G,566,566,16105,905,16509,3483,15539,G
3482,F,430,430,16535,90,16599,3483,16105,F
3482,G,1505,1505,18040,2320,18919,3483,16535,G
3482,H,2108,2108,20148,3420,22339,3483,18040,H
3482,M,6164,6164,26312,8665,31004,3483,20148,M
3482,N,2710,2710,29022,240,31244,3483,26312,N
3482,O,1891,1891,30913,3870,35114,3483,29022,O
3482,P,36268,36268,67181,11520,46634,3483,30913,P
3483,A,88,88,88,179,179,3484,0,A
3483,B,165,165,253,135,314,3484,88,B
3483,C,130,130,383,390,704,3484,253,C
3483,D,153,153,536,5400,6104,3484,383,D
3483,M,269,269,805,822,6926,3484,536,M
3483,N,749,749,1554,240,7166,3484,805,N
3483,O,238,238,1792,385,7551,3484,1554,O
3483,N,1621,1621,3413,1470,9021,3484,1792,N
3483,O,677,677,4090,930,9951,3484,3413,O
3483,P,1772,1772,5862,3780,13731,3484,4090,P
3484,AEI,173,173,173,135,135,3485,0,E
3484,AFI,202,202,375,300,435,3485,173,F
3484,AGI,846,471,846,1179,1179,3485,0,I
3484,AGJ,705,234,1080,690,1125,3485,375,G
3484,AFJ,487,253,1333,180,1359,3485,846,J
3484,AFK,394,141,1474,390,1515,3485,1080,F
3484,AGK,1736,262,1736,1794,1794,3485,0,A
3484,BGK,249,249,1985,240,2034,3485,1736,B
3484,CGK,640,129,2114,720,2235,3485,1474,G
3484,CHK,906,125,2239,930,2289,3485,1333,K
3484,CHL,754,500,2739,915,2949,3485,1985,C
3484,BHL,777,777,3516,555,3504,3485,2739,B
3484,CHL,659,659,4175,810,4314,3485,3516,C
3484,DHL,3453,1392,5567,3960,6195,3485,2114,H
3484,DL,5220,1892,7459,550,2839,3485,2239,L
3484,D,3289,5,7464,3960,8274,3485,4175,D
3484,M,2595,2595,10059,11266,19540,3485,7464,M
3484,N,9060,9060,19119,420,19960,3485,10059,N
3484,O,640,640,19759,676,20636,3485,19119,O
3484,P,5232,5232,24991,759,21395,3485,19759,P
3485,A,289,289,289,350,350,3486,0,A
3485,B,326,326,615,300,650,3486,289,B
3485,C,632,632,1247,740,1390,3486,615,C
3485,D,78,78,1325,1560,2950,3486,1247,D
3485,M,1875,1875,3200,1880,4830,3486,1325,M
3485,N,262,262,3462,300,5130,3486,3200,N
3485,O,722,722,4184,1035,6165,3486,3462,O
3485,N,307,307,4491,5,6170,3486,4184,N
3485,O,106,106,4597,1195,7365,3486,4491,O
3485,P,3088,3088,7685,1620,8985,3486,4597,P
3486,AE,215,215,215,1096,1096,3487,0,A
3486,BE,369,154,369,610,610,3487,0,E
3486,BF,236,236,605,120,730,3487,369,F
3486,BG,159,159,764,90,820,3487,605,G
3486,BF,1001,452,1216,180,1276,3487,215,B
3486,CF,589,137,1353,590,1410,3487,764,F
3486,CG,236,236,1589,385,1795,3487,1353,G
3486,CH,85,85,1674,5460,7255,3487,1589,H
3486,C,806,348,2022,1050,2326,3487,1216,C
3486,B,872,872,2894,625,2951,3487,2022,B
3486,C,259,259,3153,380,3331,3487,2894,C
3486,D,1670,1670,4823,5460,8791,3487,3153,D
3486,M,92,92,4915,173,8964,3487,4823,M
3486,N,251,251,5166,230,9194,3487,4915,N
3486,O,297,297,5463,190,9384,3487,5166,O
3486,N,522,522,5985,720,10104,3487,5463,N
3486,O,1572,1572,7557,1596,11700,3487,5985,O
3486,P,301,301,7858,474,12174,3487,7557,P
3487,AE,1117,1117,1117,2867,2867,3488,0,E
3487,AF,2146,1029,2146,3375,3375,3488,0,A
3487,BF,1933,904,3050,240,3107,3488,1117,F
3487,BG,1387,483,3533,180,3555,3488,2146,B
3487,CG,717,234,3767,845,3952,3488,3050,G
3487,CH,597,363,4130,560,4115,3488,3533,C
3487,BH,842,842,4972,870,4985,3488,4130,B
3487,CH,570,570,5542,735,5720,3488,4972,C
3487,DH,108,108,5650,1560,7280,3488,5542,D
3487,H,4842,2959,8609,5220,9172,3488,3767,H
3487,M,4694,4694,13303,4729,13901,3488,8609,M
3487,N,300,300,13603,300,14201,3488,13303,N
3487,O,760,760,14363,750,14951,3488,13603,O
3487,N,285,285,14648,250,15201,3488,14363,N
3487,O,911,911,15559,450,15651,3488,14648,O
3487,N,714,714,16273,1245,16896,3488,15559,N
3487,O,925,925,17198,1080,17976,3488,16273,O
3487,P,3190,3190,20388,1620,19596,3488,17198,P
3488,A,56,56,56,399,399,3489,0,A
3488,B,437,437,493,135,534,3489,56,B
3488,C,228,228,721,295,829,3489,493,C
3488,D,86,86,807,5100,5929,3489,721,D
3488,M,2233,2233,3040,2561,8490,3489,807,M
3488,N,449,449,3489,180,8670,3489,3040,N
3488,O,621,621,4110,895,9565,3489,3489,O
3488,N,1013,1013,5123,740,10305,3489,4110,N
3488,O,252,252,5375,345,10650,3489,5123,O
3488,P,5270,5270,10645,6900,17550,3489,5375,P
3489,A,519,519,519,773,773,3490,0,A
3489,B,284,284,803,90,863,3490,519,B
3489,C,621,621,1424,625,1488,3490,803,C
3489,D,1295,1295,2719,550,2038,3490,1424,D
3489,M,975,975,3694,1267,3305,3490,2719,M
3489,N,412,412,4106,180,3485,3490,3694,N
3489,O,550,550,4656,740,4225,3490,4106,O
3489,N,857,857,5513,665,4890,3490,4656,N
3489,O,556,556,6069,505,5395,3490,5513,O
3489,P,12264,12264,18333,6000,11395,3490,6069,P
3490,AEI,70,70,70,757,757,3491,0,A
3490,BEI,84,14,84,825,825,3491,0,E
3490,BFI,480,396,480,1241,1241,3491,0,I
3490,BFJ,867,457,937,150,907,3491,70,B
3490,CFJ,930,77,1014,240,1065,3491,84,F
3490,CGJ,943,409,1423,240,1481,3491,480,J
3490,CGK,506,20,1443,610,1517,3491,937,C
3490,DGK,561,132,1575,740,1805,3491,1014,G
3490,DHK,509,357,1932,740,2221,3491,1423,K
3490,DHL,913,424,2356,4230,5747,3491,1443,D
3490,HL,11091,10310,12666,5100,6905,3491,1575,H
3490,L,18161,7427,20093,5100,7321,3491,1932,L
3490,M,1132,1132,21225,1496,8817,3491,20093,M
3490,N,657,657,21882,90,8907,3491,21225,N
3490,O,506,506,22388,805,9712,3491,21882,O
3490,N,4150,4150,26538,4120,13832,3491,22388,N
3490,O,636,636,27174,920,14752,3491,26538,O
3490,P,964,964,28138,3780,18532,3491,27174,P
3491,AE,119,119,119,231,231,3492,0,A
3491,BE,301,301,420,240,471,3492,119,B
3491,CE,872,872,1292,875,1346,3492,420,C
3491,BE,1836,544,1836,2375,2375,3492,0,E
3491,BF,914,914,2750,420,2795,3492,1836,F
3491,BG,1787,329,3079,1750,3096,3492,1292,B
3491,CG,454,454,3533,900,3996,3492,3079,C
3491,DG,965,182,3715,1250,4045,3492,2750,G
3491,DF,550,368,4083,3960,7956,3492,3533,D
3491,F,1090,722,4805,830,4875,3492,3715,F
3491,G,547,547,5352,495,5370,3492,4805,G
3491,H,159,159,5511,470,5840,3492,5352,H
3491,M,377,377,5888,2457,10413,3492,5511,M
3491,N,2180,2180,8068,180,10593,3492,5888,N
3491,O,301,301,8369,420,11013,3492,8068,O
3491,N,846,846,9215,685,11698,3492,8369,N
3491,O,1338,1338,10553,1315,13013,3492,9215,O
3491,P,1778,1778,12331,350,13363,3492,10553,P
3492,AE,169,169,169,1611,1611,3493,0,A
3492,BE,825,656,825,1258,1258,3493,0,E
3492,BF,708,708,1533,180,1438,3493,825,F
3492,BG,1643,279,1812,240,1851,3493,169,B
3492,CG,977,698,2510,910,2348,3493,1533,G
3492,CH,922,224,2734,910,2761,3493,1812,C
3492,DH,301,301,3035,550,3311,3493,2734,D
3492,H,2123,1598,4633,550,2898,3493,2510,H
3492,M,1014,1014,5647,1619,4930,3493,4633,M
3492,N,953,953,6600,420,5350,3493,5647,N
3492,O,899,899,7499,1125,6475,3493,6600,O
3492,P,574,574,8073,350,6825,3493,7499,P
3493,AEI,28,28,28,122,122,3494,0,I
3493,AEJ,208,180,208,1241,1241,3494,0,E
3493,AFJ,214,34,242,180,302,3494,28,J
3493,AFK,261,19,261,1379,1379,3494,0,A
3493,BFK,187,168,429,260,562,3494,242,K
3493,BFJ,516,516,945,435,997,3494,429,J
3493,BFK,123,123,1068,200,1197,3494,945,K
3493,BFL,956,96,1164,240,1481,3494,208,F
3493,BGL,241,145,1309,8475,9672,3494,1068,L
3493,BG,1314,266,1575,240,1619,3494,261,B
3493,CG,692,281,1856,580,2061,3494,1164,G
3493,CF,335,335,2191,190,2251,3494,1856,F
3493,CG,726,110,2301,860,2479,3494,1575,C
3493,BG,501,501,2802,335,2814,3494,2301,B
3493,CG,731,120,2922,570,2821,3494,2191,G
3493,CH,529,409,3331,900,3714,3494,2802,C
3493,DH,336,336,3667,3960,7674,3494,3331,D
3493,H,3129,2384,6051,8580,11401,3494,2922,H
3493,M,365,365,6416,1984,13385,3494,6051,M
3493,N,2474,2474,8890,900,14285,3494,6416,N
3493,O,443,443,9333,480,14765,3494,8890,O
3493,N,2547,2547,11880,2500,17265,3494,9333,N
3493,O,909,909,12789,936,18201,3494,11880,O
3493,P,3302,3302,16091,474,18675,3494,12789,P
3494,AEI,40,40,40,94,94,3495,0,E
3494,AFI,121,81,121,231,231,3495,0,I
3494,AFJ,226,105,226,466,466,3495,0,A
3494,BFJ,204,18,244,210,304,3495,40,F
3494,BGJ,346,223,467,270,501,3495,121,J
3494,BGK,316,93,560,450,754,3495,244,G
3494,BFK,107,107,667,89,843,3495,560,F
3494,BGK,472,31,698,270,736,3495,226,B
3494,CGK,621,590,1288,901,1744,3495,667,G
3494,CFK,1064,243,1531,1115,1616,3495,467,K
3494,CFL,963,130,1661,1160,1896,3495,698,C
3494,DFL,1719,1346,3007,1320,3064,3495,1288,F
3494,DGL,886,886,3893,890,3954,3495,3007,G
3494,DHL,1814,1814,5707,5160,9114,3495,3893,H
3494,DL,8624,4578,10285,695,2591,3495,1661,D
3494,L,15519,6765,17050,335,1951,3495,1531,L
3494,M,5900,5900,22950,5974,15088,3495,17050,M
3494,N,303,303,23253,220,15308,3495,22950,N
3494,O,917,917,24170,965,16273,3495,23253,O
3494,N,910,910,25080,920,17193,3495,24170,N
3494,O,1253,1253,26333,2305,19498,3495,25080,O
3494,P,1315,1315,27648,4625,24123,3495,26333,P
3495,A,46,46,46,1623,1623,3496,0,A
3495,B,1727,1727,1773,165,1788,3496,46,B
3495,C,636,636,2409,910,2698,3496,1773,C
3495,D,1316,1316,3725,3960,6658,3496,2409,D
3495,M,5831,5831,9556,5915,12573,3496,3725,M
3495,N,137,137,9693,90,12663,3496,9556,N
3495,O,530,530,10223,870,13533,3496,9693,O
3495,N,539,539,10762,225,13758,3496,10223,N
3495,O,728,728,11490,935,14693,3496,10762,O
3495,P,1173,1173,12663,3780,18473,3496,11490,P
3496,AEI,83,83,83,938,938,3497,0,I
3496,AEJ,118,35,118,992,992,3497,0,E
3496,AFJ,841,723,841,1406,1406,3497,0,A
3496,BFJ,1058,300,1141,240,1178,3497,83,J
3496,BFK,1054,31,1172,240,1232,3497,118,F
3496,BGK,816,485,1657,300,1706,3497,841,B
3496,CGK,542,26,1683,795,1973,3497,1141,K
3496,CGL,686,175,1858,640,1872,3497,1172,G
3496,CHL,153,153,2011,5370,7242,3497,1858,H
3496,CL,531,177,2188,695,2401,3497,1657,C
3496,DL,10296,9791,11979,3960,5933,3497,1683,L
3496,D,15904,6113,18092,4140,6541,3497,2188,D
3496,M,406,406,18498,1733,8975,3497,18092,M
3496,N,1351,1351,19849,90,9065,3497,18498,N
3496,O,1517,1517,21366,1780,10845,3497,19849,O
3496,N,620,620,21986,345,11190,3497,21366,N
3496,O,734,734,22720,965,12155,3497,21986,O
3496,P,1280,1280,24000,3780,15935,3497,22720,P
3497,AE,343,343,343,400,400,3498,0,E
3497,AF,462,462,805,435,835,3498,343,F
3497,AG,398,398,1203,585,1420,3498,805,G
3497,AF,1312,109,1312,1415,1415,3498,0,A
3497,BF,311,311,1623,240,1655,3498,1312,B
3497,CF,579,159,1782,415,1835,3498,1203,F
3497,CG,301,301,2083,1235,3070,3498,1782,G
3497,CH,520,60,2143,785,2440,3498,1623,C
3497,DH,922,862,3005,2640,5710,3498,2083,H
3497,D,1021,159,3164,3960,6400,3498,2143,D
3497,M,2631,2631,5795,3064,9464,3498,3164,M
3497,N,618,618,6413,240,9704,3498,5795,N
3497,O,900,900,7313,725,10429,3498,6413,O
3497,N,662,662,7975,920,11349,3498,7313,N
3497,O,325,325,8300,660,12009,3498,7975,O
3497,P,536,536,8836,3960,15969,3498,8300,P
3498,AE,582,582,582,2450,2450,3499,0,E
3498,AF,866,284,866,1198,1198,3499,0,A
3498,BF,532,532,1398,180,1378,3499,866,B
3498,CF,882,882,2280,910,2288,3499,1398,C
3498,DF,2045,347,2627,180,2630,3499,582,F
3498,DG,1012,665,3292,550,2838,3499,2280,D
3498,G,928,263,3555,910,3540,3499,2627,G
3498,H,1070,1070,4625,550,4090,3499,3555,H
3498,M,171,171,4796,227,4317,3499,4625,M
3498,N,447,447,5243,420,4737,3499,4796,N
3498,O,1076,1076,6319,1160,5897,3499,5243,O
3498,P,3809,3809,10128,665,6562,3499,6319,P
3499,AEI,50,50,50,1062,1062,3500,0,A
3499,BEI,75,25,75,150,150,3500,0,I
3499,BEJ,119,44,119,630,630,3500,0,E
3499,BFJ,171,127,246,120,270,3500,75,J
3499,BFK,762,635,881,300,930,3500,119,F
3499,BGK,650,15,896,705,975,3500,246,K
3499,BGJ,1213,367,1263,240,1302,3500,50,B
3499,CGJ,788,421,1684,740,1715,3500,896,J
3499,CGK,926,123,1807,925,1855,3500,881,G
3499,CHK,813,269,2076,890,2192,3500,1263,C
3499,DHK,25,25,2101,5160,7352,3500,2076,D
3499,HK,955,538,2639,980,2695,3500,1684,K
3499,HL,903,903,3542,350,3045,3500,2639,L
3499,H,2575,840,4382,2760,4615,3500,1807,H
3499,M,88,88,4470,1066,8418,3500,4382,M
3499,N,1098,1098,5568,180,8598,3500,4470,N
3499,O,995,995,6563,1055,9653,3500,5568,O
3499,N,683,683,7246,620,10273,3500,6563,N
3499,O,247,247,7493,385,10658,3500,7246,O
3499,P,485,485,7978,5460,16118,3500,7493,P
3500,AEI,23,23,23,127,127,3501,0,E
3500,AFI,366,366,389,240,367,3501,23,F
3500,AGI,452,452,841,815,1182,3501,389,G
3500,AHI,73,73,914,3840,5022,3501,841,H
3500,AI,1626,712,1626,2315,2315,3501,0,I
3500,AJ,1667,41,1667,1913,1913,3501,0,A
3500,BJ,299,299,1966,90,2003,3501,1667,B
3500,CJ,762,422,2388,90,2405,3501,1626,J
3500,CK,513,91,2479,870,2873,3501,1966,C
3500,BK,556,556,3035,225,3098,3501,2479,B
3500,CK,789,142,3177,1030,3435,3501,2388,K
3500,CJ,672,530,3707,935,4033,3501,3035,C
3500,DJ,1126,1126,4833,3780,7813,3501,3707,D
3500,J,2498,842,5675,2300,5735,3501,3177,J
3500,K,1051,1051,6726,915,6650,3501,5675,K
3500,L,1806,1806,8532,3780,10430,3501,6726,L
3500,M,2173,2173,10705,2071,12501,3501,8532,M
3500,N,28,28,10733,150,12651,3501,10705,N
3500,O,394,394,11127,90,12741,3501,10733,O
3500,N,437,437,11564,885,13626,3501,11127,N
3500,O,399,399,11963,165,13791,3501,11564,O
3500,P,6784,6784,18747,300,14091,3501,11963,P
3501,AEI,1462,1462,1462,1794,1794,3502,0,I
3501,AEJ,578,578,2040,240,2034,3502,1462,J
3501,AEK,299,299,2339,845,2879,3502,2040,K
3501,AEL,4483,2144,4483,4665,4665,3502,0,A
3501,BEL,257,257,4740,135,4800,3502,4483,B
3501,CEL,247,247,4987,585,5385,3502,4740,C
3501,DEL,3052,404,5391,3720,6599,3502,2339,L
3501,DE,2690,2286,7677,5100,10485,3502,4987,D
3501,E,10500,2823,10500,10708,10708,3502,0,E
3501,F,459,459,10959,240,10948,3502,10500,F
3501,G,269,269,11228,885,11833,3502,10959,G
3501,H,3119,3119,14347,3720,15553,3502,11228,H
3501,M,27,27,14374,125,15678,3502,14347,M
3501,N,195,195,14569,120,15798,3502,14374,N
3501,O,207,207,14776,225,16023,3502,14569,O
3501,N,1759,1759,16535,1775,17798,3502,14776,N
3501,O,1005,1005,17540,2280,20078,3502,16535,O
3501,P,1300,1300,18840,1705,21783,3502,17540,P
3502,A,136,136,136,130,130,3503,0,A
3502,B,169,169,305,240,370,3503,136,B
3502,C,342,342,647,245,615,3503,305,C
3502,D,541,541,1188,5250,5865,3503,647,D
3502,M,917,917,2105,712,6577,3503,1188,M
3502,N,542,542,2647,780,7357,3503,2105,N
3502,O,1159,1159,3806,1381,8738,3503,2647,O
3502,P,1934,1934,5740,504,9242,3503,3806,P
3503,A,936,936,936,1233,1233,3504,0,A
3503,B,437,437,1373,180,1413,3504,936,B
3503,C,925,925,2298,900,2313,3504,1373,C
3503,D,3803,3803,6101,550,2863,3504,2298,D
3503,M,1633,1633,7734,1745,4608,3504,6101,M
3503,N,461,461,8195,420,5028,3504,7734,N
3503,O,708,708,8903,816,5844,3504,8195,O
3503,P,4581,4581,13484,414,6258,3504,8903,P
3504,AEI,214,214,214,1044,1044,3505,0,E
3504,AFI,794,580,794,1674,1674,3505,0,A
3504,BFI,1008,428,1222,240,1284,3505,214,F
3504,BGI,1490,268,1490,1595,1595,3505,0,I
3504,BGJ,374,374,1864,300,1895,3505,1490,J
3504,BGK,652,10,1874,665,1949,3505,1222,G
3504,BHK,1091,11,1885,240,1914,3505,794,B
3504,CHK,656,635,2520,835,2730,3505,1864,K
3504,CHL,705,70,2590,785,2699,3505,1885,C
3504,DHL,1087,1087,3677,3960,6659,3505,2590,D
3504,HL,1565,408,4085,1140,3870,3505,2520,L
3504,H,3050,839,4924,5370,7319,3505,1874,H
3504,M,1412,1412,6336,1824,9143,3505,4924,M
3504,N,443,443,6779,90,9233,3505,6336,N
3504,O,1467,1467,8246,1745,10978,3505,6779,O
3504,N,389,389,8635,90,11068,3505,8246,N
3504,O,192,192,8827,625,11693,3505,8635,O
3504,P,22827,22827,31654,3780,15473,3505,8827,P
3505,AEI,120,120,120,893,893,3506,0,A
3505,BEI,133,13,133,961,961,3506,0,E
3505,BFI,924,791,924,1083,1083,3506,0,I
3505,BFJ,956,152,1076,240,1133,3506,120,B
3505,CFJ,218,66,1142,90,1173,3506,924,J
3505,CFK,1011,2,1144,240,1201,3506,133,F
3505,CGK,501,433,1577,740,1873,3506,1076,C
3505,DGK,450,15,1592,795,1968,3506,1142,K
3505,DGJ,582,134,1726,740,1941,3506,1144,G
3505,DHJ,1841,1707,3433,1510,3478,3506,1592,J
3505,DHK,495,495,3928,815,4293,3506,3433,K
3505,DHL,12221,10019,13947,5100,7041,3506,1726,H
3505,DL,14120,1750,15697,5100,6973,3506,1577,D
3505,L,22140,10371,26068,3780,8073,3506,3928,L
3505,M,2374,2374,28442,4762,12835,3506,26068,M
3505,N,2417,2417,30859,90,12925,3506,28442,N
3505,O,555,555,31414,805,13730,3506,30859,O
3505,N,685,685,32099,420,14150,3506,31414,N
3505,O,622,622,32721,935,15085,3506,32099,O
3505,P,1136,1136,33857,3780,18865,3506,32721,P
3506,AE,2290,2290,2290,2481,2481,3507,0,E
3506,AF,216,216,2506,90,2571,3507,2290,F
3506,AG,2815,309,2815,3592,3592,3507,0,A
3506,BG,576,267,3082,795,3366,3507,2506,G
3506,BF,307,307,3389,75,3441,3507,3082,F
3506,BG,873,299,3688,90,3682,3507,2815,B
3506,CG,449,150,3838,735,4176,3507,3389,G
3506,CH,944,794,4632,815,4497,3507,3688,C
3506,BH,1277,1277,5909,1475,5972,3507,4632,B
3506,CH,439,439,6348,740,6712,3507,5909,C
3506,DH,2544,34,6382,3780,7956,3507,3838,H
3506,D,1008,974,7356,3780,10492,3507,6348,D
3506,M,1471,1471,8827,1107,11599,3507,7356,M
3506,N,952,952,9779,90,11689,3507,8827,N
3506,O,1088,1088,10867,1355,13044,3507,9779,O
3506,N,2734,2734,13601,3750,16794,3507,10867,N
3506,O,611,611,14212,955,17749,3507,13601,O
3506,P,16469,16469,30681,3780,21529,3507,14212,P
3507,AEI,227,227,227,397,397,3508,0,E
3507,AFI,180,180,407,120,517,3508,227,F
3507,AGI,591,184,591,1215,1215,3508,0,A
3507,BGI,206,22,613,390,907,3508,407,G
3507,BFI,653,40,653,858,858,3508,0,I
3507,BFJ,237,237,890,90,948,3508,653,J
3507,BFK,689,412,1302,455,1362,3508,613,F
3507,BGK,805,94,1396,240,1455,3508,591,B
3507,CGK,685,591,1987,640,2002,3508,1302,G
3507,CHK,666,75,2062,665,2120,3508,1396,C
3507,DHK,1489,317,2379,1935,2883,3508,890,K
3507,DHL,1473,1473,3852,3780,6663,3508,2379,L
3507,DH,2662,797,4649,5370,7372,3508,1987,H
3507,D,3059,472,5121,5370,7490,3508,2062,D
3507,M,175,175,5296,549,8039,3508,5121,M
3507,N,439,439,5735,90,8129,3508,5296,N
3507,O,1465,1465,7200,1745,9874,3508,5735,O
3507,N,434,434,7634,150,10024,3508,7200,N
3507,O,103,103,7737,535,10559,3508,7634,O
3507,P,992,992,8729,3780,14339,3508,7737,P
3508,AEI,939,939,939,1040,1040,3509,0,I
3508,AEJ,180,180,1119,120,1160,3509,939,J
3508,AEK,1800,681,1800,1845,1845,3509,0,E
3508,AFK,793,112,1912,785,1945,3509,1119,K
3508,AFL,405,293,2205,90,1935,3509,1800,F
3508,AGL,2869,664,2869,3721,3721,3509,0,A
3508,BGL,1115,158,3027,550,2495,3509,1912,L
3508,BG,1099,277,3304,1115,3050,3509,2205,G
3508,BH,1127,692,3996,300,4021,3509,2869,B
3508,CH,1618,926,4922,385,3435,3509,3304,H
3508,C,1037,111,5033,1050,5071,3509,3996,C
3508,B,688,688,5721,720,5791,3509,5033,B
3508,C,602,602,6323,780,6571,3509,5721,C
3508,D,500,500,6823,3960,10531,3509,6323,D
3508,M,163,163,6986,401,10932,3509,6823,M
3508,N,385,385,7371,180,11112,3509,6986,N
3508,O,627,627,7998,840,11952,3509,7371,O
3508,P,136,136,8134,6680,18632,3509,7998,P
3509,A,1431,1431,1431,1416,1416,3510,0,A
3509,B,413,413,1844,240,1656,3510,1431,B
3509,C,601,601,2445,770,2426,3510,1844,C
3509,B,169,169,2614,285,2711,3510,2445,B
3509,C,917,917,3531,1260,3971,3510,2614,C
3509,D,266,266,3797,3960,7931,3510,3531,D
3509,M,575,575,4372,673,8604,3510,3797,M
3509,N,215,215,4587,150,8754,3510,4372,N
3509,O,50,50,4637,100,8854,3510,4587,O
3509,N,411,411,5048,385,9239,3510,4637,N
3509,O,187,187,5235,225,9464,3510,5048,O
3509,P,965,965,6200,4740,14204,3510,5235,P
3510,AEI,149,149,149,232,232,3511,0,E
3510,AFI,161,12,161,902,902,3511,0,A
3510,BFI,160,148,309,135,367,3511,149,F
3510,BGI,172,172,481,285,652,3511,309,G
3510,BHI,131,131,612,5160,5812,3511,481,H
3510,BI,946,495,1107,240,1142,3511,161,B
3510,CI,768,768,1875,1015,2157,3511,1107,C
3510,BI,892,892,2767,650,2807,3511,1875,B
3510,CI,113,113,2880,385,3192,3511,2767,C
3510,DI,701,701,3581,3960,7152,3511,2880,D
3510,I,4793,1212,4793,5627,5627,3511,0,I
3510,J,1054,1054,5847,240,5867,3511,4793,J
3510,K,753,753,6600,1030,6897,3511,5847,K
3510,J,914,914,7514,650,7547,3511,6600,J
3510,K,198,198,7712,385,7932,3511,7514,K
3510,L,452,452,8164,3960,11892,3511,7712,L
3510,M,1257,1257,9421,2015,13907,3511,8164,M
3510,N,2011,2011,11432,90,13997,3511,9421,N
3510,O,898,898,12330,1240,15237,3511,11432,O
3510,N,235,235,12565,1110,16347,3511,12330,N
3510,O,710,710,13275,1080,17427,3511,12565,O
3510,P,846,846,14121,3780,21207,3511,13275,P
3511,AEI,668,668,668,1264,1264,3512,0,I
3511,AEJ,779,111,779,1399,1399,3512,0,E
3511,AFJ,1040,261,1040,1381,1381,3512,0,A
3511,BFJ,636,264,1304,90,1354,3512,668,J
3511,BFK,390,126,1430,90,1471,3512,1040,B
3511,CFK,685,34,1464,90,1489,3512,779,F
3511,CGK,217,57,1521,605,1959,3512,1304,K
3511,CGL,204,113,1634,605,2076,3512,1430,C
3511,DGL,201,31,1665,605,2094,3512,1464,G
3511,DHL,1648,1617,3282,3780,5856,3512,1634,D
3511,HL,1626,9,3291,3780,5874,3512,1665,H
3511,L,12892,11122,14413,3780,5739,3512,1521,L
3511,M,1059,1059,15472,1238,7112,3512,14413,M
3511,N,220,220,15692,90,7202,3512,15472,N
3511,O,229,229,15921,600,7802,3512,15692,O
3511,N,1897,1897,17818,1535,9337,3512,15921,N
3511,O,1250,1250,19068,1275,10612,3512,17818,O
3511,P,7003,7003,26071,3780,14392,3512,19068,P
3512,AE,82,82,82,135,135,3513,0,E
3512,AF,159,77,159,685,685,3513,0,A
3512,BF,142,65,224,150,285,3513,82,F
3512,BG,176,176,400,140,425,3513,224,G
3512,BF,555,314,714,90,775,3513,159,B
3512,CF,873,559,1273,900,1325,3513,400,F
3512,CG,432,432,1705,650,1975,3513,1273,G
3512,CH,1527,536,2241,2320,3095,3513,714,C
3512,DH,1139,1139,3380,3420,6515,3513,2241,D
3512,H,1924,249,3629,4230,6205,3513,1705,H
3512,M,1689,1689,5318,2843,9358,3513,3629,M
3512,N,1437,1437,6755,240,9598,3513,5318,N
3512,O,1010,1010,7765,850,10448,3513,6755,O
3512,N,1047,1047,8812,1280,11728,3513,7765,N
3512,O,848,848,9660,690,12418,3513,8812,O
3512,P,242,242,9902,3960,16378,3513,9660,P
3513,A,21,21,21,100,100,3514,0,A
3513,B,273,273,294,240,340,3514,21,B
3513,C,195,195,489,455,795,3514,294,C
3513,D,777,777,1266,3960,4755,3514,489,D
3513,M,1450,1450,2716,2579,7334,3514,1266,M
3513,N,1499,1499,4215,420,7754,3514,2716,N
3513,O,223,223,4438,310,8064,3514,4215,O
3513,N,1064,1064,5502,970,9034,3514,4438,N
3513,O,686,686,6188,665,9699,3514,5502,O
3513,P,11997,11997,18185,5400,15099,3514,6188,P
3514,AE,1344,1344,1344,1334,1334,3515,0,E
3514,AF,173,173,1517,270,1604,3515,1344,F
3514,AG,3434,1917,3434,3562,3562,3515,0,A
3514,BG,173,173,3607,90,3652,3515,3434,B
3514,CG,394,394,4001,800,4452,3515,3607,C
3514,BG,2916,432,4433,2910,4514,3515,1517,G
3514,BF,809,377,4810,395,4847,3515,4001,B
3514,CF,633,256,5066,585,5099,3515,4433,F
3514,CG,414,158,5224,735,5582,3515,4810,C
3514,DG,886,728,5952,920,6019,3515,5066,G
3514,DH,6443,6443,12395,775,6794,3515,5952,H
3514,D,9655,2484,14879,3780,9362,3515,5224,D
3514,M,778,778,15657,1084,10446,3515,14879,M
3514,N,401,401,16058,155,10601,3515,15657,N
3514,O,972,972,17030,1185,11786,3515,16058,O
3514,N,711,711,17741,515,12301,3515,17030,N
3514,O,290,290,18031,385,12686,3515,17741,O
3514,P,1688,1688,19719,1505,14191,3515,18031,P
3515,AEI,197,197,197,294,294,3516,0,A
3515,BEI,303,303,500,270,564,3516,197,B
3515,CEI,983,483,983,1391,1391,3516,0,E
3515,CFI,569,86,1069,735,1299,3516,500,C
3515,BFI,608,522,1591,270,1661,3516,983,F
3515,BGI,669,669,2260,735,2396,3516,1591,G
3515,BFI,1280,89,2349,1070,2369,3516,1069,B
3515,CFI,233,233,2582,535,2904,3516,2349,C
3515,DFI,1161,839,3421,1070,3466,3516,2260,F
3515,DGI,333,333,3754,535,4001,3516,3421,G
3515,DHI,7496,3742,7496,8583,8583,3516,0,I
3515,DHJ,1207,1207,8703,150,8733,3516,7496,J
3515,DHK,797,797,9500,390,9123,3516,8703,K
3515,DHJ,548,548,10048,990,10113,3516,9500,J
3515,DHK,505,505,10553,290,10403,3516,10048,K
3515,DHL,2420,2420,12973,240,10643,3516,10553,L
3515,DH,14247,5028,18001,2880,6881,3516,3754,H
3515,D,56136,40717,58718,2880,5784,3516,2582,D
3515,M,1492,1492,60210,1739,12382,3516,58718,M
3515,N,427,427,60637,240,12622,3516,60210,N
3515,O,420,420,61057,195,12817,3516,60637,O
3515,P,3550,3550,64607,660,13477,3516,61057,P
3516,AEI,19,19,19,189,189,3517,0,E
3516,AFI,49,30,49,81,81,3517,0,A
3516,BFI,60,11,60,88,88,3517,0,I
3516,BFJ,103,103,163,135,223,3517,60,J
3516,BFK,166,52,215,135,216,3517,49,B
3516,CFK,250,54,269,135,324,3517,19,F
3516,CGK,185,79,348,285,508,3517,163,K
3516,CGL,215,82,430,295,511,3517,215,C
3516,DGL,175,14,444,285,609,3517,269,G
3516,DHL,117,103,547,5160,5671,3517,430,D
3516,HL,387,188,735,5160,5668,3517,348,L
3516,H,3551,3260,3995,5160,5769,3517,444,H
3516,M,3528,3528,7523,4016,9785,3517,3995,M
3516,N,520,520,8043,90,9875,3517,7523,N
3516,O,1079,1079,9122,1250,11125,3517,8043,O
3516,N,7793,7793,16915,7615,18740,3517,9122,N
3516,O,750,750,17665,970,19710,3517,16915,O
3516,P,179,179,17844,3780,23490,3517,17665,P
3517,AE,41,41,41,105,105,3518,0,E
3517,AF,137,96,137,1382,1382,3518,0,A
3517,BF,244,148,285,240,345,3518,41,F
3517,BG,965,965,1250,1075,1420,3518,285,G
3517,BF,1545,432,1682,360,1742,3518,137,B
3517,CF,586,154,1836,475,1895,3518,1250,F
3517,CG,213,213,2049,240,2135,3518,1836,G
3517,CH,745,378,2427,695,2437,3518,1682,C
3517,DH,684,306,2733,5250,7385,3518,2049,H
3517,D,5353,5047,7780,550,2987,3518,2427,D
3517,M,1337,1337,9117,1565,8950,3518,7780,M
3517,N,517,517,9634,330,9280,3518,9117,N
3517,O,1079,1079,10713,2270,11550,3518,9634,O
3517,P,1186,1186,11899,1715,13265,3518,10713,P
3518,A,90,90,90,259,259,3519,0,A
3518,B,285,285,375,180,439,3519,90,B
3518,C,442,442,817,415,854,3519,375,C
3518,D,207,207,1024,385,1239,3519,817,D
3518,M,1095,1095,2119,1226,2465,3519,1024,M
3518,N,500,500,2619,420,2885,3519,2119,N
3518,O,953,953,3572,1041,3926,3519,2619,O
3518,P,4856,4856,8428,474,4400,3519,3572,P
3519,A,111,111,111,2213,2213,3520,0,A
3519,B,2285,2285,2396,240,2453,3520,111,B
3519,C,495,495,2891,740,3193,3520,2396,C
3519,D,3673,3673,6564,5100,8293,3520,2891,D
3519,M,3645,3645,10209,4720,13013,3520,6564,M
3519,N,1109,1109,11318,90,13103,3520,10209,N
3519,O,533,533,11851,805,13908,3520,11318,O
3519,N,457,457,12308,185,14093,3520,11851,N
3519,O,203,203,12511,585,14678,3520,12308,O
3519,P,846,846,13357,3780,18458,3520,12511,P
3520,AEI,121,121,121,224,224,3521,0,I
3520,AEJ,193,193,314,150,374,3521,121,J
3520,AEK,401,87,401,658,658,3521,0,A
3520,BEK,474,73,474,788,788,3521,0,E
3520,BFK,501,341,815,500,874,3521,314,K
3520,BFL,616,202,1017,400,1058,3521,401,B
3520,CFL,585,42,1059,240,1028,3521,474,F
3520,CGL,891,891,1950,880,1908,3521,1059,G
3520,CHL,1266,333,2283,1210,2268,3521,1017,C
3520,DHL,1484,16,2299,385,1259,3521,815,L
3520,DH,1229,1213,3512,550,2818,3521,2283,D
3520,H,4149,2587,6099,385,2293,3521,1950,H
3520,M,1083,1083,7182,1335,4153,3521,6099,M
3520,N,372,372,7554,180,4333,3521,7182,N
3520,O,462,462,8016,660,4993,3521,7554,O
3520,N,2453,2453,10469,2220,7213,3521,8016,N
3520,O,846,846,11315,890,8103,3521,10469,O
3520,P,4283,4283,15598,5160,13263,3521,11315,P
3521,A,397,397,397,786,786,3522,0,A
3521,B,447,447,844,90,876,3522,397,B
3521,C,1110,1110,1954,1465,2341,3522,844,C
3521,D,46,46,2000,3780,6121,3522,1954,D
3521,M,474,474,2474,1616,7737,3522,2000,M
3521,N,1561,1561,4035,180,7917,3522,2474,N
3521,O,685,685,4720,895,8812,3522,4035,O
3521,N,354,354,5074,430,9242,3522,4720,N
3521,O,682,682,5756,830,10072,3522,5074,O
3521,P,3060,3060,8816,2580,12652,3522,5756,P
3522,AE,44,44,44,397,397,3523,0,A
3522,BE,468,468,512,165,562,3523,44,B
3522,CE,726,214,726,1279,1279,3523,0,E
3522,CF,581,581,1307,90,1369,3523,726,F
3522,CG,1023,228,1535,1275,1837,3523,512,C
3522,DG,572,344,1879,860,2229,3523,1307,G
3522,DH,945,601,2480,3960,5797,3523,1535,D
3522,H,920,319,2799,3780,6009,3523,1879,H
3522,M,565,565,3364,1385,7394,3523,2799,M
3522,N,873,873,4237,90,7484,3523,3364,N
3522,O,511,511,4748,885,8369,3523,4237,O
3522,N,359,359,5107,5,8374,3523,4748,N
3522,O,456,456,5563,705,9079,3523,5107,O
3522,P,180,180,5743,3780,12859,3523,5563,P
3523,A,43,43,43,264,264,3524,0,A
3523,B,352,352,395,165,429,3524,43,B
3523,C,631,631,1026,910,1339,3524,395,C
3523,D,40,40,1066,3960,5299,3524,1026,D
3523,M,1357,1357,2423,1319,6618,3524,1066,M
3523,N,209,209,2632,300,6918,3524,2423,N
3523,O,760,760,3392,1000,7918,3524,2632,O
3523,N,701,701,4093,535,8453,3524,3392,N
3523,O,139,139,4232,390,8843,3524,4093,O
3523,P,3133,3133,7365,3960,12803,3524,4232,P
3524,A,64,64,64,125,125,3525,0,A
3524,B,267,267,331,240,365,3525,64,B
3524,C,728,728,1059,845,1210,3525,331,C
3524,D,1909,1909,2968,5220,6430,3525,1059,D
3524,M,365,365,3333,460,6890,3525,2968,M
3524,N,351,351,3684,300,7190,3525,3333,N
3524,O,799,799,4483,855,8045,3525,3684,O
3524,N,625,625,5108,165,8210,3525,4483,N
3524,O,75,75,5183,300,8510,3525,5108,O
3524,P,2665,2665,7848,2100,10610,3525,5183,P
3525,AEI,188,188,188,1297,1297,3526,0,A
3525,BEI,193,5,193,205,205,3526,0,I
3525,BEJ,199,6,199,215,215,3526,0,E
3525,BFJ,102,102,301,150,365,3526,199,F
3525,BGJ,119,11,312,150,355,3526,193,J
3525,BGK,133,133,445,410,765,3526,312,K
3525,BGJ,148,4,449,140,505,3526,301,G
3525,BFJ,935,935,1384,900,1405,3526,449,F
3525,BGJ,1024,85,1469,630,1395,3526,445,J
3525,BGK,1326,45,1514,240,1537,3526,188,B
3525,CGK,350,220,1734,650,2055,3526,1384,G
3525,CHK,271,6,1740,650,2045,3526,1469,K
3525,CHL,288,62,1802,915,2452,3526,1514,C
3525,DHL,1601,1601,3403,3960,6412,3526,1802,D
3525,HL,2885,1216,4619,4230,6285,3526,1734,H
3525,L,5913,3034,7653,4230,6275,3526,1740,L
3525,M,2862,2862,10515,2962,9374,3526,7653,M
3525,N,285,285,10800,240,9614,3526,10515,N
3525,O,795,795,11595,850,10464,3526,10800,O
3525,N,1302,1302,12897,1240,11704,3526,11595,N
3525,O,2915,2915,15812,1295,12999,3526,12897,O
3525,P,1398,1398,17210,3660,16659,3526,15812,P
3526,A,11,11,11,124,124,3527,0,A
3526,B,190,190,201,135,259,3527,11,B
3526,C,220,220,421,295,554,3527,201,C
3526,D,54,54,475,5100,5654,3527,421,D
3526,M,2139,2139,2614,3347,9001,3527,475,M
3526,N,1335,1335,3949,180,9181,3527,2614,N
3526,O,681,681,4630,895,10076,3527,3949,O
3526,N,612,612,5242,405,10481,3527,4630,N
3526,O,739,739,5981,850,11331,3527,5242,O
3526,P,24595,24595,30576,2580,13911,3527,5981,P
3527,AEI,131,131,131,426,426,3528,0,I
3527,AEJ,452,452,583,195,621,3528,131,J
3527,AEK,695,695,1278,695,1316,3528,583,K
3527,AEL,143,143,1421,385,1701,3528,1278,L
3527,AE,1834,413,1834,2969,2969,3528,0,A
3527,BE,2033,199,2033,2298,2298,3528,0,E
3527,BF,279,279,2312,120,2418,3528,2033,F
3527,BG,820,820,3132,755,3173,3528,2312,G
3527,BH,1550,252,3384,600,3569,3528,1834,B
3527,CH,1365,1365,4749,1345,4914,3528,3384,C
3527,DH,2709,1092,5841,550,3723,3528,3132,H
3527,D,3585,2493,8334,385,5299,3528,4749,D
3527,M,449,449,8783,1335,6634,3528,8334,M
3527,N,1144,1144,9927,330,6964,3528,8783,N
3527,O,1063,1063,10990,1040,8004,3528,9927,O
3527,P,699,699,11689,350,8354,3528,10990,P
3528,A,235,235,235,1166,1166,3529,0,A
3528,B,1113,1113,1348,240,1406,3529,235,B
3528,C,679,679,2027,640,2046,3529,1348,C
3528,D,2941,2941,4968,5370,7416,3529,2027,D
3528,M,339,339,5307,358,7774,3529,4968,M
3528,N,134,134,5441,180,7954,3529,5307,N
3528,O,1143,1143,6584,1250,9204,3529,5441,O
3528,P,3486,3486,10070,6680,15884,3529,6584,P
3529,AE,336,336,336,1369,1369,3530,0,A
3529,BE,1082,1082,1418,90,1459,3530,336,B
3529,CE,824,824,2242,1300,2759,3530,1418,C
3529,DE,300,300,2542,3780,6539,3530,2242,D
3529,E,2753,211,2753,3643,3643,3530,0,E
3529,F,1035,1035,3788,180,3823,3530,2753,F
3529,G,953,953,4741,945,4768,3530,3788,G
3529,H,126,126,4867,550,5318,3530,4741,H
3529,M,578,578,5445,1026,7565,3530,4867,M
3529,N,568,568,6013,150,7715,3530,5445,N
3529,O,1011,1011,7024,390,8105,3530,6013,O
3529,P,192,192,7216,660,8765,3530,7024,P
3530,A,144,144,144,116,116,3531,0,A
3530,B,113,113,257,180,296,3531,144,B
3530,C,137,137,394,230,526,3531,257,C
3530,B,516,516,910,490,1016,3531,394,B
3530,C,218,218,1128,390,1406,3531,910,C
3530,D,1688,1688,2816,3960,5366,3531,1128,D
3530,M,78,78,2894,88,5454,3531,2816,M
3530,N,178,178,3072,240,5694,3531,2894,N
3530,O,318,318,3390,1499,7193,3531,3072,O
3530,N,2538,2538,5928,1326,8519,3531,3390,N
3530,O,427,427,6355,570,9089,3531,5928,O
3530,P,596,596,6951,3960,13049,3531,6355,P
3531,A,130,130,130,600,600,3532,0,A
3531,B,1034,1034,1164,615,1215,3532,130,B
3531,C,421,421,1585,465,1680,3532,1164,C
3531,B,335,335,1920,285,1965,3532,1585,B
3531,C,268,268,2188,915,2880,3532,1920,C
3531,D,454,454,2642,2640,5520,3532,2188,D
3531,M,1433,1433,4075,2280,7800,3532,2642,M
3531,N,1114,1114,5189,300,8100,3532,4075,N
3531,O,1011,1011,6200,1350,9450,3532,5189,O
3531,P,1062,1062,7262,3840,13290,3532,6200,P
3532,AE,250,250,250,352,352,3533,0,A
3532,BE,337,337,587,300,652,3533,250,B
3532,CE,957,957,1544,975,1627,3533,587,C
3532,BE,2049,505,2049,2261,2261,3533,0,E
3532,BF,675,170,2219,635,2262,3533,1544,B
3532,CF,25,25,2244,415,2677,3533,2219,C
3532,DF,332,137,2381,180,2441,3533,2049,F
3532,DG,1510,1510,3891,695,3136,3533,2381,G
3532,DF,3180,3180,7071,2155,5291,3533,3891,F
3532,DG,380,380,7451,700,5991,3533,7071,G
3532,DH,4198,4198,11649,6840,12831,3533,7451,H
3532,D,10278,873,12522,6060,8737,3533,2244,D
3532,M,3982,3982,16504,3881,16712,3533,12522,M
3532,N,154,154,16658,300,17012,3533,16504,N
3532,O,647,647,17305,840,17852,3533,16658,O
3532,P,1693,1693,18998,4080,21932,3533,17305,P
3533,A,1836,1836,1836,3427,3427,3534,0,A
3533,B,1951,1951,3787,420,3847,3534,1836,B
3533,C,1040,1040,4827,985,4832,3534,3787,C
3533,D,1879,1879,6706,550,5382,3534,4827,D
3533,M,236,236,6942,572,5954,3534,6706,M
3533,N,687,687,7629,420,6374,3534,6942,N
3533,O,1233,1233,8862,1255,7629,3534,7629,O
3533,P,1669,1669,10531,420,8049,3534,8862,P
3534,AE,149,149,149,1084,1084,3535,0,A
3534,BE,1055,1055,1204,180,1264,3535,149,B
3534,CE,1442,238,1442,2183,2183,3535,0,E
3534,CF,821,583,2025,1050,2314,3535,1204,C
3534,BF,924,341,2366,240,2423,3535,1442,F
3534,BG,230,230,2596,200,2623,3535,2366,G
3534,BH,1665,1094,3690,1430,3744,3535,2025,B
3534,CH,623,623,4313,200,3944,3535,3690,C
3534,DH,6530,6530,10843,6240,10184,3535,4313,D
3534,H,10627,2380,13223,5590,8213,3535,2596,H
3534,M,344,344,13567,356,10540,3535,13223,M
3534,N,162,162,13729,210,10750,3535,13567,N
3534,O,645,645,14374,465,11215,3535,13729,O
3534,N,913,913,15287,1060,12275,3535,14374,N
3534,O,811,811,16098,828,13103,3535,15287,O
3534,P,1591,1591,17689,372,13475,3535,16098,P
3535,AEI,1,1,1,290,290,3536,0,A
3535,BEI,45,44,45,381,381,3536,0,I
3535,BEJ,79,34,79,114,114,3536,0,E
3535,BFJ,111,111,190,135,249,3536,79,F
3535,BGJ,151,151,341,295,544,3536,190,G
3535,BHJ,418,122,463,135,516,3536,45,J
3535,BHK,469,7,470,240,530,3536,1,B
3535,CHK,175,46,516,5100,5644,3536,341,H
3535,CK,200,147,663,295,811,3536,463,K
3535,CL,218,25,688,295,825,3536,470,C
3535,DL,108,83,771,5100,5911,3536,663,L
3535,D,112,29,800,5100,5925,3536,688,D
3535,M,6380,6380,7180,6921,12846,3536,800,M
3535,N,583,583,7763,180,13026,3536,7180,N
3535,O,828,828,8591,895,13921,3536,7763,O
3535,N,550,550,9141,320,14241,3536,8591,N
3535,O,450,450,9591,565,14806,3536,9141,O
3535,P,42947,42947,52538,6960,21766,3536,9591,P
3536,AEI,210,210,210,588,588,3537,0,I
3536,AEJ,225,15,225,348,348,3537,0,A
3536,BEJ,257,257,482,150,498,3537,225,B
3536,CEJ,422,150,632,90,678,3537,210,J
3536,CEK,667,667,1299,945,1623,3537,632,K
3536,CEL,1561,262,1561,2514,2514,3537,0,E
3536,CFL,1426,347,1908,1685,2183,3537,482,C
3536,DFL,52,52,1960,2520,4703,3537,1908,D
3536,FL,996,597,2557,90,2604,3537,1561,F
3536,GL,1150,1150,3707,1225,3829,3537,2557,G
3536,FL,2513,105,3812,3780,5403,3537,1299,L
3536,F,472,367,4179,400,4229,3537,3707,F
3536,G,668,668,4847,965,5194,3537,4179,G
3536,H,327,327,5174,3780,8974,3537,4847,H
3536,M,7482,7482,12656,9986,18960,3537,5174,M
3536,N,2534,2534,15190,90,19050,3537,12656,N
3536,O,901,901,16091,665,19715,3537,15190,O
3536,P,332,332,16423,3780,23495,3537,16091,P
3537,AEI,10,10,10,475,475,3538,0,A
3537,BEI,207,197,207,125,125,3538,0,E
3537,BFI,117,117,324,240,365,3538,207,F
3537,BGI,115,115,439,380,745,3538,324,G
3537,BFI,1034,605,1044,615,1090,3538,10,B
3537,CFI,1210,166,1210,1165,1165,3538,0,I
3537,CFJ,397,231,1441,465,1555,3538,1044,C
3537,BFJ,343,112,1553,420,1585,3538,1210,J
3537,BFK,1221,107,1660,950,1695,3538,439,F
3537,BGK,407,188,1848,285,1840,3538,1441,B
3537,CGK,255,255,2103,915,2755,3538,1848,C
3537,DGK,523,80,2183,780,2475,3538,1660,G
3537,DHK,683,53,2236,830,2415,3538,1553,K
3537,DHL,378,245,2481,2640,5395,3538,2103,D
3537,HL,709,464,2945,3960,6375,3538,2236,L
3537,H,791,29,2974,3960,6435,3538,2183,H
3537,M,1726,1726,4700,2065,8500,3538,2974,M
3537,N,913,913,5613,610,9110,3538,4700,N
3537,O,276,276,5889,455,9565,3538,5613,O
3537,N,1399,1399,7288,1210,10775,3538,5889,N
3537,O,177,177,7465,2940,13715,3538,7288,O
3537,P,26064,26064,33529,1440,15155,3538,7465,P
3538,AE,106,106,106,174,174,3539,0,A
3538,BE,277,277,383,240,414,3539,106,B
3538,CE,176,176,559,285,699,3539,383,C
3538,DE,2042,2042,2601,5160,5859,3539,559,D
3538,E,2927,326,2927,3214,3214,3539,0,E
3538,F,502,502,3429,240,3454,3539,2927,F
3538,G,506,506,3935,725,4179,3539,3429,G
3538,F,456,456,4391,265,4444,3539,3935,F
3538,G,239,239,4630,435,4879,3539,4391,G
3538,H,5461,5461,10091,3960,8839,3539,4630,H
3538,M,234,234,10325,1806,10645,3539,10091,M
3538,N,1872,1872,12197,360,11005,3539,10325,N
3538,O,1594,1594,13791,1495,12500,3539,12197,O
3538,N,2460,2460,16251,2525,15025,3539,13791,N
3538,O,1907,1907,18158,1160,16185,3539,16251,O
3538,P,233,233,18391,665,16850,3539,18158,P
3539,A,31,31,31,95,95,3540,0,A
3539,B,175,175,206,135,230,3540,31,B
3539,C,254,254,460,285,515,3540,206,C
3539,D,121,121,581,5160,5675,3540,460,D
3539,M,952,952,1533,2019,7694,3540,581,M
3539,N,1202,1202,2735,150,7844,3540,1533,N
3539,O,1439,1439,4174,1685,9529,3540,2735,O
3539,P,1461,1461,5635,2520,12049,3540,4174,P
3540,AEI,48,48,48,82,82,3541,0,I
3540,AEJ,109,109,157,135,217,3541,48,J
3540,AEK,167,10,167,522,522,3541,0,E
3540,AFK,311,301,468,295,512,3541,157,K
3540,AFL,365,64,532,120,642,3541,167,F
3540,AGL,142,78,610,5160,5672,3541,468,L
3540,AG,87,9,619,90,732,3541,532,G
3540,AF,646,646,1265,590,1322,3541,619,F
3540,AG,171,171,1436,295,1617,3541,1265,G
3540,AH,1592,156,1592,2423,2423,3541,0,A
3540,BH,171,15,1607,5160,6777,3541,1436,H
3540,B,1040,1025,2632,240,2663,3541,1592,B
3540,C,901,901,3533,1040,3703,3541,2632,C
3540,B,846,846,4379,690,4393,3541,3533,B
3540,C,1573,1573,5952,1201,5594,3541,4379,C
3540,D,128,128,6080,3960,9554,3541,5952,D
3540,M,24,24,6104,165,9719,3541,6080,M
3540,N,254,254,6358,150,9869,3541,6104,N
3540,O,124,124,6482,410,10279,3541,6358,O
3540,P,1,1,6483,1080,11359,3541,6482,P
3541,AE,934,934,934,2219,2219,3542,0,E
3541,AF,567,567,1501,90,2309,3542,934,F
3541,AG,1902,401,1902,2646,2646,3542,0,A
3541,BG,479,78,1980,805,3114,3542,1501,G
3541,BF,766,688,2668,90,2736,3542,1902,B
3541,CF,224,224,2892,625,3361,3542,2668,C
3541,BF,1387,475,3367,290,3404,3542,1980,F
3541,BG,1113,638,4005,700,4061,3542,2892,B
3541,CG,741,103,4108,1060,4464,3542,3367,G
3541,CH,730,627,4735,1060,5121,3542,4005,C
3541,DH,878,251,4986,3780,8244,3542,4108,H
3541,D,802,551,5537,3780,8901,3542,4735,D
3541,M,5515,5515,11052,5837,14738,3542,5537,M
3541,N,353,353,11405,90,14828,3542,11052,N
3541,O,786,786,12191,1130,15958,3542,11405,O
3541,N,742,742,12933,390,16348,3542,12191,N
3541,O,444,444,13377,790,17138,3542,12933,O
3541,P,923,923,14300,3780,20918,3542,13377,P
3542,A,218,218,218,396,396,3543,0,A
3542,B,188,188,406,120,516,3543,218,B
3542,C,223,223,629,390,906,3543,406,C
3542,B,1444,1444,2073,1225,2131,3543,629,B
3542,C,721,721,2794,830,2961,3543,2073,C
3542,D,9825,9825,12619,5400,8361,3543,2794,D
3542,M,1876,1876,14495,4219,12580,3543,12619,M
3542,N,2382,2382,16877,90,12670,3543,14495,N
3542,O,248,248,17125,625,13295,3543,16877,O
3542,N,1741,1741,18866,1375,14670,3543,17125,N
3542,O,512,512,19378,815,15485,3543,18866,O
3542,P,20940,20940,40318,3780,19265,3543,19378,P
3543,A,39,39,39,117,117,3544,0,A
3543,B,160,160,199,135,252,3544,39,B
3543,C,182,182,381,290,542,3544,199,C
3543,D,707,707,1088,5160,5702,3544,381,D
3543,M,891,891,1979,1894,7596,3544,1088,M
3543,N,1119,1119,3098,150,7746,3544,1979,N
3543,O,1508,1508,4606,1680,9426,3544,3098,O
3543,P,1481,1481,6087,2580,12006,3544,4606,P
3544,A,39,39,39,232,232,3545,0,A
3544,B,348,348,387,165,397,3545,39,B
3544,C,644,644,1031,910,1307,3545,387,C
3544,D,95,95,1126,3960,5267,3545,1031,D
3544,M,2269,2269,3395,2532,7799,3545,1126,M
3544,N,356,356,3751,150,7949,3545,3395,N
3544,O,742,742,4493,700,8649,3545,3751,O
3544,N,157,157,4650,195,8844,3545,4493,N
3544,O,65,65,4715,142,8986,3545,4650,O
3544,P,3546,3546,8261,1308,10294,3545,4715,P
3545,AE,2047,2047,2047,2613,2613,3546,0,E
3545,AF,614,614,2661,90,2703,3546,2047,F
3545,AG,905,905,3566,1230,3933,3546,2661,G
3545,AF,717,717,4283,380,4313,3546,3566,F
3545,AG,347,347,4630,735,5048,3546,4283,G
3545,AH,1130,1130,5760,3780,8828,3546,4630,H
3545,A,7559,1799,7559,9438,9438,3546,0,A
3545,B,1909,1909,9468,90,9528,3546,7559,B
3545,C,1485,1485,10953,1680,11208,3546,9468,C
3545,D,1724,1724,12677,3780,14988,3546,10953,D
3545,M,1987,1987,14664,2129,17117,3546,12677,M
3545,N,227,227,14891,155,17272,3546,14664,N
3545,O,978,978,15869,1195,18467,3546,14891,O
3545,N,757,757,16626,540,19007,3546,15869,N
3545,O,210,210,16836,390,19397,3546,16626,O
3545,P,615,615,17451,485,19882,3546,16836,P
3546,AEI,12,12,12,73,73,3547,0,I
3546,AEJ,64,52,64,222,222,3547,0,A
3546,BEJ,151,99,163,135,208,3547,12,J
3546,BEK,233,134,297,135,357,3547,64,B
3546,CEK,199,65,362,285,493,3547,163,K
3546,CEL,60,60,422,5160,5653,3547,362,L
3546,CE,151,26,448,280,637,3547,297,C
3546,DE,1898,1898,2346,5160,5797,3547,448,D
3546,E,5641,3295,5641,5745,5745,3547,0,E
3546,F,391,391,6032,300,6045,3547,5641,F
3546,G,557,557,6589,700,6745,3547,6032,G
3546,H,1607,1607,8196,1620,8365,3547,6589,H
3546,M,2039,2039,10235,2287,10652,3547,8196,M
3546,N,401,401,10636,180,10832,3547,10235,N
3546,O,1171,1171,11807,885,11717,3547,10636,O
3546,N,1048,1048,12855,1350,13067,3547,11807,N
3546,O,556,556,13411,620,13687,3547,12855,O
3546,P,155,155,13566,6960,20647,3547,13411,P
3547,A,3337,3337,3337,4204,4204,3548,0,A
3547,B,865,865,4202,90,4294,3548,3337,B
3547,C,193,193,4395,605,4899,3548,4202,C
3547,D,15873,15873,20268,3780,8679,3548,4395,D
3547,M,4211,4211,24479,4602,13281,3548,20268,M
3547,N,640,640,25119,300,13581,3548,24479,N
3547,O,1037,1037,26156,1115,14696,3548,25119,O
3547,N,785,785,26941,695,15391,3548,26156,N
3547,O,2301,2301,29242,2305,17696,3548,26941,O
3547,P,7,7,29249,4585,22281,3548,29242,P
3548,AE,38,38,38,1290,1290,3549,0,E
3548,AF,49,11,49,391,391,3549,0,A
3548,BF,478,478,527,165,556,3549,49,B
3548,CF,1372,883,1410,165,1455,3549,38,F
3548,CG,1004,121,1531,1275,1831,3549,527,C
3548,DG,557,436,1967,825,2280,3549,1410,G
3548,DH,349,349,2316,3960,6240,3549,1967,H
3548,D,1012,227,2543,3960,5791,3549,1531,D
3548,M,1838,1838,4381,1774,8014,3549,2543,M
3548,N,179,179,4560,240,8254,3549,4381,N
3548,O,1024,1024,5584,1335,9589,3549,4560,O
3548,N,2074,2074,7658,1820,11409,3549,5584,N
3548,O,1175,1175,8833,2270,13679,3549,7658,O
3548,P,1159,1159,9992,1675,15354,3549,8833,P
3549,A,1460,1460,1460,1632,1632,3550,0,A
3549,B,252,252,1712,180,1812,3550,1460,B
3549,C,1837,1837,3549,2010,3822,3550,1712,C
3549,B,2544,2544,6093,2345,6167,3550,3549,B
3549,C,1092,1092,7185,1235,7402,3550,6093,C
3549,D,787,787,7972,620,8022,3550,7185,D
3549,M,8711,8711,16683,8982,17004,3550,7972,M
3549,N,391,391,17074,180,17184,3550,16683,N
3549,O,1286,1286,18360,1060,18244,3550,17074,O
3549,P,25305,25305,43665,7210,25454,3550,18360,P
3550,AE,763,763,763,1469,1469,3551,0,E
3550,AF,747,747,1510,90,1559,3551,763,F
3550,AG,554,554,2064,880,2439,3551,1510,G
3550,AF,437,437,2501,110,2549,3551,2064,F
3550,AG,3265,764,3265,4102,4102,3551,0,A
3550,BG,866,866,4131,90,4192,3551,3265,B
3550,CG,608,608,4739,905,5097,3551,4131,C
3550,BG,386,386,5125,90,5187,3551,4739,B
3550,CG,1525,1525,6650,2320,7507,3551,5125,C
3550,DG,4343,194,6844,2315,4864,3551,2501,G
3550,DH,1331,1137,7981,3420,10927,3551,6650,D
3550,H,2906,1769,9750,3420,8284,3551,6844,H
3550,M,1456,1456,11206,1516,12443,3551,9750,M
3550,N,149,149,11355,150,12593,3551,11206,N
3550,O,599,599,11954,585,13178,3551,11355,O
3550,N,347,347,12301,340,13518,3551,11954,N
3550,O,663,663,12964,515,14033,3551,12301,O
3550,P,2471,2471,15435,4230,18263,3551,12964,P
3551,A,12,12,12,265,265,3552,0,A
3551,B,673,673,685,480,745,3552,12,B
3551,C,807,807,1492,725,1470,3552,685,C
3551,D,351,351,1843,550,2020,3552,1492,D
3551,M,659,659,2502,981,3001,3552,1843,M
3551,N,442,442,2944,180,3181,3552,2502,N
3551,O,232,232,3176,230,3411,3552,2944,O
3551,N,483,483,3659,480,3891,3552,3176,N
3551,O,728,728,4387,500,4391,3552,3659,O
3551,P,3569,3569,7956,6000,10391,3552,4387,P
3552,AEI,451,451,451,525,525,3553,0,I
3552,AEJ,484,33,484,635,635,3553,0,E
3552,AFJ,99,66,550,90,615,3553,451,J
3552,AFK,181,115,665,150,785,3553,484,F
3552,AGK,51,51,716,690,1475,3553,665,G
3552,AFK,217,51,767,360,975,3553,550,K
3552,AFJ,833,782,1549,140,1615,3553,716,F
3552,AGJ,1181,399,1948,1015,1990,3553,767,J
3552,AGK,534,135,2083,700,2315,3553,1549,G
3552,AFK,287,287,2370,115,2430,3553,2083,F
3552,AGK,927,505,2875,1162,3152,3553,1948,K
3552,AGL,3058,183,3058,3845,3845,3553,0,A
3552,BGL,1016,1016,4074,300,4145,3553,3058,B
3552,CGL,1742,543,4617,473,3625,3553,2875,L
3552,CG,662,119,4736,765,4910,3553,4074,C
3552,DG,1187,1187,5923,4080,8990,3553,4736,D
3552,G,3845,292,6215,905,3335,3553,2370,G
3552,H,180,180,6395,4200,7535,3553,6215,H
3552,M,1907,1907,8302,3076,12066,3553,6395,M
3552,N,1407,1407,9709,300,12366,3553,8302,N
3552,O,850,850,10559,785,13151,3553,9709,O
3552,P,2296,2296,12855,4080,17231,3553,10559,P
3553,AE,9,9,9,5977,5977,3554,0,E
3553,AF,1723,1714,1723,2719,2719,3554,0,A
3553,BF,1368,1368,3091,410,3129,3554,1723,B
3553,CF,800,800,3891,815,3944,3554,3091,C
3553,DF,6533,2651,6542,180,6157,3554,9,F
3553,DG,1367,1367,7909,835,6992,3554,6542,G
3553,DF,382,382,8291,1345,8337,3554,7909,F
3553,DG,536,536,8827,610,8947,3554,8291,G
3553,DH,5304,368,9195,550,4494,3554,3891,D
3553,H,2124,1756,10951,6960,15907,3554,8827,H
3553,M,7402,7402,18353,8580,24487,3554,10951,M
3553,N,1553,1553,19906,420,24907,3554,18353,N
3553,O,1083,1083,20989,1220,26127,3554,19906,O
3553,P,4208,4208,25197,635,26762,3554,20989,P
3554,A,147,147,147,377,377,3555,0,A
3554,B,396,396,543,150,527,3555,147,B
3554,C,528,528,1071,685,1212,3555,543,C
3554,D,69,69,1140,3690,4902,3555,1071,D
3554,M,5727,5727,6867,5935,10837,3555,1140,M
3554,N,389,389,7256,240,11077,3555,6867,N
3554,O,173,173,7429,255,11332,3555,7256,O
3554,N,870,870,8299,765,12097,3555,7429,N
3554,O,528,528,8827,505,12602,3555,8299,O
3554,P,2837,2837,11664,6000,18602,3555,8827,P
3555,A,460,460,460,1117,1117,3556,0,A
3555,B,943,943,1403,330,1447,3556,460,B
3555,C,861,861,2264,2049,3496,3556,1403,C
3555,D,1323,1323,3587,3746,7242,3556,2264,D
3555,M,365,365,3952,1147,8389,3556,3587,M
3555,N,1429,1429,5381,780,9169,3556,3952,N
3555,O,210,210,5591,170,9339,3556,5381,O
3555,N,2358,2358,7949,2325,11664,3556,5591,N
3555,O,2631,2631,10580,2568,14232,3556,7949,O
3555,P,1,1,10581,762,14994,3556,10580,P
3556,A,268,268,268,831,831,3557,0,A
3556,B,438,438,706,90,921,3557,268,B
3556,C,338,338,1044,575,1496,3557,706,C
3556,B,645,645,1689,250,1746,3557,1044,B
3556,C,1075,1075,2764,1465,3211,3557,1689,C
3556,D,627,627,3391,3780,6991,3557,2764,D
3556,M,405,405,3796,1165,8156,3557,3391,M
3556,N,1005,1005,4801,300,8456,3557,3796,N
3556,O,760,760,5561,755,9211,3557,4801,O
3556,N,1715,1715,7276,1725,10936,3557,5561,N
3556,O,768,768,8044,780,11716,3557,7276,O
3556,P,77,77,8121,1470,13186,3557,8044,P
3557,A,1678,1678,1678,1770,1770,3558,0,A
3557,B,332,332,2010,300,2070,3558,1678,B
3557,C,715,715,2725,900,2970,3558,2010,C
3557,B,473,473,3198,270,3240,3558,2725,B
3557,C,837,837,4035,750,3990,3558,3198,C
3557,D,2119,2119,6154,3960,7950,3558,4035,D
3557,M,435,435,6589,811,8761,3558,6154,M
3557,N,706,706,7295,420,9181,3558,6589,N
3557,O,477,477,7772,740,9921,3558,7295,O
3557,N,801,801,8573,505,10426,3558,7772,N
3557,O,380,380,8953,535,10961,3558,8573,O
3557,P,7081,7081,16034,2880,13841,3558,8953,P
3558,A,258,258,258,864,864,3559,0,A
3558,B,704,704,962,150,1014,3559,258,B
3558,C,184,184,1146,130,1144,3559,962,C
3558,B,226,226,1372,250,1394,3559,1146,B
3558,C,711,711,2083,555,1949,3559,1372,C
3558,D,155,155,2238,4230,6179,3559,2083,D
3558,M,94,94,2332,365,6544,3559,2238,M
3558,N,385,385,2717,185,6729,3559,2332,N
3558,O,525,525,3242,525,7254,3559,2717,O
3558,N,235,235,3477,220,7474,3559,3242,N
3558,O,148,148,3625,100,7574,3559,3477,O
3558,N,114,114,3739,170,7744,3559,3625,N
3558,O,686,686,4425,2910,10654,3559,3739,O
3558,P,2918,2918,7343,3450,14104,3559,4425,P
3559,AEI,86,86,86,75,75,3560,0,A
3559,BEI,1054,968,1054,1382,1382,3560,0,I
3559,BEJ,463,463,1517,195,1577,3560,1054,J
3559,BEK,1638,121,1638,1693,1693,3560,0,E
3559,BFK,355,355,1993,360,2053,3560,1638,F
3559,BGK,727,251,2244,695,2272,3560,1517,K
3559,BGL,2338,180,2424,240,315,3560,86,B
3559,CGL,247,67,2491,385,2657,3560,2244,L
3559,CG,271,204,2695,240,555,3560,2424,C
3559,DG,703,1,2696,695,2748,3560,1993,G
3559,DH,866,865,3561,5250,5805,3560,2695,D
3559,H,1694,829,4390,550,3298,3560,2696,H
3559,M,305,305,4695,5797,11602,3560,4390,M
3559,N,5894,5894,10589,420,12022,3560,4695,N
3559,O,1296,1296,11885,1454,13476,3560,10589,O
3559,P,899,899,12784,361,13837,3560,11885,P
3560,A,1212,1212,1212,4602,4602,3561,0,A
3560,B,3750,3750,4962,420,5022,3561,1212,B
3560,C,919,919,5881,855,5877,3561,4962,C
3560,D,284,284,6165,550,6427,3561,5881,D
3560,M,947,947,7112,1738,8165,3561,6165,M
3560,N,825,825,7937,90,8255,3561,7112,N
3560,O,846,846,8783,1215,9470,3561,7937,O
3560,N,1363,1363,10146,1005,10475,3561,8783,N
3560,O,146,146,10292,535,11010,3561,10146,O
3560,P,122,122,10414,3780,14790,3561,10292,P
3561,AEI,48,48,48,3317,3317,3562,0,I
3561,AEJ,452,404,452,842,842,3562,0,A
3561,BEJ,504,504,956,150,992,3562,452,B
3561,CEJ,111,111,1067,105,1097,3562,956,C
3561,BEJ,595,595,1662,605,1702,3562,1067,B
3561,CEJ,1784,122,1784,3093,3093,3562,0,E
3561,CFJ,626,504,2288,715,2417,3562,1662,C
3561,DFJ,206,206,2494,4170,6587,3562,2288,D
3561,FJ,3389,943,3437,165,3482,3562,48,J
3561,FK,2017,364,3801,780,3873,3562,1784,F
3561,GK,637,273,4074,895,4377,3562,3437,K
3561,GL,1014,741,4815,1100,4973,3562,3801,G
3561,HL,430,430,5245,420,5393,3562,4815,H
3561,L,1263,92,5337,3960,8337,3562,4074,L
3561,M,2457,2457,7794,2599,10936,3562,5337,M
3561,N,241,241,8035,150,11086,3562,7794,N
3561,O,696,696,8731,700,11786,3562,8035,O
3561,N,3689,3689,12420,3670,15456,3562,8731,N
3561,O,751,751,13171,610,16066,3562,12420,O
3561,P,2630,2630,15801,4230,20296,3562,13171,P
3562,A,60,60,60,150,150,3563,0,A
3562,B,306,306,366,240,390,3563,60,B
3562,C,168,168,534,285,675,3563,366,C
3562,D,774,774,1308,5160,5835,3563,534,D
3562,M,3183,3183,4491,5638,11473,3563,1308,M
3562,N,2529,2529,7020,90,11563,3563,4491,N
3562,O,1229,1229,8249,1365,12928,3563,7020,O
3562,N,398,398,8647,300,13228,3563,8249,N
3562,O,707,707,9354,965,14193,3563,8647,O
3562,P,1634,1634,10988,3780,17973,3563,9354,P
3563,A,1937,1937,1937,2901,2901,3564,0,A
3563,B,990,990,2927,90,2991,3564,1937,B
3563,C,522,522,3449,905,3896,3564,2927,C
3563,B,1204,1204,4653,770,4666,3564,3449,B
3563,C,839,839,5492,1300,5966,3564,4653,C
3563,D,4637,4637,10129,3780,9746,3564,5492,D
3563,M,481,481,10610,1453,11199,3564,10129,M
3563,N,1703,1703,12313,780,11979,3564,10610,N
3563,O,509,509,12822,795,12774,3564,12313,O
3563,N,775,775,13597,500,13274,3564,12822,N
3563,O,931,931,14528,1290,14564,3564,13597,O
3563,P,1751,1751,16279,300,14864,3564,14528,P
3564,AEI,80,80,80,103,103,3565,0,I
3564,AEJ,119,119,199,150,253,3565,80,J
3564,AEK,207,8,207,224,224,3565,0,E
3564,AFK,362,155,362,1820,1820,3565,0,A
3564,BFK,188,25,387,135,388,3565,199,K
3564,BFL,183,3,390,150,374,3565,207,F
3564,BGL,548,548,938,765,1139,3565,390,G
3564,BHL,1032,481,1419,4230,4618,3565,387,L
3564,BH,495,14,1433,3600,4739,3565,938,H
3564,B,1866,795,2228,300,2120,3565,362,B
3564,C,537,537,2765,735,2855,3565,2228,C
3564,B,240,240,3005,225,3080,3565,2765,B
3564,C,877,877,3882,835,3915,3565,3005,C
3564,D,1280,1280,5162,4020,7935,3565,3882,D
3564,M,3932,3932,9094,3997,11932,3565,5162,M
3564,N,154,154,9248,150,12082,3565,9094,N
3564,O,174,174,9422,135,12217,3565,9248,O
3564,N,410,410,9832,415,12632,3565,9422,N
3564,O,119,119,9951,120,12752,3565,9832,O
3564,P,983,983,10934,4230,16982,3565,9951,P
3565,AEI,64,64,64,99,99,3566,0,A
3565,BEI,81,17,81,175,175,3566,0,E
3565,BFI,85,4,85,150,150,3566,0,I
3565,BFJ,139,118,203,150,249,3566,64,B
3565,CFJ,200,82,285,180,330,3566,85,J
3565,CFK,262,58,343,240,415,3566,81,F
3565,CGK,91,33,376,183,513,3566,285,K
3565,CGL,595,422,798,685,934,3566,203,C
3565,DGL,59,59,857,3690,4624,3566,798,D
3565,GL,641,160,1017,717,1230,3566,376,L
3565,G,758,84,1101,975,1390,3566,343,G
3565,F,853,853,1954,625,2015,3566,1101,F
3565,G,167,167,2121,260,2275,3566,1954,G
3565,H,93,93,2214,5100,7375,3566,2121,H
3565,M,448,448,2662,903,8278,3566,2214,M
3565,N,656,656,3318,240,8518,3566,2662,N
3565,O,237,237,3555,397,8915,3566,3318,O
3565,P,5301,5301,8856,1108,10023,3566,3555,P
3566,AE,199,199,199,219,219,3567,0,E
3566,AF,170,170,369,210,429,3567,199,F
3566,AG,741,741,1110,690,1119,3567,369,G
3566,AF,46,46,1156,90,1209,3567,1110,F
3566,AG,824,824,1980,890,2099,3567,1156,G
3566,AH,205,205,2185,5160,7259,3567,1980,H
3566,A,5097,2912,5097,5850,5850,3567,0,A
3566,B,1139,1139,6236,420,6270,3567,5097,B
3566,C,1097,1097,7333,1180,7450,3567,6236,C
3566,D,796,796,8129,665,8115,3567,7333,D
3566,M,1614,1614,9743,2702,10817,3567,8129,M
3566,N,1120,1120,10863,90,10907,3567,9743,N
3566,O,604,604,11467,915,11822,3567,10863,O
3566,N,782,782,12249,465,12287,3567,11467,N
3566,O,417,417,12666,790,13077,3567,12249,O
3566,P,1396,1396,14062,3780,16857,3567,12666,P
3567,AEI,548,548,548,926,926,3568,0,I
3567,AEJ,669,669,1217,360,1286,3568,548,J
3567,AEK,1346,129,1346,1756,1756,3568,0,E
3567,AFK,1472,126,1472,2894,2894,3568,0,A
3567,BFK,982,727,2199,1125,2411,3568,1217,K
3567,BFJ,587,587,2786,425,2836,3568,2199,J
3567,BFK,1540,100,2886,630,2386,3568,1346,F
3567,BGK,123,23,2909,120,2956,3568,2786,K
3567,BGL,1884,447,3356,180,3074,3568,1472,B
3567,CGL,904,434,3790,855,3241,3568,2886,G
3567,CHL,1038,604,4394,835,3909,3568,3356,C
3567,BHL,231,231,4625,755,4664,3568,4394,B
3567,CHL,760,760,5385,615,5279,3568,4625,C
3567,BHL,2299,704,6089,385,3626,3568,3790,H
3567,BL,1580,876,6965,1464,6743,3568,5385,B
3567,CL,4426,370,7335,550,3506,3568,2909,L
3567,C,1033,663,7998,901,7644,3568,6965,C
3567,D,618,618,8616,6960,14604,3568,7998,D
3567,M,556,556,9172,2241,16845,3568,8616,M
3567,N,1802,1802,10974,150,16995,3568,9172,N
3567,O,983,983,11957,1027,18022,3568,10974,O
3567,P,12465,12465,24422,348,18370,3568,11957,P
3568,A,43,43,43,1269,1269,3569,0,A
3568,B,1276,1276,1319,165,1434,3569,43,B
3568,C,752,752,2071,825,2259,3569,1319,C
3568,D,229,229,2300,3960,6219,3569,2071,D
3568,M,340,340,2640,388,6607,3569,2300,M
3568,N,186,186,2826,180,6787,3569,2640,N
3568,O,880,880,3706,1060,7847,3569,2826,O
3568,N,382,382,4088,185,8032,3569,3706,N
3568,O,693,693,4781,530,8562,3569,4088,O
3568,P,2567,2567,7348,6900,15462,3569,4781,P
3569,A,229,229,229,756,756,3570,0,A
3569,B,627,627,856,150,906,3570,229,B
3569,C,154,154,1010,395,1301,3570,856,C
3569,B,271,271,1281,25,1326,3570,1010,B
3569,C,215,215,1496,155,1481,3570,1281,C
3569,D,982,982,2478,4230,5711,3570,1496,D
3569,M,1600,1600,4078,3755,9466,3570,2478,M
3569,N,2450,2450,6528,300,9766,3570,4078,N
3569,O,132,132,6660,295,10061,3570,6528,O
3569,N,1241,1241,7901,1125,11186,3570,6660,N
3569,O,813,813,8714,905,12091,3570,7901,O
3569,P,15254,15254,23968,5160,17251,3570,8714,P
3570,A,49,49,49,695,695,3571,0,A
3570,B,739,739,788,150,845,3571,49,B
3570,C,89,89,877,80,925,3571,788,C
3570,B,174,174,1051,185,1110,3571,877,B
3570,C,100,100,1151,130,1240,3571,1051,C
3570,D,422,422,1573,2850,4090,3571,1151,D
3570,M,597,597,2170,538,4628,3571,1573,M
3570,N,93,93,2263,150,4778,3571,2170,N
3570,O,606,606,2869,210,4988,3571,2263,O
3570,N,539,539,3408,960,5948,3571,2869,N
3570,O,662,662,4070,495,6443,3571,3408,O
3570,P,13415,13415,17485,4230,10673,3571,4070,P
3571,AEI,56,56,56,114,114,3572,0,E
3571,AFI,77,21,77,670,670,3572,0,A
3571,BFI,183,106,183,291,291,3572,0,I
3571,BFJ,167,40,223,135,249,3572,56,F
3571,BGJ,143,103,326,90,381,3572,183,J
3571,BGK,176,73,399,295,544,3572,223,G
3571,BHK,111,111,510,5100,5644,3572,399,H
3571,BK,213,29,539,575,956,3572,326,K
3571,BJ,781,319,858,240,910,3572,77,B
3571,CJ,204,204,1062,300,1210,3572,858,C
3571,DJ,712,712,1774,5100,6310,3572,1062,D
3571,J,1569,334,2108,1175,2131,3572,539,J
3571,K,1032,1032,3140,1465,3596,3572,2108,K
3571,L,642,642,3782,3780,7376,3572,3140,L
3571,M,429,429,4211,1120,8496,3572,3782,M
3571,N,972,972,5183,180,8676,3572,4211,N
3571,O,434,434,5617,895,9571,3572,5183,O
3571,N,630,630,6247,330,9901,3572,5617,N
3571,O,264,264,6511,340,10241,3572,6247,O
3571,P,4599,4599,11110,6900,17141,3572,6511,P
3572,AEI,19,19,19,95,95,3573,0,I
3572,AEJ,38,19,38,44,44,3573,0,A
3572,BEJ,78,40,78,113,113,3573,0,E
3572,BFJ,138,98,176,135,179,3573,38,B
3572,CFJ,110,12,188,135,248,3573,78,F
3572,CGJ,273,104,292,240,335,3573,19,J
3572,CGK,129,13,305,280,459,3573,176,C
3572,DGK,150,33,338,290,538,3573,188,G
3572,DHK,158,125,463,5160,5619,3573,305,D
3572,HK,192,21,484,290,625,3573,292,K
3572,HL,1296,1150,1634,5160,5698,3573,338,H
3572,L,1238,88,1722,5160,5785,3573,484,L
3572,M,90,90,1812,154,5939,3573,1722,M
3572,N,185,185,1997,180,6119,3573,1812,N
3572,O,212,212,2209,570,6689,3573,1997,O
3572,P,103,103,2312,2845,9534,3573,2209,P
3573,AE,158,158,158,2492,2492,3574,0,E
3573,AF,225,67,225,471,471,3574,0,A
3573,BF,287,287,512,90,561,3574,225,B
3573,CF,1421,1421,1933,1865,2426,3574,512,C
3573,DF,2521,746,2679,240,2732,3574,158,F
3573,DG,492,492,3171,825,3557,3574,2679,G
3573,DH,4133,2895,6066,3780,6206,3574,1933,D
3573,H,13024,10129,16195,3960,7517,3574,3171,H
3573,M,171,171,16366,389,7906,3574,16195,M
3573,N,333,333,16699,180,8086,3574,16366,N
3573,O,1124,1124,17823,1250,9336,3574,16699,O
3573,P,3541,3541,21364,6680,16016,3574,17823,P
3574,A,134,134,134,1532,1532,3575,0,A
3574,B,633,633,767,90,1622,3575,134,B
3574,C,372,372,1139,575,2197,3575,767,C
3574,B,1197,1197,2336,200,2397,3575,1139,B
3574,C,1001,1001,3337,1330,3727,3575,2336,C
3574,D,3061,3061,6398,3780,7507,3575,3337,D
3574,M,1369,1369,7767,1850,9357,3575,6398,M
3574,N,593,593,8360,150,9507,3575,7767,N
3574,O,65,65,8425,100,9607,3575,8360,O
3574,N,392,392,8817,385,9992,3575,8425,N
3574,O,168,168,8985,225,10217,3575,8817,O
3574,P,1468,1468,10453,4740,14957,3575,8985,P
3575,AEI,133,133,133,275,275,3576,0,E
3575,AFI,322,322,455,240,515,3576,133,F
3575,AGI,591,591,1046,575,1090,3576,455,G
3575,AFI,1554,508,1554,1822,1822,3576,0,I
3575,AFJ,1641,87,1641,1981,1981,3576,0,A
3575,BFJ,755,160,1801,795,1885,3576,1046,F
3575,BGJ,539,292,2093,300,2122,3576,1554,J
3575,BGK,548,96,2189,240,2221,3576,1641,B
3575,CGK,674,286,2475,468,2353,3576,1801,G
3575,CHK,209,209,2684,392,2745,3576,2475,H
3575,CK,837,246,2930,1070,3192,3576,2093,K
3575,CJ,996,255,3185,976,3197,3576,2189,C
3575,BJ,429,429,3614,345,3542,3576,3185,B
3575,CJ,537,537,4151,900,4442,3576,3614,C
3575,DJ,2184,963,5114,1970,5162,3576,2930,J
3575,DK,619,619,5733,900,6062,3576,5114,K
3575,DL,609,609,6342,3960,10022,3576,5733,L
3575,D,8948,6757,13099,3960,8402,3576,4151,D
3575,M,1890,1890,14989,1939,11961,3576,13099,M
3575,N,284,284,15273,180,12141,3576,14989,N
3575,O,808,808,16081,600,12741,3576,15273,O
3575,N,1559,1559,17640,1815,14556,3576,16081,N
3575,O,738,738,18378,1287,15843,3576,17640,O
3575,P,1278,1278,19656,9420,25263,3576,18378,P
3576,AE,28,28,28,48,48,3577,0,E
3576,AF,123,123,151,135,183,3577,28,F
3576,AG,249,249,400,295,478,3577,151,G
3576,AH,58,58,458,5100,5578,3577,400,H
3576,A,1106,648,1106,1135,1135,3577,0,A
3576,B,90,90,1196,120,1255,3577,1106,B
3576,C,107,107,1303,80,1335,3577,1196,C
3576,B,1055,1055,2358,1080,2415,3577,1303,B
3576,C,163,163,2521,190,2605,3577,2358,C
3576,D,674,674,3195,2850,5455,3577,2521,D
3576,M,500,500,3695,1101,6679,3577,3195,M
3576,N,694,694,4389,90,6769,3577,3695,N
3576,O,1017,1017,5406,1380,8149,3577,4389,O
3576,N,636,636,6042,320,8469,3577,5406,N
3576,O,691,691,6733,970,9439,3577,6042,O
3576,P,1186,1186,7919,3780,13219,3577,6733,P
3577,A,2605,2605,2605,3085,3085,3578,0,A
3577,B,732,732,3337,300,3385,3578,2605,B
3577,C,952,952,4289,1045,4430,3578,3337,C
3577,D,2426,2426,6715,1140,5570,3578,4289,D
3577,M,1320,1320,8035,1491,7061,3578,6715,M
3577,N,374,374,8409,240,7301,3578,8035,N
3577,O,497,497,8906,770,8071,3578,8409,O
3577,N,563,563,9469,285,8356,3578,8906,N
3577,O,789,789,10258,1260,9616,3578,9469,O
3577,P,303,303,10561,3960,13576,3578,10258,P
3578,AEI,3,3,3,190,190,3579,0,A
3578,BEI,288,285,288,375,375,3579,0,I
3578,BEJ,329,41,329,1368,1368,3579,0,E
3578,BFJ,370,44,373,240,430,3579,3,B
3578,CFJ,210,125,498,180,555,3579,288,J
3578,CFK,159,159,657,260,815,3579,498,K
3578,CFJ,314,30,687,285,715,3579,373,C
3578,DFJ,537,507,1194,430,1245,3579,657,J
3578,DFK,178,178,1372,280,1525,3579,1194,K
3578,DFL,3,3,1375,5160,6685,3579,1372,L
3578,DF,753,65,1440,5160,5875,3579,687,D
3578,F,1168,57,1497,150,1518,3579,329,F
3578,G,133,133,1630,385,1903,3579,1497,G
3578,F,898,898,2528,675,2578,3579,1630,F
3578,G,258,258,2786,165,2743,3579,2528,G
3578,H,1244,1244,4030,4230,6973,3579,2786,H
3578,M,3010,3010,7040,5346,12319,3579,4030,M
3578,N,2470,2470,9510,90,12409,3579,7040,N
3578,O,1129,1129,10639,1375,13784,3579,9510,O
3578,N,361,361,11000,210,13994,3579,10639,N
3578,O,156,156,11156,585,14579,3579,11000,O
3578,P,2612,2612,13768,3780,18359,3579,11156,P
3579,A,84,84,84,1178,1178,3580,0,A
3579,B,1284,1284,1368,240,1418,3580,84,B
3579,C,767,767,2135,780,2198,3580,1368,C
3579,D,27,27,2162,7740,9938,3580,2135,D
3579,M,13029,13029,15191,13060,22998,3580,2162,M
3579,N,289,289,15480,300,23298,3580,15191,N
3579,O,548,548,16028,710,24008,3580,15480,O
3579,P,1762,1762,17790,1140,25148,3580,16028,P
3580,AEI,302,302,302,254,254,3581,0,A
3580,BEI,134,134,436,240,494,3581,302,B
3580,CEI,139,139,575,380,874,3581,436,C
3580,BEI,1066,491,1066,1412,1412,3581,0,E
3580,BFI,729,238,1304,460,1334,3581,575,B
3580,CFI,554,316,1620,240,1652,3581,1066,F
3580,CGI,567,251,1871,790,2124,3581,1304,C
3580,DGI,518,267,2138,785,2437,3581,1620,G
3580,DHI,1200,933,3071,3960,6084,3581,1871,D
3580,HI,1015,82,3153,3960,6397,3581,2138,H
3580,I,8864,5711,8864,9635,9635,3581,0,I
3580,J,1028,1028,9892,300,9935,3581,8864,J
3580,K,615,615,10507,805,10740,3581,9892,K
3580,L,832,832,11339,3960,14700,3581,10507,L
3580,M,1856,1856,13195,2070,16770,3581,11339,M
3580,N,793,793,13988,610,17380,3581,13195,N
3580,O,267,267,14255,435,17815,3581,13988,O
3580,N,301,301,14556,150,17965,3581,14255,N
3580,O,299,299,14855,1205,19170,3581,14556,O
3580,P,9594,9594,24449,3255,22425,3581,14855,P
3581,AEI,94,94,94,332,332,3582,0,A
3581,BEI,222,128,222,1390,1390,3582,0,I
3581,BEJ,462,334,556,270,602,3582,94,B
3581,CEJ,1350,1016,1572,240,1630,3582,222,J
3581,CEK,1074,58,1630,1115,1717,3582,556,C
3581,DEK,786,728,2358,890,2520,3582,1572,K
3581,DEL,3800,3800,6158,5160,7680,3582,2358,L
3581,DE,15051,8893,15051,15799,15799,3582,0,E
3581,DF,14051,630,15681,335,2052,3582,1630,D
3581,F,948,318,15999,240,16039,3582,15051,F
3581,G,682,682,16681,960,16999,3582,15999,G
3581,H,380,380,17061,3960,20959,3582,16681,H
3581,M,136,136,17197,3056,24015,3582,17061,M
3581,N,3109,3109,20306,250,24265,3582,17197,N
3581,O,917,917,21223,1195,25460,3582,20306,O
3581,N,2059,2059,23282,1745,27205,3582,21223,N
3581,O,902,902,24184,2049,29254,3582,23282,O
3581,P,815,815,24999,846,30100,3582,24184,P
3582,AE,209,209,209,208,208,3583,0,A
3582,BE,95,95,304,155,363,3583,209,B
3582,CE,121,121,425,90,453,3583,304,C
3582,DE,77,77,502,2880,3333,3583,425,D
3582,E,683,181,683,1028,1028,3583,0,E
3582,F,684,684,1367,400,1428,3583,683,F
3582,G,1186,1186,2553,1480,2908,3583,1367,G
3582,F,1446,1446,3999,1150,4058,3583,2553,F
3582,G,1538,1538,5537,1543,5601,3583,3999,G
3582,H,3754,3754,9291,917,6518,3583,5537,H
3582,M,591,591,9882,1000,7518,3583,9291,M
3582,N,508,508,10390,150,7668,3583,9882,N
3582,O,180,180,10570,140,7808,3583,10390,O
3582,N,305,305,10875,340,8148,3583,10570,N
3582,O,445,445,11320,390,8538,3583,10875,O
3582,P,615,615,11935,4230,12768,3583,11320,P
3583,A,2119,2119,2119,2367,2367,3584,0,A
3583,B,303,303,2422,90,2457,3584,2119,B
3583,C,747,747,3169,815,3272,3584,2422,C
3583,B,447,447,3616,230,3502,3584,3169,B
3583,C,418,418,4034,745,4247,3584,3616,C
3583,D,613,613,4647,3780,8027,3584,4034,D
3583,M,602,602,5249,570,8597,3584,4647,M
3583,N,268,268,5517,360,8957,3584,5249,N
3583,O,1096,1096,6613,1225,10182,3584,5517,O
3583,N,3239,3239,9852,3105,13287,3584,6613,N
3583,O,1216,1216,11068,2270,15557,3584,9852,O
3583,P,1070,1070,12138,1675,17232,3584,11068,P
3584,A,762,762,762,757,757,3585,0,A
3584,B,341,341,1103,420,1177,3585,762,B
3584,C,621,621,1724,831,2008,3585,1103,C
3584,D,621,621,2345,414,2422,3585,1724,D
3584,M,3,3,2348,121,2543,3585,2345,M
3584,N,354,354,2702,300,2843,3585,2348,N
3584,O,640,640,3342,820,3663,3585,2702,O
3584,N,591,591,3933,410,4073,3585,3342,N
3584,O,409,409,4342,465,4538,3585,3933,O
3584,P,3670,3670,8012,5760,10298,3585,4342,P
3585,AEI,170,170,170,232,232,3586,0,A
3585,BEI,220,50,220,917,917,3586,0,E
3585,BFI,163,113,333,150,382,3586,170,B
3585,CFI,343,10,343,757,757,3586,0,I
3585,CFJ,166,156,499,125,507,3586,333,C
3585,BFJ,504,348,847,90,847,3586,343,J
3585,BFK,879,252,1099,240,1157,3586,220,F
3585,BGK,643,43,1142,680,1187,3586,499,B
3585,CGK,172,172,1314,115,1302,3586,1142,C
3585,DGK,387,387,1701,4290,5592,3586,1314,D
3585,GK,915,61,1762,1285,2132,3586,847,K
3585,GL,761,98,1860,1015,2172,3586,1099,G
3585,FL,396,298,2158,3780,5912,3586,1762,L
3585,F,930,632,2790,650,2822,3586,1860,F
3585,G,172,172,2962,385,3207,3586,2790,G
3585,H,784,784,3746,3960,7167,3586,2962,H
3585,M,2901,2901,6647,4461,11628,3586,3746,M
3585,N,1593,1593,8240,90,11718,3586,6647,N
3585,O,912,912,9152,1250,12968,3586,8240,O
3585,N,8980,8980,18132,8635,21603,3586,9152,N
3585,O,643,643,18775,970,22573,3586,18132,O
3585,P,1260,1260,20035,3780,26353,3586,18775,P
3586,AE,1803,1803,1803,2580,2580,3587,0,E
3586,AF,897,897,2700,180,2760,3587,1803,F
3586,AG,3084,384,3084,3840,3840,3587,0,A
3586,BG,781,397,3481,975,3735,3587,2700,G
3586,BF,951,554,4035,240,4080,3587,3084,B
3586,CF,767,213,4248,590,4325,3587,3481,F
3586,CG,821,821,5069,653,4978,3587,4248,G
3586,CH,1431,397,5466,1015,5095,3587,4035,C
3586,BH,804,407,5873,1092,6070,3587,5069,H
3586,B,2122,1715,7588,2795,7890,3587,5466,B
3586,C,1424,1424,9012,1620,9510,3587,7588,C
3586,D,1272,1272,10284,3960,13470,3587,9012,D
3586,M,223,223,10507,290,13760,3587,10284,M
3586,N,159,159,10666,150,13910,3587,10507,N
3586,O,124,124,10790,110,14020,3587,10666,O
3586,N,862,862,11652,855,14875,3587,10790,N
3586,O,119,119,11771,125,15000,3587,11652,O
3586,P,2935,2935,14706,4230,19230,3587,11771,P
3587,A,44,44,44,209,209,3588,0,A
3587,B,317,317,361,165,374,3588,44,B
3587,C,648,648,1009,910,1284,3588,361,C
3587,D,229,229,1238,3960,5244,3588,1009,D
3587,M,1981,1981,3219,2780,8024,3588,1238,M
3587,N,843,843,4062,90,8114,3588,3219,N
3587,O,506,506,4568,855,8969,3588,4062,O
3587,N,5340,5340,9908,5015,13984,3588,4568,N
3587,O,195,195,10103,690,14674,3588,9908,O
3587,P,10546,10546,20649,3780,18454,3588,10103,P
3588,AEI,87,87,87,94,94,3589,0,E
3588,AFI,111,24,111,409,409,3589,0,A
3588,BFI,56,32,143,120,214,3589,87,F
3588,BGI,145,2,145,148,148,3589,0,I
3588,BGJ,81,81,226,135,283,3589,145,J
3588,BGK,246,163,389,105,319,3589,143,G
3588,BFK,194,31,420,295,578,3589,226,K
3588,BFL,14,14,434,5100,5678,3589,420,L
3588,BF,375,52,486,135,544,3589,111,B
3588,CF,185,185,671,295,839,3589,486,C
3588,DF,88,88,759,5100,5939,3589,671,D
3588,F,752,382,1141,880,1199,3589,389,F
3588,G,207,207,1348,185,1384,3589,1141,G
3588,H,711,711,2059,2850,4234,3589,1348,H
3588,M,833,833,2892,1125,7064,3589,2059,M
3588,N,417,417,3309,180,7244,3589,2892,N
3588,O,761,761,4070,895,8139,3589,3309,O
3588,N,234,234,4304,105,8244,3589,4070,N
3588,O,698,698,5002,660,8904,3589,4304,O
3588,P,2994,2994,7996,6660,15564,3589,5002,P
3589,AE,32,32,32,721,721,3590,0,E
3589,AF,359,327,359,1101,1101,3590,0,A
3589,BF,800,473,832,150,871,3590,32,F
3589,BG,451,451,1283,520,1391,3590,832,G
3589,BH,952,28,1311,240,1341,3590,359,B
3589,CH,457,457,1768,785,2126,3590,1311,C
3589,DH,1682,1682,3450,3960,6086,3590,1768,D
3589,H,4648,2481,5931,4230,5621,3590,1283,H
3589,M,514,514,6445,575,6661,3590,5931,M
3589,N,635,635,7080,610,7271,3590,6445,N
3589,O,366,366,7446,455,7726,3590,7080,O
3589,N,1293,1293,8739,1210,8936,3590,7446,N
3589,O,4569,4569,13308,1625,10561,3590,8739,O
3589,P,22968,22968,36276,2755,13316,3590,13308,P
3590,AE,62,62,62,82,82,3591,0,E
3590,AF,64,2,64,820,820,3591,0,A
3590,BF,116,114,178,135,217,3591,62,F
3590,BG,177,177,355,295,512,3591,178,G
3590,BH,199,199,554,5160,5672,3591,355,H
3590,B,939,449,1003,240,1060,3591,64,B
3590,C,863,863,1866,1015,2075,3591,1003,C
3590,B,821,821,2687,650,2725,3591,1866,B
3590,C,213,213,2900,385,3110,3591,2687,C
3590,D,585,585,3485,3960,7070,3591,2900,D
3590,M,9023,9023,12508,9183,16253,3591,3485,M
3590,N,302,302,12810,180,16433,3591,12508,N
3590,O,845,845,13655,885,17318,3591,12810,O
3590,P,31814,31814,45469,6680,23998,3591,13655,P
3591,A,478,478,478,1126,1126,3592,0,A
3591,B,768,768,1246,180,1306,3592,478,B
3591,C,754,754,2000,945,2251,3592,1246,C
3591,B,1649,1649,3649,1455,3706,3592,2000,B
3591,C,840,840,4489,2109,5815,3592,3649,C
3591,D,1240,1240,5729,1327,7142,3592,4489,D
3591,M,1405,1405,7134,1578,8720,3592,5729,M
3591,N,1083,1083,8217,780,9500,3592,7134,N
3591,O,880,880,9097,1080,10580,3592,8217,O
3591,N,781,781,9878,860,11440,3592,9097,N
3591,O,1168,1168,11046,1103,12543,3592,9878,O
3591,P,70,70,11116,402,12945,3592,11046,P
3592,AE,129,129,129,691,691,3593,0,A
3592,BE,752,752,881,240,931,3593,129,B
3592,CE,187,187,1068,285,1216,3593,881,C
3592,DE,2893,2893,3961,5160,6376,3593,1068,D
3592,E,5693,1732,5693,5846,5846,3593,0,E
3592,F,194,194,5887,90,5936,3593,5693,F
3592,G,708,708,6595,1130,7066,3593,5887,G
3592,F,1730,1730,8325,1300,8366,3593,6595,F
3592,G,997,997,9322,1300,9666,3593,8325,G
3592,H,1749,1749,11071,3780,13446,3593,9322,H
3592,M,1463,1463,12534,4462,17908,3593,11071,M
3592,N,3096,3096,15630,90,17998,3593,12534,N
3592,O,953,953,16583,1250,19248,3593,15630,O
3592,N,847,847,17430,600,19848,3593,16583,N
3592,O,310,310,17740,705,20553,3593,17430,O
3592,P,1759,1759,19499,3780,24333,3593,17740,P
3593,A,156,156,156,1352,1352,3594,0,A
3593,B,1391,1391,1547,240,1592,3594,156,B
3593,C,713,713,2260,760,2352,3594,1547,C
3593,D,87,87,2347,7680,10032,3594,2260,D
3593,M,8888,8888,11235,9785,19817,3594,2347,M
3593,N,1151,1151,12386,300,20117,3594,11235,N
3593,O,889,889,13275,905,21022,3594,12386,O
3593,P,4173,4173,17448,2760,23782,3594,13275,P
3594,AE,31,31,31,897,897,3595,0,E
3594,AF,616,585,616,1159,1159,3595,0,A
3594,BF,1060,475,1091,240,1137,3595,31,F
3594,BG,745,270,1361,240,1399,3595,616,B
3594,CG,645,375,1736,895,2032,3595,1091,G
3594,CH,679,304,2040,880,2279,3595,1361,C
3594,DH,947,643,2683,3960,5992,3595,1736,H
3594,D,998,355,3038,3960,6239,3595,2040,D
3594,M,631,631,3669,1679,7918,3595,3038,M
3594,N,1247,1247,4916,240,8158,3595,3669,N
3594,O,865,865,5781,860,9018,3595,4916,O
3594,N,436,436,6217,415,9433,3595,5781,N
3594,O,3248,3248,9465,2460,11893,3595,6217,O
3594,P,751,751,10216,3960,15853,3595,9465,P
3595,AE,174,174,174,107,107,3596,0,A
3595,BE,119,119,293,240,347,3596,174,B
3595,CE,132,132,425,380,727,3596,293,C
3595,BE,713,713,1138,440,1167,3596,425,B
3595,CE,1508,370,1508,1578,1578,3596,0,E
3595,CF,627,257,1765,895,2062,3596,1138,C
3595,DF,261,4,1769,240,1818,3596,1508,F
3595,DG,324,320,2089,3960,6022,3596,1765,D
3595,G,812,492,2581,970,2788,3596,1769,G
3595,F,1419,1419,4000,1260,4048,3596,2581,F
3595,G,591,591,4591,895,4943,3596,4000,G
3595,H,18843,18843,23434,3960,8903,3596,4591,H
3595,M,1979,1979,25413,3145,12048,3596,23434,M
3595,N,1404,1404,26817,300,12348,3596,25413,N
3595,O,856,856,27673,785,13133,3596,26817,O
3595,P,2290,2290,29963,4080,17213,3596,27673,P
3596,AEI,42,42,42,127,127,3597,0,E
3596,AFI,46,4,46,74,74,3597,0,A
3596,BFI,106,106,152,135,209,3597,46,B
3596,CFI,180,70,222,135,262,3597,42,F
3596,CGI,229,159,381,295,504,3597,152,C
3596,DGI,171,12,393,285,547,3597,222,G
3596,DHI,125,113,506,5160,5664,3597,381,D
3596,HI,199,86,592,5160,5707,3597,393,H
3596,I,1049,457,1049,1407,1407,3597,0,I
3596,J,387,387,1436,90,1497,3597,1049,J
3596,K,964,964,2400,1330,2827,3597,1436,K
3596,L,1626,1626,4026,3780,6607,3597,2400,L
3596,M,786,786,4812,1625,8232,3597,4026,M
3596,N,965,965,5777,150,8382,3597,4812,N
3596,O,1436,1436,7213,1685,10067,3597,5777,O
3596,P,1426,1426,8639,2520,12587,3597,7213,P
3597,AE,59,59,59,85,85,3598,0,A
3597,BE,131,72,131,200,200,3598,0,E
3597,BF,103,31,162,135,220,3598,59,B
3597,CF,257,257,419,285,505,3598,162,C
3597,DF,325,37,456,300,500,3598,131,F
3597,DG,449,412,868,5160,5665,3598,419,D
3597,G,602,190,1058,800,1300,3598,456,G
3597,H,146,146,1204,1140,2440,3598,1058,H
3597,M,252,252,1456,205,5870,3598,1204,M
3597,N,270,270,1726,360,6230,3598,1456,N
3597,O,569,569,2295,770,7000,3598,1726,O
3597,P,2464,2464,4759,1140,8140,3598,2295,P
3598,A,908,908,908,1028,1028,3599,0,A
3598,B,307,307,1215,240,1268,3599,908,B
3598,C,612,612,1827,585,1853,3599,1215,C
3598,B,1660,1660,3487,1675,3528,3599,1827,B
3598,C,588,588,4075,905,4433,3599,3487,C
3598,D,324,324,4399,3960,8393,3599,4075,D
3598,M,2861,2861,7260,2968,11361,3599,4399,M
3598,N,195,195,7455,90,11451,3599,7260,N
3598,O,551,551,8006,870,12321,3599,7455,O
3598,N,1097,1097,9103,820,13141,3599,8006,N
3598,O,578,578,9681,705,13846,3599,9103,O
3598,P,492,492,10173,3780,17626,3599,9681,P
3599,AEI,126,126,126,201,201,3600,0,I
3599,AEJ,151,151,277,135,336,3600,126,J
3599,AEK,176,176,453,385,721,3600,277,K
3599,AEL,24,24,477,6365,7086,3600,453,L
3599,AE,1920,1443,1920,2658,2658,3600,0,A
3599,BE,939,939,2859,240,2898,3600,1920,B
3599,CE,2968,109,2968,3268,3268,3600,0,E
3599,CF,493,493,3461,240,3508,3600,2968,F
3599,CG,1111,509,3970,1015,3913,3600,2859,C
3599,BG,880,371,4341,970,4478,3600,3461,G
3599,BF,1287,916,5257,1355,5268,3600,3970,B
3599,CF,1547,1547,6804,1620,6888,3600,5257,C
3599,DF,3216,753,7557,3090,7568,3600,4341,F
3599,DG,774,21,7578,3960,10848,3600,6804,D
3599,G,1545,1524,9102,1620,9188,3600,7557,G
3599,H,854,854,9956,3960,13148,3600,9102,H
3599,M,5686,5686,15642,5781,18929,3600,9956,M
3599,N,189,189,15831,150,19079,3600,15642,N
3599,O,117,117,15948,110,19189,3600,15831,O
3599,N,806,806,16754,775,19964,3600,15948,N
3599,O,233,233,16987,230,20194,3600,16754,O
3599,P,1512,1512,18499,4230,24424,3600,16987,P
3600,AE,429,429,429,1087,1087,3601,0,A
3600,BE,697,697,1126,90,1177,3601,429,B
3600,CE,640,640,1766,970,2147,3601,1126,C
3600,DE,2008,2008,3774,3780,5927,3601,1766,D
3600,E,4571,797,4571,4728,4728,3601,0,E
3600,F,199,199,4770,90,4818,3601,4571,F
3600,G,617,617,5387,820,5638,3601,4770,G
3600,F,1116,1116,6503,915,6553,3601,5387,F
3600,G,745,745,7248,970,7523,3601,6503,G
3600,H,1149,1149,8397,3780,11303,3601,7248,H
3600,M,153,153,8550,1321,12624,3601,8397,M
3600,N,2733,2733,11283,180,12804,3601,8550,N
3600,O,234,234,11517,1485,14289,3601,11283,O
3600,N,956,956,12473,1150,15439,3601,11517,N
3600,O,478,478,12951,750,16189,3601,12473,O
3600,P,3319,3319,16270,2580,18769,3601,12951,P
3601,AEI,59,59,59,1112,1112,3602,0,I
3601,AEJ,123,64,123,1137,1137,3602,0,E
3601,AFJ,1200,1077,1200,1680,1680,3602,0,A
3601,BFJ,1192,115,1315,240,1377,3602,123,F
3601,BGJ,737,622,1937,300,1980,3602,1200,B
3601,CGJ,827,205,2142,780,2157,3602,1315,G
3601,CHJ,777,572,2714,1045,3025,3602,1937,C
3601,DHJ,2673,18,2732,240,1352,3602,59,J
3601,DHK,86,68,2800,1140,4165,3602,2714,D
3601,HK,771,703,3503,780,2132,3602,2732,K
3601,HL,770,770,4273,7680,9812,3602,3503,L
3601,H,3784,1653,5926,7680,9837,3602,2142,H
3601,M,1659,1659,7585,1765,11602,3602,5926,M
3601,N,365,365,7950,300,11902,3602,7585,N
3601,O,593,593,8543,700,12602,3602,7950,O
3601,P,1627,1627,10170,1140,13742,3602,8543,P
3602,AEI,158,158,158,785,785,3603,0,A
3602,BEI,249,91,249,766,766,3603,0,I
3602,BEJ,677,428,677,1295,1295,3603,0,E
3602,BFJ,759,331,1008,300,1066,3603,249,J
3602,BFK,897,47,1055,300,1085,3603,158,B
3602,CFK,727,680,1735,825,1891,3603,1008,K
3602,CFL,795,115,1850,825,1910,3603,1055,C
3602,DFL,1388,215,2065,780,2075,3603,677,F
3602,DGL,840,840,2905,1162,3237,3603,2065,G
3602,DHL,171,171,3076,473,3710,3603,2905,H
3602,DL,1627,286,3362,4080,5971,3603,1735,L
3602,D,15440,13928,17290,4080,5990,3603,1850,D
3602,M,2183,2183,19473,3454,9444,3603,17290,M
3602,N,1523,1523,20996,300,9744,3603,19473,N
3602,O,920,920,21916,777,10521,3603,20996,O
3602,P,6,6,21922,8393,18914,3603,21916,P
3603,A,881,881,881,1550,1550,3604,0,A
3603,B,909,909,1790,300,1850,3604,881,B
3603,C,434,434,2224,780,2630,3604,1790,C
3603,B,862,862,3086,480,3110,3604,2224,B
3603,C,842,842,3928,805,3915,3604,3086,C
3603,D,2219,2219,6147,3960,7875,3604,3928,D
3603,M,60,60,6207,330,8205,3604,6147,M
3603,N,846,846,7053,610,8815,3604,6207,N
3603,O,384,384,7437,455,9270,3604,7053,O
3603,N,1315,1315,8752,1210,10480,3604,7437,N
3603,O,4595,4595,13347,1380,11860,3604,8752,O
3603,P,25620,25620,38967,3000,14860,3604,13347,P
3604,AEI,45,45,45,1986,1986,3605,0,E
3604,AFI,46,1,46,2530,2530,3605,0,I
3604,AFJ,184,138,184,1017,1017,3605,0,A
3604,BFJ,962,962,1146,180,1197,3605,184,B
3604,CFJ,169,169,1315,230,1427,3605,1146,C
3604,BFJ,506,506,1821,445,1872,3605,1315,B
3604,CFJ,2061,285,2106,165,2151,3605,45,F
3604,CGJ,668,383,2489,745,2617,3605,1821,C
3604,DGJ,128,128,2617,4140,6757,3605,2489,D
3604,GJ,2604,33,2650,165,2695,3605,46,J
3604,GK,834,290,2940,1075,3226,3605,2106,G
3604,HK,832,542,3482,1035,3730,3605,2650,K
3604,HL,1197,655,4137,4020,7246,3605,2940,H
3604,L,1078,423,4560,3960,7690,3605,3482,L
3604,M,502,502,5062,578,8268,3605,4560,M
3604,N,132,132,5194,90,8358,3605,5062,N
3604,O,475,475,5669,860,9218,3605,5194,O
3604,N,633,633,6302,240,9458,3605,5669,N
3604,O,659,659,6961,915,10373,3605,6302,O
3604,P,2623,2623,9584,3780,14153,3605,6961,P
3605,AEI,125,125,125,812,812,3606,0,E
3605,AFI,424,299,424,1215,1215,3606,0,I
3605,AFJ,899,600,1024,240,1052,3606,125,F
3605,AGJ,821,221,1245,90,1305,3606,424,J
3605,AGK,729,508,1753,960,2012,3606,1024,G
3605,AHK,128,128,1881,3960,5972,3606,1753,H
3605,AK,869,233,2114,1230,2535,3606,1245,K
3605,AJ,4155,2041,4155,4385,4385,3606,0,A
3605,BJ,225,225,4380,120,4505,3606,4155,B
3605,CJ,2440,174,4554,2050,4585,3606,2114,J
3605,CK,190,16,4570,390,4895,3606,4380,C
3605,BK,523,507,5077,915,5500,3606,4554,K
3605,BL,912,405,5482,640,5535,3606,4570,B
3605,CL,841,841,6323,890,6425,3606,5482,C
3605,DL,2955,1709,8032,3780,9280,3606,5077,L
3605,D,1812,103,8135,5160,11585,3606,6323,D
3605,M,453,453,8588,1189,12774,3606,8135,M
3605,N,886,886,9474,210,12984,3606,8588,N
3605,O,766,766,10240,740,13724,3606,9474,O
3605,N,3312,3312,13552,3330,17054,3606,10240,N
3605,O,1536,1536,15088,2280,19334,3606,13552,O
3605,P,817,817,15905,1705,21039,3606,15088,P
3606,AE,32,32,32,1323,1323,3607,0,E
3606,AF,102,70,102,988,988,3607,0,A
3606,BF,1067,1067,1169,240,1228,3607,102,B
3606,CF,243,243,1412,380,1608,3607,1169,C
3606,DF,1479,99,1511,240,1563,3607,32,F
3606,DG,243,243,1754,380,1943,3607,1511,G
3606,DH,958,616,2370,5460,7068,3607,1412,D
3606,H,1393,777,3147,5580,7523,3607,1754,H
3606,M,329,329,3476,581,8104,3607,3147,M
3606,N,498,498,3974,300,8404,3607,3476,N
3606,O,216,216,4190,315,8719,3607,3974,O
3606,N,474,474,4664,380,9099,3607,4190,N
3606,O,257,257,4921,290,9389,3607,4664,O
3606,P,4214,4214,9135,5190,14579,3607,4921,P
3607,A,157,157,157,977,977,3608,0,A
3607,B,1027,1027,1184,240,1217,3608,157,B
3607,C,757,757,1941,1030,2247,3608,1184,C
3607,B,910,910,2851,650,2897,3608,1941,B
3607,C,198,198,3049,385,3282,3608,2851,C
3607,D,395,395,3444,3960,7242,3608,3049,D
3607,M,18960,18960,22404,19189,26431,3608,3444,M
3607,N,1895,1895,24299,180,26611,3608,22404,N
3607,O,1232,1232,25531,945,27556,3608,24299,O
3607,P,4092,4092,29623,6680,34236,3608,25531,P
3608,AEI,20,20,20,145,145,3609,0,E
3608,AFI,23,3,23,351,351,3609,0,I
3608,AFJ,55,32,55,758,758,3609,0,A
3608,BFJ,205,170,225,135,280,3609,20,F
3608,BGJ,181,181,406,295,575,3609,225,G
3608,BHJ,29,29,435,5100,5675,3609,406,H
3608,BJ,415,3,438,135,486,3609,23,J
3608,BK,202,202,640,295,781,3609,438,K
3608,BL,59,59,699,5100,5881,3609,640,L
3608,B,777,133,832,135,893,3609,55,B
3608,C,245,245,1077,300,1193,3609,832,C
3608,D,81,81,1158,5100,6293,3609,1077,D
3608,M,763,763,1921,1247,7540,3609,1158,M
3608,N,527,527,2448,180,7720,3609,1921,N
3608,O,1079,1079,3527,895,8615,3609,2448,O
3608,N,1289,1289,4816,1385,10000,3609,3527,N
3608,O,551,551,5367,635,10635,3609,4816,O
3608,P,150,150,5517,6960,17595,3609,5367,P
3609,A,12785,12785,12785,13153,13153,3610,0,A
3609,B,514,514,13299,180,13333,3610,12785,B
3609,C,687,687,13986,840,14173,3610,13299,C
3609,B,882,882,14868,725,14898,3610,13986,B
3609,C,813,813,15681,710,15608,3610,14868,C
3609,D,5139,5139,20820,6960,22568,3610,15681,D
3609,M,4,4,20824,190,22758,3610,20820,M
3609,N,547,547,21371,390,23148,3610,20824,N
3609,O,987,987,22358,1175,24323,3610,21371,O
3609,N,1718,1718,24076,1560,25883,3610,22358,N
3609,O,235,235,24311,380,26263,3610,24076,O
3609,P,1172,1172,25483,1265,27528,3610,24311,P
3610,A,932,932,932,1085,1085,3611,0,A
3610,B,241,241,1173,90,1175,3611,932,B
3610,C,679,679,1852,815,1990,3611,1173,C
3610,B,1671,1671,3523,1580,3570,3611,1852,B
3610,C,111,111,3634,585,4155,3611,3523,C
3610,D,2469,2469,6103,3780,7935,3611,3634,D
3610,M,36,36,6139,961,8896,3611,6103,M
3610,N,955,955,7094,90,8986,3611,6139,N
3610,O,213,213,7307,575,9561,3611,7094,O
3610,N,1847,1847,9154,1480,11041,3611,7307,N
3610,O,757,757,9911,1060,12101,3611,9154,O
3610,P,27,27,9938,3780,15881,3611,9911,P
3611,AEI,34,34,34,243,243,3612,0,I
3611,AEJ,70,36,70,88,88,3612,0,E
3611,AFJ,102,102,172,135,223,3612,70,F
3611,AGJ,190,18,190,193,193,3612,0,A
3611,BGJ,196,178,368,295,518,3612,172,G
3611,BHJ,200,22,390,240,433,3612,190,B
3611,CHJ,403,47,437,240,483,3612,34,J
3611,CHK,130,61,498,5100,5618,3612,368,H
3611,CK,185,77,575,295,728,3612,390,C
3611,DK,173,35,610,295,778,3612,437,K
3611,DL,406,406,1016,5100,5878,3612,610,L
3611,D,997,556,1572,5220,5948,3612,575,D
3611,M,748,748,2320,1266,7214,3612,1572,M
3611,N,678,678,2998,180,7394,3612,2320,N
3611,O,580,580,3578,895,8289,3612,2998,O
3611,N,590,590,4168,315,8604,3612,3578,N
3611,O,446,446,4614,360,8964,3612,4168,O
3611,P,8685,8685,13299,7020,15984,3612,4614,P
3612,AE,44,44,44,50,50,3613,0,E
3612,AF,101,57,101,189,189,3613,0,A
3612,BF,67,10,111,120,170,3613,44,F
3612,BG,161,161,272,210,380,3613,111,G
3612,BH,342,171,443,300,489,3613,101,B
3612,CH,290,119,562,2880,3260,3613,272,H
3612,C,512,393,955,740,1229,3613,443,C
3612,D,651,651,1606,3960,5189,3613,955,D
3612,M,351,351,1957,824,6013,3613,1606,M
3612,N,596,596,2553,180,6193,3613,1957,N
3612,O,738,738,3291,885,7078,3613,2553,O
3612,P,59,59,3350,6680,13758,3613,3291,P
3613,A,53,53,53,1061,1061,3614,0,A
3613,B,1208,1208,1261,240,1301,3614,53,B
3613,C,743,743,2004,760,2061,3614,1261,C
3613,D,3671,3671,5675,7680,9741,3614,2004,D
3613,M,1293,1293,6968,1383,11124,3614,5675,M
3613,N,265,265,7233,240,11364,3614,6968,N
3613,O,883,883,8116,765,12129,3614,7233,O
3613,N,141,141,8257,295,12424,3614,8116,N
3613,O,879,879,9136,1260,13684,3614,8257,O
3613,P,246,246,9382,3960,17644,3614,9136,P
3614,AE,778,778,778,904,904,3615,0,A
3614,BE,871,93,871,1488,1488,3615,0,E
3614,BF,252,159,1030,180,1084,3615,778,B
3614,CF,747,588,1618,180,1668,3615,871,F
3614,CG,782,194,1812,920,2004,3615,1030,C
3614,DG,761,761,2573,6680,8684,3615,1812,D
3614,G,979,24,2597,885,2553,3615,1618,G
3614,H,3016,3016,5613,6680,9233,3615,2597,H
3614,M,298,298,5911,1244,10477,3615,5613,M
3614,N,1085,1085,6996,180,10657,3615,5911,N
3614,O,296,296,7292,390,11047,3615,6996,O
3614,P,1280,1280,8572,6960,18007,3615,7292,P
3615,AEI,16,16,16,109,109,3616,0,E
3615,AFI,58,42,58,156,156,3616,0,I
3615,AFJ,180,180,238,135,291,3616,58,J
3615,AFK,242,20,258,135,244,3616,16,F
3615,AGK,218,198,456,285,576,3616,238,K
3615,AGL,164,164,620,5160,5736,3616,456,L
3615,AG,636,16,636,604,604,3616,0,A
3615,BG,379,1,637,285,529,3616,258,G
3615,BH,187,187,824,5160,5689,3616,637,H
3615,B,235,47,871,300,904,3616,636,B
3615,C,834,834,1705,1070,1974,3616,871,C
3615,B,445,445,2150,215,2189,3616,1705,B
3615,C,281,281,2431,385,2574,3616,2150,C
3615,D,1647,1647,4078,3960,6534,3616,2431,D
3615,M,1994,1994,6072,2482,9016,3616,4078,M
3615,N,637,637,6709,180,9196,3616,6072,N
3615,O,963,963,7672,885,10081,3616,6709,O
3615,N,1243,1243,8915,1350,11431,3616,7672,N
3615,O,536,536,9451,620,12051,3616,8915,O
3615,P,1462,1462,10913,6960,19011,3616,9451,P
3616,A,199,199,199,4170,4170,3617,0,A
3616,B,2645,2645,2844,180,4350,3617,199,B
3616,C,2965,2965,5809,1495,5845,3617,2844,C
3616,B,1173,1173,6982,1175,7020,3617,5809,B
3616,C,481,481,7463,730,7750,3617,6982,C
3616,D,1473,1473,8936,2580,10330,3617,7463,D
3616,M,40476,40476,49412,40503,50833,3617,8936,M
3616,N,192,192,49604,210,51043,3617,49412,N
3616,O,256,256,49860,205,51248,3617,49604,O
3616,N,1400,1400,51260,1450,52698,3617,49860,N
3616,O,1003,1003,52263,980,53678,3617,51260,O
3616,P,1050,1050,53313,355,54033,3617,52263,P
3617,A,10,10,10,126,126,3618,0,A
3617,B,190,190,200,135,261,3618,10,B
3617,C,200,200,400,285,546,3618,200,C
3617,D,489,489,889,5160,5706,3618,400,D
3617,M,872,872,1761,1218,6924,3618,889,M
3617,N,489,489,2250,180,7104,3618,1761,N
3617,O,814,814,3064,885,7989,3618,2250,O
3617,N,1408,1408,4472,1360,9349,3618,3064,N
3617,O,727,727,5199,695,10044,3618,4472,O
3617,P,51450,51450,56649,6960,17004,3618,5199,P
3618,AEI,54,54,54,81,81,3619,0,A
3618,BEI,101,47,101,690,690,3619,0,E
3618,BFI,121,20,121,999,999,3619,0,I
3618,BFJ,105,38,159,135,216,3619,54,B
3618,CFJ,177,177,336,295,511,3619,159,C
3618,DFJ,172,172,508,5160,5671,3619,336,D
3618,FJ,777,370,878,240,930,3619,101,F
3618,GJ,274,274,1152,290,1220,3619,878,G
3618,HJ,1064,33,1185,240,1239,3619,121,J
3618,HK,740,707,1892,5160,6380,3619,1152,H
3618,K,793,86,1978,1030,2269,3619,1185,K
3618,J,909,909,2887,650,2919,3619,1978,J
3618,K,179,179,3066,385,3304,3619,2887,K
3618,L,276,276,3342,3960,7264,3619,3066,L
3618,M,2501,2501,5843,3006,10270,3619,3342,M
3618,N,656,656,6499,180,10450,3619,5843,N
3618,O,639,639,7138,885,11335,3619,6499,O
3618,N,1338,1338,8476,1075,12410,3619,7138,N
3618,O,545,545,9021,635,13045,3619,8476,O
3618,P,1139,1139,10160,6960,20005,3619,9021,P
3619,AE,10,10,10,119,119,3620,0,E
3619,AF,264,254,264,1160,1160,3620,0,A
3619,BF,301,47,311,240,359,3620,10,F
3619,BG,683,683,994,960,1319,3620,311,G
3619,BH,485,485,1479,3960,5279,3620,994,H
3619,B,1298,83,1562,300,1460,3620,264,B
3619,C,1010,1010,2572,930,2390,3620,1562,C
3619,D,3986,3986,6558,2760,5150,3620,2572,D
3619,M,5640,5640,12198,5923,11202,3620,6558,M
3619,N,327,327,12525,90,11292,3620,12198,N
3619,O,934,934,13459,1145,12437,3620,12525,O
3619,N,427,427,13886,230,12667,3620,13459,N
3619,O,515,515,14401,805,13472,3620,13886,O
3619,P,22080,22080,36481,3780,17252,3620,14401,P
3620,AE,68,68,68,165,165,3621,0,E
3620,AF,179,179,247,135,300,3621,68,F
3620,AG,399,399,646,290,590,3621,247,G
3620,AH,422,422,1068,5160,5750,3621,646,H
3620,A,1730,662,1730,2169,2169,3621,0,A
3620,B,640,640,2370,240,2409,3621,1730,B
3620,C,182,182,2552,115,2524,3621,2370,C
3620,D,92,92,2644,4230,6754,3621,2552,D
3620,M,1041,1041,3685,1964,8718,3621,2644,M
3620,N,1054,1054,4739,180,8898,3621,3685,N
3620,O,795,795,5534,885,9783,3621,4739,O
3620,N,769,769,6303,690,10473,3621,5534,N
3620,O,554,554,6857,635,11108,3621,6303,O
3620,P,1132,1132,7989,6960,18068,3621,6857,P
3621,A,35,35,35,44,44,3622,0,A
3621,B,192,192,227,240,284,3622,35,B
3621,C,837,837,1064,890,1174,3622,227,C
3621,D,24532,24532,25596,5160,6334,3622,1064,D
3621,M,5754,5754,31350,5882,12216,3622,25596,M
3621,N,295,295,31645,220,12436,3622,31350,N
3621,O,1131,1131,32776,1080,13516,3622,31645,O
3621,N,774,774,33550,805,14321,3622,32776,N
3621,O,1140,1140,34690,2305,16626,3622,33550,O
3621,P,1170,1170,35860,4625,21251,3622,34690,P
3622,A,46,46,46,911,911,3623,0,A
3622,B,1315,1315,1361,510,1421,3623,46,B
3622,C,603,603,1964,925,2346,3623,1361,C
3622,D,1421,1421,3385,350,2696,3623,1964,D
3622,M,1893,1893,5278,2823,5519,3623,3385,M
3622,N,1061,1061,6339,150,5669,3623,5278,N
3622,O,676,676,7015,640,6309,3623,6339,O
3622,N,1210,1210,8225,1255,7564,3623,7015,N
3622,O,210,210,8435,475,8039,3623,8225,O
3622,P,10264,10264,18699,3960,11999,3623,8435,P
3623,AE,973,973,973,1206,1206,3624,0,E
3623,AF,493,493,1466,300,1506,3624,973,F
3623,AG,1664,198,1664,1825,1825,3624,0,A
3623,BG,546,546,2210,300,2125,3624,1664,B
3623,CG,782,38,2248,1025,2531,3624,1466,G
3623,CF,581,581,2829,3220,5751,3624,2248,F
3623,CG,779,160,2989,915,3040,3624,2210,C
3623,DG,906,746,3735,830,6581,3624,2829,G
3623,DH,1406,660,4395,3960,7000,3624,2989,D
3623,H,37135,36475,40870,8400,14981,3624,3735,H
3623,M,1441,1441,42311,1541,16522,3624,40870,M
3623,N,476,476,42787,395,16917,3624,42311,N
3623,O,706,706,43493,830,17747,3624,42787,O
3623,N,1618,1618,45111,1535,19282,3624,43493,N
3623,O,2797,2797,47908,600,19882,3624,45111,O
3623,P,127,127,48035,5280,25162,3624,47908,P
3624,AEI,18,18,18,2308,2308,3625,0,E
3624,AFI,42,24,42,88,88,3625,0,A
3624,BFI,134,92,134,181,181,3625,0,I
3624,BFJ,134,42,176,135,223,3625,42,B
3624,CFJ,181,139,315,135,316,3625,134,J
3624,CFK,875,736,1051,890,1113,3625,176,C
3624,DFK,785,49,1100,890,1206,3625,315,K
3624,DFL,90,41,1141,5160,6273,3625,1051,D
3624,FL,2484,1361,2502,240,2548,3625,18,F
3624,GL,698,698,3200,960,3508,3625,2502,G
3624,HL,5804,3704,6904,5160,6366,3625,1100,L
3624,H,53526,49822,56726,3960,7468,3625,3200,H
3624,M,291,291,57017,1140,8608,3625,56726,M
3624,N,969,969,57986,180,8788,3625,57017,N
3624,O,992,992,58978,1050,9838,3625,57986,O
3624,N,776,776,59754,720,10558,3625,58978,N
3624,O,220,220,59974,260,10818,3625,59754,O
3624,P,5991,5991,65965,5160,15978,3625,59974,P
3625,AEI,304,304,304,438,438,3626,0,I
3625,AEJ,205,205,509,240,678,3626,304,J
3625,AEK,621,112,621,1240,1240,3626,0,E
3625,AFK,659,38,659,2967,2967,3626,0,A
3625,BFK,696,658,1317,120,1360,3626,621,F
3625,BGK,1391,583,1900,1560,2238,3626,509,K
3625,BGJ,1000,417,2317,890,2250,3626,1317,G
3625,BFJ,2421,763,3080,150,3117,3626,659,B
3625,CFJ,754,754,3834,5001,8118,3626,3080,C
3625,DFJ,2500,566,4400,1181,3419,3626,1900,J
3625,DFK,2863,780,5180,2455,4705,3626,2317,F
3625,DGK,1142,362,5542,1623,5042,3626,4400,K
3625,DGL,1009,647,6189,2174,6879,3626,5180,G
3625,DHL,2414,59,6248,2074,10192,3626,3834,D
3625,HL,1043,337,6585,1908,6950,3626,5542,L
3625,H,1099,703,7288,2491,9370,3626,6189,H
3625,M,192,192,7480,67,10259,3626,7288,M
3625,N,535,535,8015,780,11039,3626,7480,N
3625,O,435,435,8450,614,11653,3626,8015,O
3625,P,30,30,8480,1291,12944,3626,8450,P
3626,AEI,167,167,167,427,427,3627,0,A
3626,BEI,264,97,264,306,306,3627,0,E
3626,BFI,438,174,438,2542,2542,3627,0,I
3626,BFJ,192,18,456,210,516,3627,264,F
3626,BGJ,451,162,618,240,667,3627,167,B
3626,CGJ,409,247,865,465,981,3627,456,G
3626,CFJ,595,348,1213,895,1562,3627,618,C
3626,DFJ,220,220,1433,3960,5522,3627,1213,D
3626,FJ,1139,571,2004,1060,2041,3627,865,F
3626,GJ,863,863,2867,828,2869,3627,2004,G
3626,HJ,3553,1124,3991,300,2842,3627,438,J
3626,HK,1570,446,4437,372,3241,3627,2867,H
3626,K,2271,1825,6262,780,3622,3627,3991,K
3626,L,245,245,6507,4080,7702,3627,6262,L
3626,M,35,35,6542,426,8128,3627,6507,M
3626,N,849,849,7391,540,8668,3627,6542,N
3626,O,507,507,7898,845,9513,3627,7391,O
3626,N,720,720,8618,345,9858,3627,7898,N
3626,O,101,101,8719,188,10046,3627,8618,O
3626,P,1515,1515,10234,402,10448,3627,8719,P
3627,AEI,162,162,162,1212,1212,3628,0,E
3627,AFI,552,390,552,1195,1195,3628,0,A
3627,BFI,732,732,1284,150,1345,3628,552,B
3627,CFI,1233,111,1395,240,1452,3628,162,F
3627,CGI,579,468,1863,635,1980,3628,1284,C
3627,DGI,724,256,2119,760,2212,3628,1395,G
3627,DHI,2240,121,2240,2610,2610,3628,0,I
3627,DHJ,656,656,2896,300,2910,3628,2240,J
3627,DHK,894,894,3790,1045,3955,3628,2896,K
3627,DHL,185,185,3975,1140,5095,3628,3790,L
3627,DH,2888,1032,5007,7680,9892,3628,2119,H
3627,D,19127,15983,20990,2880,4860,3628,1863,D
3627,M,4414,4414,25404,5335,15227,3628,20990,M
3627,N,1194,1194,26598,300,15527,3628,25404,N
3627,O,869,869,27467,905,16432,3628,26598,O
3627,P,1548,1548,29015,2760,19192,3628,27467,P
3628,AE,1190,1190,1190,1326,1326,3629,0,A
3628,BE,254,254,1444,180,1506,3629,1190,B
3628,CE,1599,155,1599,2381,2381,3629,0,E
3628,CF,206,51,1650,335,1841,3629,1444,C
3628,BF,872,872,2522,740,2581,3629,1650,B
3628,CF,1070,147,2669,300,2681,3629,1599,F
3628,CG,163,16,2685,385,2966,3629,2522,C
3628,DG,887,871,3556,1050,3731,3629,2669,G
3628,DF,3004,2133,5689,5400,8366,3629,2685,D
3628,F,2842,709,6398,2660,6391,3629,3556,F
3628,G,695,695,7093,1620,8011,3629,6398,G
3628,H,1387,1387,8480,3960,11971,3629,7093,H
3628,M,1512,1512,9992,1575,13546,3629,8480,M
3628,N,253,253,10245,240,13786,3629,9992,N
3628,O,119,119,10364,380,14166,3629,10245,O
3628,N,1039,1039,11403,770,14936,3629,10364,N
3628,O,734,734,12137,1105,16041,3629,11403,O
3628,P,13476,13476,25613,3960,20001,3629,12137,P
3629,A,27,27,27,56,56,3630,0,A
3629,B,132,132,159,135,191,3630,27,B
3629,C,199,199,358,295,486,3630,159,C
3629,D,4,4,362,5100,5586,3630,358,D
3629,M,332,332,694,825,6411,3630,362,M
3629,N,612,612,1306,180,6591,3630,694,N
3629,O,163,163,1469,120,6711,3630,1306,O
3629,N,636,636,2105,660,7371,3630,1469,N
3629,O,910,910,3015,945,8316,3630,2105,O
3629,P,2289,2289,5304,5160,13476,3630,3015,P
3630,A,153,153,153,985,985,3631,0,A
3630,B,1015,1015,1168,240,1225,3631,153,B
3630,C,761,761,1929,1030,2255,3631,1168,C
3630,B,940,940,2869,650,2905,3631,1929,B
3630,C,141,141,3010,385,3290,3631,2869,C
3630,D,800,800,3810,3960,7250,3631,3010,D
3630,M,53,53,3863,569,7819,3631,3810,M
3630,N,756,756,4619,300,8119,3631,3863,N
3630,O,198,198,4817,295,8414,3631,4619,O
3630,N,1582,1582,6399,1470,9884,3631,4817,N
3630,O,183,183,6582,225,10109,3631,6399,O
3630,P,1009,1009,7591,4740,14849,3631,6582,P
3631,A,1036,1036,1036,2055,2055,3632,0,A
3631,B,1051,1051,2087,90,2145,3632,1036,B
3631,C,558,558,2645,805,2950,3632,2087,C
3631,B,662,662,3307,420,3370,3632,2645,B
3631,C,721,721,4028,1080,4450,3632,3307,C
3631,D,897,897,4925,3780,8230,3632,4028,D
3631,M,5534,5534,10459,5731,13961,3632,4925,M
3631,N,225,225,10684,90,14051,3632,10459,N
3631,O,800,800,11484,1130,15181,3632,10684,O
3631,N,729,729,12213,440,15621,3632,11484,N
3631,O,506,506,12719,800,16421,3632,12213,O
3631,P,947,947,13666,3780,20201,3632,12719,P
3632,AE,20,20,20,46,46,3633,0,E
3632,AF,135,135,155,150,196,3633,20,F
3632,AG,743,588,743,787,787,3633,0,A
3632,BG,619,31,774,680,876,3633,155,G
3632,BH,71,71,845,3690,4566,3633,774,H
3632,B,254,152,997,210,997,3633,743,B
3632,C,127,127,1124,233,1230,3633,997,C
3632,D,2980,2980,4104,402,1632,3633,1124,D
3632,M,4223,4223,8327,4464,9030,3633,4104,M
3632,N,329,329,8656,160,9190,3633,8327,N
3632,O,93,93,8749,75,9265,3633,8656,O
3632,N,767,767,9516,780,10045,3633,8749,N
3632,O,82,82,9598,85,10130,3633,9516,O
3632,P,182,182,9780,2900,13030,3633,9598,P
3633,AEI,64,64,64,921,921,3634,0,A
3633,BEI,353,289,353,971,971,3634,0,I
3633,BEJ,1076,787,1140,240,1161,3634,64,B
3633,CEJ,919,132,1272,300,1271,3634,353,J
3633,CEK,1770,498,1770,1725,1725,3634,0,E
3633,CFK,706,208,1978,920,2191,3634,1272,K
3633,CFJ,219,11,1989,300,2025,3634,1770,F
3633,CGJ,238,227,2216,5,2196,3634,1978,J
3633,CGK,1540,464,2680,1040,2201,3634,1140,C
3633,BGK,636,636,3316,1250,3451,3634,2680,B
3633,CGK,1990,663,3979,2045,4070,3634,1989,G
3633,CHK,2136,373,4352,2660,4856,3634,2216,K
3633,CHL,384,384,4736,3960,8816,3634,4352,L
3633,CH,1554,797,5533,1860,5930,3634,3979,H
3633,C,2285,68,5601,2660,6111,3634,3316,C
3633,D,1598,1598,7199,3960,10071,3634,5601,D
3633,M,27317,27317,34516,27387,37458,3634,7199,M
3633,N,246,246,34762,210,37668,3634,34516,N
3633,O,296,296,35058,205,37873,3634,34762,O
3633,N,1353,1353,36411,1450,39323,3634,35058,N
3633,O,987,987,37398,980,40303,3634,36411,O
3633,P,914,914,38312,355,40658,3634,37398,P
3634,AE,5,5,5,613,613,3635,0,E
3634,AF,355,350,355,385,385,3635,0,A
3634,BF,820,470,825,240,853,3635,5,F
3634,BG,503,33,858,505,890,3635,355,B
3634,CG,512,479,1337,790,1643,3635,825,G
3634,CH,157,157,1494,3960,5603,3635,1337,H
3634,C,813,177,1671,580,1470,3635,858,C
3634,B,459,459,2130,680,2150,3635,1671,B
3634,C,265,265,2395,905,3055,3635,2130,C
3634,D,423,423,2818,2640,5695,3635,2395,D
3634,M,2885,2885,5703,3257,8952,3635,2818,M
3634,N,422,422,6125,180,9132,3635,5703,N
3634,O,1531,1531,7656,1235,10367,3635,6125,O
3634,N,79,79,7735,290,10657,3635,7656,N
3634,O,337,337,8072,390,11047,3635,7735,O
3634,P,11588,11588,19660,6960,18007,3635,8072,P
3635,AEI,78,78,78,1026,1026,3636,0,E
3635,AFI,546,468,546,1507,1507,3636,0,A
3635,BFI,1128,660,1206,240,1266,3636,78,F
3635,BGI,1248,588,1794,330,1837,3636,546,B
3635,CGI,845,257,2051,890,2156,3636,1206,G
3635,CHI,2398,347,2398,2807,2807,3636,0,I
3635,CHJ,480,480,2878,90,2897,3636,2398,J
3635,CHK,1101,17,2895,1055,2892,3636,1794,C
3635,DHK,517,500,3395,905,3802,3636,2878,K
3635,DHL,1603,259,3654,5160,7316,3636,2051,H
3635,DL,2124,1365,5019,350,3242,3636,2895,D
3635,L,6728,5104,10123,3780,7582,3636,3395,L
3635,M,1609,1609,11732,2685,10267,3636,10123,M
3635,N,1134,1134,12866,90,10357,3636,11732,N
3635,O,576,576,13442,915,11272,3636,12866,O
3635,N,1622,1622,15064,1280,12552,3636,13442,N
3635,O,1081,1081,16145,1425,13977,3636,15064,O
3635,P,1494,1494,17639,3780,17757,3636,16145,P
3636,A,288,288,288,499,499,3637,0,A
3636,B,289,289,577,135,634,3637,288,B
3636,C,215,215,792,255,889,3637,577,C
3636,D,84,84,876,5160,6049,3637,792,D
3636,M,445,445,1321,1276,7325,3637,876,M
3636,N,1011,1011,2332,300,7625,3637,1321,N
3636,O,150,150,2482,310,7935,3637,2332,O
3636,N,540,540,3022,320,8255,3637,2482,N
3636,O,541,541,3563,465,8720,3637,3022,O
3636,P,6079,6079,9642,5760,14480,3637,3563,P
3637,A,333,333,333,884,884,3638,0,A
3637,B,657,657,990,150,1034,3638,333,B
3637,C,257,257,1247,125,1159,3638,990,C
3637,B,226,226,1473,345,1504,3638,1247,B
3637,C,122,122,1595,120,1624,3638,1473,C
3637,D,1028,1028,2623,4230,5854,3638,1595,D
3637,M,128,128,2751,1029,6883,3638,2623,M
3637,N,1122,1122,3873,240,7123,3638,2751,N
3637,O,3144,3144,7017,3601,10724,3638,3873,O
3637,N,2683,2683,9700,2259,12983,3638,7017,N
3637,O,634,634,10334,825,13808,3638,9700,O
3637,P,1556,1556,11890,3960,17768,3638,10334,P
3638,AEI,1,1,1,149,149,3639,0,A
3638,BEI,72,71,72,930,930,3639,0,E
3638,BFI,364,293,365,240,389,3639,1,B
3638,CFI,1077,784,1149,240,1170,3639,72,F
3638,CGI,942,158,1307,1045,1434,3639,365,C
3638,BGI,1606,299,1606,1446,1446,3639,0,I
3638,BGJ,488,189,1795,460,1894,3639,1307,B
3638,CGJ,210,21,1816,420,1866,3639,1606,J
3638,CGK,540,519,2335,780,2674,3639,1795,C
3638,DGK,703,184,2519,945,2811,3639,1816,K
3638,DGJ,1540,170,2689,1040,2210,3639,1149,G
3638,DFJ,718,548,3237,530,3341,3639,2519,J
3638,DFK,716,716,3953,840,4181,3639,3237,K
3638,DFL,2411,1147,5100,3160,5370,3639,2689,F
3638,DGL,907,907,6007,780,6150,3639,5100,G
3638,DHL,4132,4132,10139,3960,10110,3639,6007,H
3638,DL,8815,1011,11150,3960,6634,3639,2335,D
3638,L,28814,21617,32767,5670,9851,3639,3953,L
3638,M,1719,1719,34486,1727,11837,3639,32767,M
3638,N,84,84,34570,660,12497,3639,34486,N
3638,O,485,485,35055,1290,13787,3639,34570,O
3638,N,2415,2415,37470,1050,14837,3639,35055,N
3638,O,601,601,38071,855,15692,3639,37470,O
3638,P,27195,27195,65266,3960,19652,3639,38071,P
3639,A,187,187,187,409,409,3640,0,A
3639,B,372,372,559,210,619,3640,187,B
3639,C,467,467,1026,690,1309,3640,559,C
3639,B,265,265,1291,90,1399,3640,1026,B
3639,C,870,870,2161,900,2299,3640,1291,C
3639,B,4329,4329,6490,4240,6539,3640,2161,B
3639,C,731,731,7221,845,7384,3640,6490,C
3639,D,1746,1746,8967,5220,12604,3640,7221,D
3639,M,4285,4285,13252,4467,17071,3640,8967,M
3639,N,384,384,13636,240,17311,3640,13252,N
3639,O,926,926,14562,995,18306,3640,13636,O
3639,N,441,441,15003,250,18556,3640,14562,N
3639,O,653,653,15656,900,19456,3640,15003,O
3639,P,1808,1808,17464,3960,23416,3640,15656,P
3640,AEI,512,512,512,806,806,3641,0,I
3640,AEJ,550,38,550,3688,3688,3641,0,E
3640,AFJ,640,90,640,1287,1287,3641,0,A
3640,BFJ,371,243,883,90,896,3641,512,J
3640,BFK,847,604,1487,240,1527,3641,640,B
3640,CFK,675,675,2162,785,2312,3641,1487,C
3640,DFK,1322,43,2205,1865,2761,3641,883,K
3640,DFL,1196,1153,3358,3960,6272,3641,2162,D
3640,FL,1451,298,3656,3780,6541,3641,2205,L
3640,F,3179,73,3729,90,3778,3641,550,F
3640,G,1466,1466,5195,1935,5713,3641,3729,G
3640,H,1366,1366,6561,3780,9493,3641,5195,H
3640,M,128,128,6689,1814,11307,3641,6561,M
3640,N,1751,1751,8440,90,11397,3641,6689,N
3640,O,1402,1402,9842,1745,13142,3641,8440,O
3640,N,596,596,10438,255,13397,3641,9842,N
3640,O,118,118,10556,535,13932,3641,10438,O
3640,P,891,891,11447,3780,17712,3641,10556,P
3641,A,1924,1924,1924,2821,2821,3642,0,A
3641,B,924,924,2848,90,2911,3642,1924,B
3641,C,866,866,3714,905,3816,3642,2848,C
3641,B,1431,1431,5145,1345,5161,3642,3714,B
3641,C,1212,1212,6357,1440,6601,3642,5145,C
3641,D,4548,4548,10905,3780,10381,3642,6357,D
3641,M,1891,1891,12796,4757,15138,3642,10905,M
3641,N,2950,2950,15746,90,15228,3642,12796,N
3641,O,848,848,16594,1250,16478,3642,15746,O
3641,N,527,527,17121,180,16658,3642,16594,N
3641,O,765,765,17886,945,17603,3642,17121,O
3641,P,1261,1261,19147,3780,21383,3642,17886,P
3642,AE,35,35,35,99,99,3643,0,A
3642,BE,62,27,62,901,901,3643,0,E
3642,BF,173,146,208,150,249,3643,35,B
3642,CF,131,131,339,115,364,3643,208,C
3642,DF,195,195,534,4230,4594,3643,339,D
3642,F,1031,559,1093,240,1141,3643,62,F
3642,G,851,851,1944,1030,2171,3643,1093,G
3642,F,1016,1016,2960,875,3046,3643,1944,F
3642,G,894,894,3854,1141,4187,3643,2960,G
3642,H,2069,2069,5923,3960,8147,3643,3854,H
3642,M,2467,2467,8390,2771,10918,3643,5923,M
3642,N,331,331,8721,90,11008,3643,8390,N
3642,O,940,940,9661,1240,12248,3643,8721,O
3642,N,566,566,10227,240,12488,3643,9661,N
3642,O,431,431,10658,790,13278,3643,10227,O
3642,P,321,321,10979,3780,17058,3643,10658,P
3643,AE,54,54,54,941,941,3644,0,E
3643,AF,466,412,466,1709,1709,3644,0,A
3643,BF,1069,657,1123,240,1181,3644,54,F
3643,BG,1437,780,1903,240,1949,3644,466,B
3643,CG,838,58,1961,890,2071,3644,1123,G
3643,CH,93,93,2054,5160,7231,3644,1961,H
3643,C,1944,1793,3847,820,2769,3644,1903,C
3643,D,381,381,4228,9700,12469,3644,3847,D
3643,M,193,193,4421,1138,13607,3644,4228,M
3643,N,1045,1045,5466,150,13757,3644,4421,N
3643,O,747,747,6213,725,14482,3644,5466,O
3643,N,1044,1044,7257,1060,15542,3644,6213,N
3643,O,111,111,7368,125,15667,3644,7257,O
3643,P,260,260,7628,4230,19897,3644,7368,P
3644,AEI,733,733,733,908,908,3645,0,A
3644,BEI,196,196,929,90,998,3645,733,B
3644,CEI,471,471,1400,795,1793,3645,929,C
3644,BEI,1916,516,1916,2009,2009,3645,0,I
3644,BEJ,118,118,2034,90,2099,3645,1916,J
3644,BEK,2223,189,2223,2376,2376,3645,0,E
3644,BFK,222,222,2445,90,2466,3645,2223,F
3644,BGK,1074,29,2474,735,2528,3645,1400,B
3644,CGK,629,189,2663,820,2919,3645,2034,K
3644,CGJ,537,348,3011,735,3263,3645,2474,C
3644,DGJ,590,24,3035,815,3281,3645,2445,G
3644,DFJ,572,200,3235,375,3294,3645,2663,J
3644,DFK,308,84,3319,3780,7043,3645,3011,D
3644,FK,447,363,3682,740,4034,3645,3235,K
3644,FL,816,169,3851,570,3851,3645,3035,F
3644,GL,853,684,4535,3780,7814,3645,3682,L
3644,G,705,21,4556,745,4596,3645,3851,G
3644,H,1499,1499,6055,3780,8376,3645,4556,H
3644,M,1635,1635,7690,1929,10305,3645,6055,M
3644,N,414,414,8104,180,10485,3645,7690,N
3644,O,1465,1465,9569,885,11370,3645,8104,O
3644,N,314,314,9883,885,12255,3645,9569,N
3644,O,601,601,10484,645,12900,3645,9883,O
3644,P,803,803,11287,6960,19860,3645,10484,P
3645,AEI,26,26,26,173,173,3646,0,A
3645,BEI,339,339,365,240,413,3646,26,B
3645,CEI,370,5,370,80,80,3646,0,I
3645,CEJ,459,454,824,780,1193,3646,365,C
3645,DEJ,979,155,979,996,996,3646,0,E
3645,DFJ,638,29,1008,960,1040,3646,370,J
3645,DFK,190,6,1014,3960,5153,3646,824,D
3645,FK,465,430,1444,340,1336,3646,979,F
3645,GK,601,165,1609,595,1635,3646,1008,K
3645,GJ,963,963,2572,980,2615,3646,1609,J
3645,GK,1322,194,2766,1470,2806,3646,1444,G
3645,HK,211,17,2783,425,3040,3646,2572,K
3645,HL,60,60,2843,1590,4630,3646,2783,L
3645,H,1803,1726,4569,402,3208,3646,2766,H
3645,M,3165,3165,7734,3180,8333,3646,4569,M
3645,N,595,595,8329,610,8943,3646,7734,N
3645,O,292,292,8621,435,9378,3646,8329,O
3645,N,1349,1349,9970,1220,10598,3646,8621,N
3645,O,359,359,10329,1635,12233,3646,9970,O
3645,P,14138,14138,24467,2745,14978,3646,10329,P
3646,AE,19,19,19,95,95,3647,0,A
3646,BE,205,205,224,180,275,3647,19,B
3646,CE,99,99,323,305,580,3647,224,C
3646,DE,163,163,486,360,940,3647,323,D
3646,E,2982,2496,2982,3544,3544,3647,0,E
3646,F,593,593,3575,90,3634,3647,2982,F
3646,G,1251,1251,4826,1425,5059,3647,3575,G
3646,H,28,28,4854,3780,8839,3647,4826,H
3646,M,397,397,5251,913,9752,3647,4854,M
3646,N,1092,1092,6343,180,9932,3647,5251,N
3646,O,335,335,6678,895,10827,3647,6343,O
3646,N,299,299,6977,195,11022,3647,6678,N
3646,O,323,323,7300,690,11712,3647,6977,O
3646,P,1551,1551,8851,6660,18372,3647,7300,P
3647,AEI,27,27,27,351,351,3648,0,I
3647,AEJ,81,54,81,300,300,3648,0,E
3647,AFJ,406,352,433,135,486,3648,27,J
3647,AFK,409,57,490,240,540,3648,81,F
3647,AGK,202,145,635,295,781,3648,433,K
3647,AGL,192,47,682,295,835,3648,490,G
3647,AHL,41,41,723,5100,5935,3648,682,H
3647,AL,206,118,841,5100,5881,3648,635,L
3647,A,864,23,864,1390,1390,3648,0,A
3647,B,796,796,1660,300,1690,3648,864,B
3647,C,452,452,2112,655,2345,3648,1660,C
3647,B,468,468,2580,295,2640,3648,2112,B
3647,C,984,984,3564,480,3120,3648,2580,C
3647,D,304,304,3868,1140,4260,3648,3564,D
3647,M,631,631,4499,1203,7138,3648,3868,M
3647,N,743,743,5242,180,7318,3648,4499,N
3647,O,704,704,5946,895,8213,3648,5242,O
3647,N,245,245,6191,105,8318,3648,5946,N
3647,O,710,710,6901,660,8978,3648,6191,O
3647,P,2641,2641,9542,6660,15638,3648,6901,P
3648,AEI,185,185,185,450,450,3649,0,A
3648,BEI,355,355,540,150,600,3649,185,B
3648,CEI,602,62,602,1757,1757,3649,0,E
3648,CFI,325,263,865,140,740,3649,540,C
3648,BFI,203,203,1068,370,1110,3649,865,B
3648,CFI,606,606,1674,797,1907,3649,1068,C
3648,DFI,1850,176,1850,2543,2543,3649,0,I
3648,DFJ,1275,27,1877,180,1937,3649,602,F
3648,DGJ,258,55,1932,508,2415,3649,1674,D
3648,GJ,830,748,2680,180,2723,3649,1850,J
3648,GK,808,5,2685,840,2777,3649,1877,G
3648,FK,710,705,3390,885,3608,3649,2680,K
3648,FJ,188,188,3578,30,3638,3649,3390,J
3648,FK,1147,254,3832,1115,3892,3649,2685,F
3648,GK,386,132,3964,360,3998,3649,3578,K
3648,GL,329,197,4161,360,4252,3649,3832,G
3648,HL,2800,2603,6764,7020,11018,3649,3964,L
3648,H,2897,294,7058,7020,11272,3649,4161,H
3648,M,395,395,7453,668,11940,3649,7058,M
3648,N,363,363,7816,90,12030,3649,7453,N
3648,O,699,699,8515,930,12960,3649,7816,O
3648,N,8749,8749,17264,8570,21530,3649,8515,N
3648,O,705,705,17969,890,22420,3649,17264,O
3648,P,1068,1068,19037,3780,26200,3649,17969,P
3649,AE,50,50,50,199,199,3650,0,A
3649,BE,349,349,399,240,439,3650,50,B
3649,CE,605,206,605,1001,1001,3650,0,E
3649,CF,521,521,1126,180,1181,3650,605,F
3649,CG,846,119,1245,875,1314,3650,399,C
3649,BG,313,194,1439,265,1446,3650,1126,G
3649,BF,355,161,1600,310,1624,3650,1245,B
3649,CF,315,154,1754,365,1811,3650,1439,F
3649,CG,588,434,2188,900,2524,3650,1600,C
3649,DG,356,356,2544,3960,6484,3650,2188,D
3649,G,2318,1528,4072,200,2011,3650,1754,G
3649,H,427,427,4499,5220,7231,3650,4072,H
3649,M,899,899,5398,3669,10900,3650,4499,M
3649,N,2830,2830,8228,180,11080,3650,5398,N
3649,O,761,761,8989,300,11380,3650,8228,O
3649,N,411,411,9400,805,12185,3650,8989,N
3649,O,1365,1365,10765,1315,13500,3650,9400,O
3649,P,1477,1477,12242,350,13850,3650,10765,P
3650,AEI,108,108,108,1123,1123,3651,0,A
3650,BEI,128,20,128,1106,1106,3651,0,I
3650,BEJ,388,260,388,1306,1306,3651,0,E
3650,BFJ,1164,904,1292,240,1346,3651,128,J
3650,BFK,1210,26,1318,240,1363,3651,108,B
3650,CFK,1094,164,1482,240,1546,3651,388,F
3650,CGK,697,533,2015,780,2143,3651,1318,C
3650,DGK,728,5,2020,760,2106,3651,1292,K
3650,DGL,785,247,2267,780,2326,3651,1482,G
3650,DHL,773,526,2793,7680,9786,3651,2020,L
3650,DH,749,223,3016,7680,10006,3651,2267,H
3650,D,1112,111,3127,7680,9823,3651,2015,D
3650,M,4,4,3131,109,10115,3651,3127,M
3650,N,348,348,3479,300,10415,3651,3131,N
3650,O,798,798,4277,830,11245,3651,3479,O
3650,N,1102,1102,5379,1065,12310,3651,4277,N
3650,O,293,293,5672,540,12850,3651,5379,O
3650,P,23052,23052,28724,2880,15730,3651,5672,P
3651,A,652,652,652,1257,1257,3652,0,A
3651,B,632,632,1284,90,1347,3652,652,B
3651,C,454,454,1738,705,2052,3652,1284,C
3651,D,2381,2381,4119,3780,5832,3652,1738,D
3651,M,7935,7935,12054,8057,13889,3652,4119,M
3651,N,157,157,12211,90,13979,3652,12054,N
3651,O,532,532,12743,755,14734,3652,12211,O
3651,N,559,559,13302,325,15059,3652,12743,N
3651,O,655,655,13957,950,16009,3652,13302,O
3651,P,2279,2279,16236,3780,19789,3652,13957,P
3652,AEI,395,395,395,325,325,3653,0,E
3652,AFI,413,18,413,420,420,3653,0,I
3652,AFJ,650,237,650,1041,1041,3653,0,A
3652,BFJ,247,10,660,300,720,3653,413,J
3652,BFK,365,100,760,435,760,3653,395,F
3652,BGK,587,477,1237,240,1281,3653,650,B
3652,CGK,494,17,1254,585,1345,3653,760,G
3652,CFK,903,309,1563,900,1620,3653,660,K
3652,CFL,449,140,1703,415,1760,3653,1254,F
3652,CGL,524,58,1761,790,2071,3653,1237,C
3652,DGL,217,159,1920,1175,2935,3653,1703,G
3652,DHL,607,448,2368,3960,6031,3653,1761,D
3652,HL,865,60,2428,4020,5640,3653,1563,L
3652,H,2233,1725,4153,2640,5575,3653,1920,H
3652,M,3006,3006,7159,3456,9487,3653,4153,M
3652,N,570,570,7729,180,9667,3653,7159,N
3652,O,1234,1234,8963,1235,10902,3653,7729,O
3652,N,369,369,9332,355,11257,3653,8963,N
3652,O,456,456,9788,540,11797,3653,9332,O
3652,P,2795,2795,12583,6960,18757,3653,9788,P
3653,A,1701,1701,1701,1894,1894,3654,0,A
3653,B,245,245,1946,90,1984,3654,1701,B
3653,C,362,362,2308,820,2804,3654,1946,C
3653,B,795,795,3103,365,3169,3654,2308,B
3653,C,521,521,3624,805,3974,3654,3103,C
3653,D,20640,20640,24264,3780,7754,3654,3624,D
3653,M,15015,15015,39279,5138,12892,3654,24264,M
3653,N,1253,1253,40532,210,13102,3654,39279,N
3653,O,759,759,41291,730,13832,3654,40532,O
3653,N,325,325,41616,790,14622,3654,41291,N
3653,O,87,87,41703,140,14762,3654,41616,O
3653,P,1300,1300,43003,1320,16082,3654,41703,P
3654,A,261,261,261,210,210,3655,0,A
3654,B,4,4,265,120,330,3655,261,B
3654,C,421,421,686,225,555,3655,265,C
3654,B,634,634,1320,825,1380,3655,686,B
3654,C,576,576,1896,635,2015,3655,1320,C
3654,D,1864,1864,3760,2880,4895,3655,1896,D
3654,M,1254,1254,5014,2609,7504,3655,3760,M
3654,N,1617,1617,6631,300,7804,3655,5014,N
3654,O,271,271,6902,425,8229,3655,6631,O
3654,N,387,387,7289,235,8464,3655,6902,N
3654,O,571,571,7860,760,9224,3655,7289,O
3654,P,74,74,7934,1560,10784,3655,7860,P
3655,A,216,216,216,1240,1240,3656,0,A
3655,B,1209,1209,1425,240,1480,3656,216,B
3655,C,736,736,2161,760,2240,3656,1425,C
3655,D,30,30,2191,7680,9920,3656,2161,D
3655,M,304,304,2495,322,10242,3656,2191,M
3655,N,244,244,2739,300,10542,3656,2495,N
3655,O,796,796,3535,825,11367,3656,2739,O
3655,N,1270,1270,4805,820,12187,3656,3535,N
3655,O,299,299,5104,440,12627,3656,4805,O
3655,P,4189,4189,9293,5580,18207,3656,5104,P
3656,A,227,227,227,328,328,3657,0,A
3656,B,149,149,376,90,418,3657,227,B
3656,C,868,868,1244,1285,1703,3657,376,C
3656,D,179,179,1423,3780,5483,3657,1244,D
3656,M,8929,8929,10352,10356,15839,3657,1423,M
3656,N,1144,1144,11496,180,16019,3657,10352,N
3656,O,845,845,12341,885,16904,3657,11496,O
3656,N,2323,2323,14664,1880,18784,3657,12341,N
3656,O,934,934,15598,1070,19854,3657,14664,O
3656,P,520,520,16118,6900,26754,3657,15598,P
3657,A,722,722,722,1092,1092,3658,0,A
3657,B,399,399,1121,90,1182,3658,722,B
3657,C,519,519,1640,905,2087,3658,1121,C
3657,D,4016,4016,5656,3780,5867,3658,1640,D
3657,M,99,99,5755,1010,6877,3658,5656,M
3657,N,1031,1031,6786,180,7057,3658,5755,N
3657,O,1030,1030,7816,1055,8112,3658,6786,O
3657,N,797,797,8613,775,8887,3658,7816,N
3657,O,220,220,8833,515,9402,3658,8613,O
3657,P,4255,4255,13088,6150,15552,3658,8833,P
3658,A,77,77,77,121,121,3659,0,A
3658,B,75,75,152,120,241,3659,77,B
3658,C,517,517,669,705,946,3659,152,C
3658,B,1032,1032,1701,790,1736,3659,669,B
3658,C,2146,2146,3847,2049,3785,3659,1701,C
3658,D,11,11,3858,886,4671,3659,3847,D
3658,M,1488,1488,5346,2969,7640,3659,3858,M
3658,N,2405,2405,7751,780,8420,3659,5346,N
3658,O,1163,1163,8914,1080,9500,3659,7751,O
3658,N,467,467,9381,785,10285,3659,8914,N
3658,O,1167,1167,10548,1103,11388,3659,9381,O
3658,P,67,67,10615,402,11790,3659,10548,P
3659,AE,71,71,71,111,111,3660,0,E
3659,AF,156,156,227,135,246,3660,71,F
3659,AG,169,169,396,295,541,3660,227,G
3659,AH,95,95,491,5160,5701,3660,396,H
3659,A,548,57,548,960,960,3660,0,A
3659,B,532,532,1080,150,1110,3660,548,B
3659,C,71,71,1151,50,1160,3660,1080,C
3659,B,90,90,1241,135,1295,3660,1151,B
3659,C,184,184,1425,295,1590,3660,1241,C
3659,D,1361,1361,2786,5160,6750,3660,1425,D
3659,M,18899,18899,21685,19238,25988,3660,2786,M
3659,N,490,490,22175,180,26168,3660,21685,N
3659,O,858,858,23033,885,27053,3660,22175,O
3659,P,5961,5961,28994,6680,33733,3660,23033,P
3660,A,7,7,7,364,364,3661,0,A
3660,B,557,557,564,150,514,3661,7,B
3660,C,530,530,1094,685,1199,3661,564,C
3660,D,147,147,1241,3690,4889,3661,1094,D
3660,M,622,622,1863,2021,6910,3661,1241,M
3660,N,1596,1596,3459,240,7150,3661,1863,N
3660,O,686,686,4145,830,7980,3661,3459,O
3660,P,1201,1201,5346,1040,9020,3661,4145,P
3661,A,79,79,79,153,153,3662,0,A
3661,B,256,256,335,240,393,3662,79,B
3661,C,177,177,512,285,678,3662,335,C
3661,D,120,120,632,5160,5838,3662,512,D
3661,M,743,743,1375,1938,7776,3662,632,M
3661,N,1313,1313,2688,150,7926,3662,1375,N
3661,O,1390,1390,4078,1610,9536,3662,2688,O
3661,P,286,286,4364,2520,12056,3662,4078,P
3662,AE,1205,1205,1205,1575,1575,3663,0,E
3662,AF,1800,595,1800,1695,1695,3663,0,A
3662,BF,639,44,1844,300,1875,3663,1205,F
3662,BG,166,122,1966,300,1995,3663,1800,B
3662,CG,610,610,2576,810,2805,3663,1966,C
3662,BG,960,228,2804,1045,2920,3663,1844,G
3662,BH,408,180,2984,220,3025,3663,2576,B
3662,CH,467,467,3451,430,3455,3663,2984,C
3662,DH,961,314,3765,1140,4060,3663,2804,H
3662,D,5389,5075,8840,1140,4595,3663,3451,D
3662,M,225,225,9065,307,4902,3663,8840,M
3662,N,313,313,9378,300,5202,3663,9065,N
3662,O,656,656,10034,820,6022,3663,9378,O
3662,N,1173,1173,11207,1115,7137,3663,10034,N
3662,O,364,364,11571,630,7767,3663,11207,O
3662,P,15273,15273,26844,6060,13827,3663,11571,P
3663,A,2030,2030,2030,2453,2453,3664,0,A
3663,B,453,453,2483,90,2543,3664,2030,B
3663,C,500,500,2983,880,3423,3664,2483,C
3663,D,8261,8261,11244,3780,7203,3664,2983,D
3663,M,130,130,11374,1139,8342,3664,11244,M
3663,N,1129,1129,12503,180,8522,3664,11374,N
3663,O,934,934,13437,1055,9577,3664,12503,O
3663,N,746,746,14183,620,10197,3664,13437,N
3663,O,185,185,14368,265,10462,3664,14183,O
3663,P,1341,1341,15709,5100,15562,3664,14368,P
3664,AE,29,29,29,2242,2242,3665,0,E
3664,AF,394,365,394,1150,1150,3665,0,A
3664,BF,944,944,1338,240,1390,3665,394,B
3664,CF,584,584,1922,815,2205,3665,1338,C
3664,DF,212,212,2134,3960,6165,3665,1922,D
3664,F,2413,308,2442,240,2482,3665,29,F
3664,G,551,551,2993,810,3292,3665,2442,G
3664,H,3067,3067,6060,3960,7252,3665,2993,H
3664,M,239,239,6299,312,7564,3665,6060,M
3664,N,274,274,6573,240,7804,3665,6299,N
3664,O,510,510,7083,765,8569,3665,6573,O
3664,N,366,366,7449,110,8679,3665,7083,N
3664,O,673,673,8122,1045,9724,3665,7449,O
3664,P,592,592,8714,3960,13684,3665,8122,P
3665,AEI,207,207,207,283,283,3666,0,A
3665,BEI,231,24,231,280,280,3666,0,I
3665,BEJ,272,248,479,240,523,3666,207,B
3665,CEJ,326,78,557,300,580,3666,231,J
3665,CEK,729,651,1208,850,1373,3666,479,C
3665,DEK,672,21,1229,840,1420,3666,557,K
3665,DEL,136,136,1365,1560,2980,3666,1229,L
3665,DE,433,276,1641,5220,6593,3666,1208,D
3665,E,14540,12899,14540,14854,14854,3666,0,E
3665,F,584,584,15124,300,15154,3666,14540,F
3665,G,625,625,15749,735,15889,3666,15124,G
3665,H,40,40,15789,1560,17449,3666,15749,H
3665,M,1635,1635,17424,1660,19109,3666,15789,M
3665,N,285,285,17709,300,19409,3666,17424,N
3665,O,2642,2642,20351,840,20249,3666,17709,O
3665,N,323,323,20674,2145,22394,3666,20351,N
3665,O,759,759,21433,990,23384,3666,20674,O
3665,P,1401,1401,22834,1620,25004,3666,21433,P
3666,AEI,801,801,801,1789,1789,3667,0,I
3666,AEJ,1396,595,1396,1498,1498,3667,0,A
3666,BEJ,367,367,1763,240,1738,3667,1396,B
3666,CEJ,1122,160,1923,180,1969,3667,801,J
3666,CEK,213,213,2136,265,2234,3667,1923,K
3666,CEJ,466,466,2602,430,2664,3667,2136,J
3666,CEK,907,68,2670,1055,2793,3667,1763,C
3666,BEK,169,101,2771,205,2869,3667,2602,K
3666,BEL,2812,41,2812,3158,3158,3667,0,E
3666,BFL,267,125,2937,250,3043,3667,2670,B
3666,CFL,371,205,3142,5585,8454,3667,2771,L
3666,CF,475,270,3412,900,3943,3667,2937,C
3666,CF,600,0,3412,300,3458,3667,2812,F
3666,DG,956,956,4368,1115,4573,3667,3412,G
3666,DF,812,812,5180,630,5203,3667,4368,F
3666,DG,3535,1767,6947,3960,7903,3667,3412,D
3666,G,3232,1465,8412,900,6103,3667,5180,G
3666,H,1976,1976,10388,3960,10063,3667,8412,H
3666,M,1643,1643,12031,3574,13637,3667,10388,M
3666,N,2786,2786,14817,900,14537,3667,12031,N
3666,O,491,491,15308,480,15017,3667,14817,O
3666,N,1351,1351,16659,1355,16372,3667,15308,N
3666,O,1287,1287,17946,2207,18579,3667,16659,O
3666,P,833,833,18779,353,18932,3667,17946,P
3667,AEI,386,386,386,414,414,3668,0,I
3667,AEJ,257,257,643,300,714,3668,386,J
3667,AEK,1169,526,1169,1469,1469,3668,0,E
3667,AFK,674,148,1317,775,1489,3668,643,K
3667,AFJ,348,200,1517,90,1559,3668,1169,F
3667,AGJ,542,542,2059,805,2364,3668,1517,G
3667,AHJ,1200,458,2517,1085,2574,3668,1317,J
3667,AHK,3004,487,3004,3235,3235,3668,0,A
3667,BHK,559,72,3076,740,3314,3668,2517,K
3667,BHL,263,191,3267,90,3325,3668,3004,B
3667,CHL,558,558,3825,805,4130,3668,3267,C
3667,DHL,1980,1980,5805,3780,7910,3668,3825,D
3667,HL,7740,3994,9799,3780,6144,3668,2059,H
3667,L,25494,18771,28570,5100,8414,3668,3076,L
3667,M,8243,8243,36813,9307,17721,3668,28570,M
3667,N,1105,1105,37918,90,17811,3668,36813,N
3667,O,520,520,38438,805,18616,3668,37918,O
3667,N,589,589,39027,315,18931,3668,38438,N
3667,O,868,868,39895,1080,20011,3668,39027,O
3667,P,695,695,40590,3780,23791,3668,39895,P
3668,AE,125,125,125,370,370,3669,0,E
3668,AF,533,533,658,300,670,3669,125,F
3668,AG,1044,386,1044,1435,1435,3669,0,A
3668,BG,643,257,1301,840,1510,3669,658,G
3668,BH,284,284,1585,1560,3070,3669,1301,H
3668,B,639,98,1683,300,1735,3669,1044,B
3668,C,651,651,2334,760,2495,3669,1683,C
3668,D,136,136,2470,1560,4055,3669,2334,D
3668,M,1220,1220,3690,1310,5365,3669,2470,M
3668,N,422,422,4112,300,5665,3669,3690,N
3668,O,770,770,4882,750,6415,3669,4112,O
3668,N,1474,1474,6356,1570,7985,3669,4882,N
3668,O,272,272,6628,1300,9285,3669,6356,O
3668,P,1067,1067,7695,2940,12225,3669,6628,P
3669,AEI,2,2,2,720,720,3670,0,I
3669,AEJ,9,7,9,96,96,3670,0,A
3669,BEJ,292,292,301,240,336,3670,9,B
3669,CEJ,377,76,377,281,281,3670,0,E
3669,CFJ,98,98,475,240,521,3670,377,F
3669,CGJ,120,120,595,380,901,3670,475,G
3669,CFJ,511,217,812,780,1116,3670,301,C
3669,DFJ,98,98,910,3960,5076,3670,812,D
3669,FJ,1019,111,1021,300,1020,3670,2,J
3669,FK,744,318,1339,460,1361,3670,595,F
3669,GK,365,47,1386,590,1610,3670,1021,K
3669,GL,507,460,1846,790,2151,3670,1339,G
3669,HL,862,402,2248,3960,5570,3670,1386,L
3669,H,5441,5039,7287,3960,6111,3670,1846,H
3669,M,665,665,7952,725,6836,3670,7287,M
3669,N,634,634,8586,610,7446,3670,7952,N
3669,O,366,366,8952,455,7901,3670,8586,O
3669,N,1293,1293,10245,1210,9111,3670,8952,N
3669,O,4570,4570,14815,1625,10736,3670,10245,O
3669,P,21367,21367,36182,2755,13491,3670,14815,P
3670,A,4,4,4,862,862,3671,0,A
3670,B,976,976,980,150,1012,3671,4,B
3670,C,1247,1247,2227,1290,2302,3671,980,C
3670,D,350,350,2577,3660,5962,3671,2227,D
3670,M,196,196,2773,1938,7900,3671,2577,M
3670,N,1930,1930,4703,240,8140,3671,2773,N
3670,O,1738,1738,6441,985,9125,3671,4703,O
3670,N,378,378,6819,1100,10225,3671,6441,N
3670,O,688,688,7507,925,11150,3671,6819,O
3670,P,10991,10991,18498,3960,15110,3671,7507,P
3671,AE,254,254,254,948,948,3672,0,E
3671,AF,784,784,1038,150,1098,3672,254,F
3671,AG,177,177,1215,540,1638,3672,1038,G
3671,AH,391,391,1606,720,2358,3672,1215,H
3671,A,5752,4146,5752,5830,5830,3672,0,A
3671,B,339,339,6091,300,6130,3672,5752,B
3671,C,703,703,6794,800,6930,3672,6091,C
3671,D,115,115,6909,1140,8070,3672,6794,D
3671,M,838,838,7747,945,9015,3672,6909,M
3671,N,234,234,7981,150,9165,3672,7747,N
3671,O,173,173,8154,390,9555,3672,7981,O
3671,N,1465,1465,9619,1215,10770,3672,8154,N
3671,O,670,670,10289,615,11385,3672,9619,O
3671,P,10987,10987,21276,4230,15615,3672,10289,P
3672,AE,18,18,18,219,219,3673,0,A
3672,BE,55,37,55,189,189,3673,0,E
3672,BF,223,223,278,135,324,3673,55,F
3672,BG,279,19,297,135,354,3673,18,B
3672,CG,183,164,461,285,609,3673,278,G
3672,CH,191,27,488,280,634,3673,297,C
3672,DH,207,207,695,5160,5794,3673,488,D
3672,H,322,88,783,5160,5769,3673,461,H
3672,M,523,523,1306,657,6451,3673,783,M
3672,N,494,494,1800,420,6871,3673,1306,N
3672,O,49,49,1849,295,7166,3673,1800,O
3672,N,284,284,2133,30,7196,3673,1849,N
3672,O,157,157,2290,225,7421,3673,2133,O
3672,P,958,958,3248,4740,12161,3673,2290,P
3673,AE,46,46,46,75,75,3674,0,E
3673,AF,75,29,75,99,99,3674,0,A
3673,BF,114,85,160,135,210,3674,46,F
3673,BG,104,19,179,135,234,3674,75,B
3673,CG,157,138,317,285,495,3674,160,G
3673,CH,186,48,365,285,519,3674,179,C
3673,DH,160,112,477,5160,5655,3674,317,H
3673,D,134,22,499,5160,5679,3674,365,D
3673,M,523,523,1022,1955,7634,3674,499,M
3673,N,1602,1602,2624,150,7784,3674,1022,N
3673,O,1343,1343,3967,1610,9394,3674,2624,O
3673,P,36,36,4003,2520,11914,3674,3967,P
3674,AEI,395,395,395,800,800,3675,0,E
3674,AFI,570,570,965,210,1010,3675,395,F
3674,AGI,164,164,1129,300,1310,3675,965,G
3674,AFI,1272,143,1272,1837,1837,3675,0,A
3674,BFI,1551,279,1551,2066,2066,3675,0,I
3674,BFJ,747,325,1876,605,1915,3675,1129,F
3674,BGJ,635,310,2186,180,2246,3675,1551,J
3674,BGK,938,24,2210,420,2257,3675,1272,B
3674,CGK,197,173,2383,190,2436,3675,2186,K
3674,CGJ,998,491,2874,2357,4272,3675,1876,G
3674,CHJ,893,229,3103,2049,4306,3675,2210,C
3674,DHJ,779,550,3653,918,5190,3675,2874,H
3674,DJ,658,108,3761,1327,5633,3675,3103,D
3674,J,1766,388,4149,1755,4191,3675,2383,J
3674,K,892,892,5041,2059,6250,3675,4149,K
3674,L,471,471,5512,3746,9996,3675,5041,L
3674,M,1596,1596,7108,843,10839,3675,5512,M
3674,N,642,642,7750,1500,12339,3675,7108,N
3674,O,224,224,7974,170,12509,3675,7750,O
3674,N,701,701,8675,710,13219,3675,7974,N
3674,O,2349,2349,11024,2268,15487,3675,8675,O
3674,P,1,1,11025,762,16249,3675,11024,P
3675,AE,33,33,33,1410,1410,3676,0,A
3675,BE,1210,1177,1210,1580,1580,3676,0,E
3675,BF,1564,387,1597,240,1650,3676,33,B
3675,CF,637,250,1847,300,1880,3676,1210,F
3675,CG,678,428,2275,760,2410,3676,1597,C
3675,DG,1051,623,2898,1045,2925,3676,1847,G
3675,DH,824,201,3099,7680,10090,3676,2275,D
3675,H,5615,5414,8513,1140,4065,3676,2898,H
3675,M,5800,5800,14313,7322,17412,3676,8513,M
3675,N,1568,1568,15881,90,17502,3676,14313,N
3675,O,1904,1904,17785,2030,19532,3676,15881,O
3675,P,47520,47520,65305,3780,23312,3676,17785,P
3676,AEI,374,374,374,923,923,3677,0,E
3676,AFI,392,18,392,893,893,3677,0,I
3676,AFJ,528,528,920,90,983,3677,392,J
3676,AFK,652,106,1026,150,1073,3677,374,F
3676,AGK,114,114,1140,115,1188,3677,1026,G
3676,AFK,345,125,1265,705,1688,3677,920,K
3676,AFL,806,681,1946,800,1988,3677,1140,F
3676,AGL,822,822,2768,705,2693,3677,1946,G
3676,AHL,127,127,2895,4230,6923,3677,2768,H
3676,AL,2671,1041,3936,3840,5528,3677,1265,L
3676,A,4425,489,4425,4688,4688,3677,0,A
3676,B,304,304,4729,90,4778,3677,4425,B
3676,C,279,279,5008,705,5483,3677,4729,C
3676,D,1091,1091,6099,3780,9263,3677,5008,D
3676,M,1159,1159,7258,1390,10653,3677,6099,M
3676,N,426,426,7684,240,10893,3677,7258,N
3676,O,958,958,8642,1005,11898,3677,7684,O
3676,N,130,130,8772,650,12548,3677,8642,N
3676,O,475,475,9247,562,13110,3677,8772,O
3676,P,4040,4040,13287,3960,17070,3677,9247,P
3677,AE,2752,2752,2752,2350,2350,3678,0,A
3677,BE,2891,139,2891,3073,3073,3678,0,E
3677,BF,215,215,3106,90,3163,3678,2891,F
3677,BG,385,31,3137,90,2440,3678,2752,B
3677,CG,654,623,3760,820,3983,3678,3106,G
3677,CF,669,46,3806,815,3255,3678,3137,C
3677,BF,877,877,4683,1485,4740,3678,3806,B
3677,CF,1005,82,4765,845,4828,3678,3760,F
3677,CG,446,364,5129,740,5480,3678,4683,C
3677,DG,434,70,5199,740,5568,3678,4765,G
3677,DH,932,932,6131,3780,9348,3678,5199,H
3677,D,2454,1452,7583,3780,9260,3678,5129,D
3677,M,537,537,8120,756,10104,3678,7583,M
3677,N,519,519,8639,360,10464,3678,8120,N
3677,O,653,653,9292,835,11299,3678,8639,O
3677,N,2206,2206,11498,2005,13304,3678,9292,N
3677,O,1079,1079,12577,2270,15574,3678,11498,O
3677,P,1185,1185,13762,1675,17249,3678,12577,P
3678,AEI,277,277,277,772,772,3679,0,E
3678,AFI,696,419,696,2380,2380,3679,0,A
3678,BFI,649,230,926,180,952,3679,277,F
3678,BGI,2008,1082,2008,2291,2291,3679,0,I
3678,BGJ,1223,141,2149,1290,2242,3679,926,G
3678,BHJ,319,178,2327,90,2381,3679,2008,J
3678,BHK,1893,262,2589,240,2620,3679,696,B
3678,CHK,949,687,3276,1325,3706,3679,2327,K
3678,CHL,54,54,3330,3780,7486,3679,3276,L
3678,CH,1068,327,3657,1295,3915,3679,2589,C
3678,DH,1825,317,3974,3660,5902,3679,2149,H
3678,D,4834,4517,8491,3660,7575,3679,3657,D
3678,M,446,446,8937,1356,8931,3679,8491,M
3678,N,986,986,9923,180,9111,3679,8937,N
3678,O,990,990,10913,1155,10266,3679,9923,O
3678,N,1094,1094,12007,885,11151,3679,10913,N
3678,O,953,953,12960,1070,12221,3679,12007,O
3678,P,499,499,13459,6900,19121,3679,12960,P
3679,AE,424,424,424,512,512,3680,0,A
3679,BE,208,208,632,180,692,3680,424,B
3679,CE,31,31,663,420,1112,3680,632,C
3679,BE,1150,487,1150,1630,1630,3680,0,E
3679,BF,819,332,1482,425,1537,3680,663,B
3679,CF,723,391,1873,300,1930,3680,1150,F
3679,CG,677,286,2159,760,2297,3680,1482,C
3679,DG,223,223,2382,7680,9977,3680,2159,D
3679,G,891,382,2764,1045,2975,3680,1873,G
3679,H,171,171,2935,1140,4115,3680,2764,H
3679,M,3023,3023,5958,3087,13064,3680,2935,M
3679,N,276,276,6234,240,13304,3680,5958,N
3679,O,609,609,6843,770,14074,3680,6234,O
3679,N,374,374,7217,285,14359,3680,6843,N
3679,O,852,852,8069,1260,15619,3680,7217,O
3679,P,387,387,8456,3960,19579,3680,8069,P
3680,AEI,69,69,69,1207,1207,3681,0,E
3680,AFI,152,83,152,535,535,3681,0,I
3680,AFJ,163,11,163,857,857,3681,0,A
3680,BFJ,492,481,644,150,685,3681,152,J
3680,BFK,726,245,889,90,947,3681,163,B
3680,CFK,369,369,1258,705,1652,3681,889,C
3680,DFK,1340,151,1409,240,1447,3681,69,F
3680,DGK,856,91,1500,945,1630,3681,644,K
3680,DGL,638,638,2138,5160,6790,3681,1500,L
3680,DG,776,47,2185,970,2417,3681,1409,G
3680,DH,1141,214,2399,3780,5432,3681,1258,D
3680,H,921,707,3106,3960,6377,3681,2185,H
3680,M,490,490,3596,700,7490,3681,3106,M
3680,N,444,444,4040,300,7790,3681,3596,N
3680,O,824,824,4864,1055,8845,3681,4040,O
3680,N,869,869,5733,625,9470,3681,4864,N
3680,O,944,944,6677,2049,11519,3681,5733,O
3680,P,946,946,7623,846,12365,3681,6677,P
3681,AE,84,84,84,700,700,3682,0,E
3681,AF,365,281,365,295,295,3682,0,A
3681,BF,316,316,681,435,730,3682,365,B
3681,CF,821,224,905,240,940,3682,84,F
3681,CG,463,239,1144,585,1315,3682,681,C
3681,BG,632,393,1537,785,1725,3682,905,G
3681,BH,540,147,1684,415,1730,3682,1144,B
3681,CH,236,236,1920,875,2605,3682,1684,C
3681,DH,835,452,2372,3960,5685,3682,1537,H
3681,D,718,266,2638,1620,4225,3682,1920,D
3681,M,1783,1783,4421,1967,7652,3682,2638,M
3681,N,301,301,4722,150,7802,3682,4421,N
3681,O,511,511,5233,455,8257,3682,4722,O
3681,N,195,195,5428,215,8472,3682,5233,N
3681,O,147,147,5575,145,8617,3682,5428,O
3681,P,25,25,5600,4230,12847,3682,5575,P
3682,AE,104,104,104,2645,2645,3683,0,A
3682,BE,123,19,123,130,130,3683,0,E
3682,BF,265,265,388,300,430,3683,123,F
3682,BG,628,628,1016,785,1215,3683,388,G
3682,BH,1101,1101,2117,4020,5235,3683,1016,H
3682,B,2806,793,2910,300,2945,3683,104,B
3682,C,654,654,3564,805,3750,3683,2910,C
3682,D,643,643,4207,3960,7710,3683,3564,D
3682,M,1880,1880,6087,1940,9650,3683,4207,M
3682,N,634,634,6721,610,10260,3683,6087,N
3682,O,365,365,7086,455,10715,3683,6721,O
3682,N,1294,1294,8380,1210,11925,3683,7086,N
3682,O,306,306,8686,1625,13550,3683,8380,O
3682,P,27231,27231,35917,2755,16305,3683,8686,P
3683,A,1272,1272,1272,383,383,3684,0,A
3683,B,803,803,2075,240,623,3684,1272,B
3683,C,1049,1049,3124,2281,2904,3684,2075,C
3683,B,11550,11550,14674,7470,10374,3684,3124,B
3683,C,551,551,15225,780,11154,3684,14674,C
3683,D,583,583,15808,3960,15114,3684,15225,D
3683,M,11785,11785,27593,12009,27123,3684,15808,M
3683,N,334,334,27927,180,27303,3684,27593,N
3683,O,989,989,28916,1235,28538,3684,27927,O
3683,P,2051,2051,30967,6680,35218,3684,28916,P
3684,A,74,74,74,153,153,3685,0,A
3684,B,258,258,332,240,393,3685,74,B
3684,C,405,405,737,285,678,3685,332,C
3684,D,439,439,1176,5160,5838,3685,737,D
3684,M,1965,1965,3141,4326,10164,3685,1176,M
3684,N,2415,2415,5556,90,10254,3685,3141,N
3684,O,1148,1148,6704,1375,11629,3685,5556,O
3684,N,584,584,7288,355,11984,3685,6704,N
3684,O,720,720,8008,1060,13044,3685,7288,O
3684,P,891,891,8899,3780,16824,3685,8008,P
3685,AE,78,78,78,161,161,3686,0,E
3685,AF,170,92,170,818,818,3686,0,A
3685,BF,172,80,250,135,296,3686,78,F
3685,BG,235,235,485,290,586,3686,250,G
3685,BH,76,76,561,5160,5746,3686,485,H
3685,B,733,342,903,150,968,3686,170,B
3685,C,42,42,945,90,1058,3686,903,C
3685,B,311,311,1256,255,1313,3686,945,B
3685,C,192,192,1448,280,1593,3686,1256,C
3685,D,358,358,1806,5160,6753,3686,1448,D
3685,M,161,161,1967,413,7166,3686,1806,M
3685,N,390,390,2357,180,7346,3686,1967,N
3685,O,94,94,2451,149,7495,3686,2357,O
3685,P,149,149,2600,391,7886,3686,2451,P
3686,A,139,139,139,760,760,3687,0,A
3686,B,670,670,809,110,870,3687,139,B
3686,C,193,193,1002,285,1155,3687,809,C
3686,D,123,123,1125,5160,6315,3687,1002,D
3686,M,184,184,1309,635,6950,3687,1125,M
3686,N,770,770,2079,360,7310,3687,1309,N
3686,O,521,521,2600,780,8090,3687,2079,O
3686,P,120,120,2720,4020,12110,3687,2600,P
3687,A,10061,10061,10061,10980,10980,3688,0,A
3687,B,1185,1185,11246,300,11280,3688,10061,B
3687,C,872,872,12118,905,12185,3688,11246,C
3687,D,15442,15442,27560,2760,14945,3688,12118,D
3687,M,159,159,27719,1047,15992,3688,27560,M
3687,N,1008,1008,28727,180,16172,3688,27719,N
3687,O,1024,1024,29751,1050,17222,3688,28727,O
3687,N,666,666,30417,630,17852,3688,29751,N
3687,O,52,52,30469,415,18267,3688,30417,O
3687,P,3560,3560,34029,6060,24327,3688,30469,P
3688,AE,227,227,227,203,203,3689,0,E
3688,AF,239,239,466,300,503,3689,227,F
3688,AG,1254,788,1254,1457,1457,3689,0,A
3688,BG,920,132,1386,1115,1618,3689,466,G
3688,BF,384,252,1638,240,1697,3689,1254,B
3688,CF,731,479,2117,630,2248,3689,1386,F
3688,CG,652,173,2290,200,1897,3689,1638,C
3688,DG,296,296,2586,5220,7117,3689,2290,D
3688,G,502,33,2619,900,3148,3689,2117,G
3688,H,3535,3535,6154,3960,7108,3689,2619,H
3688,M,1442,1442,7596,1952,9069,3689,6154,M
3688,N,1275,1275,8871,900,9969,3689,7596,N
3688,O,400,400,9271,480,10449,3689,8871,O
3688,N,1020,1020,10291,830,11279,3689,9271,N
3688,O,479,479,10770,626,11905,3689,10291,O
3688,P,3596,3596,14366,944,12849,3689,10770,P
3689,AEI,307,307,307,1139,1139,3690,0,A
3689,BEI,1185,878,1185,1555,1555,3690,0,E
3689,BFI,1190,5,1190,1560,1560,3690,0,I
3689,BFJ,1015,132,1322,240,1379,3690,307,B
3689,CFJ,641,504,1826,300,1855,3690,1185,F
3689,CGJ,641,5,1831,300,1860,3690,1190,J
3689,CGK,986,477,2308,1410,2789,3690,1322,C
3689,BGK,956,474,2782,1045,2900,3690,1826,G
3689,BHK,956,5,2787,1045,2905,3690,1831,K
3689,BHL,48,43,2830,1140,4040,3690,2782,H
3689,BL,1425,1382,4212,1140,4045,3690,2787,L
3689,B,2026,122,4334,1530,4319,3690,2308,B
3689,C,738,738,5072,830,5149,3690,4334,C
3689,D,4071,4071,9143,3960,9109,3690,5072,D
3689,M,299,299,9442,1225,10334,3690,9143,M
3689,N,1211,1211,10653,300,10634,3690,9442,N
3689,O,947,947,11600,905,11539,3690,10653,O
3689,P,11202,11202,22802,2760,14299,3690,11600,P
3690,A,82,82,82,1150,1150,3691,0,A
3690,B,1265,1265,1347,240,1390,3691,82,B
3690,C,679,679,2026,760,2150,3691,1347,C
3690,D,2835,2835,4861,7680,9830,3691,2026,D
3690,M,276,276,5137,631,10461,3691,4861,M
3690,N,856,856,5993,540,11001,3691,5137,N
3690,O,623,623,6616,845,11846,3691,5993,O
3690,N,996,996,7612,780,12626,3691,6616,N
3690,O,709,709,8321,888,13514,3691,7612,O
3690,P,493,493,8814,402,13916,3691,8321,P
3691,AE,1,1,1,2125,2125,3692,0,A
3691,BE,2317,2317,2318,240,2365,3692,1,B
3691,CE,2451,133,2451,2600,2600,3692,0,E
3691,CF,527,527,2978,420,3020,3692,2451,F
3691,CG,701,41,3019,960,3325,3692,2318,C
3691,DG,223,223,3242,3960,7285,3692,3019,D
3691,G,979,715,3957,1180,4200,3692,2978,G
3691,H,951,951,4908,665,4865,3692,3957,H
3691,M,991,991,5899,2294,9579,3692,4908,M
3691,N,1501,1501,7400,240,9819,3692,5899,N
3691,O,811,811,8211,910,10729,3692,7400,O
3691,N,1541,1541,9752,1460,12189,3692,8211,N
3691,O,665,665,10417,1010,13199,3692,9752,O
3691,P,3619,3619,14036,340,13539,3692,10417,P
3692,A,88,88,88,114,114,3693,0,A
3692,B,104,104,192,135,249,3693,88,B
3692,C,240,240,432,285,534,3693,192,C
3692,D,48,48,480,5160,5694,3693,432,D
3692,M,689,689,1169,1267,6961,3693,480,M
3692,N,719,719,1888,180,7141,3693,1169,N
3692,O,672,672,2560,885,8026,3693,1888,O
3692,P,9230,9230,11790,6680,14706,3693,2560,P
3693,AE,6,6,6,33,33,3694,0,A
3693,BE,136,136,142,150,183,3694,6,B
3693,CE,180,180,322,830,1013,3694,142,C
3693,DE,390,68,390,1034,1034,3694,0,E
3693,DF,539,471,861,3490,4503,3694,322,D
3693,F,870,399,1260,270,1304,3694,390,F
3693,G,213,213,1473,180,1484,3694,1260,G
3693,H,2497,2497,3970,2850,4334,3694,1473,H
3693,M,297,297,4267,254,4757,3694,3970,M
3693,N,291,291,4558,400,5157,3694,4267,N
3693,O,192,192,4750,100,5257,3694,4558,O
3693,N,596,596,5346,680,5937,3694,4750,N
3693,O,372,372,5718,255,6192,3694,5346,O
3693,P,23,23,5741,2880,9072,3694,5718,P
3694,A,2023,2023,2023,2445,2445,3695,0,A
3694,B,454,454,2477,90,2535,3695,2023,B
3694,C,488,488,2965,905,3440,3695,2477,C
3694,D,2525,2525,5490,3780,7220,3695,2965,D
3694,M,254,254,5744,1091,8311,3695,5490,M
3694,N,957,957,6701,180,8491,3695,5744,N
3694,O,801,801,7502,1050,9541,3695,6701,O
3694,N,885,885,8387,625,10166,3695,7502,N
3694,O,245,245,8632,380,10546,3695,8387,O
3694,P,1238,1238,9870,5460,16006,3695,8632,P
3695,A,99,99,99,170,170,3696,0,A
3695,B,352,352,451,300,470,3696,99,B
3695,C,669,669,1120,780,1250,3696,451,C
3695,D,2085,2085,3205,1140,2390,3696,1120,D
3695,M,914,914,4119,1933,4323,3696,3205,M
3695,N,1152,1152,5271,150,4473,3696,4119,N
3695,O,1377,1377,6648,1625,6098,3696,5271,O
3695,P,1471,1471,8119,2520,8618,3696,6648,P
3696,AEI,40,40,40,50,50,3697,0,E
3696,AFI,48,8,48,716,716,3697,0,A
3696,BFI,252,204,252,413,413,3697,0,I
3696,BFJ,519,307,559,570,620,3697,40,F
3696,BGJ,334,27,586,240,653,3697,252,J
3696,BGK,71,44,630,80,700,3697,559,G
3696,BFK,248,248,878,240,940,3697,630,F
3696,BGK,848,18,896,240,956,3697,48,B
3696,CGK,128,110,1006,130,1070,3697,878,G
3696,CHK,196,86,1092,260,1216,3697,896,C
3696,DHK,845,339,1431,975,1628,3697,586,K
3696,DHJ,567,142,1573,2850,3920,3697,1006,H
3696,DJ,743,601,2174,605,2233,3697,1431,J
3696,DK,167,167,2341,260,2493,3697,2174,K
3696,DL,1389,140,2481,5160,6376,3697,1092,D
3696,L,5819,5679,8160,5160,7653,3697,2341,L
3696,M,329,329,8489,373,8026,3697,8160,M
3696,N,154,154,8643,170,8196,3697,8489,N
3696,O,516,516,9159,465,8661,3697,8643,O
3696,N,335,335,9494,365,9026,3697,9159,N
3696,O,695,695,10189,683,9709,3697,9494,O
3696,P,2443,2443,12632,372,10081,3697,10189,P
3697,A,1334,1334,1334,1767,1767,3698,0,A
3697,B,653,653,1987,240,2007,3698,1334,B
3697,C,1162,1162,3149,1320,3327,3698,1987,C
3697,B,533,533,3682,365,3692,3698,3149,B
3697,C,547,547,4229,1260,4952,3698,3682,C
3697,D,563,563,4792,3960,8912,3698,4229,D
3697,M,510,510,5302,1091,10003,3698,4792,M
3697,N,835,835,6137,300,10303,3698,5302,N
3697,O,164,164,6301,295,10598,3698,6137,O
3697,N,1619,1619,7920,1470,12068,3698,6301,N
3697,O,170,170,8090,225,12293,3698,7920,O
3697,P,6635,6635,14725,4740,17033,3698,8090,P
3698,A,117,117,117,140,140,3699,0,A
3698,B,304,304,421,300,440,3699,117,B
3698,C,681,681,1102,780,1220,3699,421,C
3698,D,1263,1263,2365,1140,2360,3699,1102,D
3698,M,980,980,3345,1778,4138,3699,2365,M
3698,N,916,916,4261,150,4288,3699,3345,N
3698,O,1425,1425,5686,1685,5973,3699,4261,O
3698,P,303,303,5989,2520,8493,3699,5686,P
3699,A,1235,1235,1235,1605,1605,3700,0,A
3699,B,634,634,1869,300,1905,3700,1235,B
3699,C,996,996,2865,1045,2950,3700,1869,C
3699,D,157,157,3022,1140,4090,3700,2865,D
3699,M,3975,3975,6997,2820,6910,3700,3022,M
3699,N,487,487,7484,240,7150,3700,6997,N
3699,O,592,592,8076,770,7920,3700,7484,O
3699,N,1484,1484,9560,1300,9220,3700,8076,N
3699,O,1091,1091,10651,1295,10515,3700,9560,O
3699,P,1811,1811,12462,3660,14175,3700,10651,P
3700,AE,7,7,7,614,614,3701,0,A
3700,BE,553,546,553,290,290,3701,0,E
3700,BF,809,263,816,240,854,3701,7,B
3700,CF,665,402,1218,960,1250,3701,553,F
3700,CG,533,131,1349,790,1644,3701,816,C
3700,DG,399,268,1617,595,1845,3701,1218,G
3700,DF,1257,1257,2874,1040,2885,3701,1617,F
3700,DG,366,366,3240,1475,4360,3701,2874,G
3700,DH,1010,1010,4250,1590,5950,3701,3240,H
3700,D,3026,125,4375,4020,5664,3701,1349,D
3700,M,1512,1512,5887,1829,7779,3701,4375,M
3700,N,432,432,6319,180,7959,3701,5887,N
3700,O,1307,1307,7626,1240,9199,3701,6319,O
3700,N,2839,2839,10465,2860,12059,3701,7626,N
3700,O,714,714,11179,780,12839,3701,10465,O
3700,P,33471,33471,44650,4020,16859,3701,11179,P
3701,AE,92,92,92,150,150,3702,0,A
3701,AE,92,0,92,29,29,3702,0,E
3701,BF,120,120,212,240,269,3702,92,F
3701,BG,330,210,422,300,450,3702,92,B
3701,CG,275,65,487,285,554,3702,212,G
3701,CH,697,632,1119,790,1240,3702,422,C
3701,DH,77,77,1196,1140,2380,3702,1119,D
3701,H,2099,1390,2586,5160,5714,3702,487,H
3701,M,197,197,2783,544,6258,3702,2586,M
3701,N,482,482,3265,150,6408,3702,2783,N
3701,O,1443,1443,4708,1685,8093,3702,3265,O
3701,P,1457,1457,6165,2520,10613,3702,4708,P
3702,A,553,553,553,1539,1539,3703,0,A
3702,B,1187,1187,1740,240,1779,3703,553,B
3702,C,783,783,2523,970,2749,3703,1740,C
3702,D,145,145,2668,3960,6709,3703,2523,D
3702,M,24280,24280,26948,24557,31266,3703,2668,M
3702,N,593,593,27541,90,31356,3703,26948,N
3702,O,442,442,27983,700,32056,3703,27541,O
3702,N,190,190,28173,200,32256,3703,27983,N
3702,O,544,544,28717,940,33196,3703,28173,O
3702,P,2619,2619,31336,3780,36976,3703,28717,P
3703,AE,220,220,220,235,235,3704,0,E
3703,AF,285,65,285,1053,1053,3704,0,A
3703,BF,185,120,405,120,355,3704,220,F
3703,BG,217,217,622,210,565,3704,405,G
3703,BH,951,614,1236,240,1293,3704,285,B
3703,CH,1183,1183,2419,1030,2323,3704,1236,C
3703,BH,609,609,3028,875,3198,3704,2419,B
3703,CH,738,738,3766,1141,4339,3704,3028,C
3703,DH,3596,452,4218,2880,3445,3704,622,H
3703,D,804,352,4570,3960,8299,3704,3766,D
3703,M,1057,1057,5627,3841,12140,3704,4570,M
3703,N,3019,3019,8646,240,12380,3704,5627,N
3703,O,1221,1221,9867,1680,14060,3704,8646,O
3703,P,5620,5620,15487,6000,20060,3704,9867,P
3704,AE,5231,5231,5231,5474,5474,3705,0,E
3704,AF,291,291,5522,90,5564,3705,5231,F
3704,AG,5673,151,5673,5774,5774,3705,0,A
3704,BG,129,129,5802,90,5864,3705,5673,B
3704,CG,482,202,6004,735,6299,3705,5522,G
3704,CH,464,262,6266,820,6684,3705,5802,C
3704,BH,1352,1352,7618,994,7678,3705,6266,B
3704,CH,411,411,8029,744,8422,3705,7618,C
3704,DH,2121,2121,10150,3780,12202,3705,8029,D
3704,H,16564,12418,22568,3780,10079,3705,6004,H
3704,M,439,439,23007,697,12899,3705,22568,M
3704,N,558,558,23565,360,13259,3705,23007,N
3704,O,690,690,24255,835,14094,3705,23565,O
3704,N,945,945,25200,815,14909,3705,24255,N
3704,O,304,304,25504,390,15299,3705,25200,O
3704,P,741,741,26245,365,15664,3705,25504,P
3705,AEI,42,42,42,115,115,3706,0,A
3705,BEI,127,85,127,199,199,3706,0,I
3705,BEJ,133,48,175,120,235,3706,42,B
3705,CEJ,162,114,289,150,349,3706,127,J
3705,CEK,5,5,294,110,459,3706,289,K
3705,CEJ,185,66,360,390,625,3706,175,C
3705,BEJ,524,164,524,1319,1319,3706,0,E
3705,BFJ,494,264,788,375,834,3706,294,J
3705,BFK,667,239,1027,450,1075,3706,360,B
3705,CFK,417,178,1205,465,1299,3706,788,K
3705,CFL,241,241,1446,5760,7059,3706,1205,L
3705,CF,443,24,1470,465,1540,3706,1027,C
3705,DF,978,32,1502,240,1559,3706,524,F
3705,DG,480,480,1982,470,2029,3706,1502,G
3705,DH,6703,6191,8173,5820,7360,3706,1470,D
3705,H,27315,21124,29297,5760,7789,3706,1982,H
3705,M,956,956,30253,953,8742,3706,29297,M
3705,N,218,218,30471,240,8982,3706,30253,N
3705,O,1089,1089,31560,585,9567,3706,30471,O
3705,N,1504,1504,33064,2030,11597,3706,31560,N
3705,O,785,785,33849,1120,12717,3706,33064,O
3705,P,2117,2117,35966,3960,16677,3706,33849,P
3706,AEI,93,93,93,130,130,3707,0,E
3706,AFI,140,47,140,184,184,3707,0,A
3706,BFI,141,1,141,140,140,3707,0,I
3706,BFJ,53,53,194,120,260,3707,141,J
3706,BFK,98,44,238,120,304,3707,140,B
3706,CFK,162,17,255,180,310,3707,93,F
3706,CGK,111,50,305,125,385,3707,194,K
3706,CGL,123,73,378,220,530,3707,255,G
3706,CFL,206,66,444,125,429,3707,238,C
3706,DFL,890,824,1268,780,1310,3707,378,F
3706,DGL,1069,106,1374,2880,3265,3707,305,L
3706,DG,119,13,1387,210,1520,3707,1268,G
3706,DH,990,47,1434,2880,3309,3707,444,D
3706,H,2823,2776,4210,4140,5660,3707,1387,H
3706,M,232,232,4442,1090,6750,3707,4210,M
3706,N,944,944,5386,150,6900,3707,4442,N
3706,O,129,129,5515,135,7035,3707,5386,O
3706,P,2665,2665,8180,2880,9915,3707,5515,P
3707,AE,136,136,136,1751,1751,3708,0,A
3707,BE,736,600,736,1005,1005,3708,0,E
3707,BF,440,440,1176,180,1185,3708,736,F
3707,BG,1788,748,1924,240,1991,3708,136,B
3707,CG,918,170,2094,1200,2385,3708,1176,G
3707,CF,1208,1038,3132,1410,3401,3708,1924,C
3707,BF,2245,1207,4339,1975,4360,3708,2094,F
3707,BG,1448,241,4580,1230,4631,3708,3132,B
3707,CG,798,557,5137,2049,6409,3708,4339,G
3707,CH,759,202,5339,2342,6973,3708,4580,C
3707,DH,946,946,6285,2118,9091,3708,5339,D
3707,H,2474,1326,7611,847,7256,3708,5137,H
3707,M,480,480,8091,386,9477,3708,7611,M
3707,N,502,502,8593,600,10077,3708,8091,N
3707,O,202,202,8795,280,10357,3708,8593,O
3707,N,782,782,9577,760,11117,3708,8795,N
3707,O,2358,2358,11935,2058,13175,3708,9577,O
3707,P,1,1,11936,687,13862,3708,11935,P
3708,A,30,30,30,125,125,3709,0,A
3708,B,379,379,409,300,425,3709,30,B
3708,C,702,702,1111,735,1160,3709,409,C
3708,D,4,4,1115,1560,2720,3709,1111,D
3708,M,8537,8537,9652,8579,11299,3709,1115,M
3708,N,305,305,9957,240,11539,3709,9652,N
3708,O,732,732,10689,1055,12594,3709,9957,O
3708,N,434,434,11123,280,12874,3709,10689,N
3708,O,916,916,12039,1080,13954,3709,11123,O
3708,P,4574,4574,16613,4020,17974,3709,12039,P
3709,AEI,29,29,29,49,49,3710,0,E
3709,AFI,77,48,77,169,169,3710,0,I
3709,AFJ,95,18,95,730,730,3710,0,A
3709,BFJ,76,10,105,120,169,3710,29,F
3709,BGJ,116,116,221,125,294,3710,105,G
3709,BHJ,148,4,225,120,289,3710,77,J
3709,BHK,268,268,493,125,414,3710,225,K
3709,BHL,756,358,851,180,910,3710,95,B
3709,CHL,307,307,1158,230,1140,3710,851,C
3709,BHL,897,232,1390,2880,3294,3710,493,L
3709,BH,598,366,1756,650,1790,3710,1158,B
3709,CH,101,101,1857,600,2390,3710,1756,C
3709,DH,635,635,2492,3750,6140,3710,1857,D
3709,H,2358,87,2579,2880,3174,3710,221,H
3709,M,107,107,2686,195,6335,3710,2579,M
3709,N,148,148,2834,120,6455,3710,2686,N
3709,O,1220,1220,4054,1110,7565,3710,2834,O
3709,N,180,180,4234,290,7855,3710,4054,N
3709,O,200,200,4434,290,8145,3710,4234,O
3709,N,788,788,5222,670,8815,3710,4434,N
3709,O,611,611,5833,470,9285,3710,5222,O
3709,P,4912,4912,10745,5760,15045,3710,5833,P
3710,AE,185,185,185,265,265,3711,0,E
3710,AF,245,60,245,279,279,3711,0,A
3710,BF,159,159,404,180,459,3711,245,B
3710,CF,260,41,445,240,505,3711,185,F
3710,CG,431,390,835,265,724,3711,404,C
3710,BG,591,201,1036,575,1080,3711,445,G
3710,BF,273,72,1108,430,1154,3711,835,B
3710,CF,240,240,1348,205,1359,3711,1108,C
3710,DF,755,443,1791,795,1875,3711,1036,F
3710,DG,480,37,1828,5585,6944,3711,1348,D
3710,G,674,637,2465,468,2343,3711,1791,G
3710,H,209,209,2674,392,2735,3711,2465,H
3710,M,347,347,3021,1422,8366,3711,2674,M
3710,N,1195,1195,4216,180,8546,3711,3021,N
3710,O,434,434,4650,510,9056,3711,4216,O
3710,N,1241,1241,5891,1165,10221,3711,4650,N
3710,O,586,586,6477,925,11146,3711,5891,O
3710,P,2848,2848,9325,350,11496,3711,6477,P
3711,AEI,74,74,74,276,276,3712,0,A
3711,BEI,80,6,80,220,220,3712,0,E
3711,BFI,147,67,147,236,236,3712,0,I
3711,BFJ,237,170,317,150,370,3712,80,F
3711,BGJ,181,11,328,150,386,3712,147,J
3711,BGK,300,46,374,150,426,3712,74,B
3711,CGK,112,66,440,125,511,3712,328,K
3711,CGJ,200,77,517,155,525,3712,317,G
3711,CFJ,158,15,532,155,581,3712,374,C
3711,BFJ,809,794,1326,830,1355,3712,517,F
3711,BGJ,845,51,1377,830,1411,3712,532,B
3711,CGJ,116,65,1442,125,1480,3712,1326,G
3711,CHJ,110,45,1487,125,1536,3712,1377,C
3711,DHJ,1066,19,1506,1045,1556,3712,440,J
3711,DHK,149,149,1655,120,1676,3712,1506,K
3711,DHL,302,89,1744,4230,5710,3712,1442,H
3711,DL,275,18,1762,4230,5766,3712,1487,D
3711,L,2883,2776,4538,4230,5906,3712,1655,L
3711,M,305,305,4843,930,6836,3712,4538,M
3711,N,736,736,5579,150,6986,3712,4843,N
3711,O,185,185,5764,130,7116,3712,5579,O
3711,N,199,199,5963,250,7366,3712,5764,N
3711,O,629,629,6592,610,7976,3712,5963,O
3711,P,2750,2750,9342,4230,12206,3712,6592,P
3712,AEI,27,27,27,63,63,3713,0,A
3712,BEI,50,23,50,98,98,3713,0,I
3712,BEJ,56,6,56,36,36,3713,0,E
3712,BFJ,125,96,152,135,198,3713,27,B
3712,CFJ,108,6,158,120,218,3713,50,J
3712,CFK,180,78,236,240,276,3713,56,F
3712,CGK,182,104,340,210,428,3713,158,K
3712,CGL,249,61,401,295,493,3713,152,C
3712,DGL,207,42,443,290,566,3713,236,G
3712,DHL,108,66,509,5160,5653,3713,401,D
3712,HL,953,784,1293,2880,3308,3713,340,L
3712,H,1353,503,1796,5160,5726,3713,443,H
3712,M,7952,7952,9748,11566,17292,3713,1796,M
3712,N,3646,3646,13394,90,17382,3713,9748,N
3712,O,1012,1012,14406,1240,18622,3713,13394,O
3712,N,4604,4604,19010,4375,22997,3713,14406,N
3712,O,730,730,19740,900,23897,3713,19010,O
3712,P,21320,21320,41060,3780,27677,3713,19740,P
3713,AE,1372,1372,1372,2236,2236,3714,0,E
3713,AF,1013,1013,2385,210,2446,3714,1372,F
3713,AG,2437,52,2437,2532,2532,3714,0,A
3713,BG,122,122,2559,90,2622,3714,2437,B
3713,CG,196,22,2581,255,2701,3714,2385,G
3713,CF,456,434,3015,800,3422,3714,2559,C
3713,BF,591,591,3606,245,3667,3714,3015,B
3713,CF,1245,220,3826,1175,3876,3714,2581,F
3713,CG,411,411,4237,540,4416,3714,3826,G
3713,CH,935,304,4541,1210,4877,3714,3606,C
3713,DH,3378,3378,7919,3780,8657,3714,4541,D
3713,H,14036,10354,18273,2880,7296,3714,4237,H
3713,M,506,506,18779,1161,9818,3714,18273,M
3713,N,1380,1380,20159,240,10058,3714,18779,N
3713,O,69,69,20228,255,10313,3714,20159,O
3713,P,4311,4311,24539,660,10973,3714,20228,P
3714,A,90,90,90,189,189,3715,0,A
3714,B,229,229,319,180,369,3715,90,B
3714,C,122,122,441,260,629,3715,319,C
3714,B,571,571,1012,440,1069,3715,441,B
3714,C,135,135,1147,200,1269,3715,1012,C
3714,D,590,590,1737,7030,8299,3715,1147,D
3714,M,1644,1644,3381,3575,11874,3715,1737,M
3714,N,2786,2786,6167,900,12774,3715,3381,N
3714,O,443,443,6610,480,13254,3715,6167,O
3714,N,1399,1399,8009,1355,14609,3715,6610,N
3714,O,1286,1286,9295,2207,16816,3715,8009,O
3714,P,834,834,10129,353,17169,3715,9295,P
3715,AE,245,245,245,1039,1039,3716,0,E
3715,AF,331,86,331,492,492,3716,0,A
3715,BF,196,196,527,120,612,3716,331,B
3715,CF,244,244,771,390,1002,3716,527,C
3715,BF,983,457,1228,240,1279,3716,245,F
3715,BG,631,174,1402,450,1452,3716,771,B
3715,CG,557,383,1785,470,1749,3716,1228,G
3715,CH,553,170,1955,465,1917,3716,1402,C
3715,DH,3568,3568,5523,5760,7677,3716,1955,D
3715,H,6557,2819,8342,5760,7509,3716,1785,H
3715,M,639,639,8981,706,8383,3716,8342,M
3715,N,342,342,9323,240,8623,3716,8981,N
3715,O,894,894,10217,585,9208,3716,9323,O
3715,N,1522,1522,11739,1855,11063,3716,10217,N
3715,O,693,693,12432,945,12008,3716,11739,O
3715,P,13028,13028,25460,3960,15968,3716,12432,P
3716,A,3765,3765,3765,4135,4135,3717,0,A
3716,B,628,628,4393,300,4435,3717,3765,B
3716,C,967,967,5360,1045,5480,3717,4393,C
3716,D,215,215,5575,1140,6620,3717,5360,D
3716,M,256,256,5831,1070,7690,3717,5575,M
3716,N,1077,1077,6908,300,7990,3717,5831,N
3716,O,884,884,7792,905,8895,3717,6908,O
3716,P,4212,4212,12004,2760,11655,3717,7792,P
3717,A,156,156,156,928,928,3718,0,A
3717,B,962,962,1118,240,1168,3718,156,B
3717,C,1160,1160,2278,1175,2343,3718,1118,C
3717,D,1781,1781,4059,720,3063,3718,2278,D
3717,M,1894,1894,5953,2517,5580,3718,4059,M
3717,N,753,753,6706,180,5760,3718,5953,N
3717,O,989,989,7695,885,6645,3718,6706,O
3717,N,750,750,8445,810,7455,3718,7695,N
3717,O,936,936,9381,1030,8485,3718,8445,O
3717,P,732,732,10113,6960,15445,3718,9381,P
3718,A,21,21,21,47,47,3719,0,A
3718,B,111,111,132,135,182,3719,21,B
3718,C,146,146,278,295,477,3719,132,C
3718,D,143,143,421,5160,5637,3719,278,D
3718,M,1821,1821,2242,2769,8406,3719,421,M
3718,N,1060,1060,3302,150,8556,3719,2242,N
3718,O,798,798,4100,885,9441,3719,3302,O
3718,P,426,426,4526,3960,13401,3719,4100,P
3719,A,405,405,405,611,611,3720,0,A
3719,B,333,333,738,210,821,3720,405,B
3719,C,610,610,1348,1000,1821,3720,738,C
3719,B,1018,1018,2366,605,2426,3720,1348,B
3719,C,524,524,2890,540,2966,3720,2366,C
3719,D,15253,15253,18143,2880,5846,3720,2890,D
3719,M,18987,18987,37130,20722,26568,3720,18143,M
3719,N,1920,1920,39050,240,26808,3720,37130,N
3719,O,525,525,39575,185,26993,3720,39050,O
3719,P,3000,3000,42575,660,27653,3720,39575,P
3720,AEI,70,70,70,679,679,3721,0,I
3720,AEJ,380,310,380,2467,2467,3721,0,A
3720,BEJ,394,14,394,657,657,3721,0,E
3720,BFJ,322,322,716,90,747,3721,394,F
3720,BGJ,805,159,875,240,919,3721,70,J
3720,BGK,270,270,1145,285,1204,3721,875,K
3720,BGL,86,86,1231,5160,6364,3721,1145,L
3720,BG,668,153,1384,825,1572,3721,716,G
3720,BF,2117,1113,2497,90,2557,3721,380,B
3720,CF,506,506,3003,820,3377,3721,2497,C
3720,BF,2048,429,3432,1920,3492,3721,1384,F
3720,BG,1018,1018,4450,1340,4832,3721,3432,G
3720,BH,1749,302,4752,1400,4777,3721,3003,B
3720,CH,1537,1235,5987,3780,8612,3721,4450,H
3720,C,1269,34,6021,1440,6217,3721,4752,C
3720,D,2470,2470,8491,3780,9997,3721,6021,D
3720,M,2891,2891,11382,5840,15837,3721,8491,M
3720,N,3057,3057,14439,90,15927,3721,11382,N
3720,O,945,945,15384,1250,17177,3721,14439,O
3720,N,3022,3022,18406,2795,19972,3721,15384,N
3720,O,665,665,19071,945,20917,3721,18406,O
3720,P,1348,1348,20419,3780,24697,3721,19071,P
3721,AEI,1446,1446,1446,1753,1753,3722,0,I
3721,AEJ,1697,251,1697,2621,2621,3722,0,A
3721,BEJ,337,86,1783,90,1843,3722,1446,J
3721,BEK,2160,377,2160,3017,3017,3722,0,E
3721,BFK,517,140,2300,825,2668,3722,1783,K
3721,BFJ,954,351,2651,90,2711,3722,1697,B
3721,CFJ,638,287,2938,335,3003,3722,2300,J
3721,CFK,886,108,3046,90,3107,3722,2160,F
3721,CGK,861,466,3512,1200,3911,3722,2651,C
3721,BGK,753,179,3691,1080,4083,3722,2938,K
3721,BGL,820,641,4332,440,4351,3722,3512,B
3721,CGL,1333,47,4379,1635,4742,3722,3046,G
3721,CFL,938,250,4629,3780,7863,3722,3691,L
3721,CF,736,439,5068,1060,5411,3722,4332,C
3721,DF,833,833,5901,3780,9191,3722,5068,D
3721,F,1724,202,6103,1380,6122,3722,4379,F
3721,G,943,943,7046,1280,7402,3722,6103,G
3721,H,304,304,7350,3780,11182,3722,7046,H
3721,M,9837,9837,17187,10181,21363,3722,7350,M
3721,N,359,359,17546,90,21453,3722,17187,N
3721,O,289,289,17835,725,22178,3722,17546,O
3721,P,738,738,18573,3780,25958,3722,17835,P
3722,A,236,236,236,405,405,3723,0,A
3722,B,229,229,465,120,525,3723,236,B
3722,C,273,273,738,210,735,3723,465,C
3722,D,1252,1252,1990,2880,3615,3723,738,D
3722,M,18577,18577,20567,18999,22614,3723,1990,M
3722,N,1292,1292,21859,180,22794,3723,20567,N
3722,O,613,613,22472,885,23679,3723,21859,O
3722,P,22687,22687,45159,6680,30359,3723,22472,P
3723,A,173,173,173,179,179,3724,0,A
3723,B,186,186,359,240,419,3724,173,B
3723,C,293,293,652,450,869,3724,359,C
3723,B,802,802,1454,645,1514,3724,652,B
3723,C,664,664,2118,876,2390,3724,1454,C
3723,D,733,733,2851,584,2974,3724,2118,D
3723,M,612,612,3463,1785,4759,3724,2851,M
3723,N,1430,1430,4893,300,5059,3724,3463,N
3723,O,626,626,5519,665,5724,3724,4893,O
3723,P,41,41,5560,4020,9744,3724,5519,P
3724,A,111,111,111,296,296,3725,0,A
3724,B,275,275,386,150,446,3725,111,B
3724,C,738,738,1124,845,1291,3725,386,C
3724,D,1920,1920,3044,5220,6511,3725,1124,D
3724,M,375,375,3419,446,6957,3725,3044,M
3724,N,346,346,3765,240,7197,3725,3419,N
3724,O,1159,1159,4924,1055,8252,3725,3765,O
3724,N,3015,3015,7939,3190,11442,3725,4924,N
3724,O,805,805,8744,1080,12522,3725,7939,O
3724,P,2955,2955,11699,3960,16482,3725,8744,P
3725,A,379,379,379,1136,1136,3726,0,A
3725,B,865,865,1244,150,1286,3726,379,B
3725,C,180,180,1424,100,1386,3726,1244,C
3725,B,2209,2209,3633,2225,3611,3726,1424,B
3725,C,558,558,4191,605,4216,3726,3633,C
3725,D,9819,9819,14010,4230,8446,3726,4191,D
3725,M,3067,3067,17077,4353,12799,3726,14010,M
3725,N,1473,1473,18550,240,13039,3726,17077,N
3725,O,866,866,19416,1080,14119,3726,18550,O
3725,P,1621,1621,21037,3960,18079,3726,19416,P
3726,AEI,37,37,37,56,56,3727,0,A
3726,BEI,83,46,83,124,124,3727,0,E
3726,BFI,102,56,139,135,191,3727,37,B
3726,CFI,186,47,186,333,333,3727,0,I
3726,CFJ,135,32,218,135,259,3727,83,F
3726,CGJ,125,46,264,280,471,3727,139,C
3726,DGJ,203,157,421,285,544,3727,218,G
3726,DHJ,250,93,514,5160,5631,3727,264,D
3726,HJ,102,9,523,5280,5824,3727,421,H
3726,J,373,36,559,240,573,3727,186,J
3726,K,171,171,730,285,858,3727,559,K
3726,L,2297,2297,3027,5160,6018,3727,730,L
3726,M,974,974,4001,1883,7901,3727,3027,M
3726,N,1036,1036,5037,150,8051,3727,4001,N
3726,O,1416,1416,6453,1610,9661,3727,5037,O
3726,P,120,120,6573,2520,12181,3727,6453,P
3727,A,13442,13442,13442,13479,13479,3728,0,A
3727,B,300,300,13742,300,13779,3728,13442,B
3727,C,691,691,14433,740,14519,3728,13742,C
3727,D,61,61,14494,1560,16079,3728,14433,D
3727,M,390,390,14884,335,16414,3728,14494,M
3727,N,221,221,15105,300,16714,3728,14884,N
3727,O,866,866,15971,855,17569,3728,15105,O
3727,N,673,673,16644,720,18289,3728,15971,N
3727,O,583,583,17227,3360,21649,3728,16644,O
3727,P,6407,6407,23634,1440,23089,3728,17227,P
3728,AEI,329,329,329,491,491,3729,0,E
3728,AFI,202,202,531,180,671,3729,329,F
3728,AGI,707,707,1238,720,1391,3729,531,G
3728,AFI,1816,578,1816,2511,2511,3729,0,A
3728,BFI,1822,6,1822,2488,2488,3729,0,I
3728,BFJ,811,227,2049,695,2086,3729,1238,F
3728,BGJ,694,467,2516,90,2578,3729,1822,J
3728,BGK,752,52,2568,90,2601,3729,1816,B
3728,CGK,520,468,3036,905,3483,3729,2516,K
3728,CGL,1046,59,3095,1160,3246,3729,2049,G
3728,CHL,541,14,3109,905,3506,3729,2568,C
3728,DHL,2587,2573,5682,665,3911,3729,3095,H
3728,DL,3782,1209,6891,3780,7286,3729,3109,D
3728,L,6819,2964,9855,3780,7263,3729,3036,L
3728,M,3003,3003,12858,3205,10491,3729,9855,M
3728,N,240,240,13098,90,10581,3729,12858,N
3728,O,785,785,13883,1025,11606,3729,13098,O
3728,N,1702,1702,15585,1470,13076,3729,13883,N
3728,O,832,832,16417,925,14001,3729,15585,O
3728,P,2041,2041,18458,3780,17781,3729,16417,P
3729,A,140,140,140,1015,1015,3730,0,A
3729,B,961,961,1101,150,1165,3730,140,B
3729,C,728,728,1829,745,1910,3730,1101,C
3729,D,1548,1548,3377,2820,4730,3730,1829,D
3729,M,1304,1304,4681,3374,8104,3730,3377,M
3729,N,2088,2088,6769,90,8194,3730,4681,N
3729,O,1192,1192,7961,1600,9794,3730,6769,O
3729,N,867,867,8828,440,10234,3730,7961,N
3729,O,798,798,9626,920,11154,3730,8828,O
3729,P,973,973,10599,3780,14934,3730,9626,P
3730,AE,69,69,69,140,140,3731,0,A
3730,BE,360,360,429,300,440,3731,69,B
3730,CE,586,586,1015,735,1175,3731,429,C
3730,DE,105,105,1120,1560,2735,3731,1015,D
3730,E,1396,276,1396,2319,2319,3731,0,E
3730,F,1068,1068,2464,210,2529,3731,1396,F
3730,G,190,190,2654,265,2794,3731,2464,G
3730,F,570,570,3224,485,3279,3731,2654,F
3730,G,714,714,3938,845,4124,3731,3224,G
3730,H,3185,3185,7123,5280,9404,3731,3938,H
3730,M,346,346,7469,488,9892,3731,7123,M
3730,N,402,402,7871,300,10192,3731,7469,N
3730,O,892,892,8763,850,11042,3731,7871,O
3730,N,184,184,8947,235,11277,3731,8763,N
3730,O,1204,1204,10151,335,11612,3731,8947,O
3730,P,90,90,10241,1440,13052,3731,10151,P
3731,AEI,89,89,89,110,110,3732,0,E
3731,AFI,201,112,201,875,875,3732,0,I
3731,AFJ,284,172,373,300,410,3732,89,F
3731,AGJ,707,535,908,90,965,3732,201,J
3731,AGK,801,266,1174,780,1190,3732,373,G
3731,AHK,1484,310,1484,2371,2371,3732,0,A
3731,BHK,962,386,1870,1330,2295,3732,908,K
3731,BHL,941,555,2425,90,2461,3732,1484,B
3731,CHL,1580,329,2754,1140,2330,3732,1174,H
3731,CL,1222,338,3092,3780,6075,3732,1870,L
3731,C,1058,391,3483,1445,3906,3732,2425,C
3731,D,1349,1349,4832,3780,7686,3732,3483,D
3731,M,953,953,5785,1877,9563,3732,4832,M
3731,N,1049,1049,6834,150,9713,3732,5785,N
3731,O,1396,1396,8230,1610,11323,3732,6834,O
3731,P,463,463,8693,2520,13843,3732,8230,P
3732,A,2135,2135,2135,2717,2717,3733,0,A
3732,B,1077,1077,3212,90,2807,3733,2135,B
3732,C,1102,1102,4314,1430,4237,3733,3212,C
3732,B,726,726,5040,845,5082,3733,4314,B
3732,C,199,199,5239,605,5687,3733,5040,C
3732,D,25758,25758,30997,3780,9467,3733,5239,D
3732,M,60,60,31057,1448,10915,3733,30997,M
3732,N,1539,1539,32596,210,11125,3733,31057,N
3732,O,265,265,32861,400,11525,3733,32596,O
3732,N,2663,2663,35524,2530,14055,3733,32861,N
3732,O,432,432,35956,490,14545,3733,35524,O
3732,P,5334,5334,41290,1260,15805,3733,35956,P
3733,AE,15,15,15,555,555,3734,0,A
3733,BE,817,817,832,300,855,3734,15,B
3733,CE,955,955,1787,930,1785,3734,832,C
3733,DE,1938,151,1938,2716,2716,3734,0,E
3733,DF,807,807,2745,90,2806,3734,1938,F
3733,DG,821,821,3566,1100,3906,3734,2745,G
3733,DH,2460,681,4247,2760,4545,3734,1787,D
3733,H,3515,2834,7081,3780,7686,3734,3566,H
3733,M,243,243,7324,226,7912,3734,7081,M
3733,N,179,179,7503,250,8162,3734,7324,N
3733,O,941,941,8444,1180,9342,3734,7503,O
3733,N,1265,1265,9709,1080,10422,3734,8444,N
3733,O,315,315,10024,530,10952,3734,9709,O
3733,P,7044,7044,17068,1275,12227,3734,10024,P
3734,AE,97,97,97,751,751,3735,0,A
3734,BE,842,842,939,240,991,3735,97,B
3734,CE,1421,482,1421,1192,1192,3735,0,E
3734,CF,32,32,1453,300,1492,3735,1421,F
3734,CG,561,47,1500,895,1886,3735,939,C
3734,DG,817,770,2270,825,2317,3735,1453,G
3734,DH,912,912,3182,4080,6397,3735,2270,H
3734,D,4292,2610,5792,3960,5846,3735,1500,D
3734,M,1856,1856,7648,4033,10430,3735,5792,M
3734,N,2273,2273,9921,180,10610,3735,7648,N
3734,O,551,551,10472,560,11170,3735,9921,O
3734,N,120,120,10592,170,11340,3735,10472,N
3734,O,321,321,10913,306,11646,3735,10592,O
3734,P,1504,1504,12417,734,12380,3735,10913,P
3735,A,1,1,1,13,13,3736,0,A
3735,B,125,125,126,135,148,3736,1,B
3735,C,261,261,387,290,438,3736,126,C
3735,D,165,165,552,5160,5598,3736,387,D
3735,M,8251,8251,8803,9101,14699,3736,552,M
3735,N,981,981,9784,180,14879,3736,8803,N
3735,O,804,804,10588,885,15764,3736,9784,O
3735,N,509,509,11097,405,16169,3736,10588,N
3735,O,436,436,11533,565,16734,3736,11097,O
3735,P,20590,20590,32123,6960,23694,3736,11533,P
3736,AEI,471,471,471,802,802,3737,0,A
3736,BEI,529,529,1000,240,1042,3737,471,B
3736,CEI,1210,210,1210,1580,1580,3737,0,I
3736,CEJ,668,458,1668,810,1852,3737,1000,C
3736,DEJ,654,196,1864,300,1880,3737,1210,J
3736,DEK,954,954,2818,1045,2925,3737,1864,K
3736,DEL,1621,471,3289,3960,5812,3737,1668,D
3736,EL,3307,18,3307,5806,5806,3737,0,E
3736,FL,817,328,3635,1140,4065,3737,2818,L
3736,F,3933,3605,7240,90,5896,3737,3307,F
3736,G,534,534,7774,1015,6911,3737,7240,G
3736,H,1172,1172,8946,3780,10691,3737,7774,H
3736,M,571,571,9517,858,11549,3737,8946,M
3736,N,522,522,10039,300,11849,3737,9517,N
3736,O,625,625,10664,820,12669,3737,10039,O
3736,N,390,390,11054,245,12914,3737,10664,N
3736,O,1310,1310,12364,1320,14234,3737,11054,O
3736,P,4309,4309,16673,6060,20294,3737,12364,P
3737,A,49,49,49,84,84,3738,0,A
3737,B,221,221,270,240,324,3738,49,B
3737,C,213,213,483,285,609,3738,270,C
3737,D,1114,1114,1597,5160,5769,3738,483,D
3737,M,2027,2027,3624,2295,8064,3738,1597,M
3737,N,409,409,4033,180,8244,3738,3624,N
3737,O,797,797,4830,885,9129,3738,4033,O
3737,N,1494,1494,6324,1410,10539,3738,4830,N
3737,O,514,514,6838,635,11174,3738,6324,O
3737,P,1422,1422,8260,6960,18134,3738,6838,P
3738,AE,64,64,64,66,66,3739,0,E
3738,AF,120,56,120,204,204,3739,0,A
3738,BF,77,21,141,135,201,3739,64,F
3738,BG,151,151,292,280,481,3739,141,G
3738,BH,187,15,307,135,339,3739,120,B
3738,CH,172,172,479,290,629,3739,307,C
3738,DH,95,95,574,5160,5789,3739,479,D
3738,H,1626,1344,1918,5160,5641,3739,292,H
3738,M,1047,1047,2965,1515,7304,3739,1918,M
3738,N,604,604,3569,180,7484,3739,2965,N
3738,O,609,609,4178,885,8369,3739,3569,O
3738,P,490,490,4668,6680,15049,3739,4178,P
3739,AEI,2205,2205,2205,2965,2965,3740,0,A
3739,BEI,1000,1000,3205,300,3265,3740,2205,B
3739,CEI,308,308,3513,660,3925,3740,3205,C
3739,BEI,3933,420,3933,4132,4132,3740,0,E
3739,BFI,484,64,3997,105,4030,3740,3513,B
3739,CFI,411,347,4344,240,4372,3740,3933,F
3739,CGI,4430,86,4430,6360,6360,3740,0,I
3739,CGJ,548,115,4545,760,4790,3740,3997,C
3739,DGJ,588,387,4932,740,5112,3740,4344,G
3739,DHJ,7,7,4939,3960,9072,3740,4932,H
3739,DJ,1301,907,5846,3960,8750,3740,4545,D
3739,J,2498,1082,6928,615,6975,3740,4430,J
3739,K,402,402,7330,465,7440,3740,6928,K
3739,J,365,365,7695,290,7730,3740,7330,J
3739,K,570,570,8265,880,8610,3740,7695,K
3739,L,135,135,8400,2640,11250,3740,8265,L
3739,M,121,121,8521,360,11610,3740,8400,M
3739,N,503,503,9024,300,11910,3740,8521,N
3739,O,453,453,9477,695,12605,3740,9024,O
3739,P,2179,2179,11656,3960,16565,3740,9477,P
3740,AEI,9,9,9,1293,1293,3741,0,A
3740,BEI,512,503,512,1078,1078,3741,0,I
3740,BEJ,893,381,893,1558,1558,3741,0,E
3740,BFJ,767,386,1279,240,1318,3741,512,J
3740,BFK,1507,237,1516,240,1533,3741,9,B
3740,CFK,850,227,1743,240,1798,3741,893,F
3740,CGK,741,277,2020,975,2293,3741,1279,K
3740,CGL,713,209,2229,975,2508,3741,1516,C
3740,DGL,804,318,2547,945,2743,3741,1743,G
3740,DHL,1114,587,3134,3960,6253,3741,2020,L
3740,DH,2120,1533,4667,5160,7903,3741,2547,H
3740,D,2498,60,4727,3960,6468,3741,2229,D
3740,M,4572,4572,9299,5089,12992,3741,4727,M
3740,N,600,600,9899,90,13082,3741,9299,N
3740,O,367,367,10266,700,13782,3741,9899,O
3740,N,496,496,10762,200,13982,3741,10266,N
3740,O,541,541,11303,940,14922,3741,10762,O
3740,P,1320,1320,12623,3780,18702,3741,11303,P
3741,AEI,753,753,753,901,901,3742,0,I
3741,AEJ,288,288,1041,180,1081,3742,753,J
3741,AEK,789,789,1830,920,2001,3742,1041,K
3741,AEL,1845,15,1845,3312,3312,3742,0,E
3741,AFL,667,652,2497,6680,8681,3742,1830,L
3741,AF,1642,990,3487,180,3492,3742,1845,F
3741,AG,668,668,4155,855,4347,3742,3487,G
3741,AH,17203,13048,17203,17586,17586,3742,0,A
3741,BH,535,535,17738,180,17766,3742,17203,B
3741,CH,819,819,18557,830,18596,3742,17738,C
3741,DH,22887,8485,27042,6680,11027,3742,4155,H
3741,D,25754,17269,44311,6680,25276,3742,18557,D
3741,M,435,435,44746,2100,27376,3742,44311,M
3741,N,1785,1785,46531,180,27556,3742,44746,N
3741,O,956,956,47487,635,28191,3742,46531,O
3741,P,944,944,48431,6960,35151,3742,47487,P
3742,AE,49,49,49,74,74,3743,0,E
3742,AF,56,7,56,117,117,3743,0,A
3742,BF,119,112,168,135,209,3743,49,F
3742,BG,156,44,212,135,252,3743,56,B
3742,CG,138,94,306,295,504,3743,168,G
3742,CH,170,76,382,290,542,3743,212,C
3742,DH,209,133,515,5160,5664,3743,306,H
3742,D,3036,2903,3418,5160,5702,3743,382,D
3742,M,19356,19356,22774,20249,25951,3743,3418,M
3742,N,923,923,23697,90,26041,3743,22774,N
3742,O,1408,1408,25105,1610,27651,3743,23697,O
3742,N,4225,4225,29330,4015,31666,3743,25105,N
3742,O,1667,1667,30997,1220,32886,3743,29330,O
3742,P,36,36,31033,3780,36666,3743,30997,P
3743,AE,739,739,739,1198,1198,3744,0,E
3743,AF,499,499,1238,90,1288,3744,739,F
3743,AG,410,410,1648,815,2103,3744,1238,G
3743,AH,3003,1355,3003,3357,3357,3744,0,A
3743,BH,389,389,3392,90,3447,3744,3003,B
3743,CH,510,510,3902,805,4252,3744,3392,C
3743,DH,3000,746,4648,3780,5883,3744,1648,H
3743,D,24960,24214,28862,3780,8032,3744,3902,D
3743,M,1222,1222,30084,2135,10167,3744,28862,M
3743,N,971,971,31055,90,10257,3744,30084,N
3743,O,628,628,31683,805,11062,3744,31055,O
3743,N,589,589,32272,420,11482,3744,31683,N
3743,O,685,685,32957,935,12417,3744,32272,O
3743,P,176,176,33133,3780,16197,3744,32957,P
3744,A,101,101,101,834,834,3745,0,A
3744,B,911,911,1012,240,1074,3745,101,B
3744,C,533,533,1545,740,1814,3745,1012,C
3744,D,3666,3666,5211,5100,6914,3745,1545,D
3744,M,1076,1076,6287,2026,8940,3745,5211,M
3744,N,977,977,7264,90,9030,3745,6287,N
3744,O,542,542,7806,805,9835,3745,7264,O
3744,N,685,685,8491,410,10245,3745,7806,N
3744,O,641,641,9132,705,10950,3745,8491,O
3744,P,151,151,9283,3780,14730,3745,9132,P
3745,A,222,222,222,217,217,3746,0,A
3745,B,122,122,344,150,367,3746,222,B
3745,C,268,268,612,125,492,3746,344,C
3745,B,877,877,1489,1045,1537,3746,612,B
3745,C,1227,1227,2716,1295,2832,3746,1489,C
3745,D,7323,7323,10039,3660,6492,3746,2716,D
3745,M,1309,1309,11348,1935,8427,3746,10039,M
3745,N,807,807,12155,240,8667,3746,11348,N
3745,O,905,905,13060,1005,9672,3746,12155,O
3745,N,1484,1484,14544,1360,11032,3746,13060,N
3745,O,537,537,15081,845,11877,3746,14544,O
3745,P,3901,3901,18982,3960,15837,3746,15081,P
3746,AEI,31,31,31,195,195,3747,0,E
3746,AFI,339,339,370,240,435,3747,31,F
3746,AGI,399,29,399,996,996,3747,0,A
3746,BGI,713,314,713,1164,1164,3747,0,I
3746,BGJ,722,379,1092,825,1260,3747,370,G
3746,BHJ,696,3,1095,150,1146,3747,399,B
3746,CHJ,475,93,1188,90,1254,3747,713,J
3746,CHK,138,45,1233,135,1281,3747,1095,C
3746,BHK,219,174,1407,625,1879,3747,1188,K
3746,BHL,398,83,1490,5400,6660,3747,1092,H
3746,BL,714,457,1947,690,1971,3747,1233,B
3746,CL,682,682,2629,655,2626,3747,1947,C
3746,DL,4997,3775,6404,3780,5659,3747,1407,L
3746,D,21488,17713,24117,4230,6856,3747,2629,D
3746,M,3265,3265,27382,4610,11466,3747,24117,M
3746,N,1403,1403,28785,90,11556,3747,27382,N
3746,O,278,278,29063,625,12181,3747,28785,O
3746,N,3477,3477,32540,3140,15321,3747,29063,N
3746,O,717,717,33257,1155,16476,3747,32540,O
3746,P,60,60,33317,3780,20256,3747,33257,P
3747,A,121,121,121,102,102,3748,0,A
3747,B,115,115,236,180,282,3748,121,B
3747,C,215,215,451,275,557,3748,236,C
3747,D,100,100,551,4140,4697,3748,451,D
3747,M,405,405,956,1128,5825,3748,551,M
3747,N,963,963,1919,300,6125,3748,956,N
3747,O,245,245,2164,315,6440,3748,1919,O
3747,N,536,536,2700,475,6915,3748,2164,N
3747,O,916,916,3616,970,7885,3748,2700,O
3747,P,3533,3533,7149,5160,13045,3748,3616,P
3748,AEI,44,44,44,64,64,3749,0,E
3748,AFI,47,3,47,191,191,3749,0,I
3748,AFJ,146,143,190,135,199,3749,44,F
3748,AGJ,216,73,263,135,326,3749,47,J
3748,AGK,148,75,338,285,484,3749,190,G
3748,AHK,356,18,356,558,558,3749,0,A
3748,BHK,203,110,466,290,616,3749,263,K
3748,BHL,212,102,568,120,678,3749,356,B
3748,CHL,285,55,623,5160,5644,3749,338,H
3748,CL,183,26,649,5160,5776,3749,466,L
3748,C,101,20,669,90,768,3749,568,C
3748,B,653,653,1322,590,1358,3749,669,B
3748,C,188,188,1510,295,1653,3749,1322,C
3748,D,162,162,1672,5160,6813,3749,1510,D
3748,M,799,799,2471,1620,8433,3749,1672,M
3748,N,947,947,3418,150,8583,3749,2471,N
3748,O,1385,1385,4803,1610,10193,3749,3418,O
3748,P,329,329,5132,2520,12713,3749,4803,P
3749,AE,34,34,34,1105,1105,3750,0,A
3749,BE,337,303,337,1395,1395,3750,0,E
3749,BF,1261,958,1295,240,1345,3750,34,B
3749,CF,1248,290,1585,240,1635,3750,337,F
3749,CG,702,412,1997,760,2105,3750,1295,C
3749,DG,707,295,2292,760,2395,3750,1585,G
3749,DH,799,799,3091,7740,10135,3750,2292,H
3749,D,1281,187,3278,7680,9785,3750,1997,D
3749,M,1197,1197,4475,1295,11430,3750,3278,M
3749,N,327,327,4802,240,11670,3750,4475,N
3749,O,707,707,5509,765,12435,3750,4802,O
3749,N,3047,3047,8556,3025,15460,3750,5509,N
3749,O,685,685,9241,1045,16505,3750,8556,O
3749,P,585,585,9826,3960,20465,3750,9241,P
3750,A,3939,3939,3939,3966,3966,3751,0,A
3750,B,115,115,4054,150,4116,3751,3939,B
3750,C,230,230,4284,285,4401,3751,4054,C
3750,D,2829,2829,7113,5160,9561,3751,4284,D
3750,M,2491,2491,9604,2613,12174,3751,7113,M
3750,N,273,273,9877,180,12354,3751,9604,N
3750,O,823,823,10700,885,13239,3751,9877,O
3750,N,391,391,11091,345,13584,3751,10700,N
3750,O,455,455,11546,565,14149,3751,11091,O
3750,P,2678,2678,14224,6960,21109,3751,11546,P
3751,AEI,24,24,24,23,23,3752,0,A
3751,BEI,34,10,34,78,78,3752,0,I
3751,BEJ,79,69,103,135,158,3752,24,B
3751,CEJ,132,29,132,160,160,3752,0,E
3751,CFJ,124,26,158,135,213,3752,34,J
3751,CFK,300,245,403,285,443,3752,103,C
3751,DFK,312,67,470,295,508,3752,158,K
3751,DFL,348,10,480,300,460,3752,132,F
3751,DGL,149,139,619,5160,5668,3752,470,L
3751,DG,312,96,715,5160,5603,3752,403,D
3751,G,633,398,1113,780,1240,3752,480,G
3751,H,754,754,1867,1140,2380,3752,1113,H
3751,M,642,642,2509,1740,7408,3752,1867,M
3751,N,4126,4126,6635,180,7588,3752,2509,N
3751,O,898,898,7533,885,8473,3752,6635,O
3751,P,8389,8389,15922,6680,15153,3752,7533,P
3752,A,6732,6732,6732,7165,7165,3753,0,A
3752,B,467,467,7199,90,7255,3753,6732,B
3752,C,468,468,7667,805,8060,3753,7199,C
3752,B,2089,2089,9756,1740,9800,3753,7667,B
3752,C,801,801,10557,1060,10860,3753,9756,C
3752,D,199,199,10756,3780,14640,3753,10557,D
3752,M,6042,6042,16798,6136,20776,3753,10756,M
3752,N,143,143,16941,90,20866,3753,16798,N
3752,O,823,823,17764,1275,22141,3753,16941,O
3752,N,1207,1207,18971,770,22911,3753,17764,N
3752,O,518,518,19489,955,23866,3753,18971,O
3752,P,183,183,19672,3780,27646,3753,19489,P
3753,A,68,68,68,471,471,3754,0,A
3753,B,598,598,666,240,711,3754,68,B
3753,C,683,683,1349,825,1536,3754,666,C
3753,D,57328,57328,58677,3960,5496,3754,1349,D
3753,M,38,38,58715,378,5874,3754,58677,M
3753,N,583,583,59298,300,6174,3754,58715,N
3753,O,839,839,60137,820,6994,3754,59298,O
3753,N,2251,2251,62388,2265,9259,3754,60137,N
3753,O,222,222,62610,440,9699,3754,62388,O
3753,P,493,493,63103,5580,15279,3754,62610,P
3754,A,3321,3321,3321,3414,3414,3755,0,A
3754,B,170,170,3491,90,3504,3755,3321,B
3754,C,548,548,4039,860,4364,3755,3491,C
3754,B,937,937,4976,670,5034,3755,4039,B
3754,C,390,390,5366,735,5769,3755,4976,C
3754,D,2444,2444,7810,3780,9549,3755,5366,D
3754,M,468,468,8278,608,10157,3755,7810,M
3754,N,320,320,8598,240,10397,3755,8278,N
3754,O,653,653,9251,625,11022,3755,8598,O
3754,N,5031,5031,14282,5030,16052,3755,9251,N
3754,O,1205,1205,15487,2305,18357,3755,14282,O
3754,P,1093,1093,16580,4625,22982,3755,15487,P
3755,AEI,24,24,24,32,32,3756,0,I
3755,AEJ,45,21,45,231,231,3756,0,A
3755,BEJ,64,19,64,126,126,3756,0,E
3755,BFJ,83,43,107,135,167,3756,24,J
3755,BFK,136,136,243,280,447,3756,107,K
3755,BFL,262,64,307,135,366,3756,45,B
3755,CFL,293,50,357,240,366,3756,64,F
3755,CGL,220,106,463,5160,5607,3756,243,L
3755,CG,177,21,484,290,656,3756,307,C
3755,DG,234,107,591,285,651,3756,357,G
3755,DH,138,31,622,5160,5816,3756,484,D
3755,H,2648,2617,3239,5160,5811,3756,591,H
3755,M,3571,3571,6810,4393,10209,3756,3239,M
3755,N,855,855,7665,90,10299,3756,6810,N
3755,O,902,902,8567,1240,11539,3756,7665,O
3755,N,405,405,8972,55,11594,3756,8567,N
3755,O,630,630,9602,900,12494,3756,8972,O
3755,P,2685,2685,12287,3780,16274,3756,9602,P
3756,A,4800,4800,4800,5382,5382,3757,0,A
3756,B,137,137,4937,480,5862,3757,4800,B
3756,C,1178,1178,6115,1020,6882,3757,4937,C
3756,B,1765,1765,7880,1045,7927,3757,6115,B
3756,C,820,820,8700,966,8893,3757,7880,C
3756,D,16072,16072,24772,1379,10272,3757,8700,D
3756,M,9757,9757,34529,9969,20241,3757,24772,M
3756,N,555,555,35084,240,20481,3757,34529,N
3756,O,1140,1140,36224,720,21201,3757,35084,O
3756,N,259,259,36483,795,21996,3757,36224,N
3756,O,1226,1226,37709,602,22598,3757,36483,O
3756,P,5902,5902,43611,1258,23856,3757,37709,P
3757,AE,27,27,27,591,591,3758,0,E
3757,AF,185,158,185,1229,1229,3758,0,A
3757,BF,762,604,789,240,831,3758,27,F
3757,BG,1238,634,1423,240,1469,3758,185,B
3757,CG,702,68,1491,810,1641,3758,789,G
3757,CH,743,675,2166,760,2229,3758,1423,C
3757,DH,745,745,2911,7680,9909,3758,2166,D
3757,H,18293,16873,19784,3960,5601,3758,1491,H
3757,M,4572,4572,24356,6124,16033,3758,19784,M
3757,N,2319,2319,26675,90,16123,3758,24356,N
3757,O,1728,1728,28403,2055,18178,3758,26675,O
3757,N,9559,9559,37962,9975,28153,3758,28403,N
3757,O,1172,1172,39134,915,29068,3758,37962,O
3757,P,939,939,40073,3840,32908,3758,39134,P
3758,AE,42,42,42,673,673,3759,0,E
3758,AF,172,130,172,1395,1395,3759,0,A
3758,BF,830,700,872,240,913,3759,42,F
3758,BG,620,620,1492,810,1723,3759,872,G
3758,BH,1446,126,1618,240,1635,3759,172,B
3758,CH,341,215,1833,3960,5683,3759,1492,H
3758,C,674,459,2292,760,2395,3759,1618,C
3758,D,2326,2326,4618,7740,10135,3759,2292,D
3758,M,1254,1254,5872,1443,11578,3759,4618,M
3758,N,288,288,6160,150,11728,3759,5872,N
3758,O,538,538,6698,500,12228,3759,6160,O
3758,N,2178,2178,8876,2210,14438,3759,6698,N
3758,O,692,692,9568,835,15273,3759,8876,O
3758,P,3073,3073,12641,3630,18903,3759,9568,P
3759,AE,148,148,148,147,147,3760,0,A
3759,BE,149,149,297,210,357,3760,148,B
3759,CE,532,235,532,575,575,3760,0,E
3759,CF,329,94,626,450,807,3760,297,C
3759,BF,136,136,762,89,896,3760,626,B
3759,CF,306,76,838,300,875,3760,532,F
3759,CG,691,691,1529,740,1615,3760,838,G
3759,CH,61,61,1590,1560,3175,3760,1529,H
3759,C,924,96,1686,901,1797,3760,762,C
3759,B,523,523,2209,460,2257,3760,1686,B
3759,C,718,718,2927,845,3102,3760,2209,C
3759,D,311,311,3238,5220,8322,3760,2927,D
3759,M,581,581,3819,525,8847,3760,3238,M
3759,N,216,216,4035,300,9147,3760,3819,N
3759,O,746,746,4781,840,9987,3760,4035,O
3759,N,767,767,5548,705,10692,3760,4781,N
3759,O,893,893,6441,990,11682,3760,5548,O
3759,P,6047,6047,12488,4020,15702,3760,6441,P
3760,A,59,59,59,1569,1569,3761,0,A
3760,B,1753,1753,1812,240,1809,3761,59,B
3760,C,894,894,2706,1180,2989,3761,1812,C
3760,B,1262,1262,3968,1085,4074,3761,2706,B
3760,C,298,298,4266,385,4459,3761,3968,C
3760,D,3001,3001,7267,370,4829,3761,4266,D
3760,M,202,202,7469,392,5221,3761,7267,M
3760,N,281,281,7750,240,5461,3761,7469,N
3760,O,580,580,8330,660,6121,3761,7750,O
3760,N,471,471,8801,305,6426,3761,8330,N
3760,O,932,932,9733,1145,7571,3761,8801,O
3760,P,887,887,10620,350,7921,3761,9733,P
3761,AEI,27,27,27,56,56,3762,0,E
3761,AFI,39,12,39,128,128,3762,0,I
3761,AFJ,105,66,105,255,255,3762,0,A
3761,BFJ,110,32,137,135,191,3762,27,F
3761,BGJ,175,77,214,135,263,3762,39,J
3761,BGK,242,133,347,150,405,3762,105,B
3761,CGK,216,6,353,295,486,3762,137,G
3761,CHK,92,92,445,5160,5646,3762,353,H
3761,CK,243,12,457,285,548,3762,214,K
3761,CL,183,73,530,280,685,3762,347,C
3761,DL,873,800,1330,5160,5708,3762,457,L
3761,D,2728,1928,3258,5160,5845,3762,530,D
3761,M,244,244,3502,1326,7171,3762,3258,M
3761,N,1113,1113,4615,90,7261,3762,3502,N
3761,O,1074,1074,5689,1240,8501,3762,4615,O
3761,N,404,404,6093,240,8741,3762,5689,N
3761,O,693,693,6786,790,9531,3762,6093,O
3761,P,38,38,6824,3780,13311,3762,6786,P
3762,AEI,12,12,12,106,106,3763,0,E
3762,AFI,56,44,56,795,795,3763,0,A
3762,BFI,198,154,210,150,256,3763,12,F
3762,BGI,255,45,255,732,732,3763,0,I
3762,BGJ,203,158,413,475,731,3763,210,G
3762,BHJ,42,42,455,3960,4691,3763,413,H
3762,BJ,620,420,875,180,912,3763,255,J
3762,BK,899,80,955,180,975,3763,56,B
3762,CK,187,107,1062,3920,4832,3763,875,K
3762,CL,190,83,1145,455,1430,3763,955,C
3762,DL,1436,1436,2581,3960,5390,3763,1145,D
3762,L,4300,2781,5362,495,5327,3763,1062,L
3762,M,59,59,5421,884,6274,3763,5362,M
3762,N,1065,1065,6486,300,6574,3763,5421,N
3762,O,271,271,6757,345,6919,3763,6486,O
3762,N,1744,1744,8501,1660,8579,3763,6757,N
3762,O,865,865,9366,945,9524,3763,8501,O
3762,P,657,657,10023,5160,14684,3763,9366,P
3763,AE,213,213,213,1180,1180,3764,0,E
3763,AF,891,891,1104,240,1420,3764,213,F
3763,AG,1470,366,1470,1626,1626,3764,0,A
3763,BG,732,366,1836,580,2000,3764,1104,G
3763,BF,418,52,1888,300,1926,3764,1470,B
3763,CF,294,242,2130,190,2190,3764,1836,F
3763,CG,917,917,3047,570,2760,3764,2130,G
3763,CH,1319,160,3207,1115,3041,3764,1888,C
3763,BH,327,327,3534,630,3671,3764,3207,B
3763,CH,524,524,4058,900,4571,3764,3534,C
3763,DH,1483,472,4530,5700,8460,3764,3047,H
3763,D,6289,5817,10347,3960,8531,3764,4058,D
3763,M,1339,1339,11686,1995,10526,3764,10347,M
3763,N,1485,1485,13171,900,11426,3764,11686,N
3763,O,500,500,13671,630,12056,3764,13171,O
3763,N,395,395,14066,255,12311,3764,13671,N
3763,O,1326,1326,15392,1454,13765,3764,14066,O
3763,P,1225,1225,16617,361,14126,3764,15392,P
3764,AEI,125,125,125,363,363,3765,0,E
3764,AFI,478,478,603,300,663,3765,125,F
3764,AGI,813,210,813,1212,1212,3765,0,I
3764,AGJ,513,513,1326,180,1392,3765,813,J
3764,AGK,317,317,1643,685,2077,3765,1326,K
3764,AGJ,1047,7,1650,985,1648,3765,603,G
3764,AFJ,596,596,2246,635,2283,3765,1650,F
3764,AGJ,18,18,2264,415,2698,3765,2246,G
3764,AHJ,656,35,2299,285,2362,3765,1643,J
3764,AHK,139,139,2438,415,2777,3765,2299,K
3764,AHL,4597,2159,4597,5042,5042,3765,0,A
3764,BHL,2400,241,4838,6060,8837,3765,2438,L
3764,BH,565,324,5162,180,5222,3765,4597,B
3764,CH,4686,1788,6950,6060,8758,3765,2264,H
3764,C,1821,33,6983,695,5917,3765,5162,C
3764,B,1461,1461,8444,2555,8472,3765,6983,B
3764,C,355,355,8799,700,9172,3765,8444,C
3764,D,8912,8912,17711,6840,16012,3765,8799,D
3764,M,1474,1474,19185,1906,17918,3765,17711,M
3764,N,569,569,19754,180,18098,3765,19185,N
3764,O,929,929,20683,830,18928,3765,19754,O
3764,N,2448,2448,23131,2550,21478,3765,20683,N
3764,O,260,260,23391,405,21883,3765,23131,O
3764,P,4992,4992,28383,2580,24463,3765,23391,P
3765,AE,608,608,608,888,888,3766,0,E
3765,AF,912,304,912,3179,3179,3766,0,A
3765,BF,405,101,1013,180,1068,3766,608,F
3765,BG,218,218,1231,265,1333,3766,1013,G
3765,BF,618,618,1849,550,1883,3766,1231,F
3765,BG,825,825,2674,200,2083,3766,1849,G
3765,BH,2563,801,3475,240,3419,3766,912,B
3765,CH,607,607,4082,900,4319,3766,3475,C
3765,DH,204,204,4286,3960,8279,3766,4082,D
3765,H,4373,2761,7047,5220,7303,3766,2674,H
3765,M,5664,5664,12711,5820,14099,3766,7047,M
3765,N,161,161,12872,180,14279,3766,12711,N
3765,O,393,393,13265,420,14699,3766,12872,O
3765,N,1318,1318,14583,635,15334,3766,13265,N
3765,O,1128,1128,15711,1431,16765,3766,14583,O
3765,P,1795,1795,17506,604,17369,3766,15711,P
3766,A,145,145,145,906,906,3767,0,A
3766,B,980,980,1125,240,1146,3767,145,B
3766,C,785,785,1910,1015,2161,3767,1125,C
3766,B,864,864,2774,650,2811,3767,1910,B
3766,C,119,119,2893,385,3196,3767,2774,C
3766,D,389,389,3282,3960,7156,3767,2893,D
3766,M,397,397,3679,691,7847,3767,3282,M
3766,N,354,354,4033,90,7937,3767,3679,N
3766,O,824,824,4857,1250,9187,3767,4033,O
3766,N,859,859,5716,455,9642,3767,4857,N
3766,O,573,573,6289,790,10432,3767,5716,O
3766,P,3070,3070,9359,3780,14212,3767,6289,P
3767,AE,121,121,121,238,238,3768,0,E
3767,AF,272,151,272,355,355,3768,0,A
3767,BF,210,59,331,150,388,3768,121,F
3767,BG,201,142,473,180,535,3768,272,B
3767,CG,161,19,492,260,648,3768,331,G
3767,CF,202,183,675,265,800,3768,473,C
3767,BF,994,811,1486,895,1543,3768,492,F
3767,BG,957,146,1632,890,1690,3768,675,B
3767,BG,146,0,1632,225,1768,3768,1486,G
3767,CH,161,161,1793,225,1915,3768,1632,C
3767,DH,1254,1254,3047,4740,6655,3768,1793,D
3767,H,60526,59111,62158,4740,6508,3768,1632,H
3767,M,363,363,62521,469,7124,3768,62158,M
3767,N,282,282,62803,240,7364,3768,62521,N
3767,O,285,285,63088,295,7659,3768,62803,O
3767,N,538,538,63626,515,8174,3768,63088,N
3767,O,210,210,63836,295,8469,3768,63626,O
3767,P,724,724,64560,5160,13629,3768,63836,P
3768,A,473,473,473,1268,1268,3769,0,A
3768,B,976,976,1449,240,1508,3769,473,B
3768,C,915,915,2364,740,2248,3769,1449,C
3768,D,3406,3406,5770,5100,7348,3769,2364,D
3768,M,6017,6017,11787,9311,16659,3769,5770,M
3768,N,3337,3337,15124,180,16839,3769,11787,N
3768,O,666,666,15790,1220,18059,3769,15124,O
3768,N,3747,3747,19537,3105,21164,3769,15790,N
3768,O,375,375,19912,1050,22214,3769,19537,O
3768,P,3284,3284,23196,3510,25724,3769,19912,P
3769,AE,113,113,113,242,242,3770,0,E
3769,AF,137,24,137,299,299,3770,0,A
3769,BF,255,231,368,135,377,3770,113,F
3769,BG,236,5,373,135,434,3770,137,B
3769,CG,146,146,519,290,724,3770,373,C
3769,DG,266,115,634,285,662,3770,368,G
3769,DH,120,5,639,5160,5884,3770,519,D
3769,H,167,162,801,5160,5822,3770,634,H
3769,M,447,447,1248,378,6262,3770,801,M
3769,N,291,291,1539,420,6682,3770,1248,N
3769,O,27,27,1566,100,6782,3770,1539,O
3769,N,461,461,2027,385,7167,3770,1566,N
3769,O,189,189,2216,225,7392,3770,2027,O
3769,P,4402,4402,6618,4740,12132,3770,2216,P
3770,A,12885,12885,12885,12915,12915,3771,0,A
3770,B,288,288,13173,300,13215,3771,12885,B
3770,C,721,721,13894,800,14015,3771,13173,C
3770,D,1569,1569,15463,1140,15155,3771,13894,D
3770,M,624,624,16087,2494,17649,3771,15463,M
3770,N,574,574,16661,180,17829,3771,16087,N
3770,O,694,694,17355,885,18714,3771,16661,O
3770,P,2342,2342,19697,6680,25394,3771,17355,P
3771,A,335,335,335,750,750,3772,0,A
3771,B,547,547,882,180,930,3772,335,B
3771,C,597,597,1479,565,1495,3772,882,C
3771,B,283,283,1762,290,1785,3772,1479,B
3771,C,716,716,2478,825,2610,3772,1762,C
3771,D,12,12,2490,2940,5550,3772,2478,D
3771,M,1510,1510,4000,1510,7060,3772,2490,M
3771,N,269,269,4269,310,7370,3772,4000,N
3771,O,831,831,5100,770,8140,3772,4269,O
3771,N,268,268,5368,340,8480,3772,5100,N
3771,O,205,205,5573,410,8890,3772,5368,O
3771,P,2453,2453,8026,1140,10030,3772,5573,P
3772,AE,132,132,132,2126,2126,3773,0,A
3772,BE,165,33,165,220,220,3773,0,E
3772,BF,298,298,463,240,460,3773,165,F
3772,BG,894,894,1357,1180,1640,3773,463,G
3772,BF,2186,961,2318,240,2366,3773,132,B
3772,CF,1262,301,2619,1085,2725,3773,1357,F
3772,CG,300,300,2919,385,3110,3773,2619,G
3772,CH,946,345,3264,1200,3566,3773,2318,C
3772,BH,878,878,4142,660,4226,3773,3264,B
3772,CH,225,225,4367,385,4611,3773,4142,C
3772,DH,389,389,4756,370,4981,3773,4367,D
3772,H,3437,1600,6356,370,3480,3773,2919,H
3772,M,231,231,6587,717,5698,3773,6356,M
3772,N,579,579,7166,150,5848,3773,6587,N
3772,O,141,141,7307,125,5973,3773,7166,O
3772,N,373,373,7680,380,6353,3773,7307,N
3772,O,625,625,8305,780,7133,3773,7680,O
3772,P,3801,3801,12106,4230,11363,3773,8305,P
3773,AEI,24,24,24,239,239,3774,0,A
3773,BEI,30,6,30,134,134,3774,0,I
3773,BEJ,53,23,53,181,181,3774,0,E
3773,BFJ,180,157,210,135,269,3774,30,J
3773,BFK,199,42,252,135,316,3774,53,F
3773,BGK,320,92,344,135,374,3774,24,B
3773,CGK,178,44,388,295,564,3774,210,K
3773,CGL,190,54,442,285,601,3774,252,G
3773,CHL,113,59,501,5160,5724,3774,388,L
3773,CH,179,22,523,290,664,3774,344,C
3773,DH,125,125,648,5160,5824,3774,523,D
3773,H,590,384,1032,5160,5761,3774,442,H
3773,M,4863,4863,5895,6151,11975,3774,1032,M
3773,N,1408,1408,7303,180,12155,3774,5895,N
3773,O,729,729,8032,885,13040,3774,7303,O
3773,N,864,864,8896,690,13730,3774,8032,N
3773,O,524,524,9420,635,14365,3774,8896,O
3773,P,70,70,9490,6960,21325,3774,9420,P
3774,A,153,153,153,564,564,3775,0,A
3774,B,436,436,589,90,654,3775,153,B
3774,C,873,873,1462,1080,1734,3775,589,C
3774,D,697,697,2159,3780,5514,3775,1462,D
3774,M,49015,49015,51174,49136,54650,3775,2159,M
3774,N,166,166,51340,90,54740,3775,51174,N
3774,O,789,789,52129,1105,55845,3775,51340,O
3774,N,712,712,52841,410,56255,3775,52129,N
3774,O,170,170,53011,605,56860,3775,52841,O
3774,P,8842,8842,61853,3780,60640,3775,53011,P
3775,AE,813,813,813,1106,1106,3776,0,E
3775,AF,440,440,1253,180,1286,3776,813,F
3775,AG,1298,45,1298,1290,1290,3776,0,A
3775,BG,368,368,1666,390,1680,3776,1298,B
3775,CG,954,541,2207,1200,2486,3776,1253,G
3775,CF,944,403,2610,1175,2855,3776,1666,C
3775,BF,1397,994,3604,1160,3646,3776,2207,F
3775,BG,122,122,3726,215,3861,3776,3604,G
3775,BH,1175,59,3785,1070,3925,3776,2610,B
3775,CH,334,334,4119,390,4315,3776,3785,C
3775,DH,3009,3009,7128,485,4800,3776,4119,D
3775,H,4287,885,8013,975,4836,3776,3726,H
3775,M,546,546,8559,1043,5879,3776,8013,M
3775,N,592,592,9151,150,6029,3776,8559,N
3775,O,137,137,9288,125,6154,3776,9151,O
3775,N,418,418,9706,405,6559,3776,9288,N
3775,O,691,691,10397,695,7254,3776,9706,O
3775,P,577,577,10974,4230,11484,3776,10397,P
3776,A,1880,1880,1880,2635,2635,3777,0,A
3776,B,782,782,2662,90,2725,3777,1880,B
3776,C,187,187,2849,585,3310,3777,2662,C
3776,D,2871,2871,5720,3780,7090,3777,2849,D
3776,M,221,221,5941,332,7422,3777,5720,M
3776,N,149,149,6090,90,7512,3777,5941,N
3776,O,232,232,6322,575,8087,3777,6090,O
3776,N,705,705,7027,350,8437,3777,6322,N
3776,O,522,522,7549,905,9342,3777,7027,O
3776,P,2621,2621,10170,3780,13122,3777,7549,P
3777,AEI,37,37,37,157,157,3778,0,I
3777,AEJ,130,93,130,653,653,3778,0,E
3777,AFJ,211,118,248,135,292,3778,37,J
3777,AFK,193,193,441,285,577,3778,248,K
3777,AFL,109,109,550,5160,5737,3778,441,L
3777,AF,624,74,624,1802,1802,3778,0,A
3777,BF,722,228,852,240,893,3778,130,F
3777,BG,224,224,1076,290,1183,3778,852,G
3777,BH,1359,907,1983,240,2042,3778,624,B
3777,CH,181,181,2164,295,2337,3778,1983,C
3777,BH,1663,575,2739,5280,6463,3778,1076,H
3777,B,638,63,2802,515,2852,3778,2164,B
3777,C,173,173,2975,290,3142,3778,2802,C
3777,D,1054,1054,4029,5160,8302,3778,2975,D
3777,M,1632,1632,5661,3057,11359,3778,4029,M
3777,N,1553,1553,7214,180,11539,3778,5661,N
3777,O,1149,1149,8363,885,12424,3778,7214,O
3777,N,1338,1338,9701,1610,14034,3778,8363,N
3777,O,433,433,10134,270,14304,3778,9701,O
3777,P,1267,1267,11401,7020,21324,3778,10134,P
3778,AEI,72,72,72,88,88,3779,0,I
3778,AEJ,91,91,163,135,223,3779,72,J
3778,AEK,217,54,217,215,215,3779,0,E
3778,AFK,242,25,242,254,254,3779,0,A
3778,BFK,93,68,310,135,350,3779,217,F
3778,BGK,174,27,337,295,518,3779,163,K
3778,BGL,101,6,343,150,404,3779,242,B
3778,CGL,151,118,461,280,630,3779,310,G
3778,CHL,167,43,504,5160,5678,3779,337,L
3778,CH,178,17,521,280,684,3779,343,C
3778,DH,339,279,800,5160,5790,3779,461,H
3778,D,1012,733,1533,5160,5844,3779,521,D
3778,M,624,624,2157,673,6517,3779,1533,M
3778,N,367,367,2524,360,6877,3779,2157,N
3778,O,556,556,3080,750,7627,3779,2524,O
3778,N,641,641,3721,465,8092,3779,3080,N
3778,O,638,638,4359,780,8872,3779,3721,O
3778,P,117,117,4476,1470,10342,3779,4359,P
3779,AE,163,163,163,1085,1085,3780,0,A
3779,BE,1025,1025,1188,150,1235,3780,163,B
3779,CE,186,186,1374,385,1620,3780,1188,C
3779,BE,1173,1173,2547,870,2490,3780,1374,B
3779,CE,678,678,3225,815,3305,3780,2547,C
3779,DE,1343,1343,4568,4230,7535,3780,3225,D
3779,E,14546,9978,14546,14854,14854,3780,0,E
3779,F,584,584,15130,300,15154,3780,14546,F
3779,G,688,688,15818,735,15889,3780,15130,G
3779,H,1231,1231,17049,1560,17449,3780,15818,H
3779,M,353,353,17402,340,17789,3780,17049,M
3779,N,249,249,17651,300,18089,3780,17402,N
3779,O,641,641,18292,840,18929,3780,17651,O
3779,N,822,822,19114,645,19574,3780,18292,N
3779,O,714,714,19828,900,20474,3780,19114,O
3779,P,1676,1676,21504,2580,23054,3780,19828,P
3780,A,1375,1375,1375,1413,1413,3781,0,A
3780,B,261,261,1636,240,1653,3781,1375,B
3780,C,641,641,2277,850,2503,3781,1636,C
3780,B,1649,1649,3926,1420,3923,3781,2277,B
3780,C,770,770,4696,930,4853,3781,3926,C
3780,D,1796,1796,6492,3780,8633,3781,4696,D
3780,M,361,361,6853,1109,9742,3781,6492,M
3780,N,868,868,7721,180,9922,3781,6853,N
3780,O,588,588,8309,610,10532,3781,7721,O
3780,P,2903,2903,11212,840,11372,3781,8309,P
3781,AE,38,38,38,62,62,3782,0,E
3781,AF,80,42,80,55,55,3782,0,A
3781,BF,101,59,139,135,197,3782,38,F
3781,BG,164,105,244,240,295,3782,80,B
3781,CG,198,93,337,295,492,3782,139,G
3781,CH,182,89,426,290,585,3782,244,C
3781,DH,157,68,494,5160,5652,3782,337,H
3781,D,4337,4269,4763,5160,5745,3782,426,D
3781,M,6126,6126,10889,7577,13322,3782,4763,M
3781,N,1277,1277,12166,90,13412,3782,10889,N
3781,O,821,821,12987,1250,14662,3782,12166,O
3781,N,1950,1950,14937,1315,15977,3782,12987,N
3781,O,613,613,15550,890,16867,3782,14937,O
3781,P,154,154,15704,3780,20647,3782,15550,P
3782,AE,46,46,46,90,90,3783,0,E
3782,AF,78,32,78,133,133,3783,0,A
3782,BF,139,107,185,135,225,3783,46,F
3782,BG,144,37,222,135,268,3783,78,B
3782,CG,171,134,356,285,510,3783,185,G
3782,CH,235,101,457,290,558,3783,222,C
3782,DH,199,98,555,5160,5670,3783,356,H
3782,D,1046,948,1503,5160,5718,3783,457,D
3782,M,3429,3429,4932,5852,11570,3783,1503,M
3782,N,2445,2445,7377,90,11660,3783,4932,N
3782,O,863,863,8240,1240,12900,3783,7377,O
3782,N,1921,1921,10161,1515,14415,3783,8240,N
3782,O,727,727,10888,970,15385,3783,10161,O
3782,P,1071,1071,11959,3780,19165,3783,10888,P
3783,A,14535,14535,14535,14855,14855,3784,0,A
3783,B,665,665,15200,300,15155,3784,14535,B
3783,C,583,583,15783,735,15890,3784,15200,C
3783,D,97,97,15880,1560,17450,3784,15783,D
3783,M,2330,2330,18210,2837,20287,3784,15880,M
3783,N,1967,1967,20177,1500,21787,3784,18210,N
3783,O,791,791,20968,995,22782,3784,20177,O
3783,N,1254,1254,22222,1055,23837,3784,20968,N
3783,O,217,217,22439,255,24092,3784,22222,O
3783,P,4430,4430,26869,5160,29252,3784,22439,P
3784,AEI,230,230,230,170,170,3785,0,E
3784,AFI,200,200,430,240,410,3785,230,F
3784,AGI,474,474,904,630,1040,3785,430,G
3784,AFI,122,122,1026,45,1085,3785,904,F
3784,AGI,609,609,1635,725,1810,3785,1026,G
3784,AHI,2325,690,2325,2695,2695,3785,0,A
3784,BHI,622,622,2947,300,2995,3785,2325,B
3784,CHI,1325,13,2960,4140,5950,3785,1635,H
3784,CI,998,985,3945,1045,4040,3785,2947,C
3784,DI,120,120,4065,1140,5180,3785,3945,D
3784,I,4105,40,4105,4585,4585,3785,0,I
3784,J,749,749,4854,300,4885,3785,4105,J
3784,K,931,931,5785,1050,5935,3785,4854,K
3784,L,3139,3139,8924,1140,7075,3785,5785,L
3784,M,1936,1936,10860,2119,9194,3785,8924,M
3784,N,303,303,11163,180,9374,3785,10860,N
3784,O,1491,1491,12654,1000,10374,3785,11163,O
3784,P,13591,13591,26245,660,11034,3785,12654,P
3785,AE,336,336,336,1700,1700,3786,0,A
3785,BE,1504,1504,1840,90,1790,3786,336,B
3785,CE,1906,66,1906,6451,6451,3786,0,E
3785,CF,1331,1265,3171,1780,3570,3786,1840,C
3785,BF,695,695,3866,345,3915,3786,3171,B
3785,CF,634,634,4500,965,4880,3786,3866,C
3785,DF,1904,1904,6404,3780,8660,3786,4500,D
3785,F,4572,74,6478,90,6541,3786,1906,F
3785,G,523,523,7001,750,7291,3786,6478,G
3785,F,760,760,7761,530,7821,3786,7001,F
3785,G,645,645,8406,950,8771,3786,7761,G
3785,H,12968,12968,21374,3780,12551,3786,8406,H
3785,M,248,248,21622,1408,13959,3786,21374,M
3785,N,1303,1303,22925,180,14139,3786,21622,N
3785,O,1597,1597,24522,1805,15944,3786,22925,O
3785,P,281,281,24803,720,16664,3786,24522,P
3786,AE,248,248,248,1177,1177,3787,0,A
3786,BE,629,381,629,1244,1244,3787,0,E
3786,BF,1112,731,1360,240,1417,3787,248,B
3786,CF,855,124,1484,300,1544,3787,629,F
3786,CG,627,503,1987,615,2032,3787,1360,C
3786,DG,740,237,2224,660,2204,3787,1484,G
3786,DF,453,453,2677,1950,4154,3787,2224,F
3786,DG,590,590,3267,760,4914,3787,2677,G
3786,DH,1301,1301,4568,3960,8874,3787,3267,H
3786,D,5892,3311,7879,5100,7132,3787,1987,D
3786,M,28,28,7907,1484,10358,3787,7879,M
3786,N,1649,1649,9556,240,10598,3787,7907,N
3786,O,571,571,10127,695,11293,3787,9556,O
3786,N,626,626,10753,475,11768,3787,10127,N
3786,O,688,688,11441,945,12713,3787,10753,O
3786,P,1912,1912,13353,3960,16673,3787,11441,P
3787,AE,544,544,544,741,741,3788,0,A
3787,BE,317,317,861,180,921,3788,544,B
3787,CE,811,811,1672,1035,1956,3788,861,C
3787,BE,1747,75,1747,2105,2105,3788,0,E
3787,BF,727,727,2474,400,2505,3788,1747,F
3787,BG,1210,1210,3684,1210,3715,3788,2474,G
3787,BF,3114,1102,4786,2840,4796,3788,1672,B
3787,CF,793,793,5579,2034,6830,3788,4786,C
3787,DF,2190,295,5874,2195,5910,3788,3684,F
3787,DG,861,861,6735,2342,8252,3788,5874,G
3787,DH,1187,31,6766,846,7676,3788,5579,D
3787,H,377,346,7112,1804,10056,3788,6735,H
3787,M,361,361,7473,1215,11271,3788,7112,M
3787,N,1398,1398,8871,600,11871,3788,7473,N
3787,O,832,832,9703,785,12656,3788,8871,O
3787,N,1026,1026,10729,1095,13751,3788,9703,N
3787,O,203,203,10932,327,14078,3788,10729,O
3787,P,729,729,11661,353,14431,3788,10932,P
3788,AEI,55,55,55,308,308,3789,0,A
3788,BEI,475,475,530,270,578,3789,55,B
3788,CEI,943,413,943,1043,1043,3789,0,I
3788,CEJ,292,292,1235,240,1283,3789,943,J
3788,CEK,1081,376,1611,1100,1678,3789,530,C
3788,DEK,704,328,1939,960,2243,3789,1235,K
3788,DEL,169,169,2108,3960,6203,3789,1939,L
3788,DE,3167,1059,3167,3771,3771,3789,0,E
3788,DF,874,874,4041,330,4101,3789,3167,F
3788,DG,848,848,4889,1000,5101,3789,4041,G
3788,DF,958,958,5847,800,5901,3789,4889,F
3788,DG,800,800,6647,890,6791,3789,5847,G
3788,DH,5267,231,6878,335,2013,3789,1611,D
3788,H,11609,11378,18256,5160,11951,3789,6647,H
3788,M,1544,1544,19800,1747,13698,3789,18256,M
3788,N,240,240,20040,90,13788,3789,19800,N
3788,O,852,852,20892,1055,14843,3789,20040,O
3788,N,1371,1371,22263,1175,16018,3789,20892,N
3788,O,200,200,22463,690,16708,3789,22263,O
3788,P,1342,1342,23805,3780,20488,3789,22463,P
3789,AE,40,40,40,133,133,3790,0,A
3789,BE,106,66,106,846,846,3790,0,E
3789,BF,188,122,228,135,268,3790,40,B
3789,CF,207,207,435,290,558,3790,228,C
3789,DF,304,304,739,5160,5718,3790,435,D
3789,F,923,290,1029,240,1086,3790,106,F
3789,G,778,778,1807,1015,2101,3790,1029,G
3789,F,906,906,2713,650,2751,3790,1807,F
3789,G,118,118,2831,385,3136,3790,2713,G
3789,H,502,502,3333,3960,7096,3790,2831,H
3789,M,750,750,4083,1285,8381,3790,3333,M
3789,N,521,521,4604,300,8681,3790,4083,N
3789,O,628,628,5232,740,9421,3790,4604,O
3789,P,1121,1121,6353,3960,13381,3790,5232,P
3790,AEI,30,30,30,795,795,3791,0,A
3790,BEI,73,43,73,850,850,3791,0,I
3790,BEJ,948,905,978,240,1035,3791,30,B
3790,CEJ,957,52,1030,240,1090,3791,73,J
3790,CEK,547,547,1577,740,1830,3791,1030,K
3790,CEL,1650,73,1650,3153,3153,3791,0,E
3790,CFL,723,51,1701,740,1775,3791,978,C
3790,DFL,1631,1580,3281,90,3243,3791,1650,F
3790,DGL,814,814,4095,1045,4288,3791,3281,G
3790,DFL,1555,1555,5650,1445,5733,3791,4095,F
3790,DGL,588,588,6238,995,6728,3791,5650,G
3790,DHL,12484,7823,14061,5100,6930,3791,1577,L
3790,DH,18840,11017,25078,3780,10508,3791,6238,H
3790,D,23816,439,25517,5100,6875,3791,1701,D
3790,M,5346,5346,30863,6437,16945,3791,25517,M
3790,N,1132,1132,31995,90,17035,3791,30863,N
3790,O,519,519,32514,805,17840,3791,31995,O
3790,N,344,344,32858,60,17900,3791,32514,N
3790,O,285,285,33143,535,18435,3791,32858,O
3790,P,612,612,33755,3780,22215,3791,33143,P
3791,A,396,396,396,2516,2516,3792,0,A
3791,B,961,961,1357,300,2816,3792,396,B
3791,C,700,700,2057,780,3596,3792,1357,C
3791,D,3869,3869,5926,4080,7676,3792,2057,D
3791,M,366,366,6292,1057,8733,3792,5926,M
3791,N,801,801,7093,180,8913,3792,6292,N
3791,O,595,595,7688,550,9463,3792,7093,O
3791,N,1592,1592,9280,1650,11113,3792,7688,N
3791,O,397,397,9677,485,11598,3792,9280,O
3791,P,10232,10232,19909,355,11953,3792,9677,P
3792,AE,18,18,18,46,46,3793,0,A
3792,BE,142,124,142,430,430,3793,0,E
3792,BF,133,9,151,150,196,3793,18,B
3792,CF,131,131,282,400,596,3793,151,C
3792,BF,559,419,701,300,730,3793,142,F
3792,BG,918,499,1200,575,1171,3793,282,B
3792,CG,616,117,1317,3345,4075,3793,701,G
3792,CH,143,143,1460,1440,5515,3793,1317,H
3792,C,671,411,1871,800,1971,3793,1200,C
3792,D,2545,2545,4416,4230,6201,3793,1871,D
3792,M,40,40,4456,220,6421,3793,4416,M
3792,N,469,469,4925,310,6731,3793,4456,N
3792,O,861,861,5786,830,7561,3793,4925,O
3792,N,3230,3230,9016,3480,11041,3793,5786,N
3792,O,1271,1271,10287,2700,13741,3793,9016,O
3792,P,2640,2640,12927,2280,16021,3793,10287,P
3793,AE,7,7,7,2151,2151,3794,0,E
3793,AF,96,89,96,685,685,3794,0,A
3793,BF,851,851,947,300,985,3794,96,B
3793,CF,933,933,1880,925,1910,3794,947,C
3793,DF,2337,464,2344,240,2391,3794,7,F
3793,DG,708,708,3052,960,3351,3794,2344,G
3793,DH,204,204,3256,3960,7311,3794,3052,H
3793,D,4163,2787,6043,2760,4670,3794,1880,D
3793,M,3237,3237,9280,3353,10664,3794,6043,M
3793,N,137,137,9417,90,10754,3794,9280,N
3793,O,1001,1001,10418,1145,11899,3794,9417,O
3793,N,482,482,10900,330,12229,3794,10418,N
3793,O,747,747,11647,965,13194,3794,10900,O
3793,P,1406,1406,13053,3780,16974,3794,11647,P
3794,AEI,75,75,75,1112,1112,3795,0,A
3794,BEI,1160,1085,1160,1530,1530,3795,0,I
3794,BEJ,1219,134,1294,240,1352,3795,75,B
3794,CEJ,611,477,1771,300,1830,3795,1160,J
3794,CEK,732,255,2026,780,2132,3795,1294,C
3794,DEK,835,580,2606,1045,2875,3795,1771,K
3794,DEL,816,236,2842,7680,9812,3795,2026,D
3794,EL,5006,2164,5006,7636,7636,3795,0,E
3794,FL,2979,579,5585,1140,4015,3795,2606,L
3794,F,2655,2076,7661,90,7726,3795,5006,F
3794,G,575,575,8236,1015,8741,3795,7661,G
3794,H,2379,2379,10615,3780,12521,3795,8236,H
3794,M,13,13,10628,335,12856,3795,10615,M
3794,N,554,554,11182,300,13156,3795,10628,N
3794,O,770,770,11952,820,13976,3795,11182,O
3794,N,1279,1279,13231,1245,15221,3795,11952,N
3794,O,289,289,13520,430,15651,3795,13231,O
3794,P,1547,1547,15067,8050,23701,3795,13520,P
3795,A,42205,42205,42205,42990,42990,3796,0,A
3795,B,815,815,43020,90,43080,3796,42205,B
3795,C,852,852,43872,1240,44320,3796,43020,C
3795,B,793,793,44665,380,44700,3796,43872,B
3795,C,524,524,45189,920,45620,3796,44665,C
3795,D,432,432,45621,3780,49400,3796,45189,D
3795,M,1804,1804,47425,2824,52224,3796,45621,M
3795,N,1607,1607,49032,90,52314,3796,47425,N
3795,O,462,462,49494,680,52994,3796,49032,O
3795,P,1352,1352,50846,3780,56774,3796,49494,P
3796,A,123,123,123,315,315,3797,0,A
3796,B,371,371,494,240,555,3797,123,B
3796,C,767,767,1261,830,1385,3797,494,C
3796,D,1301,1301,2562,5460,6845,3797,1261,D
3796,M,1795,1795,4357,2531,9376,3797,2562,M
3796,N,763,763,5120,90,9466,3797,4357,N
3796,O,257,257,5377,630,10096,3797,5120,O
3796,N,587,587,5964,210,10306,3797,5377,N
3796,O,635,635,6599,935,11241,3797,5964,O
3796,P,919,919,7518,3780,15021,3797,6599,P
3797,A,118,118,118,195,195,3798,0,A
3797,B,367,367,485,300,495,3798,118,B
3797,C,596,596,1081,800,1295,3798,485,C
3797,D,151,151,1232,1140,2435,3798,1081,D
3797,M,163,163,1395,199,2634,3798,1232,M
3797,N,155,155,1550,180,2814,3798,1395,N
3797,O,221,221,1771,210,3024,3798,1550,O
3797,P,20,20,1791,2850,5874,3798,1771,P
3798,AE,74,74,74,101,101,3799,0,E
3798,AF,135,61,135,28,28,3799,0,A
3798,BF,136,75,210,150,251,3799,74,F
3798,BG,248,173,383,420,448,3799,135,B
3798,CG,180,7,390,830,1081,3799,210,G
3798,CH,484,484,874,3490,4571,3799,390,H
3798,C,719,228,1102,955,1403,3799,383,C
3798,B,562,562,1664,325,1728,3799,1102,B
3798,C,180,180,1844,265,1993,3799,1664,C
3798,D,12509,12509,14353,5160,7153,3799,1844,D
3798,M,1834,1834,16187,2308,9461,3799,14353,M
3798,N,584,584,16771,150,9611,3799,16187,N
3798,O,240,240,17011,165,9776,3799,16771,O
3798,N,3063,3063,20074,3130,12906,3799,17011,N
3798,O,677,677,20751,625,13531,3799,20074,O
3798,P,1016,1016,21767,4230,17761,3799,20751,P
3799,AE,408,408,408,839,839,3800,0,E
3799,AF,640,232,640,901,901,3800,0,A
3799,BF,291,291,931,90,991,3800,640,B
3799,CF,559,36,967,180,1019,3800,408,F
3799,CG,676,640,1607,805,1796,3800,931,C
3799,BG,959,319,1926,1200,2219,3800,967,G
3799,BF,1269,1269,3195,1030,3249,3800,1926,F
3799,BG,2252,664,3859,2105,3901,3800,1607,B
3799,CG,865,201,4060,2049,5298,3800,3195,G
3799,CH,1012,811,4871,2049,5950,3800,3859,C
3799,DH,322,322,5193,1327,7277,3800,4871,D
3799,H,1239,106,5299,846,6144,3800,4060,H
3799,M,587,587,5886,1146,8423,3800,5299,M
3799,N,1220,1220,7106,780,9203,3800,5886,N
3799,O,202,202,7308,170,9373,3800,7106,O
3799,N,2352,2352,9660,2325,11698,3800,7308,N
3799,O,2666,2666,12326,2568,14266,3800,9660,O
3799,P,2,2,12328,762,15028,3800,12326,P
3800,AE,17207,17207,17207,18469,18469,3801,0,E
3800,AF,1292,1292,18499,90,18559,3801,17207,F
3800,AG,1016,1016,19515,1210,19769,3801,18499,G
3800,AF,298,298,19813,85,19854,3801,19515,F
3800,AG,184,184,19997,585,20439,3801,19813,G
3800,AH,2710,2710,22707,3780,24219,3801,19997,H
3800,A,36955,14248,36955,37994,37994,3801,0,A
3800,B,1069,1069,38024,90,38084,3801,36955,B
3800,C,1021,1021,39045,1210,39294,3801,38024,C
3800,B,408,408,39453,205,39499,3801,39045,B
3800,C,1296,1296,40749,585,40084,3801,39453,C
3800,D,4000,4000,44749,3780,43864,3801,40749,D
3800,M,78,78,44827,297,44161,3801,44749,M
3800,N,415,415,45242,240,44401,3801,44827,N
3800,O,1237,1237,46479,1285,45686,3801,45242,O
3800,N,629,629,47108,640,46326,3801,46479,N
3800,O,776,776,47884,1080,47406,3801,47108,O
3800,P,263,263,48147,3960,51366,3801,47884,P
3801,AEI,904,904,904,1746,1746,3802,0,I
3801,AEJ,959,55,959,1565,1565,3802,0,E
3801,AFJ,1590,631,1590,1952,1952,3802,0,A
3801,BFJ,394,394,1984,90,2042,3802,1590,B
3801,CFJ,1653,628,2612,90,1655,3802,959,F
3801,CGJ,1805,97,2709,90,1836,3802,904,J
3801,CGK,754,29,2738,1060,3102,3802,1984,C
3801,DGK,41,41,2779,3780,6882,3802,2738,D
3801,GK,1318,1151,3930,1430,3085,3802,2612,G
3801,FK,1301,80,4010,1430,3266,3802,2709,K
3801,FJ,408,328,4338,1285,4370,3802,3930,F
3801,GJ,482,154,4492,1285,4551,3802,4010,J
3801,GK,682,528,5020,1070,5440,3802,4338,G
3801,HK,23,23,5043,3780,9220,3802,5020,H
3801,K,694,143,5186,1070,5621,3802,4492,K
3801,L,2632,2632,7818,3780,9401,3802,5186,L
3801,M,2435,2435,10253,2614,12015,3802,7818,M
3801,N,216,216,10469,90,12105,3802,10253,N
3801,O,748,748,11217,1130,13235,3802,10469,O
3801,N,800,800,12017,415,13650,3802,11217,N
3801,O,397,397,12414,765,14415,3802,12017,O
3801,P,4492,4492,16906,3780,18195,3802,12414,P
3802,AEI,118,118,118,903,903,3803,0,I
3802,AEJ,133,15,133,1013,1013,3803,0,E
3802,AFJ,173,40,173,1006,1006,3803,0,A
3802,BFJ,967,912,1085,240,1143,3803,118,J
3802,BFK,1014,102,1187,240,1246,3803,173,B
3802,CFK,1071,17,1204,240,1253,3803,133,F
3802,CGK,204,85,1289,585,1728,3803,1085,K
3802,CGL,194,109,1398,585,1838,3803,1204,G
3802,CHL,217,6,1404,585,1831,3803,1187,C
3802,DHL,2933,2933,4337,5100,6931,3803,1404,D
3802,HL,11317,8269,12606,5100,6828,3803,1289,L
3802,H,18752,7544,20150,5100,6938,3803,1398,H
3802,M,50,50,20200,2923,9861,3803,20150,M
3802,N,2903,2903,23103,90,9951,3803,20200,N
3802,O,685,685,23788,1170,11121,3803,23103,O
3802,N,3756,3756,27544,3245,14366,3803,23788,N
3802,O,351,351,27895,735,15101,3803,27544,O
3802,P,9465,9465,37360,3780,18881,3803,27895,P
3803,AEI,34,34,34,1094,1094,3804,0,I
3803,AEJ,48,14,48,1104,1104,3804,0,A
3803,BEJ,279,231,279,480,480,3804,0,E
3803,BFJ,261,261,540,120,600,3804,279,F
3803,BGJ,150,150,690,390,990,3804,540,G
3803,BFJ,1246,604,1294,240,1344,3804,48,B
3803,CFJ,1262,2,1296,240,1334,3804,34,J
3803,CFK,890,284,1580,645,1635,3804,690,F
3803,CGK,699,415,1995,760,2094,3804,1296,K
3803,CGL,704,3,1998,760,2104,3804,1294,C
3803,DGL,244,244,2242,7680,9784,3804,1998,D
3803,GL,736,74,2316,760,2395,3804,1580,G
3803,HL,785,464,2780,7680,9774,3804,1995,L
3803,H,1446,982,3762,7680,10075,3804,2316,H
3803,M,398,398,4160,1185,11260,3804,3762,M
3803,N,1045,1045,5205,300,11560,3804,4160,N
3803,O,903,903,6108,905,12465,3804,5205,O
3803,P,1472,1472,7580,2760,15225,3804,6108,P
3804,AEI,98,98,98,165,165,3805,0,E
3804,AFI,228,130,228,343,343,3805,0,A
3804,BFI,293,65,293,553,553,3805,0,I
3804,BFJ,167,102,395,90,433,3805,228,B
3804,CFJ,366,69,464,300,465,3805,98,F
3804,CGJ,225,54,518,120,673,3805,293,J
3804,CGK,103,103,621,90,763,3805,518,K
3804,CGJ,685,528,1149,780,1245,3805,464,G
3804,CHJ,900,146,1295,1330,1763,3805,395,C
3804,DHJ,677,3,1298,585,1348,3805,621,J
3804,DHK,201,201,1499,290,1638,3805,1298,K
3804,DHL,223,223,1722,5160,6798,3805,1499,L
3804,DH,1872,1299,3021,1140,2385,3805,1149,H
3804,D,2369,643,3664,3780,5543,3805,1295,D
3804,M,23,23,3687,210,7008,3805,3664,M
3804,N,305,305,3992,180,7188,3805,3687,N
3804,O,295,295,4287,215,7403,3805,3992,O
3804,P,1245,1245,5532,2880,10283,3805,4287,P
3805,AE,6,6,6,183,183,3806,0,E
3805,AF,104,98,104,163,163,3806,0,A
3805,BF,269,171,275,135,318,3806,6,F
3805,BG,240,69,344,240,403,3806,104,B
3805,CG,285,216,560,290,608,3806,275,G
3805,CH,237,21,581,280,683,3806,344,C
3805,DH,63,42,623,5160,5768,3806,560,H
3805,D,1463,1421,2044,5160,5843,3806,581,D
3805,M,818,818,2862,1394,7237,3806,2044,M
3805,N,621,621,3483,90,7327,3806,2862,N
3805,O,982,982,4465,1240,8567,3806,3483,O
3805,N,502,502,4967,240,8807,3806,4465,N
3805,O,405,405,5372,790,9597,3806,4967,O
3805,P,391,391,5763,3780,13377,3806,5372,P
3806,AEI,41,41,41,56,56,3807,0,A
3806,BEI,72,31,72,166,166,3807,0,I
3806,BEJ,111,39,111,545,545,3807,0,E
3806,BFJ,93,23,134,135,191,3807,41,B
3806,CFJ,188,126,260,135,301,3807,72,J
3806,CFK,145,19,279,295,486,3807,134,C
3806,DFK,153,134,413,285,586,3807,260,K
3806,DFL,238,104,517,5160,5646,3807,279,D
3806,FL,193,89,606,5160,5746,3807,413,L
3806,F,693,198,804,300,845,3807,111,F
3806,G,473,473,1277,650,1495,3807,804,G
3806,H,207,207,1484,3960,5455,3807,1277,H
3806,M,575,575,2059,598,6344,3807,1484,M
3806,N,109,109,2168,150,6494,3807,2059,N
3806,O,39,39,2207,95,6589,3807,2168,O
3806,N,451,451,2658,390,6979,3807,2207,N
3806,O,190,190,2848,225,7204,3807,2658,O
3806,P,34884,34884,37732,4740,11944,3807,2848,P
3807,A,46,46,46,70,70,3808,0,A
3807,B,106,106,152,135,205,3808,46,B
3807,C,238,238,390,295,500,3808,152,C
3807,D,220,220,610,5160,5660,3808,390,D
3807,M,696,696,1306,499,6159,3808,610,M
3807,N,165,165,1471,420,6579,3808,1306,N
3807,O,29,29,1500,100,6679,3808,1471,O
3807,N,472,472,1972,385,7064,3808,1500,N
3807,O,146,146,2118,225,7289,3808,1972,O
3807,P,80,80,2198,4740,12029,3808,2118,P
3808,AE,13,13,13,236,236,3809,0,A
3808,BE,218,205,218,190,190,3809,0,E
3808,BF,315,110,328,135,371,3809,13,B
3808,CF,163,53,381,240,430,3809,218,F
3808,CG,286,233,614,290,661,3809,328,C
3808,DG,238,5,619,285,715,3809,381,G
3808,DH,89,84,703,5160,5821,3809,614,D
3808,H,1611,1527,2230,5160,5875,3809,619,H
3808,M,1656,1656,3886,1815,7690,3809,2230,M
3808,N,301,301,4187,180,7870,3809,3886,N
3808,O,772,772,4959,885,8755,3809,4187,O
3808,N,518,518,5477,405,9160,3809,4959,N
3808,O,439,439,5916,565,9725,3809,5477,O
3808,P,302,302,6218,6960,16685,3809,5916,P
3809,AE,16,16,16,652,652,3810,0,E
3809,AF,189,173,189,324,324,3810,0,A
3809,BF,235,235,424,210,534,3810,189,B
3809,CF,57,57,481,480,1014,3810,424,C
3809,BF,839,374,855,240,892,3810,16,F
3809,BG,831,457,1312,350,1364,3810,481,B
3809,CG,830,373,1685,815,1707,3810,855,G
3809,CH,22,22,1707,3960,5667,3810,1685,H
3809,C,649,254,1961,775,2139,3810,1312,C
3809,D,1657,1657,3618,2880,5019,3810,1961,D
3809,M,1308,1308,4926,6228,11895,3810,3618,M
3809,N,4938,4938,9864,90,11985,3810,4926,N
3809,O,1192,1192,11056,1600,13585,3810,9864,O
3809,N,1042,1042,12098,610,14195,3810,11056,N
3809,O,658,658,12756,890,15085,3810,12098,O
3809,P,125,125,12881,3780,18865,3810,12756,P
3810,A,176,176,176,227,227,3811,0,A
3810,B,135,135,311,135,362,3811,176,B
3810,C,167,167,478,285,647,3811,311,C
3810,D,102,102,580,5160,5807,3811,478,D
3810,M,846,846,1426,1396,7203,3811,580,M
3810,N,345,345,1771,180,7383,3811,1426,N
3810,O,938,938,2709,885,8268,3811,1771,O
3810,P,482,482,3191,6680,14948,3811,2709,P
3811,A,343,343,343,759,759,3812,0,A
3811,B,465,465,808,90,849,3812,343,B
3811,C,900,900,1708,1285,2134,3812,808,C
3811,D,2642,2642,4350,3780,5914,3812,1708,D
3811,M,1469,1469,5819,1845,7759,3812,4350,M
3811,N,507,507,6326,180,7939,3812,5819,N
3811,O,952,952,7278,885,8824,3812,6326,O
3811,N,327,327,7605,405,9229,3812,7278,N
3811,O,500,500,8105,565,9794,3812,7605,O
3811,P,24623,24623,32728,6960,16754,3812,8105,P
3812,AEI,36,36,36,205,205,3813,0,A
3812,BEI,107,71,107,199,199,3813,0,E
3812,BFI,133,26,133,317,317,3813,0,I
3812,BFJ,349,252,385,240,445,3813,36,B
3812,CFJ,308,30,415,240,439,3813,107,F
3812,CGJ,310,28,443,150,467,3813,133,J
3812,CGK,161,103,546,207,652,3813,385,C
3812,DGK,74,74,620,393,1045,3813,546,D
3812,GK,603,426,1046,680,1147,3813,443,K
3812,GL,726,95,1141,798,1237,3813,415,G
3812,HL,119,24,1165,3690,4837,3813,1046,L
3812,H,266,242,1407,402,1639,3813,1141,H
3812,M,109,109,1516,345,5182,3813,1407,M
3812,N,336,336,1852,160,5342,3813,1516,N
3812,O,178,178,2030,75,5417,3813,1852,O
3812,N,869,869,2899,945,6362,3813,2030,N
3812,O,617,617,3516,505,6867,3813,2899,O
3812,P,7435,7435,10951,6000,12867,3813,3516,P
3813,A,2032,2032,2032,2257,2257,3814,0,A
3813,B,260,260,2292,90,2347,3814,2032,B
3813,C,415,415,2707,820,3167,3814,2292,C
3813,B,665,665,3372,230,3397,3814,2707,B
3813,C,191,191,3563,605,4002,3814,3372,C
3813,D,10840,10840,14403,3780,7782,3814,3563,D
3813,M,416,416,14819,464,8246,3814,14403,M
3813,N,300,300,15119,300,8546,3814,14819,N
3813,O,971,971,16090,1115,9661,3814,15119,O
3813,N,1656,1656,17746,1525,11186,3814,16090,N
3813,O,1320,1320,19066,1476,12662,3814,17746,O
3813,P,1621,1621,20687,474,13136,3814,19066,P
3814,AE,155,155,155,1162,1162,3815,0,A
3814,BE,1228,1228,1383,240,1402,3815,155,B
3814,CE,1805,422,1805,2333,2333,3815,0,E
3814,CF,662,240,2045,925,2327,3815,1383,C
3814,DF,579,339,2384,90,2423,3815,1805,F
3814,DG,203,203,2587,625,3048,3815,2384,G
3814,DH,214,214,2801,3780,6828,3815,2587,H
3814,D,7323,6567,9368,3960,6287,3815,2045,D
3814,M,2536,2536,11904,3097,9925,3815,9368,M
3814,N,586,586,12490,90,10015,3815,11904,N
3814,O,410,410,12900,625,10640,3815,12490,O
3814,N,1230,1230,14130,1010,11650,3815,12900,N
3814,O,470,470,14600,790,12440,3815,14130,O
3814,P,1810,1810,16410,3780,16220,3815,14600,P
3815,A,838,838,838,1328,1328,3816,0,A
3815,B,530,530,1368,90,1418,3816,838,B
3815,C,184,184,1552,605,2023,3816,1368,C
3815,D,1623,1623,3175,3780,5803,3816,1552,D
3815,M,1369,1369,4544,2747,8550,3816,3175,M
3815,N,1421,1421,5965,90,8640,3816,4544,N
3815,O,345,345,6310,595,9235,3816,5965,O
3815,N,1613,1613,7923,1310,10545,3816,6310,N
3815,O,73,73,7996,585,11130,3816,7923,O
3815,P,2324,2324,10320,3780,14910,3816,7996,P
3816,AEI,969,969,969,1908,1908,3817,0,A
3816,BEI,1559,1559,2528,90,1998,3817,969,B
3816,CEI,1060,1060,3588,1370,3368,3817,2528,C
3816,BEI,4157,569,4157,4876,4876,3817,0,I
3816,BEJ,774,774,4931,90,4966,3817,4157,J
3816,BEK,625,625,5556,920,5886,3817,4931,K
3816,BEL,2327,359,5915,2590,5958,3817,3588,B
3816,CEL,737,378,6293,3780,9666,3817,5556,L
3816,CE,1091,713,7006,925,6883,3817,5915,C
3816,DE,630,630,7636,3780,10663,3817,7006,D
3816,E,35852,28216,35852,36338,36338,3817,0,E
3816,F,1047,1047,36899,90,36428,3817,35852,F
3816,G,1313,1313,38212,1385,37813,3817,36899,G
3816,F,213,213,38425,670,38483,3817,38212,F
3816,G,882,882,39307,920,39403,3817,38425,G
3816,H,717,717,40024,3780,43183,3817,39307,H
3816,M,481,481,40505,1478,44661,3817,40024,M
3816,N,1032,1032,41537,90,44751,3817,40505,N
3816,O,577,577,42114,960,45711,3817,41537,O
3816,N,458,458,42572,80,45791,3817,42114,N
3816,O,819,819,43391,915,46706,3817,42572,O
3816,P,190,190,43581,3780,50486,3817,43391,P
3817,AE,76,76,76,120,120,3818,0,E
3817,AF,148,72,148,317,317,3818,0,A
3817,BF,131,59,207,135,255,3818,76,F
3817,BG,261,261,468,285,540,3818,207,G
3817,BH,362,42,510,240,557,3818,148,B
3817,CH,108,66,576,5160,5700,3818,468,H
3817,C,197,131,707,285,842,3818,510,C
3817,D,5824,5824,6531,5160,6002,3818,707,D
3817,M,845,845,7376,1102,7104,3818,6531,M
3817,N,494,494,7870,300,7404,3818,7376,N
3817,O,170,170,8040,290,7694,3818,7870,O
3817,N,1313,1313,9353,1170,8864,3818,8040,N
3817,O,185,185,9538,225,9089,3818,9353,O
3817,P,3931,3931,13469,4740,13829,3818,9538,P
3818,AE,125,125,125,100,100,3819,0,E
3818,AF,168,43,168,533,533,3819,0,A
3818,BF,101,58,226,180,280,3819,125,F
3818,BG,117,117,343,205,485,3819,226,G
3818,BF,375,200,543,120,653,3819,168,B
3818,CF,98,98,641,90,743,3819,543,C
3818,BF,756,458,1099,660,1145,3819,343,F
3818,BG,640,182,1281,595,1338,3819,641,B
3818,CG,249,67,1348,275,1420,3819,1099,G
3818,CH,118,118,1466,4140,5560,3819,1348,H
3818,C,243,58,1524,380,1718,3819,1281,C
3818,D,143,143,1667,5460,7178,3819,1524,D
3818,M,282,282,1949,579,7757,3819,1667,M
3818,N,400,400,2349,150,7907,3819,1949,N
3818,O,593,593,2942,185,8092,3819,2349,O
3818,N,208,208,3150,605,8697,3819,2942,N
3818,O,114,114,3264,130,8827,3819,3150,O
3818,P,307,307,3571,4230,13057,3819,3264,P
3819,AEI,133,133,133,731,731,3820,0,I
3819,AEJ,223,90,223,328,328,3820,0,A
3819,BEJ,75,75,298,840,1168,3820,223,B
3819,CEJ,374,76,374,950,950,3820,0,E
3819,CFJ,694,453,827,150,881,3820,133,J
3819,CFK,103,103,930,95,976,3820,827,K
3819,CFJ,705,149,1079,180,1130,3820,374,F
3819,CGJ,183,183,1262,400,1530,3820,1079,G
3819,CFJ,432,100,1362,405,1381,3820,930,J
3819,CFK,1149,85,1447,1020,2188,3820,298,C
3819,BFK,332,147,1594,50,1580,3820,1262,F
3819,BGK,299,299,1893,1265,2845,3820,1594,G
3819,BHK,668,137,2030,710,2091,3820,1362,K
3819,BHL,162,162,2192,4230,6321,3820,2030,L
3819,BH,1012,713,2905,3195,6040,3820,1893,H
3819,B,1977,519,3424,755,2943,3820,1447,B
3819,C,1130,1130,4554,1431,4374,3820,3424,C
3819,D,5757,5757,10311,604,4978,3820,4554,D
3819,M,90,90,10401,590,6911,3820,10311,M
3819,N,863,863,11264,420,7331,3820,10401,N
3819,O,869,869,12133,1135,8466,3820,11264,O
3819,N,1111,1111,13244,875,9341,3820,12133,N
3819,O,262,262,13506,520,9861,3820,13244,O
3819,P,8791,8791,22297,555,10416,3820,13506,P
3820,A,986,986,986,1358,1358,3821,0,A
3820,B,751,751,1737,420,1778,3821,986,B
3820,C,1030,1030,2767,1190,2968,3821,1737,C
3820,D,790,790,3557,665,3633,3821,2767,D
3820,M,1325,1325,4882,2610,6243,3821,3557,M
3820,N,1426,1426,6308,180,6423,3821,4882,N
3820,O,882,882,7190,960,7383,3821,6308,O
3820,N,131,131,7321,10,7393,3821,7190,N
3820,O,1143,1143,8464,1220,8613,3821,7321,O
3820,P,613,613,9077,1620,10233,3821,8464,P
3821,A,1063,1063,1063,2367,2367,3822,0,A
3821,B,1424,1424,2487,180,2547,3822,1063,B
3821,C,1016,1016,3503,1055,3602,3822,2487,C
3821,B,805,805,4308,830,4432,3822,3503,B
3821,C,292,292,4600,300,4732,3822,4308,C
3821,D,293,293,4893,5100,9832,3822,4600,D
3821,M,122,122,5015,953,10785,3822,4893,M
3821,N,939,939,5954,150,10935,3822,5015,N
3821,O,232,232,6186,115,11050,3822,5954,O
3821,N,2119,2119,8305,2220,13270,3822,6186,N
3821,O,592,592,8897,585,13855,3822,8305,O
3821,P,19994,19994,28891,4230,18085,3822,8897,P
3822,AE,66,66,66,1390,1390,3823,0,A
3822,BE,770,704,770,1501,1501,3823,0,E
3822,BF,1516,812,1582,240,1630,3823,66,B
3822,CF,1117,305,1887,420,1921,3823,770,F
3822,CG,754,449,2336,780,2410,3823,1582,C
3822,DG,632,183,2519,831,2752,3823,1887,G
3822,DH,1161,978,3497,7680,10090,3823,2336,D
3822,H,2585,1607,5104,629,3381,3823,2519,H
3822,M,279,279,5383,442,10532,3823,5104,M
3822,N,346,346,5729,240,10772,3823,5383,N
3822,O,237,237,5966,530,11302,3823,5729,O
3822,N,424,424,6390,130,11432,3823,5966,N
3822,O,137,137,6527,180,11612,3823,6390,O
3822,P,269,269,6796,5220,16832,3823,6527,P
3823,AEI,40,40,40,49,49,3824,0,A
3823,BEI,85,85,125,135,184,3824,40,B
3823,CEI,139,139,264,280,464,3824,125,C
3823,DEI,363,363,627,5160,5624,3824,264,D
3823,EI,1753,1126,1753,2538,2538,3824,0,I
3823,EJ,968,968,2721,240,2778,3824,1753,J
3823,EK,765,765,3486,1030,3808,3824,2721,K
3823,EJ,932,932,4418,650,4458,3824,3486,J
3823,EK,174,174,4592,385,4843,3824,4418,K
3823,EL,1795,1795,6387,3960,8803,3824,4592,L
3823,E,12564,6177,12564,11304,11304,3824,0,E
3823,F,137,137,12701,1445,12749,3824,12564,F
3823,G,339,339,13040,490,13239,3824,12701,G
3823,F,345,345,13385,175,13414,3824,13040,F
3823,G,748,748,14133,750,14164,3824,13385,G
3823,H,455,455,14588,1140,15304,3824,14133,H
3823,M,10605,10605,25193,11166,26470,3824,14588,M
3823,N,116,116,25309,300,26770,3824,25193,N
3823,O,2558,2558,27867,765,27535,3824,25309,O
3823,P,412,412,28279,4080,31615,3824,27867,P
3824,A,23,23,23,180,180,3825,0,A
3824,B,423,423,446,300,480,3825,23,B
3824,C,590,590,1036,740,1220,3825,446,C
3824,D,89,89,1125,1560,2780,3825,1036,D
3824,M,1455,1455,2580,2960,5740,3825,1125,M
3824,N,1801,1801,4381,300,6040,3825,2580,N
3824,O,897,897,5278,850,6890,3825,4381,O
3824,N,512,512,5790,615,7505,3825,5278,N
3824,O,1191,1191,6981,960,8465,3825,5790,O
3824,P,2534,2534,9515,1740,10205,3825,6981,P
3825,AE,111,111,111,1123,1123,3826,0,A
3825,BE,772,661,772,1107,1107,3826,0,E
3825,BF,483,483,1255,180,1287,3826,772,F
3825,BG,1190,46,1301,240,1363,3826,111,B
3825,CG,735,689,1990,858,2145,3826,1255,G
3825,CH,35,35,2025,4080,6225,3826,1990,H
3825,C,846,122,2147,890,2253,3826,1301,C
3825,D,205,205,2352,5160,7413,3826,2147,D
3825,M,3063,3063,5415,3147,10560,3826,2352,M
3825,N,185,185,5600,150,10710,3826,5415,N
3825,O,915,915,6515,870,11580,3826,5600,O
3825,N,1047,1047,7562,1085,12665,3826,6515,N
3825,O,1341,1341,8903,2205,14870,3826,7562,O
3825,P,400,400,9303,1780,16650,3826,8903,P
3826,A,86,86,86,142,142,3827,0,A
3826,B,139,139,225,135,277,3827,86,B
3826,C,211,211,436,285,562,3827,225,C
3826,D,83,83,519,5160,5722,3827,436,D
3826,M,776,776,1295,1327,7049,3827,519,M
3826,N,702,702,1997,180,7229,3827,1295,N
3826,O,515,515,2512,885,8114,3827,1997,O
3826,P,7554,7554,10066,6680,14794,3827,2512,P
3827,A,78,78,78,385,385,3828,0,A
3827,B,518,518,596,180,565,3828,78,B
3827,C,253,253,849,660,1225,3828,596,C
3827,B,576,576,1425,255,1480,3828,849,B
3827,C,156,156,1581,280,1760,3828,1425,C
3827,D,1164,1164,2745,4050,5810,3828,1581,D
3827,M,293,293,3038,1184,6994,3828,2745,M
3827,N,994,994,4032,155,7149,3828,3038,N
3827,O,580,580,4612,640,7789,3828,4032,O
3827,P,3271,3271,7883,2880,10669,3828,4612,P
3828,A,229,229,229,3105,3105,3829,0,A
3828,B,3059,3059,3288,240,3345,3829,229,B
3828,C,254,254,3542,285,3630,3829,3288,C
3828,D,1483,1483,5025,5160,8790,3829,3542,D
3828,M,1706,1706,6731,2035,10825,3829,5025,M
3828,N,370,370,7101,90,10915,3829,6731,N
3828,O,917,917,8018,1250,12165,3829,7101,O
3828,N,786,786,8804,455,12620,3829,8018,N
3828,O,471,471,9275,790,13410,3829,8804,O
3828,P,891,891,10166,3780,17190,3829,9275,P
3829,AE,3904,3904,3904,4803,4803,3830,0,E
3829,AF,957,957,4861,90,4893,3830,3904,F
3829,AG,827,827,5688,1060,5953,3830,4861,G
3829,AH,75,75,5763,3780,9733,3830,5688,H
3829,A,33139,27376,33139,32519,32519,3830,0,A
3829,B,347,347,33486,90,32609,3830,33139,B
3829,C,1332,1332,34818,1430,34039,3830,33486,C
3829,B,5203,5203,40021,5790,39829,3830,34818,B
3829,C,1069,1069,41090,1280,41109,3830,40021,C
3829,D,159,159,41249,3780,44889,3830,41090,D
3829,M,15667,15667,56916,15903,60792,3830,41249,M
3829,N,261,261,57177,90,60882,3830,56916,N
3829,O,723,723,57900,1105,61987,3830,57177,O
3829,N,982,982,58882,595,62582,3830,57900,N
3829,O,643,643,59525,935,63517,3830,58882,O
3829,P,30248,30248,89773,3780,67297,3830,59525,P
3830,A,22,22,22,289,289,3831,0,A
3830,B,267,267,289,300,589,3831,22,B
3830,C,956,956,1245,720,1309,3831,289,C
3830,B,2456,2456,3701,2385,3694,3831,1245,B
3830,C,637,637,4338,920,4614,3831,3701,C
3830,D,133,133,4471,3960,8574,3831,4338,D
3830,M,2710,2710,7181,2745,11319,3831,4471,M
3830,N,345,345,7526,355,11674,3831,7181,N
3830,O,668,668,8194,1025,12699,3831,7526,O
3830,N,822,822,9016,480,13179,3831,8194,N
3830,O,2044,2044,11060,840,14019,3831,9016,O
3830,P,506,506,11566,1620,15639,3831,11060,P
3831,A,60,60,60,130,130,3832,0,A
3831,B,165,165,225,150,280,3832,60,B
3831,C,76,76,301,80,360,3832,225,C
3831,B,148,148,449,150,510,3832,301,B
3831,C,690,690,1139,130,640,3832,449,C
3831,D,2,2,1141,2850,3490,3832,1139,D
3831,M,300,300,1441,430,3920,3832,1141,M
3831,N,237,237,1678,180,4100,3832,1441,N
3831,O,266,266,1944,145,4245,3832,1678,O
3831,N,650,650,2594,710,4955,3832,1944,N
3831,O,335,335,2929,465,5420,3832,2594,O
3831,P,1107,1107,4036,5760,11180,3832,2929,P
3832,A,559,559,559,1038,1038,3833,0,A
3832,B,571,571,1130,150,1188,3833,559,B
3832,C,147,147,1277,115,1303,3833,1130,C
3832,B,565,565,1842,575,1878,3833,1277,B
3832,C,789,789,2631,590,2468,3833,1842,C
3832,D,379,379,3010,4230,6698,3833,2631,D
3832,M,251,251,3261,980,7678,3833,3010,M
3832,N,1028,1028,4289,300,7978,3833,3261,N
3832,O,652,652,4941,920,8898,3833,4289,O
3832,N,219,219,5160,5,8903,3833,4941,N
3832,O,2331,2331,7491,2660,11563,3833,5160,O
3832,P,4683,4683,12174,3960,15523,3833,7491,P
3833,AE,1370,1370,1370,1470,1470,3834,0,E
3833,AF,220,220,1590,180,1650,3834,1370,F
3833,AG,2022,432,2022,2447,2447,3834,0,A
3833,BG,120,120,2142,210,2657,3834,2022,B
3833,CG,822,270,2412,870,2520,3834,1590,G
3833,CF,308,308,2720,320,2840,3834,2412,F
3833,CG,633,55,2775,300,2957,3834,2142,C
3833,BG,164,109,2884,410,3250,3834,2720,G
3833,BF,811,702,3586,670,3627,3834,2775,B
3833,CF,954,954,4540,2174,5801,3834,3586,C
3833,DF,464,464,5004,846,6647,3834,4540,D
3833,F,3000,880,5884,2695,5945,3834,2884,F
3833,G,829,829,6713,4946,10891,3834,5884,G
3833,H,1194,1194,7907,4650,15541,3834,6713,H
3833,M,356,356,8263,1215,16756,3834,7907,M
3833,N,1403,1403,9666,600,17356,3834,8263,N
3833,O,836,836,10502,785,18141,3834,9666,O
3833,N,1022,1022,11524,1095,19236,3834,10502,N
3833,O,201,201,11725,327,19563,3834,11524,O
3833,P,731,731,12456,353,19916,3834,11725,P
3834,A,66,66,66,27,27,3835,0,A
3834,B,159,159,225,240,267,3835,66,B
3834,C,183,183,408,285,552,3835,225,C
3834,D,2579,2579,2987,5160,5712,3835,408,D
3834,M,2616,2616,5603,3216,8928,3835,2987,M
3834,N,731,731,6334,180,9108,3835,5603,N
3834,O,952,952,7286,885,9993,3835,6334,O
3834,P,11377,11377,18663,6680,16673,3835,7286,P
3835,AE,134,134,134,232,232,3836,0,E
3835,AF,141,7,141,144,144,3836,0,A
3835,BF,75,75,216,135,279,3836,141,B
3835,CF,209,127,343,135,367,3836,134,F
3835,CG,209,82,425,285,564,3836,216,C
3835,DG,255,173,598,285,652,3836,343,G
3835,DH,263,90,688,5160,5724,3836,425,D
3835,H,96,6,694,5160,5812,3836,598,H
3835,M,693,693,1387,992,6804,3836,694,M
3835,N,330,330,1717,90,6894,3836,1387,N
3835,O,934,934,2651,1240,8134,3836,1717,O
3835,N,1422,1422,4073,1095,9229,3836,2651,N
3835,O,198,198,4271,675,9904,3836,4073,O
3835,P,14613,14613,18884,3780,13684,3836,4271,P
3836,AE,41,41,41,233,233,3837,0,A
3836,BE,156,115,156,177,177,3837,0,E
3836,BF,77,77,233,110,287,3837,156,F
3836,BG,268,76,309,135,368,3837,41,B
3836,CG,136,60,369,285,572,3837,233,G
3836,CH,103,103,472,5160,5732,3837,369,H
3836,C,176,13,485,290,658,3837,309,C
3836,D,137,137,622,5160,5818,3837,485,D
3836,M,936,936,1558,2015,7833,3837,622,M
3836,N,1213,1213,2771,150,7983,3837,1558,N
3836,O,1425,1425,4196,1685,9668,3837,2771,O
3836,P,52,52,4248,2520,12188,3837,4196,P
3837,A,9,9,9,44,44,3838,0,A
3837,B,215,215,224,240,284,3838,9,B
3837,C,1075,1075,1299,1365,1649,3838,224,C
3837,B,2414,2414,3713,1725,3374,3838,1299,B
3837,C,1294,1294,5007,1300,4674,3838,3713,C
3837,D,1530,1530,6537,360,5034,3838,5007,D
3837,M,1,1,6538,275,5309,3838,6537,M
3837,N,378,378,6916,150,5459,3838,6538,N
3837,O,645,645,7561,655,6114,3838,6916,O
3837,N,1379,1379,8940,1370,7484,3838,7561,N
3837,O,685,685,9625,775,8259,3838,8940,O
3837,P,30779,30779,40404,4230,12489,3838,9625,P
3838,A,10508,10508,10508,10565,10565,3839,0,A
3838,B,345,345,10853,300,10865,3839,10508,B
3838,C,551,551,11404,750,11615,3839,10853,C
3838,D,116,116,11520,1560,13175,3839,11404,D
3838,M,1485,1485,13005,1440,14615,3839,11520,M
3838,N,259,259,13264,300,14915,3839,13005,N
3838,O,681,681,13945,840,15755,3839,13264,O
3838,N,800,800,14745,705,16460,3839,13945,N
3838,O,990,990,15735,990,17450,3839,14745,O
3838,P,5190,5190,20925,4020,21470,3839,15735,P
3839,AEI,257,257,257,749,749,3840,0,I
3839,AEJ,289,32,289,817,817,3840,0,E
3839,AFJ,608,576,865,150,899,3840,257,J
3839,AFK,625,49,914,150,967,3840,289,F
3839,AGK,157,108,1022,125,1024,3840,865,K
3839,AGJ,150,42,1064,125,1092,3840,914,G
3839,AFJ,322,322,1386,345,1437,3840,1064,F
3839,AGJ,376,12,1398,345,1369,3840,1022,J
3839,AGK,1430,32,1430,1700,1700,3840,0,A
3839,BGK,110,66,1496,120,1557,3840,1386,G
3839,BHK,130,32,1528,120,1489,3840,1398,K
3839,BHL,370,272,1800,150,1850,3840,1430,B
3839,CHL,166,166,1966,165,2015,3840,1800,C
3839,BHL,981,543,2509,4230,5719,3840,1528,L
3839,BH,1076,63,2572,4230,5787,3840,1496,H
3839,B,826,220,2792,830,2845,3840,1966,B
3839,C,118,118,2910,130,2975,3840,2792,C
3839,D,1365,1365,4275,4230,7205,3840,2910,D
3839,M,543,543,4818,974,8179,3840,4275,M
3839,N,619,619,5437,240,8419,3840,4818,N
3839,O,275,275,5712,400,8819,3840,5437,O
3839,N,1662,1662,7374,1515,10334,3840,5712,N
3839,O,675,675,8049,960,11294,3840,7374,O
3839,P,1645,1645,9694,3960,15254,3840,8049,P
3840,AEI,21,21,21,73,73,3841,0,A
3840,BEI,28,7,28,134,134,3841,0,I
3840,BEJ,71,43,71,370,370,3841,0,E
3840,BFJ,168,118,189,150,223,3841,21,B
3840,CFJ,189,28,217,135,269,3841,28,J
3840,CFK,140,112,329,110,333,3841,189,C
3840,DFK,72,72,401,4230,4563,3841,329,D
3840,FK,282,98,499,285,554,3841,217,K
3840,FL,82,82,581,5160,5714,3841,499,L
3840,F,663,153,734,300,670,3841,71,F
3840,G,722,722,1456,790,1460,3841,734,G
3840,H,149,149,1605,1140,2600,3841,1456,H
3840,M,1879,1879,3484,2501,8215,3841,1605,M
3840,N,686,686,4170,90,8305,3841,3484,N
3840,O,993,993,5163,1250,9555,3841,4170,O
3840,N,458,458,5621,205,9760,3841,5163,N
3840,O,374,374,5995,790,10550,3841,5621,O
3840,P,1070,1070,7065,3780,14330,3841,5995,P
3841,A,5380,5380,5380,5537,5537,3842,0,A
3841,B,205,205,5585,90,5627,3842,5380,B
3841,C,362,362,5947,800,6427,3842,5585,C
3841,B,1103,1103,7050,670,7097,3842,5947,B
3841,C,187,187,7237,535,7632,3842,7050,C
3841,D,14,14,7251,3780,11412,3842,7237,D
3841,M,507,507,7758,550,11962,3842,7251,M
3841,N,176,176,7934,180,12142,3842,7758,N
3841,O,976,976,8910,935,13077,3842,7934,O
3841,N,252,252,9162,275,13352,3842,8910,N
3841,O,1318,1318,10480,602,13954,3842,9162,O
3841,P,8803,8803,19283,1263,15217,3842,10480,P
3842,AE,141,141,141,366,366,3843,0,A
3842,BE,345,345,486,180,546,3843,141,B
3842,CE,699,213,699,1307,1307,3843,0,E
3842,CF,621,408,1107,840,1386,3843,486,C
3842,DF,169,169,1276,6680,8066,3843,1107,D
3842,F,768,191,1467,180,1487,3843,699,F
3842,G,572,572,2039,855,2342,3843,1467,G
3842,H,16404,16404,18443,6680,9022,3843,2039,H
3842,M,268,268,18711,885,9907,3843,18443,M
3842,N,749,749,19460,180,10087,3843,18711,N
3842,O,273,273,19733,370,10457,3843,19460,O
3842,P,1233,1233,20966,6960,17417,3843,19733,P
3843,AEI,60,60,60,1630,1630,3844,0,A
3843,BEI,1753,1753,1813,240,1870,3844,60,B
3843,CEI,717,717,2530,845,2715,3844,1813,C
3843,DEI,4837,4837,7367,5220,7935,3844,2530,D
3843,EI,13123,5756,13123,13479,13479,3844,0,I
3843,EJ,654,654,13777,300,13779,3844,13123,J
3843,EK,574,574,14351,740,14519,3844,13777,K
3843,EL,113,113,14464,1560,16079,3844,14351,L
3843,E,14838,374,14838,14920,14920,3844,0,E
3843,F,331,331,15169,300,15220,3844,14838,F
3843,G,662,662,15831,740,15960,3844,15169,G
3843,H,184,184,16015,1560,17520,3844,15831,H
3843,M,1462,1462,17477,2421,19941,3844,16015,M
3843,N,1708,1708,19185,780,20721,3844,17477,N
3843,O,719,719,19904,930,21651,3844,19185,O
3843,N,1628,1628,21532,1470,23121,3844,19904,N
3843,O,1065,1065,22597,1103,24224,3844,21532,O
3843,P,97,97,22694,402,24626,3844,22597,P
3844,AE,156,156,156,832,832,3845,0,E
3844,AF,402,246,402,609,609,3845,0,A
3844,BF,387,387,789,240,849,3845,402,B
3844,CF,825,192,981,150,982,3845,156,F
3844,CG,226,34,1015,539,1388,3845,789,C
3844,BG,197,163,1178,120,1102,3845,981,G
3844,BF,243,243,1421,355,1457,3845,1178,F
3844,BG,699,293,1714,335,1723,3845,1015,B
3844,CG,670,377,2091,710,2167,3845,1421,G
3844,CH,1159,782,2873,1339,3062,3845,1714,C
3844,DH,798,798,3671,526,3588,3845,2873,D
3844,H,1617,37,3708,4230,6397,3845,2091,H
3844,M,6930,6930,10638,6890,13287,3845,3708,M
3844,N,220,220,10858,300,13587,3845,10638,N
3844,O,293,293,11151,495,14082,3845,10858,O
3844,P,14297,14297,25448,1140,15222,3845,11151,P
3845,AEI,1856,1856,1856,3240,3240,3846,0,A
3845,BEI,1543,1543,3399,180,3420,3846,1856,B
3845,CEI,345,345,3744,560,3980,3846,3399,C
3845,BEI,890,890,4634,685,4665,3846,3744,B
3845,CEI,736,736,5370,805,5470,3846,4634,C
3845,DEI,30,30,5400,1560,7030,3846,5370,D
3845,EI,13348,7948,13348,13389,13389,3846,0,I
3845,EJ,13564,216,13564,13469,13469,3846,0,E
3845,FJ,312,96,13660,300,13689,3846,13348,J
3845,FK,180,84,13744,300,13769,3846,13564,F
3845,GK,575,491,14235,740,14429,3846,13660,K
3845,GL,565,74,14309,750,14519,3846,13744,G
3845,HL,119,45,14354,1560,15989,3846,14235,L
3845,H,70,25,14379,1560,16079,3846,14309,H
3845,M,1425,1425,15804,1560,17639,3846,14379,M
3845,N,393,393,16197,300,17939,3846,15804,N
3845,O,685,685,16882,835,18774,3846,16197,O
3845,N,1544,1544,18426,1385,20159,3846,16882,N
3845,O,945,945,19371,960,21119,3846,18426,O
3845,P,2828,2828,22199,2760,23879,3846,19371,P
3846,AE,3190,3190,3190,3979,3979,3847,0,E
3846,AF,885,885,4075,90,4069,3847,3190,F
3846,AG,4246,171,4246,4649,4649,3847,0,A
3846,BG,437,437,4683,90,4739,3847,4246,B
3846,CG,955,347,5030,815,4884,3847,4075,G
3846,CF,433,86,5116,735,5474,3847,4683,C
3846,DF,2155,2069,7185,2370,7254,3847,5030,F
3846,DG,597,597,7782,745,7999,3847,7185,G
3846,DH,1091,1091,8873,3780,11779,3847,7782,H
3846,D,17627,13870,22743,3780,9254,3847,5116,D
3846,M,1696,1696,24439,1976,13755,3847,22743,M
3846,N,580,580,25019,360,14115,3847,24439,N
3846,O,1093,1093,26112,1485,15600,3847,25019,O
3846,N,1900,1900,28012,1510,17110,3847,26112,N
3846,O,660,660,28672,831,17941,3847,28012,O
3846,P,3523,3523,32195,414,18355,3847,28672,P
3847,AE,203,203,203,765,765,3848,0,A
3847,BE,381,178,381,1422,1422,3848,0,E
3847,BF,848,670,1051,300,1065,3848,203,B
3847,CF,1503,833,1884,420,1842,3848,381,F
3847,CG,958,125,2009,930,1995,3848,1051,C
3847,DG,972,847,2856,1190,3032,3848,1884,G
3847,DH,1425,578,3434,2760,4755,3848,2009,D
3847,H,8409,7831,11265,665,3697,3848,2856,H
3847,M,196,196,11461,1187,5942,3848,11265,M
3847,N,1087,1087,12548,150,6092,3848,11461,N
3847,O,726,726,13274,995,7087,3848,12548,O
3847,N,1378,1378,14652,1090,8177,3848,13274,N
3847,O,707,707,15359,735,8912,3848,14652,O
3847,P,1569,1569,16928,4230,13142,3848,15359,P
3848,AEI,430,430,430,1042,1042,3849,0,A
3848,BEI,710,280,710,375,375,3849,0,E
3848,BFI,1120,410,1120,871,871,3849,0,I
3848,BFJ,4,4,1124,300,1171,3849,1120,J
3848,BFK,578,164,1288,960,1335,3849,710,F
3848,BGK,1100,242,1530,660,1702,3849,430,B
3848,CGK,758,352,1882,825,1996,3849,1124,K
3848,CGL,674,80,1962,595,1930,3849,1288,G
3848,CFL,1174,1094,3056,4080,6076,3849,1882,L
3848,CF,1203,109,3165,1295,3225,3849,1962,F
3848,CG,2811,1176,4341,1920,3622,3849,1530,C
3848,BG,1199,23,4364,1440,4665,3849,3165,G
3848,BH,1128,1105,5469,1860,5482,3849,4341,B
3848,CH,1560,455,5924,2280,6945,3849,4364,H
3848,C,631,176,6100,895,6377,3849,5469,C
3848,D,432,432,6532,3960,10337,3849,6100,D
3848,M,1480,1480,8012,3895,14232,3849,6532,M
3848,N,2513,2513,10525,180,14412,3849,8012,N
3848,O,590,590,11115,560,14972,3849,10525,O
3848,N,113,113,11228,135,15107,3849,11115,N
3848,O,293,293,11521,268,15375,3849,11228,O
3848,P,2910,2910,14431,807,16182,3849,11521,P
3849,AEI,73,73,73,124,124,3850,0,E
3849,AFI,82,9,82,93,93,3850,0,I
3849,AFJ,146,64,146,164,164,3850,0,A
3849,BFJ,85,21,167,135,228,3850,82,J
3849,BFK,94,73,240,135,299,3850,146,B
3849,CFK,244,77,317,240,364,3850,73,F
3849,CGK,189,39,356,295,523,3850,167,K
3849,CGL,147,31,387,280,579,3850,240,C
3849,DGL,143,112,499,5160,5683,3850,356,L
3849,DG,191,9,508,285,649,3850,317,G
3849,DH,308,187,695,5160,5739,3850,387,D
3849,H,5831,5644,6339,5160,5809,3850,508,H
3849,M,2607,2607,8946,2696,8505,3850,6339,M
3849,N,356,356,9302,300,8805,3850,8946,N
3849,O,384,384,9686,470,9275,3850,9302,O
3849,P,6948,6948,16634,4020,13295,3850,9686,P
3850,AE,656,656,656,1320,1320,3851,0,E
3850,AF,784,784,1440,180,1500,3851,656,F
3850,AG,1525,85,1525,3212,3212,3851,0,A
3850,BG,936,851,2376,860,2360,3851,1440,G
3850,BH,1820,969,3345,180,3392,3851,1525,B
3850,CH,690,690,4035,875,4267,3851,3345,C
3850,DH,10529,8870,12905,6680,9040,3851,2376,H
3850,D,24618,15748,28653,6680,10947,3851,4035,D
3850,M,1408,1408,30061,1720,12667,3851,28653,M
3850,N,432,432,30493,180,12847,3851,30061,N
3850,O,189,189,30682,310,13157,3851,30493,O
3850,P,342,342,31024,6900,20057,3851,30682,P
3851,A,1137,1137,1137,2144,2144,3852,0,A
3851,B,1367,1367,2504,420,2564,3852,1137,B
3851,C,687,687,3191,848,3412,3852,2504,C
3851,D,2645,2645,5836,847,4259,3852,3191,D
3851,M,393,393,6229,640,4899,3852,5836,M
3851,N,277,277,6506,90,4989,3852,6229,N
3851,O,892,892,7398,595,5584,3852,6506,O
3851,N,2031,2031,9429,2315,7899,3852,7398,N
3851,O,1124,1124,10553,2289,10188,3852,9429,O
3851,P,522,522,11075,1696,11884,3852,10553,P
3852,A,157,157,157,690,690,3853,0,A
3852,B,936,936,1093,440,1130,3853,157,B
3852,C,652,652,1745,706,1836,3853,1093,C
3852,D,3897,3897,5642,414,2250,3853,1745,D
3852,M,176,176,5818,670,2920,3853,5642,M
3852,N,1030,1030,6848,540,3460,3853,5818,N
3852,O,533,533,7381,840,4300,3853,6848,O
3852,N,2013,2013,9394,1785,6085,3853,7381,N
3852,O,1696,1696,11090,1940,8025,3853,9394,O
3852,P,1707,1707,12797,340,8365,3853,11090,P
3853,AEI,106,106,106,631,631,3854,0,E
3853,AFI,159,53,159,224,224,3854,0,I
3853,AFJ,162,3,162,203,203,3854,0,A
3853,BFJ,232,232,394,240,443,3854,162,B
3853,CFJ,261,26,420,240,464,3854,159,J
3853,CFK,157,131,551,420,863,3854,394,C
3853,BFK,714,269,820,240,871,3854,106,F
3853,BGK,193,193,1013,435,1306,3854,820,G
3853,BFK,781,188,1201,425,889,3854,420,K
3853,BFJ,830,180,1381,555,1418,3854,551,B
3853,CFJ,376,8,1389,75,1381,3854,1013,F
3853,CGJ,207,19,1408,555,1444,3854,1201,J
3853,CGK,133,106,1514,395,1813,3854,1381,C
3853,DGK,129,4,1518,395,1776,3854,1389,G
3853,DHK,114,4,1522,400,1844,3854,1408,K
3853,DHL,307,307,1829,3960,5804,3854,1522,L
3853,DH,1011,700,2529,3960,5736,3854,1518,H
3853,D,1330,315,2844,3960,5773,3854,1514,D
3853,M,480,480,3324,1018,6822,3854,2844,M
3853,N,634,634,3958,150,6972,3854,3324,N
3853,O,215,215,4173,135,7107,3854,3958,O
3853,N,268,268,4441,325,7432,3854,4173,N
3853,O,663,663,5104,735,8167,3854,4441,O
3853,P,169,169,5273,4230,12397,3854,5104,P
3854,AEI,44,44,44,820,820,3855,0,I
3854,AEJ,63,19,63,822,822,3855,0,E
3854,AFJ,957,938,1001,240,1060,3855,44,J
3854,AFK,948,10,1011,240,1062,3855,63,F
3854,AGK,577,577,1588,740,1802,3855,1011,G
3854,AHK,1653,65,1653,2411,2411,3855,0,A
3854,BHK,915,263,1916,740,1800,3855,1001,K
3854,BHL,803,540,2456,90,2501,3855,1653,B
3854,CHL,501,501,2957,855,3356,3855,2456,C
3854,BHL,915,915,3872,555,3911,3855,2957,B
3854,CHL,399,399,4271,815,4726,3855,3872,C
3854,DHL,6172,3817,8088,5100,6900,3855,1916,L
3854,DH,15960,12143,20231,3780,8506,3855,4271,D
3854,H,19734,1091,21322,5100,6902,3855,1588,H
3854,M,1793,1793,23115,2218,10724,3855,21322,M
3854,N,634,634,23749,300,11024,3855,23115,N
3854,O,454,454,24203,740,11764,3855,23749,O
3854,P,983,983,25186,1320,13084,3855,24203,P
3855,A,220,220,220,164,164,3856,0,A
3855,B,4,4,224,120,284,3856,220,B
3855,C,412,412,636,225,509,3856,224,C
3855,B,638,638,1274,825,1334,3856,636,B
3855,C,606,606,1880,635,1969,3856,1274,C
3855,D,4719,4719,6599,2880,4849,3856,1880,D
3855,M,3,3,6602,329,5178,3856,6599,M
3855,N,562,562,7164,300,5478,3856,6602,N
3855,O,629,629,7793,820,6298,3856,7164,O
3855,N,1271,1271,9064,1115,7413,3856,7793,N
3855,O,443,443,9507,630,8043,3856,9064,O
3855,P,4236,4236,13743,6060,14103,3856,9507,P
3856,A,5415,5415,5415,6847,6847,3857,0,A
3856,B,1462,1462,6877,90,6937,3857,5415,B
3856,C,982,982,7859,1220,8157,3857,6877,C
3856,B,450,450,8309,215,8372,3857,7859,B
3856,C,179,179,8488,605,8977,3857,8309,C
3856,D,9878,9878,18366,3780,12757,3857,8488,D
3856,M,1091,1091,19457,1715,14472,3857,18366,M
3856,N,696,696,20153,90,14562,3857,19457,N
3856,O,244,244,20397,600,15162,3857,20153,O
3856,N,1322,1322,21719,1000,16162,3857,20397,N
3856,O,1111,1111,22830,1275,17437,3857,21719,O
3856,P,5732,5732,28562,3780,21217,3857,22830,P
3857,AEI,232,232,232,958,958,3858,0,I
3857,AEJ,757,757,989,90,1048,3858,232,J
3857,AEK,183,183,1172,585,1633,3858,989,K
3857,AEL,2026,854,2026,5334,5334,3858,0,A
3857,BEL,4139,2113,4139,4744,4744,3858,0,E
3857,BFL,650,650,4789,90,4834,3858,4139,F
3857,BGL,208,208,4997,585,5419,3858,4789,G
3857,BHL,3347,376,5373,90,5424,3858,2026,B
3857,CHL,957,957,6330,1225,6649,3858,5373,C
3857,BHL,1215,1215,7545,465,7114,3858,6330,B
3857,CHL,232,232,7777,580,7694,3858,7545,C
3857,DHL,1837,1837,9614,3780,11474,3858,7777,D
3857,HL,5675,1058,10672,3780,9199,3858,4997,H
3857,L,11603,2103,12775,3780,5413,3858,1172,L
3857,M,10,10,12785,91,11565,3858,12775,M
3857,N,510,510,13295,390,11955,3858,12785,N
3857,O,988,988,14283,1175,13130,3858,13295,O
3857,N,578,578,14861,490,13620,3858,14283,N
3857,O,83,83,14944,180,13800,3858,14861,O
3857,P,6670,6670,21614,825,14625,3858,14944,P
3858,AE,74,74,74,1087,1087,3859,0,E
3858,AF,360,286,360,1401,1401,3859,0,A
3858,BF,1193,907,1267,240,1327,3859,74,F
3858,BG,1226,319,1586,240,1641,3859,360,B
3858,CG,732,413,1999,780,2107,3859,1267,G
3858,CH,757,344,2343,780,2421,3859,1586,C
3858,DH,789,445,2788,7680,9787,3859,1999,H
3858,D,2782,2337,5125,7680,10101,3859,2343,D
3858,M,1456,1456,6581,6103,16204,3859,5125,M
3858,N,3830,3830,10411,540,16744,3859,6581,N
3858,O,2043,2043,12454,830,17574,3859,10411,O
3858,N,719,719,13173,670,18244,3859,12454,N
3858,O,2615,2615,15788,2988,21232,3859,13173,O
3858,P,412,412,16200,417,21649,3859,15788,P
3859,AEI,720,720,720,1935,1935,3860,0,I
3859,AEJ,1078,358,1078,2945,2945,3860,0,A
3859,BEJ,1080,2,1080,1712,1712,3860,0,E
3859,BFJ,732,732,1812,120,1832,3860,1080,F
3859,BGJ,1335,243,2055,180,2115,3860,720,J
3859,BGK,919,676,2731,900,2732,3860,1812,G
3859,BFK,874,198,2929,930,3045,3860,2055,K
3859,BFJ,2061,210,3139,250,3195,3860,1078,B
3859,CFJ,566,356,3495,510,3555,3860,2929,J
3859,CFK,225,225,3720,385,3940,3860,3495,K
3859,CFL,1242,253,3973,1305,4037,3860,2731,F
3859,CGL,945,111,4084,1195,4390,3860,3139,C
3859,BGL,234,123,4207,377,4414,3860,3973,G
3859,BHL,1367,880,5087,950,4890,3860,3720,L
3859,BH,1209,206,5293,1010,5400,3860,4084,B
3859,CH,232,232,5525,390,5790,3860,5293,C
3859,DH,1530,212,5737,863,5277,3860,4207,H
3859,D,346,134,5871,485,6275,3860,5525,D
3859,M,551,551,6422,709,6984,3860,5871,M
3859,N,293,293,6715,240,7224,3860,6422,N
3859,O,761,761,7476,660,7884,3860,6715,O
3859,N,207,207,7683,265,8149,3860,7476,N
3859,O,1009,1009,8692,1094,9243,3860,7683,O
3859,P,786,786,9478,351,9594,3860,8692,P
3860,AEI,116,116,116,534,534,3861,0,I
3860,AEJ,210,94,210,586,586,3861,0,E
3860,AFJ,243,33,243,886,886,3861,0,A
3860,BFJ,538,411,654,180,714,3861,116,J
3860,BFK,497,53,707,240,826,3861,210,F
3860,BGK,804,340,1047,180,1066,3861,243,B
3860,CGK,576,183,1230,700,1414,3861,654,K
3860,CGJ,607,84,1314,685,1511,3861,707,G
3860,CFJ,305,221,1535,260,1674,3861,1230,J
3860,CFK,262,41,1576,120,1631,3861,1314,F
3860,CGK,37,37,1613,415,2046,3861,1576,G
3860,CHK,1366,800,2413,710,1776,3861,1047,C
3860,BHK,880,2,2415,1320,2994,3861,1535,K
3860,BHL,420,418,2833,1105,2881,3861,2413,B
3860,CHL,381,381,3214,715,3596,3861,2833,C
3860,DHL,5463,3862,7076,6060,8106,3861,1613,H
3860,DL,8758,4097,11173,6060,9054,3861,2415,L
3860,D,30149,22190,33363,6840,10436,3861,3214,D
3860,M,360,360,33723,543,10979,3861,33363,M
3860,N,417,417,34140,300,11279,3861,33723,N
3860,O,856,856,34996,935,12214,3861,34140,O
3860,N,320,320,35316,240,12454,3861,34996,N
3860,O,212,212,35528,335,12789,3861,35316,O
3860,P,1045,1045,36573,1260,14049,3861,35528,P
3861,A,42,42,42,105,105,3862,0,A
3861,B,149,149,191,135,240,3862,42,B
3861,C,213,213,404,285,525,3862,191,C
3861,D,141,141,545,5160,5685,3862,404,D
3861,M,1073,1073,1618,1827,7512,3862,545,M
3861,N,781,781,2399,90,7602,3862,1618,N
3861,O,916,916,3315,1240,8842,3862,2399,O
3861,N,449,449,3764,125,8967,3862,3315,N
3861,O,545,545,4309,800,9767,3862,3764,O
3861,P,1348,1348,5657,3780,13547,3862,4309,P
3862,A,3214,3214,3214,3971,3971,3863,0,A
3862,B,905,905,4119,180,4151,3863,3214,B
3862,C,55,55,4174,130,4281,3863,4119,C
3862,B,558,558,4732,500,4781,3863,4174,B
3862,C,318,318,5050,465,5246,3863,4732,C
3862,D,41053,41053,46103,5760,11006,3863,5050,D
3862,M,904,904,47007,985,11991,3863,46103,M
3862,N,285,285,47292,240,12231,3863,47007,N
3862,O,402,402,47694,585,12816,3863,47292,O
3862,N,1587,1587,49281,1410,14226,3863,47694,N
3862,O,692,692,49973,880,15106,3863,49281,O
3862,P,2444,2444,52417,3960,19066,3863,49973,P
3863,AEI,32,32,32,147,147,3864,0,E
3863,AFI,210,210,242,150,297,3864,32,F
3863,AGI,297,55,297,310,310,3864,0,A
3863,BGI,123,68,365,85,382,3864,242,G
3863,BFI,264,196,561,300,610,3864,297,B
3863,CFI,443,443,1004,665,1275,3864,561,C
3863,DFI,680,41,1045,720,1102,3864,365,F
3863,DGI,216,216,1261,255,1357,3864,1045,G
3863,DHI,351,94,1355,4020,5295,3864,1004,D
3863,HI,1373,18,1373,1779,1779,3864,0,I
3863,HJ,680,680,2053,300,2079,3864,1373,J
3863,HK,1428,636,2689,5160,6517,3864,1261,H
3863,K,655,19,2708,795,2874,3864,2053,K
3863,J,251,251,2959,145,3019,3864,2708,J
3863,K,891,891,3850,1080,4099,3864,2959,K
3863,L,411,411,4261,4020,8119,3864,3850,L
3863,M,37906,37906,42167,37888,46007,3864,4261,M
3863,N,155,155,42322,210,46217,3864,42167,N
3863,O,182,182,42504,215,46432,3864,42322,O
3863,N,1470,1470,43974,1460,47892,3864,42504,N
3863,O,942,942,44916,1005,48897,3864,43974,O
3863,P,932,932,45848,355,49252,3864,44916,P
3864,A,280,280,280,438,438,3865,0,A
3864,B,338,338,618,240,678,3865,280,B
3864,C,143,143,761,299,977,3865,618,C
3864,D,253,253,1014,391,1368,3865,761,D
3864,M,1942,1942,2956,2006,3374,3865,1014,M
3864,N,44,44,3000,150,3524,3865,2956,N
3864,O,776,776,3776,840,4364,3865,3000,O
3864,N,1399,1399,5175,1225,5589,3865,3776,N
3864,O,480,480,5655,535,6124,3865,5175,O
3864,P,3951,3951,9606,2880,9004,3865,5655,P
3865,AE,478,478,478,1128,1128,3866,0,A
3865,BE,772,772,1250,180,1308,3866,478,B
3865,CE,926,926,2176,890,2198,3866,1250,C
3865,BE,1282,1282,3458,1315,3513,3866,2176,B
3865,CE,4273,815,4273,4366,4366,3866,0,E
3865,CF,215,215,4488,150,4516,3866,4273,F
3865,CG,135,135,4623,125,4641,3866,4488,G
3865,CF,1240,75,4698,1389,4902,3866,3458,C
3865,DF,1030,955,5653,1050,5691,3866,4623,F
3865,DG,657,657,6310,735,6426,3866,5653,G
3865,DH,182,182,6492,4230,10656,3866,6310,H
3865,D,2295,501,6993,686,5588,3866,4698,D
3865,M,201,201,7194,579,11235,3866,6993,M
3865,N,496,496,7690,150,11385,3866,7194,N
3865,O,612,612,8302,920,12305,3866,7690,O
3865,N,1398,1398,9700,1095,13400,3866,8302,N
3865,O,719,719,10419,780,14180,3866,9700,O
3865,P,2076,2076,12495,4230,18410,3866,10419,P
3866,A,109,109,109,1164,1164,3867,0,A
3866,B,1252,1252,1361,240,1404,3867,109,B
3866,C,679,679,2040,760,2164,3867,1361,C
3866,D,2252,2252,4292,7680,9844,3867,2040,D
3866,M,129,129,4421,1492,11336,3867,4292,M
3866,N,1358,1358,5779,90,11426,3867,4421,N
3866,O,1655,1655,7434,1955,13381,3867,5779,O
3866,P,30480,30480,37914,3780,17161,3867,7434,P
3867,AE,41,41,41,464,464,3868,0,A
3867,BE,266,225,266,333,333,3868,0,E
3867,BF,262,262,528,240,573,3868,266,F
3867,BG,522,35,563,135,599,3868,41,B
3867,CG,220,185,748,285,858,3868,528,G
3867,CH,263,78,826,295,894,3868,563,C
3867,DH,289,289,1115,5160,6054,3868,826,D
3867,H,1852,1485,2600,5160,6018,3868,748,H
3867,M,662,662,3262,1191,7245,3868,2600,M
3867,N,679,679,3941,180,7425,3868,3262,N
3867,O,836,836,4777,885,8310,3868,3941,O
3867,P,3229,3229,8006,6680,14990,3868,4777,P
3868,AEI,930,930,930,997,997,3869,0,E
3868,AFI,161,161,1091,150,1147,3869,930,F
3868,AGI,1207,116,1207,1286,1286,3869,0,I
3868,AGJ,204,88,1295,140,1287,3869,1091,G
3868,AFJ,268,180,1475,240,1526,3869,1207,J
3868,AFK,167,167,1642,400,1926,3869,1475,K
3868,AFJ,853,853,2495,590,2516,3869,1642,J
3868,AFK,1307,107,2602,1335,2622,3869,1295,F
3868,AGK,2884,282,2884,3064,3064,3869,0,A
3868,BGK,220,220,3104,90,3154,3869,2884,B
3868,CGK,472,472,3576,800,3954,3869,3104,C
3868,BGK,1091,10,3586,1295,3811,3869,2495,K
3868,BGL,1230,246,3832,1290,3912,3869,2602,G
3868,BHL,1375,1119,4951,1060,5014,3869,3576,B
3868,CHL,927,927,5878,1325,6339,3869,4951,C
3868,DHL,46,46,5924,3780,10119,3869,5878,D
3868,HL,4799,2461,8385,3660,7471,3869,3586,L
3868,H,7554,3001,11386,3660,7572,3869,3832,H
3868,M,170,170,11556,1881,12000,3869,11386,M
3868,N,1894,1894,13450,240,12240,3869,11556,N
3868,O,959,959,14409,1005,13245,3869,13450,O
3868,N,1055,1055,15464,990,14235,3869,14409,N
3868,O,599,599,16063,830,15065,3869,15464,O
3868,P,2749,2749,18812,3960,19025,3869,16063,P
3869,AE,506,506,506,1226,1226,3870,0,A
3869,BE,903,903,1409,240,1466,3870,506,B
3869,CE,600,600,2009,740,2206,3870,1409,C
3869,DE,2973,964,2973,3770,3770,3870,0,E
3869,DF,1578,1578,4551,90,3860,3870,2973,F
3869,DG,519,519,5070,815,4675,3870,4551,G
3869,DF,1719,1719,6789,2175,6850,3870,5070,F
3869,DG,416,416,7205,810,7660,3870,6789,G
3869,DH,13066,7870,15075,5100,7306,3870,2009,D
3869,H,28920,21050,36125,3780,11440,3870,7205,H
3869,M,1789,1789,37914,3923,15363,3870,36125,M
3869,N,2172,2172,40086,90,15453,3870,37914,N
3869,O,469,469,40555,805,16258,3870,40086,O
3869,N,2129,2129,42684,1690,17948,3870,40555,N
3869,O,479,479,43163,960,18908,3870,42684,O
3869,P,60,60,43223,3780,22688,3870,43163,P
3870,AE,107,107,107,1098,1098,3871,0,A
3870,BE,203,96,203,174,174,3871,0,E
3870,BF,11,11,214,120,294,3871,203,F
3870,BG,372,372,586,225,519,3871,214,G
3870,BF,698,698,1284,825,1344,3871,586,F
3870,BG,1195,18,1302,240,1338,3871,107,B
3870,CG,567,549,1851,635,1979,3871,1284,G
3870,CH,700,151,2002,760,2098,3871,1302,C
3870,DH,1888,1737,3739,2880,4859,3871,1851,H
3870,D,2423,686,4425,7680,9778,3871,2002,D
3870,M,787,787,5212,1131,10909,3871,4425,M
3870,N,576,576,5788,300,11209,3871,5212,N
3870,O,770,770,6558,820,12029,3871,5788,O
3870,N,1132,1132,7690,1050,13079,3871,6558,N
3870,O,616,616,8306,760,13839,3871,7690,O
3870,P,4085,4085,12391,5160,18999,3871,8306,P
3871,AEI,23,23,23,74,74,3872,0,I
3871,AEJ,59,36,59,64,64,3872,0,A
3871,BEJ,110,51,110,19,19,3872,0,E
3871,BFJ,95,44,154,150,214,3872,59,B
3871,CFJ,141,10,164,150,224,3872,23,J
3871,CFK,161,151,315,130,344,3872,154,C
3871,DFK,156,5,320,130,354,3872,164,K
3871,DFL,36,31,351,2850,3194,3872,315,D
3871,FL,36,5,356,2850,3204,3872,320,L
3871,F,858,612,968,485,504,3872,110,F
3871,G,231,231,1199,490,994,3872,968,G
3871,H,174,174,1373,2765,3759,3872,1199,H
3871,M,261,261,1634,743,4502,3872,1373,M
3871,N,582,582,2216,150,4652,3872,1634,N
3871,O,248,248,2464,160,4812,3872,2216,O
3871,N,1608,1608,4072,1690,6502,3872,2464,N
3871,O,627,627,4699,610,7112,3872,4072,O
3871,P,1186,1186,5885,4230,11342,3872,4699,P
3872,A,14,14,14,246,246,3873,0,A
3872,B,308,308,322,135,381,3873,14,B
3872,C,200,200,522,280,661,3873,322,C
3872,D,919,919,1441,5160,5821,3873,522,D
3872,M,1007,1007,2448,2020,7841,3873,1441,M
3872,N,1148,1148,3596,150,7991,3873,2448,N
3872,O,1448,1448,5044,1685,9676,3873,3596,O
3872,P,1452,1452,6496,2520,12196,3873,5044,P
3873,AE,227,227,227,324,324,3874,0,A
3873,BE,280,280,507,240,564,3874,227,B
3873,CE,715,715,1222,845,1409,3874,507,C
3873,DE,565,565,1787,5220,6629,3874,1222,D
3873,E,14606,12819,14606,14854,14854,3874,0,E
3873,F,591,591,15197,300,15154,3874,14606,F
3873,G,642,642,15839,735,15889,3874,15197,G
3873,H,65,65,15904,1560,17449,3874,15839,H
3873,M,1350,1350,17254,1415,18864,3874,15904,M
3873,N,321,321,17575,300,19164,3874,17254,N
3873,O,697,697,18272,1015,20179,3874,17575,O
3873,N,320,320,18592,10,20189,3874,18272,N
3873,O,96,96,18688,2630,22819,3874,18592,O
3873,P,5851,5851,24539,1620,24439,3874,18688,P
3874,AEI,1,1,1,747,747,3875,0,I
3874,AEJ,570,569,570,944,944,3875,0,A
3874,BEJ,954,385,955,240,987,3875,1,J
3874,BEK,736,351,1306,420,1364,3875,570,B
3874,CEK,709,358,1664,960,1947,3875,955,K
3874,CEL,1833,169,1833,2396,2396,3875,0,E
3874,CFL,613,444,2277,3960,5907,3875,1664,L
3874,CF,604,160,2437,90,2486,3875,1833,F
3874,CG,1160,29,2466,1220,2584,3875,1306,C
3874,DG,678,678,3144,635,3219,3875,2466,D
3874,G,775,68,3212,1100,3586,3875,2437,G
3874,H,4982,4982,8194,3780,7366,3875,3212,H
3874,M,3033,3033,11227,4104,11470,3875,8194,M
3874,N,1103,1103,12330,90,11560,3875,11227,N
3874,O,694,694,13024,935,12495,3875,12330,O
3874,N,1342,1342,14366,1100,13595,3875,13024,N
3874,O,461,461,14827,740,14335,3875,14366,O
3874,P,6779,6779,21606,3780,18115,3875,14827,P
3875,AEI,15,15,15,128,128,3876,0,I
3875,AEJ,92,77,92,1169,1169,3876,0,E
3875,AFJ,330,253,345,240,368,3876,15,J
3875,AFK,672,672,1017,965,1333,3876,345,K
3875,AFL,81,81,1098,3960,5293,3876,1017,L
3875,AF,1282,276,1374,240,1409,3876,92,F
3875,AG,824,824,2198,890,2299,3876,1374,G
3875,AH,3933,1735,3933,4083,4083,3876,0,A
3875,BH,346,346,4279,240,4323,3876,3933,B
3875,CH,680,680,4959,960,5283,3876,4279,C
3875,DH,418,418,5377,3960,9243,3876,4959,D
3875,H,4523,1344,6721,5220,7519,3876,2198,H
3875,M,329,329,7050,1263,10506,3876,6721,M
3875,N,1054,1054,8104,180,10686,3876,7050,N
3875,O,966,966,9070,1050,11736,3876,8104,O
3875,N,705,705,9775,620,12356,3876,9070,N
3875,O,187,187,9962,260,12616,3876,9775,O
3875,P,109,109,10071,5100,17716,3876,9962,P
3876,AEI,31,31,31,159,159,3877,0,E
3876,AFI,52,21,52,55,55,3877,0,I
3876,AFJ,78,78,130,135,190,3877,52,J
3876,AFK,151,151,281,280,470,3877,130,K
3876,AFL,314,64,345,240,399,3877,31,F
3876,AGL,212,212,557,285,684,3877,345,G
3876,AHL,585,28,585,1198,1198,3877,0,A
3876,BHL,661,661,1246,90,1288,3877,585,B
3876,CHL,1115,426,1672,5160,5844,3877,557,H
3876,CL,1643,252,1924,5160,5630,3877,281,L
3876,C,989,311,2235,1285,2573,3877,1246,C
3876,D,1048,1048,3283,3780,6353,3877,2235,D
3876,M,774,774,4057,3316,9669,3877,3283,M
3876,N,2614,2614,6671,90,9759,3877,4057,N
3876,O,858,858,7529,1250,11009,3877,6671,O
3876,N,1016,1016,8545,670,11679,3877,7529,N
3876,O,392,392,8937,790,12469,3877,8545,O
3876,P,1117,1117,10054,3780,16249,3877,8937,P
3877,A,347,347,347,796,796,3878,0,A
3877,B,478,478,825,90,886,3878,347,B
3877,C,586,586,1411,850,1736,3878,825,C
3877,D,572,572,1983,3780,5516,3878,1411,D
3877,M,256,256,2239,1112,6628,3878,1983,M
3877,N,1132,1132,3371,300,6928,3878,2239,N
3877,O,744,744,4115,920,7848,3878,3371,O
3877,N,1043,1043,5158,860,8708,3878,4115,N
3877,O,651,651,5809,785,9493,3878,5158,O
3877,P,5290,5290,11099,3960,13453,3878,5809,P
3878,AEI,34,34,34,711,711,3879,0,I
3878,AEJ,352,318,352,771,771,3879,0,A
3878,BEJ,928,610,962,300,1011,3879,34,J
3878,BEK,656,46,1008,300,1071,3879,352,B
3878,CEK,755,755,1763,825,1896,3879,1008,C
3878,DEK,815,14,1777,810,1821,3879,962,K
3878,DEL,3795,2018,3795,4129,4129,3879,0,E
3878,DFL,567,567,4362,240,4369,3879,3795,F
3878,DGL,2816,231,4593,4080,5901,3879,1777,L
3878,DG,3175,345,4938,4080,5976,3879,1763,D
3878,G,577,1,4939,865,5234,3879,4362,G
3878,H,2875,2875,7814,3960,9194,3879,4939,H
3878,M,1282,1282,9096,2601,11795,3879,7814,M
3878,N,1572,1572,10668,300,12095,3879,9096,N
3878,O,612,612,11280,730,12825,3879,10668,O
3878,P,195,195,11475,5760,18585,3879,11280,P
3879,A,134,134,134,1147,1147,3880,0,A
3879,B,1040,1040,1174,90,1237,3880,134,B
3879,C,1026,1026,2200,1220,2457,3880,1174,C
3879,B,403,403,2603,195,2652,3880,2200,B
3879,C,172,172,2775,585,3237,3880,2603,C
3879,D,5248,5248,8023,3780,7017,3880,2775,D
3879,M,285,285,8308,1531,8548,3880,8023,M
3879,N,1459,1459,9767,240,8788,3880,8308,N
3879,O,4177,4177,13944,1285,10073,3880,9767,O
3879,N,245,245,14189,1715,11788,3880,13944,N
3879,O,523,523,14712,750,12538,3880,14189,O
3879,P,27,27,14739,3960,16498,3880,14712,P
3880,AE,123,123,123,350,350,3881,0,A
3880,BE,378,378,501,180,530,3881,123,B
3880,CE,756,756,1257,830,1360,3881,501,C
3880,DE,2537,1280,2537,2665,2665,3881,0,E
3880,DF,316,316,2853,240,2905,3881,2537,F
3880,DG,1978,382,3235,6680,8040,3881,1257,D
3880,G,850,468,3703,855,3760,3881,2853,G
3880,F,2729,2729,6432,2710,6470,3881,3703,F
3880,G,834,834,7266,685,7155,3881,6432,G
3880,H,1849,1849,9115,3960,11115,3881,7266,H
3880,M,174,174,9289,1218,12333,3881,9115,M
3880,N,1169,1169,10458,180,12513,3881,9289,N
3880,O,365,365,10823,390,12903,3881,10458,O
3880,P,4131,4131,14954,6960,19863,3881,10823,P
3881,A,269,269,269,963,963,3882,0,A
3881,B,883,883,1152,240,1203,3882,269,B
3881,C,797,797,1949,1015,2218,3882,1152,C
3881,B,878,878,2827,650,2868,3882,1949,B
3881,C,149,149,2976,385,3253,3882,2827,C
3881,D,406,406,3382,3960,7213,3882,2976,D
3881,M,931,931,4313,1840,9053,3882,3382,M
3881,N,1060,1060,5373,180,9233,3882,4313,N
3881,O,1253,1253,6626,885,10118,3882,5373,O
3881,N,308,308,6934,690,10808,3882,6626,N
3881,O,511,511,7445,635,11443,3882,6934,O
3881,P,1108,1108,8553,6960,18403,3882,7445,P
3882,AEI,24,24,24,91,91,3883,0,A
3882,BEI,35,11,35,221,221,3883,0,I
3882,BEJ,149,138,173,135,226,3883,24,B
3882,CEJ,278,105,278,235,235,3883,0,E
3882,CFJ,246,3,281,120,341,3883,35,J
3882,CFK,666,663,944,730,965,3883,278,F
3882,CGK,784,13,957,890,1116,3883,173,C
3882,DGK,807,131,1088,890,1231,3883,281,K
3882,DGL,357,226,1314,5160,6276,3883,957,D
3882,GL,1055,685,1999,925,1890,3883,944,G
3882,HL,953,953,2952,2760,4650,3883,1999,H
3882,L,2069,205,3157,5160,6391,3883,1088,L
3882,M,3094,3094,6251,3240,9631,3883,3157,M
3882,N,178,178,6429,90,9721,3883,6251,N
3882,O,843,843,7272,1145,10866,3883,6429,O
3882,N,612,612,7884,300,11166,3883,7272,N
3882,O,359,359,8243,740,11906,3883,7884,O
3882,P,9734,9734,17977,3780,15686,3883,8243,P
3883,AEI,76,76,76,120,120,3884,0,A
3883,BEI,553,553,629,570,690,3884,76,B
3883,CEI,77,77,706,80,770,3884,629,C
3883,BEI,151,151,857,145,915,3884,706,B
3883,CEI,115,115,972,130,1045,3884,857,C
3883,DEI,1399,427,1399,1463,1463,3884,0,E
3883,DFI,423,423,1822,420,1883,3884,1399,F
3883,DGI,2575,753,2575,2786,2786,3884,0,I
3883,DGJ,787,34,2609,955,2838,3884,1822,G
3883,DFJ,490,490,3099,325,3163,3884,2609,F
3883,DGJ,570,46,3145,420,3206,3884,2575,J
3883,DGK,561,515,3660,265,3428,3884,3099,G
3883,DHK,751,236,3896,945,4151,3884,3145,K
3883,DHJ,2119,2119,6015,1890,6041,3884,3896,J
3883,DHK,2588,2588,8603,2360,8401,3884,6015,K
3883,DHL,452,452,9055,5160,13561,3884,8603,L
3883,DH,7942,2547,11602,5160,8588,3884,3660,H
3883,D,15647,5017,16619,2850,3895,3884,972,D
3883,M,201,201,16820,728,14289,3884,16619,M
3883,N,117,117,16937,140,14429,3884,16820,N
3883,O,624,624,17561,160,14589,3884,16937,O
3883,N,1541,1541,19102,1495,16084,3884,17561,N
3883,O,659,659,19761,680,16764,3884,19102,O
3883,P,4601,4601,24362,320,17084,3884,19761,P
3884,A,147,147,147,1142,1142,3885,0,A
3884,B,1172,1172,1319,240,1382,3885,147,B
3884,C,821,821,2140,780,2162,3885,1319,C
3884,D,719,719,2859,7680,9842,3885,2140,D
3884,M,1574,1574,4433,1783,11625,3885,2859,M
3884,N,448,448,4881,300,11925,3885,4433,N
3884,O,666,666,5547,820,12745,3885,4881,O
3884,N,466,466,6013,295,13040,3885,5547,N
3884,O,477,477,6490,500,13540,3885,6013,O
3884,P,6317,6317,12807,6000,19540,3885,6490,P
3885,AE,117,117,117,194,194,3886,0,A
3885,BE,161,44,161,169,169,3886,0,E
3885,BF,189,145,306,135,329,3886,117,B
3885,CF,194,49,355,240,409,3886,161,F
3885,CG,246,246,601,285,694,3886,355,G
3885,CH,365,70,671,290,619,3886,306,C
3885,DH,67,67,738,5160,5779,3886,671,D
3885,H,1405,1268,2006,5160,5854,3886,601,H
3885,M,997,997,3003,1797,7651,3886,2006,M
3885,N,940,940,3943,150,7801,3886,3003,N
3885,O,1369,1369,5312,1610,9411,3886,3943,O
3885,P,6294,6294,11606,2520,11931,3886,5312,P
3886,A,11,11,11,81,81,3887,0,A
3886,B,163,163,174,135,216,3887,11,B
3886,C,230,230,404,285,501,3887,174,C
3886,D,141,141,545,5160,5661,3887,404,D
3886,M,19030,19030,19575,19192,24853,3887,545,M
3886,N,290,290,19865,180,25033,3887,19575,N
3886,O,863,863,20728,885,25918,3887,19865,O
3886,P,1354,1354,22082,6680,32598,3887,20728,P
3887,A,26,26,26,141,141,3888,0,A
3887,B,301,301,327,240,381,3888,26,B
3887,C,221,221,548,285,666,3888,327,C
3887,D,79,79,627,5160,5826,3888,548,D
3887,M,2384,2384,3011,2754,8580,3888,627,M
3887,N,395,395,3406,90,8670,3888,3011,N
3887,O,971,971,4377,1240,9910,3888,3406,O
3887,N,610,610,4987,340,10250,3888,4377,N
3887,O,586,586,5573,970,11220,3888,4987,O
3887,P,191,191,5764,3780,15000,3888,5573,P
3888,AE,79,79,79,200,200,3889,0,E
3888,AF,253,174,253,950,950,3889,0,A
3888,BF,213,39,292,135,335,3889,79,F
3888,BG,191,191,483,290,625,3889,292,G
3888,BH,139,139,622,5160,5785,3889,483,H
3888,B,891,522,1144,240,1190,3889,253,B
3888,C,776,776,1920,1030,2220,3889,1144,C
3888,B,918,918,2838,650,2870,3889,1920,B
3888,C,182,182,3020,385,3255,3889,2838,C
3888,D,422,422,3442,3960,7215,3889,3020,D
3888,M,783,783,4225,2747,9962,3889,3442,M
3888,N,2102,2102,6327,180,10142,3889,4225,N
3888,O,595,595,6922,885,11027,3889,6327,O
3888,N,302,302,7224,30,11057,3889,6922,N
3888,O,245,245,7469,360,11417,3889,7224,O
3888,P,37485,37485,44954,7020,18437,3889,7469,P
3889,AEI,253,253,253,307,307,3890,0,I
3889,AEJ,244,244,497,180,487,3890,253,J
3889,AEK,742,245,742,5813,5813,3890,0,E
3889,AFK,879,634,1376,1245,1732,3890,497,K
3889,AFL,1041,1041,2417,6680,8412,3890,1376,L
3889,AF,5191,3516,5933,180,5993,3890,742,F
3889,AG,798,798,6731,840,6833,3890,5933,G
3889,AH,15602,8871,15602,16183,16183,3890,0,A
3889,BH,719,719,16321,180,16363,3890,15602,B
3889,CH,380,380,16701,840,17203,3890,16321,C
3889,DH,17892,7922,24623,6680,13513,3890,6731,H
3889,D,10482,2560,27183,6680,23883,3890,16701,D
3889,M,289,289,27472,1078,24961,3890,27183,M
3889,N,938,938,28410,180,25141,3890,27472,N
3889,O,192,192,28602,315,25456,3890,28410,O
3889,P,7125,7125,35727,6900,32356,3890,28602,P
3890,AE,464,464,464,865,865,3891,0,E
3890,AF,449,449,913,90,955,3891,464,F
3890,AG,483,483,1396,735,1690,3891,913,G
3890,AH,347,347,1743,3780,5470,3891,1396,H
3890,A,2969,1226,2969,3116,3116,3891,0,A
3890,B,254,254,3223,90,3206,3891,2969,B
3890,C,547,547,3770,820,4026,3891,3223,C
3890,B,1037,1037,4807,845,4871,3891,3770,B
3890,C,357,357,5164,740,5611,3891,4807,C
3890,D,1128,1128,6292,3780,9391,3891,5164,D
3890,M,594,594,6886,2146,11537,3891,6292,M
3890,N,1580,1580,8466,90,11627,3891,6886,N
3890,O,452,452,8918,750,12377,3891,8466,O
3890,N,734,734,9652,415,12792,3891,8918,N
3890,O,618,618,10270,920,13712,3891,9652,O
3890,P,1618,1618,11888,3780,17492,3891,10270,P
3891,AEI,26,26,26,115,115,3892,0,I
3891,AEJ,156,130,156,350,350,3892,0,A
3891,BEJ,277,147,303,240,355,3892,26,J
3891,BEK,382,235,538,240,590,3892,156,B
3891,CEK,1063,525,1063,1369,1369,3892,0,E
3891,CFK,839,79,1142,850,1205,3892,303,K
3891,CFL,839,235,1377,850,1440,3892,538,C
3891,DFL,451,137,1514,210,1579,3892,1063,F
3891,DGL,105,105,1619,255,1834,3892,1514,G
3891,DFL,1562,1562,3181,1390,3224,3892,1619,F
3891,DGL,721,721,3902,845,4069,3892,3181,G
3891,DHL,2878,118,4020,5220,6425,3892,1142,L
3891,DH,2879,236,4256,5220,6660,3892,1377,D
3891,H,3111,2757,7013,5220,9289,3892,3902,H
3891,M,7570,7570,14583,7605,16894,3892,7013,M
3891,N,281,281,14864,300,17194,3892,14583,N
3891,O,767,767,15631,1035,18229,3892,14864,O
3891,N,375,375,16006,105,18334,3892,15631,N
3891,O,195,195,16201,825,19159,3892,16006,O
3891,P,1022,1022,17223,1560,20719,3892,16201,P
3892,AEI,45,45,45,81,81,3893,0,I
3892,AEJ,96,96,141,120,201,3893,45,J
3892,AEK,150,150,291,120,321,3893,141,K
3892,AEJ,432,141,432,540,540,3893,0,E
3892,AFJ,168,168,600,120,660,3893,432,F
3892,AGJ,710,110,710,1262,1262,3893,0,A
3892,BGJ,136,26,736,134,794,3893,600,G
3892,BHJ,41,41,777,366,1160,3893,736,H
3892,BJ,730,663,1440,240,1502,3893,710,B
3892,CJ,196,196,1636,270,1772,3893,1440,C
3892,BJ,484,484,2120,380,2152,3893,1636,B
3892,CJ,215,215,2335,260,2412,3893,2120,C
3892,DJ,509,509,2844,5100,7512,3893,2335,D
3892,J,3523,970,3814,3550,3871,3893,291,J
3892,K,190,190,4004,260,4131,3893,3814,K
3892,L,68,68,4072,5100,9231,3893,4004,L
3892,M,1816,1816,5888,4057,13288,3893,4072,M
3892,N,2511,2511,8399,300,13588,3893,5888,N
3892,O,380,380,8779,658,14246,3893,8399,O
3892,P,8044,8044,16823,647,14893,3893,8779,P
3893,AEI,717,717,717,975,975,3894,0,A
3893,BEI,731,14,731,1017,1017,3894,0,E
3893,BFI,296,282,1013,90,1065,3894,717,B
3893,CFI,486,204,1217,240,1257,3894,731,F
3893,CGI,412,208,1425,815,1880,3894,1013,C
3893,DGI,474,266,1691,845,2102,3894,1217,G
3893,DHI,1788,97,1788,1964,1964,3894,0,I
3893,DHJ,202,202,1990,90,2054,3894,1788,J
3893,DHK,452,452,2442,800,2854,3894,1990,K
3893,DHJ,738,738,3180,390,3244,3894,2442,J
3893,DHK,514,514,3694,815,4059,3894,3180,K
3893,DHL,3529,1526,5220,3960,6062,3894,1691,H
3893,DL,5880,2085,7305,3780,5660,3894,1425,D
3893,L,26520,22909,30214,3780,7839,3894,3694,L
3893,M,1306,1306,31520,2324,10163,3894,30214,M
3893,N,1050,1050,32570,90,10253,3894,31520,N
3893,O,492,492,33062,805,11058,3894,32570,O
3893,N,2723,2723,35785,2380,13438,3894,33062,N
3893,O,1698,1698,37483,2035,15473,3894,35785,O
3893,P,5124,5124,42607,3780,19253,3894,37483,P
3894,A,324,324,324,338,338,3895,0,A
3894,B,139,139,463,180,518,3895,324,B
3894,C,984,984,1447,1245,1763,3895,463,C
3894,D,31,31,1478,6680,8443,3895,1447,D
3894,M,1252,1252,2730,1625,10068,3895,1478,M
3894,N,493,493,3223,180,10248,3895,2730,N
3894,O,609,609,3832,680,10928,3895,3223,O
3894,P,3413,3413,7245,5460,16388,3895,3832,P
3895,A,145,145,145,420,420,3896,0,A
3895,B,415,415,560,180,600,3896,145,B
3895,C,533,533,1093,840,1440,3896,560,C
3895,D,664,664,1757,6680,8120,3896,1093,D
3895,M,313,313,2070,914,9034,3896,1757,M
3895,N,734,734,2804,180,9214,3896,2070,N
3895,O,440,440,3244,390,9604,3896,2804,O
3895,P,14201,14201,17445,6960,16564,3896,3244,P
3896,AEI,26,26,26,122,122,3897,0,E
3896,AFI,178,178,204,135,257,3897,26,F
3896,AGI,333,129,333,442,442,3897,0,A
3896,BGI,166,166,499,110,552,3897,333,B
3896,CGI,399,104,603,290,547,3897,204,G
3896,CHI,196,92,695,280,832,3897,499,C
3896,DHI,298,206,901,5160,5707,3897,603,H
3896,DI,1255,354,1255,1346,1346,3897,0,I
3896,DJ,183,183,1438,150,1496,3897,1255,J
3896,DK,327,327,1765,280,1776,3897,1438,K
3896,DL,1460,390,2155,5160,5992,3897,695,D
3896,L,1015,625,2780,5160,6936,3897,1765,L
3896,M,1037,1037,3817,1993,8929,3897,2780,M
3896,N,1081,1081,4898,150,9079,3897,3817,N
3896,O,1435,1435,6333,1685,10764,3897,4898,O
3896,P,2803,2803,9136,2520,13284,3897,6333,P
3897,AE,21,21,21,51,51,3898,0,A
3897,BE,90,90,111,120,171,3898,21,B
3897,CE,103,103,214,120,291,3898,111,C
3897,BE,276,62,276,1077,1077,3898,0,E
3897,BF,688,626,902,670,961,3898,214,B
3897,CF,190,190,1092,265,1226,3898,902,C
3897,DF,958,142,1234,180,1257,3898,276,F
3897,DG,264,122,1356,5100,6326,3898,1092,D
3897,G,606,484,1840,600,1857,3898,1234,G
3897,F,130,130,1970,165,2022,3898,1840,F
3897,G,115,115,2085,167,2189,3898,1970,G
3897,H,148,148,2233,393,2582,3898,2085,H
3897,M,133,133,2366,442,6768,3898,2233,M
3897,N,506,506,2872,240,7008,3898,2366,N
3897,O,686,686,3558,830,7838,3898,2872,O
3897,P,1214,1214,4772,1040,8878,3898,3558,P
3898,AE,67,67,67,363,363,3899,0,E
3898,AF,453,453,520,180,543,3899,67,F
3898,AG,893,893,1413,830,1373,3899,520,G
3898,AH,227,227,1640,6680,8053,3899,1413,H
3898,A,7284,5644,7284,7666,7666,3899,0,A
3898,B,534,534,7818,180,7846,3899,7284,B
3898,C,626,626,8444,820,8666,3899,7818,C
3898,D,751,751,9195,4725,13391,3899,8444,D
3898,M,55,55,9250,369,13760,3899,9195,M
3898,N,405,405,9655,150,13910,3899,9250,N
3898,O,495,495,10150,745,14655,3899,9655,O
3898,N,592,592,10742,335,14990,3899,10150,N
3898,O,96,96,10838,105,15095,3899,10742,O
3898,P,2362,2362,13200,4230,19325,3899,10838,P
3899,AEI,39,39,39,136,136,3900,0,A
3899,BEI,133,94,133,1000,1000,3900,0,E
3899,BFI,175,81,214,135,271,3900,39,B
3899,CFI,809,809,1023,890,1161,3900,214,C
3899,DFI,1073,183,1206,240,1240,3900,133,F
3899,DGI,851,851,2057,950,2190,3900,1206,G
3899,DHI,293,293,2350,5160,7350,3900,2057,H
3899,DI,4419,2069,4419,4560,4560,3900,0,I
3899,DJ,196,196,4615,120,4680,3900,4419,J
3899,DK,179,179,4794,390,5070,3900,4615,K
3899,DJ,872,872,5666,640,5710,3900,4794,J
3899,DK,772,772,6438,890,6600,3900,5666,K
3899,DL,5758,343,6781,5160,6321,3900,1023,D
3899,L,1526,1183,7964,5160,11760,3900,6438,L
3899,M,196,196,8160,1119,12879,3900,7964,M
3899,N,1043,1043,9203,180,13059,3900,8160,N
3899,O,956,956,10159,1050,14109,3900,9203,O
3899,N,714,714,10873,620,14729,3900,10159,N
3899,O,129,129,11002,260,14989,3900,10873,O
3899,P,370,370,11372,5100,20089,3900,11002,P
3900,A,1336,1336,1336,1574,1574,3901,0,A
3900,B,388,388,1724,210,1784,3901,1336,B
3900,C,738,738,2462,690,2474,3901,1724,C
3900,B,60,60,2522,90,2564,3901,2462,B
3900,C,524,524,3046,540,3104,3901,2522,C
3900,D,12727,12727,15773,2880,5984,3901,3046,D
3900,M,1829,1829,17602,2484,8468,3901,15773,M
3900,N,1380,1380,18982,240,8708,3901,17602,N
3900,O,69,69,19051,255,8963,3901,18982,O
3900,P,653,653,19704,660,9623,3901,19051,P
3901,A,149,149,149,141,141,3902,0,A
3901,B,67,67,216,135,276,3902,149,B
3901,C,201,201,417,280,556,3902,216,C
3901,D,5395,5395,5812,5160,5716,3902,417,D
3901,M,1076,1076,6888,934,6650,3902,5812,M
3901,N,676,676,7564,180,6830,3902,6888,N
3901,O,695,695,8259,885,7715,3902,7564,O
3901,P,1843,1843,10102,6680,14395,3902,8259,P
3902,AE,105,105,105,1048,1048,3903,0,E
3902,AF,510,405,510,880,880,3903,0,A
3902,BF,642,642,1152,300,1180,3903,510,B
3902,CF,1132,85,1237,240,1288,3903,105,F
3902,CG,802,802,2039,760,2048,3903,1237,G
3902,CH,930,43,2082,1045,2225,3903,1152,C
3902,DH,695,652,2734,7680,9728,3903,2039,H
3902,D,5313,4661,7395,1140,3365,3903,2082,D
3902,M,1315,1315,8710,1527,11255,3903,7395,M
3902,N,333,333,9043,150,11405,3903,8710,N
3902,O,541,541,9584,495,11900,3903,9043,O
3902,N,735,735,10319,790,12690,3903,9584,N
3902,O,760,760,11079,706,13396,3903,10319,O
3902,P,2948,2948,14027,3630,17026,3903,11079,P
3903,AE,319,319,319,377,377,3904,0,E
3903,AF,208,208,527,210,587,3904,319,F
3903,AG,153,153,680,255,842,3904,527,G
3903,AF,1495,1495,2175,1390,2232,3904,680,F
3903,AG,699,699,2874,845,3077,3904,2175,G
3903,AH,466,466,3340,5280,8357,3904,2874,H
3903,A,14765,11425,14765,14919,14919,3904,0,A
3903,B,494,494,15259,300,15219,3904,14765,B
3903,C,665,665,15924,740,15959,3904,15259,C
3903,D,75,75,15999,1560,17519,3904,15924,D
3903,M,59,59,16058,1682,19201,3904,15999,M
3903,N,3063,3063,19121,1500,20701,3904,16058,N
3903,O,880,880,20001,1000,21701,3904,19121,O
3903,N,1021,1021,21022,900,22601,3904,20001,N
3903,O,180,180,21202,260,22861,3904,21022,O
3903,P,1411,1411,22613,5100,27961,3904,21202,P
3904,AE,222,222,222,439,439,3905,0,A
3904,BE,320,320,542,150,589,3905,222,B
3904,CE,48,48,590,75,664,3905,542,C
3904,BE,772,772,1362,755,1419,3905,590,B
3904,CE,475,475,1837,535,1954,3905,1362,C
3904,DE,2500,663,2500,7721,7721,3905,0,E
3904,DF,5515,4852,7352,2880,4834,3905,1837,D
3904,F,5281,429,7781,150,7871,3905,2500,F
3904,G,1286,1286,9067,395,8266,3905,7781,G
3904,F,6029,6029,15096,7010,15276,3905,9067,F
3904,G,820,820,15916,280,15556,3905,15096,G
3904,H,44645,44645,60561,240,15796,3905,15916,H
3904,M,679,679,61240,1446,17242,3905,60561,M
3904,N,947,947,62187,240,17482,3905,61240,N
3904,O,460,460,62647,185,17667,3905,62187,O
3904,P,4772,4772,67419,660,18327,3905,62647,P
3905,AEI,70,70,70,757,757,3906,0,A
3905,BEI,92,22,92,2266,2266,3906,0,E
3905,BFI,106,14,106,848,848,3906,0,I
3905,BFJ,867,831,937,150,907,3906,70,B
3905,CFJ,922,91,1028,240,1088,3906,106,J
3905,CFK,506,415,1443,610,1517,3906,937,C
3905,DFK,582,167,1610,740,1828,3906,1028,K
3905,DFL,899,732,2342,4230,5747,3906,1443,D
3905,FL,2354,104,2446,240,2506,3906,92,F
3905,GL,504,504,2950,740,3246,3906,2446,G
3905,HL,13887,12547,15497,5100,6928,3906,1610,L
3905,H,35626,23079,38576,5100,8346,3906,2950,H
3905,M,2319,2319,40895,3341,11687,3906,38576,M
3905,N,1042,1042,41937,90,11777,3906,40895,N
3905,O,647,647,42584,805,12582,3906,41937,O
3905,N,1161,1161,43745,990,13572,3906,42584,N
3905,O,470,470,44215,850,14422,3906,43745,O
3905,P,415,415,44630,3780,18202,3906,44215,P
3906,AEI,37,37,37,224,224,3907,0,E
3906,AFI,125,88,125,109,109,3907,0,A
3906,BFI,152,27,152,339,339,3907,0,I
3906,BFJ,48,21,173,120,229,3907,125,B
3906,CFJ,281,145,318,135,359,3907,37,F
3906,CGJ,303,158,476,210,439,3907,173,C
3906,DGJ,375,51,527,240,579,3907,152,J
3906,DGK,226,17,544,285,644,3907,318,G
3906,DHK,210,193,737,290,869,3907,527,K
3906,DHL,194,1,738,5160,5804,3907,544,H
3906,DL,736,474,1212,2880,3319,3907,476,D
3906,L,1257,782,1994,5160,6029,3907,737,L
3906,M,773,773,2767,1241,7270,3907,1994,M
3906,N,619,619,3386,180,7450,3907,2767,N
3906,O,683,683,4069,885,8335,3907,3386,O
3906,N,1883,1883,5952,1680,10015,3907,4069,N
3906,O,859,859,6811,1125,11140,3907,5952,O
3906,P,923,923,7734,5220,16360,3907,6811,P
3907,A,17,17,17,189,189,3908,0,A
3907,B,253,253,270,135,324,3908,17,B
3907,C,286,286,556,280,604,3908,270,C
3907,D,178,178,734,5160,5764,3908,556,D
3907,M,524,524,1258,1157,6921,3908,734,M
3907,N,423,423,1681,180,7101,3908,1258,N
3907,O,758,758,2439,885,7986,3908,1681,O
3907,P,842,842,3281,6680,14666,3908,2439,P
3908,AEI,4,4,4,242,242,3909,0,I
3908,AEJ,68,64,68,153,153,3909,0,A
3908,BEJ,82,14,82,95,95,3909,0,E
3908,BFJ,94,94,176,135,230,3909,82,F
3908,BGJ,179,71,247,135,288,3909,68,B
3908,CGJ,315,72,319,135,377,3909,4,J
3908,CGK,185,42,361,285,515,3909,176,G
3908,CHK,152,110,471,280,657,3909,319,K
3908,CHL,373,149,620,290,578,3909,247,C
3908,DHL,349,90,710,5160,5675,3909,361,H
3908,DL,133,43,753,5160,5738,3909,620,D
3908,L,298,16,769,5160,5817,3909,471,L
3908,M,1731,1731,2500,1677,7494,3909,769,M
3908,N,143,143,2643,240,7734,3909,2500,N
3908,O,111,111,2754,380,8114,3909,2643,O
3908,N,941,941,3695,670,8784,3909,2754,N
3908,O,643,643,4338,825,9609,3909,3695,O
3908,P,1768,1768,6106,3960,13569,3909,4338,P
3909,AE,139,139,139,347,347,3910,0,E
3909,AF,215,76,215,371,371,3910,0,A
3909,BF,100,24,239,90,437,3910,139,F
3909,BG,241,217,456,130,501,3910,215,B
3909,CG,771,554,1010,900,1337,3910,239,G
3909,CF,902,348,1358,940,1441,3910,456,C
3909,BF,797,449,1807,510,1847,3910,1010,F
3909,BG,885,885,2692,2174,4021,3910,1807,G
3909,BH,530,530,3222,896,4917,3910,2692,H
3909,B,1998,134,3356,1935,3376,3910,1358,B
3909,C,858,858,4214,2049,5425,3910,3356,C
3909,D,695,695,4909,886,6311,3910,4214,D
3909,M,3013,3013,7922,3370,9681,3910,4909,M
3909,N,1072,1072,8994,715,10396,3910,7922,N
3909,O,939,939,9933,921,11317,3910,8994,O
3909,N,1369,1369,11302,1394,12711,3910,9933,N
3909,O,844,844,12146,1114,13825,3910,11302,O
3909,P,2848,2848,14994,341,14166,3910,12146,P
3910,AEI,247,247,247,686,686,3911,0,A
3910,BEI,298,51,298,1159,1159,3911,0,E
3910,BFI,1044,1044,1342,240,1399,3911,298,F
3910,BGI,1232,137,1479,240,926,3911,247,B
3910,BGI,1479,0,1479,1935,1935,3911,0,I
3910,CGJ,190,53,1532,585,1984,3911,1342,G
3910,CHJ,472,419,1951,845,1771,3911,1479,C
3910,DHJ,606,134,2085,240,2175,3911,1479,J
3910,DHK,395,395,2480,845,3020,3911,2085,K
3910,DHL,457,457,2937,3720,6740,3911,2480,L
3910,DH,1150,164,3101,3720,5491,3911,1951,D
3910,H,37256,35687,38788,5100,7084,3911,1532,H
3910,M,458,458,39246,2918,10002,3911,38788,M
3910,N,2490,2490,41736,90,10092,3911,39246,N
3910,O,796,796,42532,1170,11262,3911,41736,O
3910,N,758,758,43290,370,11632,3911,42532,N
3910,O,547,547,43837,945,12577,3911,43290,O
3910,P,199,199,44036,3780,16357,3911,43837,P
3911,AEI,31,31,31,62,62,3912,0,E
3911,AFI,61,30,61,87,87,3912,0,I
3911,AFJ,113,83,144,135,197,3912,31,F
3911,AGJ,103,20,164,135,222,3912,61,J
3911,AGK,195,31,195,199,199,3912,0,A
3911,BGK,166,115,310,295,492,3912,144,G
3911,BHK,156,10,320,290,512,3912,164,K
3911,BHL,136,11,331,135,334,3912,195,B
3911,CHL,128,117,448,5160,5672,3912,320,L
3911,CH,129,12,460,280,614,3912,331,C
3911,DH,199,49,509,5160,5652,3912,310,H
3911,D,159,110,619,5160,5774,3912,460,D
3911,M,310,310,929,456,6230,3912,619,M
3911,N,253,253,1182,150,6380,3912,929,N
3911,O,51,51,1233,100,6480,3912,1182,O
3911,N,346,346,1579,255,6735,3912,1233,N
3911,O,214,214,1793,520,7255,3912,1579,O
3911,P,1218,1218,3011,6150,13405,3912,1793,P
3912,A,20,20,20,258,258,3913,0,A
3912,B,314,314,334,135,393,3913,20,B
3912,C,146,146,480,280,673,3913,334,C
3912,D,310,310,790,5160,5833,3913,480,D
3912,M,1819,1819,2609,2058,7891,3913,790,M
3912,N,608,608,3217,420,8311,3913,2609,N
3912,O,75,75,3292,100,8411,3913,3217,O
3912,N,281,281,3573,255,8666,3913,3292,N
3912,O,202,202,3775,520,9186,3913,3573,O
3912,P,1149,1149,4924,6150,15336,3913,3775,P
3913,AEI,7,7,7,107,107,3914,0,I
3913,AEJ,33,26,33,61,61,3914,0,E
3913,AFJ,76,43,76,187,187,3914,0,A
3913,BFJ,100,57,133,135,196,3914,33,F
3913,BGJ,182,56,189,135,242,3914,7,J
3913,BGK,189,76,265,135,322,3914,76,B
3913,CGK,232,100,365,295,491,3914,133,G
3913,CHK,221,45,410,285,527,3914,189,K
3913,CHL,212,67,477,285,607,3914,265,C
3913,DHL,167,55,532,5160,5651,3914,365,H
3913,DL,84,29,561,5160,5767,3914,477,D
3913,L,160,9,570,5160,5687,3914,410,L
3913,M,490,490,1060,364,6131,3914,570,M
3913,N,224,224,1284,420,6551,3914,1060,N
3913,O,46,46,1330,100,6651,3914,1284,O
3913,N,463,463,1793,385,7036,3914,1330,N
3913,O,186,186,1979,225,7261,3914,1793,O
3913,P,4459,4459,6438,4740,12001,3914,1979,P
3914,AE,190,190,190,911,911,3915,0,A
3914,BE,632,442,632,1234,1234,3915,0,E
3914,BF,920,478,1110,240,1151,3915,190,B
3914,CF,21,21,1131,415,1566,3915,1110,C
3914,DF,694,195,1326,150,1384,3915,632,F
3914,DG,73,73,1399,190,1574,3915,1326,G
3914,DH,199,199,1598,2880,4454,3915,1399,H
3914,D,7246,6779,8377,6060,7626,3915,1131,D
3914,M,2261,2261,10638,3021,10647,3915,8377,M
3914,N,955,955,11593,240,10887,3915,10638,N
3914,O,156,156,11749,415,11302,3915,11593,O
3914,N,1511,1511,13260,1215,12517,3915,11749,N
3914,O,446,446,13706,560,13077,3915,13260,O
3914,P,8501,8501,22207,3960,17037,3915,13706,P
3915,AE,117,117,117,1045,1045,3916,0,E
3915,AF,236,119,236,1412,1412,3916,0,A
3915,BF,1111,992,1228,240,1285,3916,117,F
3915,BG,1355,363,1591,240,1652,3916,236,B
3915,CG,691,328,1919,760,2045,3916,1228,G
3915,CH,845,517,2436,760,2412,3916,1591,C
3915,DH,673,673,3109,7680,10092,3916,2436,D
3915,H,1474,284,3393,7680,9725,3916,1919,H
3915,M,2709,2709,6102,6022,16114,3916,3393,M
3915,N,3433,3433,9535,180,16294,3916,6102,N
3915,O,995,995,10530,1290,17584,3916,9535,O
3915,P,17970,17970,28500,6680,24264,3916,10530,P
3916,AEI,96,96,96,129,129,3917,0,I
3916,AEJ,169,73,169,523,523,3917,0,A
3916,BEJ,107,34,203,135,264,3917,96,J
3916,BEK,353,150,353,556,556,3917,0,E
3916,BFK,221,71,424,380,644,3917,203,K
3916,BFL,364,109,533,120,643,3917,169,B
3916,CFL,213,33,566,120,676,3917,353,F
3916,CGL,87,54,620,90,733,3917,533,C
3916,BGL,101,47,667,90,766,3917,566,G
3916,BFL,644,597,1264,590,1323,3917,620,B
3916,CFL,631,34,1298,590,1356,3917,667,F
3916,CGL,967,93,1391,5460,6104,3917,424,L
3916,CG,215,88,1479,385,1708,3917,1264,C
3916,DG,249,68,1547,385,1741,3917,1298,G
3916,DH,130,62,1609,5460,7168,3917,1479,D
3916,H,193,131,1740,5460,7201,3917,1547,H
3916,M,383,383,2123,1122,8323,3917,1740,M
3916,N,843,843,2966,150,8473,3917,2123,N
3916,O,209,209,3175,185,8658,3917,2966,O
3916,N,330,330,3505,355,9013,3917,3175,N
3916,O,120,120,3625,120,9133,3917,3505,O
3916,P,1093,1093,4718,4230,13363,3917,3625,P
3917,AE,167,167,167,1078,1078,3918,0,E
3917,AF,1260,1093,1260,894,894,3918,0,A
3917,BF,1116,23,1283,240,1318,3918,167,F
3917,BG,363,340,1623,780,1674,3918,1260,B
3917,CG,602,262,1885,895,2213,3918,1283,G
3917,CH,740,478,2363,1162,2836,3918,1623,C
3917,DH,1610,1132,3495,3960,6173,3918,1885,H
3917,D,3695,2563,6058,513,3349,3918,2363,D
3917,M,1620,1620,7678,2651,8824,3918,6058,M
3917,N,1282,1282,8960,300,9124,3918,7678,N
3917,O,614,614,9574,685,9809,3918,8960,O
3917,N,360,360,9934,300,10109,3918,9574,N
3917,O,1108,1108,11042,1200,11309,3918,9934,O
3917,P,3212,3212,14254,6990,18299,3918,11042,P
3918,AE,71,71,71,152,152,3919,0,A
3918,BE,238,167,238,335,335,3919,0,E
3918,BF,277,110,348,240,392,3919,71,B
3918,CF,781,671,1019,730,1065,3919,238,F
3918,CG,732,61,1080,960,1352,3919,348,C
3918,DG,142,142,1222,3960,5312,3919,1080,D
3918,G,996,793,2015,925,1990,3919,1019,G
3918,H,2465,2465,4480,2760,4750,3919,2015,H
3918,M,491,491,4971,1370,6682,3919,4480,M
3918,N,1125,1125,6096,300,6982,3919,4971,N
3918,O,1606,1606,7702,995,7977,3919,6096,O
3918,N,1121,1121,8823,1735,9712,3919,7702,N
3918,O,332,332,9155,660,10372,3919,8823,O
3918,P,1467,1467,10622,3960,14332,3919,9155,P
3919,A,93,93,93,246,246,3920,0,A
3919,B,229,229,322,135,381,3920,93,B
3919,C,340,340,662,285,666,3920,322,C
3919,D,103,103,765,5160,5826,3920,662,D
3919,M,2059,2059,2824,2544,8370,3920,765,M
3919,N,627,627,3451,180,8550,3920,2824,N
3919,O,924,924,4375,885,9435,3920,3451,O
3919,N,1289,1289,5664,1350,10785,3920,4375,N
3919,O,572,572,6236,620,11405,3920,5664,O
3919,P,89,89,6325,6960,18365,3920,6236,P
3920,AEI,26,26,26,266,266,3921,0,E
3920,AFI,32,6,32,188,188,3921,0,A
3920,BFI,250,250,282,135,323,3921,32,B
3920,CFI,315,59,341,135,401,3921,26,F
3920,CGI,151,151,492,280,681,3921,341,G
3920,CHI,227,17,509,285,608,3921,282,C
3920,DHI,194,194,703,5160,5768,3921,509,D
3920,HI,310,99,802,5160,5841,3921,492,H
3920,I,8870,8068,8870,9065,9065,3921,0,I
3920,J,465,465,9335,300,9365,3921,8870,J
3920,K,690,690,10025,700,10065,3921,9335,K
3920,L,198,198,10223,1140,11205,3921,10025,L
3920,M,680,680,10903,810,12015,3921,10223,M
3920,N,451,451,11354,360,12375,3921,10903,N
3920,O,618,618,11972,775,13150,3921,11354,O
3920,P,5741,5741,17713,1140,14290,3921,11972,P
3921,AEI,219,219,219,285,285,3922,0,I
3921,AEJ,345,345,564,300,585,3922,219,J
3921,AEK,738,174,738,1775,1775,3922,0,A
3921,BEK,559,385,1123,735,1320,3922,564,K
3921,BEL,197,197,1320,1560,2880,3922,1123,L
3921,BE,1329,747,2067,300,2075,3922,738,B
3921,CE,797,797,2864,840,2915,3922,2067,C
3921,DE,21,21,2885,1560,4475,3922,2864,D
3921,E,14852,11967,14852,14854,14854,3922,0,E
3921,F,299,299,15151,300,15154,3922,14852,F
3921,G,561,561,15712,735,15889,3922,15151,G
3921,H,107,107,15819,1560,17449,3922,15712,H
3921,M,1624,1624,17443,1873,19322,3922,15819,M
3921,N,411,411,17854,180,19502,3922,17443,N
3921,O,928,928,18782,815,20317,3922,17854,O
3921,N,1841,1841,20623,1880,22197,3922,18782,N
3921,O,607,607,21230,900,23097,3922,20623,O
3921,P,280,280,21510,3960,27057,3922,21230,P
3922,A,315,315,315,2175,2175,3923,0,A
3922,B,1907,1907,2222,90,2265,3923,315,B
3922,C,568,568,2790,805,3070,3923,2222,C
3922,B,643,643,3433,420,3490,3923,2790,B
3922,C,1797,1797,5230,1080,4570,3923,3433,C
3922,D,169,169,5399,3780,8350,3923,5230,D
3922,M,2742,2742,8141,3015,11365,3923,5399,M
3922,N,301,301,8442,90,11455,3923,8141,N
3922,O,963,963,9405,1130,12585,3923,8442,O
3922,N,558,558,9963,390,12975,3923,9405,N
3922,O,500,500,10463,790,13765,3923,9963,O
3922,P,1114,1114,11577,3780,17545,3923,10463,P
3923,AEI,77,77,77,355,355,3924,0,I
3923,AEJ,154,77,154,756,756,3924,0,E
3923,AFJ,469,392,546,240,595,3924,77,J
3923,AFK,870,478,1024,300,1056,3924,154,F
3923,AGK,639,161,1185,895,1490,3924,546,K
3923,AGL,1465,280,1465,2281,2281,3924,0,A
3923,BGL,1005,564,2029,810,1866,3924,1024,G
3923,BHL,1081,517,2546,300,2581,3924,1465,B
3923,CHL,1629,268,2814,3960,5450,3924,1185,L
3923,CH,1186,401,3215,4080,5946,3924,2029,H
3923,C,732,63,3278,810,3391,3924,2546,C
3923,D,330,330,3608,4080,7471,3924,3278,D
3923,M,443,443,4051,3385,10856,3924,3608,M
3923,N,3231,3231,7282,300,11156,3924,4051,N
3923,O,510,510,7792,1050,12206,3924,7282,O
3923,P,27517,27517,35309,9480,21686,3924,7792,P
3924,A,52,52,52,206,206,3925,0,A
3924,B,248,248,300,135,341,3925,52,B
3924,C,227,227,527,285,626,3925,300,C
3924,D,193,193,720,5160,5786,3925,527,D
3924,M,235,235,955,425,6211,3925,720,M
3924,N,292,292,1247,150,6361,3925,955,N
3924,O,92,92,1339,105,6466,3925,1247,O
3924,N,1405,1405,2744,1380,7846,3925,1339,N
3924,O,562,562,3306,585,8431,3925,2744,O
3924,P,17454,17454,20760,4230,12661,3925,3306,P
3925,AEI,57,57,57,88,88,3926,0,A
3925,AEI,57,0,57,213,213,3926,0,I
3925,BEJ,150,150,207,135,223,3926,57,B
3925,CEJ,232,82,289,135,348,3926,57,J
3925,CEK,141,59,348,295,518,3926,207,C
3925,DEK,195,195,543,5160,5678,3926,348,D
3925,DEK,254,0,543,280,628,3926,289,K
3925,EL,249,249,792,5160,5788,3926,543,L
3925,E,1038,246,1038,1060,1060,3926,0,E
3925,F,123,123,1161,150,1210,3926,1038,F
3925,G,224,224,1385,280,1490,3926,1161,G
3925,H,1837,1837,3222,5160,6650,3926,1385,H
3925,M,2079,2079,5301,2733,9383,3926,3222,M
3925,N,797,797,6098,180,9563,3926,5301,N
3925,O,815,815,6913,885,10448,3926,6098,O
3925,N,1142,1142,8055,1080,11528,3926,6913,N
3925,O,528,528,8583,620,12148,3926,8055,O
3925,P,956,956,9539,6960,19108,3926,8583,P
3926,AEI,61,61,61,308,308,3927,0,E
3926,AFI,186,125,186,259,259,3927,0,A
3926,BFI,186,186,372,150,409,3927,186,B
3926,CFI,356,45,417,150,458,3927,61,F
3926,CGI,158,113,530,130,539,3927,372,C
3926,BGI,163,50,580,135,593,3927,417,G
3926,BFI,1065,485,1065,1175,1175,3927,0,I
3926,BFJ,135,135,1200,90,1265,3927,1065,J
3926,BFK,879,209,1409,890,1429,3927,530,B
3926,CFK,847,18,1427,860,1453,3927,580,F
3926,CGK,445,218,1645,820,2085,3927,1200,K
3926,CGJ,651,651,2296,275,2360,3927,1645,J
3926,CGK,1230,343,2639,1290,2719,3927,1409,C
3926,DGK,1221,9,2648,1290,2743,3927,1427,G
3926,DHK,899,547,3195,1310,3670,3927,2296,K
3926,DHL,1772,1225,4420,3660,6403,3927,2648,H
3926,DL,1625,400,4820,3780,7450,3927,3195,L
3926,D,7578,5397,10217,3660,6379,3927,2639,D
3926,M,1655,1655,11872,1968,9418,3927,10217,M
3926,N,503,503,12375,240,9658,3927,11872,N
3926,O,1252,1252,13627,1005,10663,3927,12375,O
3926,N,1723,1723,15350,2165,12828,3927,13627,N
3926,O,858,858,16208,780,13608,3927,15350,O
3926,P,1294,1294,17502,3960,17568,3927,16208,P
3927,AE,86,86,86,154,154,3928,0,E
3927,AF,308,308,394,300,454,3928,86,F
3927,AG,652,652,1046,900,1354,3928,394,G
3927,AF,417,417,1463,145,1499,3928,1046,F
3927,AG,2067,604,2067,5844,5844,3928,0,A
3927,BG,651,47,2114,625,2124,3928,1463,G
3927,BH,988,988,3102,4080,6204,3928,2114,H
3927,B,3980,2945,6047,240,6084,3928,2067,B
3927,C,671,671,6718,750,6834,3928,6047,C
3927,D,2109,2109,8827,3960,10794,3928,6718,D
3927,M,125,125,8952,294,11088,3928,8827,M
3927,N,346,346,9298,240,11328,3928,8952,N
3927,O,633,633,9931,745,12073,3928,9298,O
3927,N,2232,2232,12163,2115,14188,3928,9931,N
3927,O,898,898,13061,945,15133,3928,12163,O
3927,P,620,620,13681,5160,20293,3928,13061,P
3928,AE,263,263,263,715,715,3929,0,E
3928,AF,635,635,898,240,955,3929,263,F
3928,AG,1557,659,1557,4614,4614,3929,0,A
3928,BG,942,283,1840,1200,2155,3929,898,G
3928,BF,751,751,2591,540,2695,3929,1840,F
3928,BG,251,251,2842,390,3085,3929,2591,G
3928,BH,247,247,3089,485,3570,3929,2842,H
3928,B,3192,1660,4749,195,4809,3929,1557,B
3928,C,714,714,5463,670,5479,3929,4749,C
3928,B,488,488,5951,555,6034,3929,5463,B
3928,C,203,203,6154,377,6411,3929,5951,C
3928,D,1451,1451,7605,863,7274,3929,6154,D
3928,M,281,281,7886,248,7522,3929,7605,M
3928,N,161,161,8047,240,7762,3929,7886,N
3928,O,260,260,8307,450,8212,3929,8047,O
3928,N,821,821,9128,645,8857,3929,8307,N
3928,O,907,907,10035,816,9673,3929,9128,O
3928,P,408,408,10443,584,10257,3929,10035,P
3929,A,15,15,15,55,55,3930,0,A
3929,B,140,140,155,150,205,3930,15,B
3929,C,61,61,216,163,368,3930,155,C
3929,D,933,933,1149,402,770,3930,216,D
3929,M,803,803,1952,1181,1951,3930,1149,M
3929,N,574,574,2526,240,2191,3930,1952,N
3929,O,2614,2614,5140,178,2369,3930,2526,O
3929,P,385,385,5525,2802,5171,3930,5140,P
3930,A,6,6,6,92,92,3931,0,A
3930,B,207,207,213,150,242,3931,6,B
3930,C,762,762,975,680,922,3931,213,C
3930,D,2752,2752,3727,3690,4612,3931,975,D
3930,M,289,289,4016,336,4948,3931,3727,M
3930,N,232,232,4248,240,5188,3931,4016,N
3930,O,129,129,4377,255,5443,3931,4248,O
3930,N,889,889,5266,765,6208,3931,4377,N
3930,O,472,472,5738,505,6713,3931,5266,O
3930,P,6984,6984,12722,6000,12713,3931,5738,P
3931,AE,650,650,650,1542,1542,3932,0,E
3931,AF,1460,810,1460,1783,1783,3932,0,A
3931,BF,517,517,1977,240,2023,3932,1460,B
3931,CF,1359,32,2009,600,2142,3932,650,F
3931,CG,851,819,2828,976,2999,3932,1977,C
3931,BG,543,543,3371,375,3374,3932,2828,B
3931,CG,1392,30,3401,1255,3397,3932,2009,G
3931,CF,400,400,3801,485,3882,3932,3401,F
3931,CG,278,278,4079,322,4204,3932,3801,G
3931,CH,855,147,4226,1080,4454,3932,3371,C
3931,DH,543,396,4622,353,4557,3932,4079,H
3931,D,5738,5342,9964,3960,8414,3932,4226,D
3931,M,3474,3474,13438,3449,11863,3932,9964,M
3931,N,169,169,13607,240,12103,3932,13438,N
3931,O,260,260,13867,450,12553,3932,13607,O
3931,N,1002,1002,14869,805,13358,3932,13867,N
3931,O,998,998,15867,1175,14533,3932,14869,O
3931,P,2906,2906,18773,665,15198,3932,15867,P
3932,AEI,184,184,184,318,318,3933,0,A
3932,BEI,331,147,331,424,424,3933,0,E
3932,BFI,344,13,344,420,420,3933,0,I
3932,BFJ,199,199,543,780,1200,3933,344,J
3932,BFK,105,105,648,60,1260,3933,543,K
3932,BFJ,859,395,1043,780,1098,3933,184,B
3932,CFJ,63,63,1106,60,1158,3933,1043,C
3932,BFJ,783,8,1114,780,1204,3933,331,F
3932,BGJ,139,139,1253,270,1474,3933,1114,G
3932,BFJ,267,120,1373,205,1363,3933,1106,B
3932,CFJ,755,30,1403,205,1465,3933,648,J
3932,CFK,658,628,2031,745,2108,3933,1373,C
3932,DFK,739,111,2142,745,2210,3933,1403,K
3932,DFL,1659,770,2912,1490,2964,3933,1253,F
3932,DGL,695,695,3607,1315,4279,3933,2912,G
3932,DHL,2400,935,4542,2820,5030,3933,2142,L
3932,DH,3951,1440,5982,2820,4928,3933,2031,D
3932,H,3064,689,6671,3480,7759,3933,3607,H
3932,M,575,575,7246,1205,8964,3933,6671,M
3932,N,649,649,7895,90,9054,3933,7246,N
3932,O,1204,1204,9099,1600,10654,3933,7895,O
3932,N,1029,1029,10128,610,11264,3933,9099,N
3932,O,658,658,10786,890,12154,3933,10128,O
3932,P,1130,1130,11916,3780,15934,3933,10786,P
3933,A,151,151,151,145,145,3934,0,A
3933,B,49,49,200,120,265,3934,151,B
3933,C,175,175,375,125,390,3934,200,C
3933,D,3791,3791,4166,2880,3270,3934,375,D
3933,M,79,79,4245,639,3909,3934,4166,M
3933,N,703,703,4948,180,4089,3934,4245,N
3933,O,162,162,5110,220,4309,3934,4948,O
3933,N,1493,1493,6603,1415,5724,3934,5110,N
3933,O,415,415,7018,740,6464,3934,6603,O
3933,N,495,495,7513,545,7009,3934,7018,N
3933,O,2112,2112,9625,780,7789,3934,7513,O
3933,P,5798,5798,15423,3900,11689,3934,9625,P
3934,AEI,8,8,8,1362,1362,3935,0,A
3934,BEI,88,80,88,1223,1223,3935,0,I
3934,BEJ,379,291,379,430,430,3935,0,E
3934,BFJ,151,151,530,150,580,3935,379,F
3934,BGJ,481,481,1011,480,1060,3935,530,G
3934,BFJ,185,185,1196,195,1255,3935,1011,F
3934,BGJ,1325,217,1413,240,1463,3935,88,J
3934,BGK,1553,148,1561,240,1602,3935,8,B
3934,CGK,590,225,1786,635,1890,3935,1196,G
3934,CHK,359,359,2145,2880,4770,3935,1786,H
3934,CK,831,99,2244,760,2223,3935,1413,K
3934,CL,760,77,2321,760,2362,3935,1561,C
3934,DL,1151,1074,3395,7680,9903,3935,2244,L
3934,D,2586,1512,4907,7680,10042,3935,2321,D
3934,M,2,2,4909,345,10387,3935,4907,M
3934,N,572,572,5481,300,10687,3935,4909,N
3934,O,627,627,6108,820,11507,3935,5481,O
3934,N,2740,2740,8848,2510,14017,3935,6108,N
3934,O,323,323,9171,535,14552,3935,8848,O
3934,P,8647,8647,17818,2880,17432,3935,9171,P
3935,AE,113,113,113,675,675,3936,0,A
3935,BE,240,127,240,318,318,3936,0,E
3935,BF,268,268,508,180,498,3936,240,F
3935,BG,260,260,768,660,1158,3936,508,G
3935,BF,741,86,854,240,915,3936,113,B
3935,CF,197,197,1051,260,1175,3936,854,C
3935,DF,226,226,1277,5160,6335,3936,1051,D
3935,F,584,75,1352,255,1413,3936,768,F
3935,G,226,226,1578,280,1693,3936,1352,G
3935,H,3822,3822,5400,4050,5743,3936,1578,H
3935,M,215,215,5615,2644,8979,3936,5400,M
3935,N,2525,2525,8140,155,9134,3936,5615,N
3935,O,691,691,8831,775,9909,3936,8140,O
3935,P,1734,1734,10565,2820,12729,3936,8831,P
3936,AE,195,195,195,1111,1111,3937,0,E
3936,AF,1016,1016,1211,150,1261,3937,195,F
3936,AG,137,137,1348,370,1631,3937,1211,G
3936,AF,575,575,1923,325,1956,3937,1348,F
3936,AG,860,860,2783,590,2546,3937,1923,G
3936,AH,3941,1158,3941,4772,4772,3937,0,A
3936,BH,860,860,4801,90,4862,3937,3941,B
3936,CH,545,545,5346,845,5707,3937,4801,C
3936,DH,390,390,5736,3780,9487,3937,5346,D
3936,H,7563,4610,10346,4230,6776,3937,2783,H
3936,M,203,203,10549,950,10437,3937,10346,M
3936,N,1008,1008,11557,300,10737,3937,10549,N
3936,O,896,896,12453,920,11657,3937,11557,O
3936,N,1528,1528,13981,1445,13102,3937,12453,N
3936,O,2136,2136,16117,2660,15762,3937,13981,O
3936,P,571,571,16688,3960,19722,3937,16117,P
3937,AEI,150,150,150,1055,1055,3938,0,I
3937,AEJ,360,210,360,703,703,3938,0,A
3937,BEJ,521,161,521,1044,1044,3938,0,E
3937,BFJ,493,332,853,210,913,3938,360,B
3937,CFJ,673,341,1194,210,1254,3938,521,F
3937,CGJ,1136,92,1286,240,1295,3938,150,J
3937,CGK,908,475,1761,1000,1913,3938,853,C
3937,BGK,543,68,1829,535,1830,3938,1286,K
3937,BGL,694,626,2455,605,2518,3938,1761,B
3937,CGL,1477,216,2671,1000,2254,3938,1194,G
3937,CFL,411,195,2866,535,3053,3938,2455,C
3937,DFL,1689,1494,4360,2165,4419,3938,2671,F
3937,DGL,560,560,4920,540,4959,3938,4360,G
3937,DHL,14211,12157,17077,2880,5933,3938,2866,D
3937,HL,16979,1731,18808,2880,4710,3938,1829,L
3937,H,25469,11581,30389,2880,7839,3938,4920,H
3937,M,1483,1483,31872,1726,9565,3938,30389,M
3937,N,423,423,32295,240,9805,3938,31872,N
3937,O,420,420,32715,195,10000,3938,32295,O
3937,N,2124,2124,34839,2460,12460,3938,32715,N
3937,O,197,197,35036,165,12625,3938,34839,O
3937,P,2512,2512,37548,300,12925,3938,35036,P
3938,AEI,19,19,19,122,122,3939,0,A
3938,BEI,278,278,297,240,362,3939,19,B
3938,CEI,761,761,1058,830,1192,3939,297,C
3938,DEI,2400,1342,2400,2562,2562,3939,0,E
3938,DFI,250,250,2650,90,2652,3939,2400,F
3938,DGI,632,632,3282,815,3467,3939,2650,G
3938,DFI,839,839,4121,705,4172,3939,3282,F
3938,DGI,3124,61,4182,5400,6592,3939,1058,D
3938,GI,213,152,4334,625,4797,3939,4121,G
3938,HI,5554,1220,5554,5712,5712,3939,0,I
3938,HJ,200,200,5754,90,5802,3939,5554,J
3938,HK,559,559,6313,820,6622,3939,5754,K
3938,HJ,321,321,6634,75,6697,3939,6313,J
3938,HK,227,227,6861,625,7322,3939,6634,K
3938,HL,4863,2336,9197,3780,8577,3939,4334,H
3938,L,4501,2165,11362,3780,11102,3939,6861,L
3938,M,3135,3135,14497,3019,14121,3939,11362,M
3938,N,64,64,14561,240,14361,3939,14497,N
3938,O,1393,1393,15954,1555,15916,3939,14561,O
3938,N,3255,3255,19209,3090,19006,3939,15954,N
3938,O,1005,1005,20214,2280,21286,3939,19209,O
3938,P,1300,1300,21514,1665,22951,3939,20214,P
3939,A,413,413,413,2028,2028,3940,0,A
3939,B,1825,1825,2238,270,2298,3940,413,B
3939,C,2535,2535,4773,2610,4908,3940,2238,C
3939,B,3005,3005,7778,2915,7823,3940,4773,B
3939,C,916,916,8694,1160,8983,3940,7778,C
3939,D,1148,1148,9842,635,9618,3940,8694,D
3939,M,1858,1858,11700,2003,11621,3940,9842,M
3939,N,177,177,11877,90,11711,3940,11700,N
3939,O,855,855,12732,1145,12856,3940,11877,O
3939,N,692,692,13424,370,13226,3940,12732,N
3939,O,752,752,14176,1080,14306,3940,13424,O
3939,P,807,807,14983,3780,18086,3940,14176,P
3940,A,178,178,178,1356,1356,3941,0,A
3940,B,1359,1359,1537,240,1596,3941,178,B
3940,C,716,716,2253,760,2356,3941,1537,C
3940,D,4125,4125,6378,7680,10036,3941,2253,D
3940,M,249,249,6627,348,10384,3941,6378,M
3940,N,327,327,6954,300,10684,3941,6627,N
3940,O,703,703,7657,820,11504,3941,6954,O
3940,N,1348,1348,9005,1245,12749,3941,7657,N
3940,O,333,333,9338,430,13179,3941,9005,O
3940,P,4381,4381,13719,5100,18279,3941,9338,P
3941,AE,532,532,532,1427,1427,3942,0,E
3941,AF,919,919,1451,90,1517,3942,532,F
3941,AG,1856,405,1856,2692,2692,3942,0,A
3941,BG,578,173,2029,880,2397,3942,1451,G
3941,BF,867,694,2723,90,2782,3942,1856,B
3941,CF,1531,837,3560,1225,3622,3942,2029,F
3941,CG,1049,212,3772,1060,3842,3942,2723,C
3941,DG,762,550,4322,1060,4682,3942,3560,G
3941,DH,1317,767,5089,3780,7622,3942,3772,D
3941,H,968,201,5290,3780,8462,3942,4322,H
3941,M,5633,5633,10923,5939,14401,3942,5290,M
3941,N,330,330,11253,90,14491,3942,10923,N
3941,O,916,916,12169,1105,15596,3942,11253,O
3941,N,576,576,12745,380,15976,3942,12169,N
3941,O,384,384,13129,800,16776,3942,12745,O
3941,P,945,945,14074,3780,20556,3942,13129,P
